ID_Pedido,Data_Pedido,Tempo_Separacao,Tempo_Expedicao,Tipo_Produto,Quantidade,Tempo_Total_Processamento
1,2025-01-01 00:00:00,92,93,Brinquedo,2,185
2,2025-01-01 01:00:00,95,67,Vestuário,5,162
3,2025-01-01 02:00:00,114,23,Vestuário,9,137
4,2025-01-01 03:00:00,86,28,Alimento,2,114
5,2025-01-01 04:00:00,78,126,Brinquedo,6,204
6,2025-01-01 05:00:00,36,85,Móvel,4,121
7,2025-01-01 06:00:00,62,96,Vestuário,2,158
8,2025-01-01 07:00:00,73,112,Eletrônico,7,185
9,2025-01-01 08:00:00,90,11,Brinquedo,4,101
10,2025-01-01 09:00:00,113,165,Eletrônico,9,278
11,2025-01-01 10:00:00,79,94,Alimento,8,173
12,2025-01-01 11:00:00,101,151,Eletrônico,6,252
13,2025-01-01 12:00:00,95,25,Alimento,5,120
14,2025-01-01 13:00:00,114,20,Móvel,3,134
15,2025-01-01 14:00:00,99,88,Alimento,8,187
16,2025-01-01 15:00:00,71,52,Alimento,1,123
17,2025-01-01 16:00:00,34,80,Vestuário,7,114
18,2025-01-01 17:00:00,103,63,Brinquedo,5,166
19,2025-01-01 18:00:00,14,60,Móvel,8,74
20,2025-01-01 19:00:00,67,114,Móvel,4,181
21,2025-01-01 20:00:00,108,26,Alimento,4,134
22,2025-01-01 21:00:00,16,85,Vestuário,7,101
23,2025-01-01 22:00:00,13,35,Brinquedo,5,48
24,2025-01-01 23:00:00,81,156,Alimento,7,237
25,2025-01-02 00:00:00,88,55,Brinquedo,1,143
26,2025-01-02 01:00:00,83,80,Eletrônico,5,163
27,2025-01-02 02:00:00,49,45,Móvel,1,94
28,2025-01-02 03:00:00,92,83,Móvel,6,175
29,2025-01-02 04:00:00,43,176,Eletrônico,4,219
30,2025-01-02 05:00:00,40,175,Alimento,9,215
31,2025-01-02 06:00:00,98,155,Alimento,9,253
32,2025-01-02 07:00:00,38,109,Alimento,1,147
33,2025-01-02 08:00:00,114,100,Eletrônico,2,214
34,2025-01-02 09:00:00,21,80,Brinquedo,9,101
35,2025-01-02 10:00:00,94,156,Vestuário,8,250
36,2025-01-02 11:00:00,55,93,Móvel,4,148
37,2025-01-02 12:00:00,92,17,Vestuário,9,109
38,2025-01-02 13:00:00,21,150,Móvel,8,171
39,2025-01-02 14:00:00,113,129,Eletrônico,7,242
40,2025-01-02 15:00:00,52,85,Eletrônico,3,137
41,2025-01-02 16:00:00,25,24,Móvel,8,49
42,2025-01-02 17:00:00,79,32,Móvel,1,111
43,2025-01-02 18:00:00,48,50,Vestuário,1,98
44,2025-01-02 19:00:00,12,42,Brinquedo,2,54
45,2025-01-02 20:00:00,109,12,Brinquedo,3,121
46,2025-01-02 21:00:00,78,67,Vestuário,5,145
47,2025-01-02 22:00:00,101,45,Alimento,3,146
48,2025-01-02 23:00:00,18,88,Móvel,1,106
49,2025-01-03 00:00:00,59,164,Brinquedo,3,223
50,2025-01-03 01:00:00,96,59,Alimento,8,155
51,2025-01-03 02:00:00,87,14,Vestuário,3,101
52,2025-01-03 03:00:00,87,173,Vestuário,3,260
53,2025-01-03 04:00:00,112,134,Alimento,7,246
54,2025-01-03 05:00:00,10,111,Alimento,8,121
55,2025-01-03 06:00:00,108,116,Eletrônico,7,224
56,2025-01-03 07:00:00,47,134,Eletrônico,9,181
57,2025-01-03 08:00:00,115,55,Alimento,2,170
58,2025-01-03 09:00:00,25,52,Vestuário,8,77
59,2025-01-03 10:00:00,39,21,Eletrônico,5,60
60,2025-01-03 11:00:00,118,53,Móvel,9,171
61,2025-01-03 12:00:00,91,138,Vestuário,9,229
62,2025-01-03 13:00:00,103,77,Alimento,1,180
63,2025-01-03 14:00:00,104,49,Alimento,3,153
64,2025-01-03 15:00:00,50,64,Alimento,5,114
65,2025-01-03 16:00:00,47,112,Brinquedo,6,159
66,2025-01-03 17:00:00,99,14,Móvel,5,113
67,2025-01-03 18:00:00,53,143,Brinquedo,3,196
68,2025-01-03 19:00:00,116,97,Alimento,9,213
69,2025-01-03 20:00:00,101,91,Eletrônico,7,192
70,2025-01-03 21:00:00,49,137,Móvel,5,186
71,2025-01-03 22:00:00,108,116,Alimento,6,224
72,2025-01-03 23:00:00,75,168,Móvel,8,243
73,2025-01-04 00:00:00,66,21,Brinquedo,8,87
74,2025-01-04 01:00:00,25,119,Alimento,2,144
75,2025-01-04 02:00:00,43,67,Eletrônico,3,110
76,2025-01-04 03:00:00,36,79,Móvel,3,115
77,2025-01-04 04:00:00,117,36,Móvel,9,153
78,2025-01-04 05:00:00,31,96,Vestuário,1,127
79,2025-01-04 06:00:00,74,159,Alimento,2,233
80,2025-01-04 07:00:00,52,98,Vestuário,5,150
81,2025-01-04 08:00:00,62,124,Vestuário,9,186
82,2025-01-04 09:00:00,35,80,Eletrônico,5,115
83,2025-01-04 10:00:00,26,35,Alimento,1,61
84,2025-01-04 11:00:00,47,117,Móvel,5,164
85,2025-01-04 12:00:00,103,161,Vestuário,6,264
86,2025-01-04 13:00:00,51,59,Brinquedo,4,110
87,2025-01-04 14:00:00,35,54,Móvel,6,89
88,2025-01-04 15:00:00,63,150,Móvel,7,213
89,2025-01-04 16:00:00,42,162,Vestuário,5,204
90,2025-01-04 17:00:00,66,89,Móvel,2,155
91,2025-01-04 18:00:00,79,143,Vestuário,5,222
92,2025-01-04 19:00:00,17,17,Brinquedo,4,34
93,2025-01-04 20:00:00,93,53,Alimento,4,146
94,2025-01-04 21:00:00,100,48,Alimento,4,148
95,2025-01-04 22:00:00,40,14,Eletrônico,9,54
96,2025-01-04 23:00:00,90,101,Brinquedo,2,191
97,2025-01-05 00:00:00,107,65,Móvel,8,172
98,2025-01-05 01:00:00,27,178,Vestuário,3,205
99,2025-01-05 02:00:00,76,30,Alimento,6,106
100,2025-01-05 03:00:00,109,162,Brinquedo,1,271
101,2025-01-05 04:00:00,85,134,Alimento,2,219
102,2025-01-05 05:00:00,117,38,Móvel,7,155
103,2025-01-05 06:00:00,105,16,Vestuário,1,121
104,2025-01-05 07:00:00,111,159,Móvel,2,270
105,2025-01-05 08:00:00,75,129,Móvel,1,204
106,2025-01-05 09:00:00,54,80,Móvel,8,134
107,2025-01-05 10:00:00,81,80,Alimento,3,161
108,2025-01-05 11:00:00,89,58,Alimento,6,147
109,2025-01-05 12:00:00,119,91,Brinquedo,5,210
110,2025-01-05 13:00:00,35,172,Brinquedo,6,207
111,2025-01-05 14:00:00,74,123,Vestuário,3,197
112,2025-01-05 15:00:00,102,55,Brinquedo,2,157
113,2025-01-05 16:00:00,16,91,Móvel,8,107
114,2025-01-05 17:00:00,52,46,Eletrônico,2,98
115,2025-01-05 18:00:00,33,142,Móvel,6,175
116,2025-01-05 19:00:00,66,84,Eletrônico,5,150
117,2025-01-05 20:00:00,36,118,Brinquedo,6,154
118,2025-01-05 21:00:00,12,50,Alimento,6,62
119,2025-01-05 22:00:00,74,166,Eletrônico,2,240
120,2025-01-05 23:00:00,110,75,Eletrônico,6,185
121,2025-01-06 00:00:00,62,137,Alimento,5,199
122,2025-01-06 01:00:00,111,12,Vestuário,5,123
123,2025-01-06 02:00:00,84,50,Móvel,3,134
124,2025-01-06 03:00:00,110,126,Brinquedo,2,236
125,2025-01-06 04:00:00,21,130,Vestuário,8,151
126,2025-01-06 05:00:00,59,119,Vestuário,6,178
127,2025-01-06 06:00:00,17,166,Móvel,7,183
128,2025-01-06 07:00:00,102,116,Vestuário,1,218
129,2025-01-06 08:00:00,19,125,Brinquedo,5,144
130,2025-01-06 09:00:00,60,99,Alimento,8,159
131,2025-01-06 10:00:00,113,160,Brinquedo,2,273
132,2025-01-06 11:00:00,73,12,Vestuário,8,85
133,2025-01-06 12:00:00,77,14,Eletrônico,2,91
134,2025-01-06 13:00:00,98,162,Alimento,6,260
135,2025-01-06 14:00:00,10,165,Vestuário,4,175
136,2025-01-06 15:00:00,52,66,Brinquedo,4,118
137,2025-01-06 16:00:00,85,178,Móvel,9,263
138,2025-01-06 17:00:00,60,29,Brinquedo,5,89
139,2025-01-06 18:00:00,13,136,Alimento,9,149
140,2025-01-06 19:00:00,44,61,Brinquedo,4,105
141,2025-01-06 20:00:00,113,75,Brinquedo,1,188
142,2025-01-06 21:00:00,75,52,Vestuário,8,127
143,2025-01-06 22:00:00,70,168,Vestuário,4,238
144,2025-01-06 23:00:00,46,29,Móvel,7,75
145,2025-01-07 00:00:00,16,162,Vestuário,9,178
146,2025-01-07 01:00:00,10,114,Eletrônico,6,124
147,2025-01-07 02:00:00,44,47,Móvel,9,91
148,2025-01-07 03:00:00,27,159,Eletrônico,5,186
149,2025-01-07 04:00:00,38,86,Vestuário,4,124
150,2025-01-07 05:00:00,75,24,Eletrônico,8,99
151,2025-01-07 06:00:00,100,101,Móvel,8,201
152,2025-01-07 07:00:00,68,11,Alimento,1,79
153,2025-01-07 08:00:00,77,26,Alimento,8,103
154,2025-01-07 09:00:00,85,113,Móvel,2,198
155,2025-01-07 10:00:00,88,125,Vestuário,9,213
156,2025-01-07 11:00:00,94,48,Eletrônico,7,142
157,2025-01-07 12:00:00,72,82,Eletrônico,1,154
158,2025-01-07 13:00:00,98,36,Eletrônico,5,134
159,2025-01-07 14:00:00,24,74,Brinquedo,8,98
160,2025-01-07 15:00:00,96,49,Brinquedo,9,145
161,2025-01-07 16:00:00,39,63,Alimento,9,102
162,2025-01-07 17:00:00,83,141,Móvel,2,224
163,2025-01-07 18:00:00,28,61,Móvel,5,89
164,2025-01-07 19:00:00,76,120,Móvel,2,196
165,2025-01-07 20:00:00,25,116,Brinquedo,7,141
166,2025-01-07 21:00:00,29,67,Vestuário,5,96
167,2025-01-07 22:00:00,82,162,Brinquedo,8,244
168,2025-01-07 23:00:00,113,37,Móvel,1,150
169,2025-01-08 00:00:00,31,60,Móvel,2,91
170,2025-01-08 01:00:00,57,74,Eletrônico,5,131
171,2025-01-08 02:00:00,28,155,Alimento,9,183
172,2025-01-08 03:00:00,55,14,Vestuário,4,69
173,2025-01-08 04:00:00,81,60,Vestuário,9,141
174,2025-01-08 05:00:00,117,150,Móvel,8,267
175,2025-01-08 06:00:00,107,163,Eletrônico,4,270
176,2025-01-08 07:00:00,88,146,Eletrônico,3,234
177,2025-01-08 08:00:00,87,37,Móvel,1,124
178,2025-01-08 09:00:00,53,39,Eletrônico,3,92
179,2025-01-08 10:00:00,95,88,Alimento,8,183
180,2025-01-08 11:00:00,84,73,Vestuário,7,157
181,2025-01-08 12:00:00,32,123,Vestuário,3,155
182,2025-01-08 13:00:00,42,153,Móvel,6,195
183,2025-01-08 14:00:00,30,166,Brinquedo,8,196
184,2025-01-08 15:00:00,72,121,Brinquedo,3,193
185,2025-01-08 16:00:00,66,102,Vestuário,3,168
186,2025-01-08 17:00:00,110,178,Alimento,6,288
187,2025-01-08 18:00:00,108,177,Eletrônico,5,285
188,2025-01-08 19:00:00,41,156,Alimento,7,197
189,2025-01-08 20:00:00,17,103,Móvel,7,120
190,2025-01-08 21:00:00,103,143,Brinquedo,1,246
191,2025-01-08 22:00:00,104,136,Brinquedo,7,240
192,2025-01-08 23:00:00,27,22,Brinquedo,8,49
193,2025-01-09 00:00:00,61,132,Brinquedo,1,193
194,2025-01-09 01:00:00,66,105,Vestuário,5,171
195,2025-01-09 02:00:00,62,27,Alimento,3,89
196,2025-01-09 03:00:00,24,26,Alimento,9,50
197,2025-01-09 04:00:00,52,109,Vestuário,4,161
198,2025-01-09 05:00:00,63,177,Brinquedo,8,240
199,2025-01-09 06:00:00,20,52,Vestuário,7,72
200,2025-01-09 07:00:00,106,150,Vestuário,2,256
201,2025-01-09 08:00:00,119,21,Brinquedo,4,140
202,2025-01-09 09:00:00,61,104,Vestuário,9,165
203,2025-01-09 10:00:00,38,47,Móvel,1,85
204,2025-01-09 11:00:00,22,43,Brinquedo,2,65
205,2025-01-09 12:00:00,113,150,Vestuário,1,263
206,2025-01-09 13:00:00,37,168,Vestuário,3,205
207,2025-01-09 14:00:00,47,139,Brinquedo,1,186
208,2025-01-09 15:00:00,79,93,Alimento,9,172
209,2025-01-09 16:00:00,63,138,Alimento,1,201
210,2025-01-09 17:00:00,55,32,Brinquedo,6,87
211,2025-01-09 18:00:00,19,125,Móvel,1,144
212,2025-01-09 19:00:00,97,12,Móvel,3,109
213,2025-01-09 20:00:00,31,139,Vestuário,7,170
214,2025-01-09 21:00:00,102,35,Brinquedo,4,137
215,2025-01-09 22:00:00,96,127,Brinquedo,1,223
216,2025-01-09 23:00:00,106,129,Alimento,4,235
217,2025-01-10 00:00:00,87,113,Móvel,5,200
218,2025-01-10 01:00:00,19,143,Móvel,7,162
219,2025-01-10 02:00:00,37,165,Eletrônico,1,202
220,2025-01-10 03:00:00,91,168,Brinquedo,6,259
221,2025-01-10 04:00:00,14,156,Brinquedo,5,170
222,2025-01-10 05:00:00,90,79,Móvel,1,169
223,2025-01-10 06:00:00,59,93,Vestuário,9,152
224,2025-01-10 07:00:00,32,26,Brinquedo,3,58
225,2025-01-10 08:00:00,10,179,Eletrônico,3,189
226,2025-01-10 09:00:00,27,128,Eletrônico,9,155
227,2025-01-10 10:00:00,33,34,Móvel,8,67
228,2025-01-10 11:00:00,72,58,Eletrônico,2,130
229,2025-01-10 12:00:00,32,173,Brinquedo,1,205
230,2025-01-10 13:00:00,11,177,Vestuário,3,188
231,2025-01-10 14:00:00,25,61,Eletrônico,7,86
232,2025-01-10 15:00:00,84,84,Alimento,5,168
233,2025-01-10 16:00:00,99,94,Eletrônico,9,193
234,2025-01-10 17:00:00,43,105,Brinquedo,1,148
235,2025-01-10 18:00:00,69,86,Vestuário,5,155
236,2025-01-10 19:00:00,53,69,Brinquedo,8,122
237,2025-01-10 20:00:00,94,166,Eletrônico,4,260
238,2025-01-10 21:00:00,72,178,Eletrônico,9,250
239,2025-01-10 22:00:00,55,51,Alimento,6,106
240,2025-01-10 23:00:00,100,129,Eletrônico,9,229
241,2025-01-11 00:00:00,59,135,Alimento,4,194
242,2025-01-11 01:00:00,21,77,Brinquedo,2,98
243,2025-01-11 02:00:00,111,89,Eletrônico,5,200
244,2025-01-11 03:00:00,41,165,Vestuário,8,206
245,2025-01-11 04:00:00,27,119,Móvel,6,146
246,2025-01-11 05:00:00,98,108,Alimento,1,206
247,2025-01-11 06:00:00,52,53,Alimento,3,105
248,2025-01-11 07:00:00,19,137,Eletrônico,5,156
249,2025-01-11 08:00:00,68,66,Móvel,9,134
250,2025-01-11 09:00:00,21,14,Vestuário,8,35
251,2025-01-11 10:00:00,102,124,Vestuário,7,226
252,2025-01-11 11:00:00,80,44,Brinquedo,8,124
253,2025-01-11 12:00:00,35,17,Brinquedo,1,52
254,2025-01-11 13:00:00,100,51,Eletrônico,3,151
255,2025-01-11 14:00:00,101,115,Eletrônico,1,216
256,2025-01-11 15:00:00,75,153,Móvel,5,228
257,2025-01-11 16:00:00,103,45,Móvel,6,148
258,2025-01-11 17:00:00,55,115,Alimento,1,170
259,2025-01-11 18:00:00,58,63,Móvel,2,121
260,2025-01-11 19:00:00,65,140,Alimento,2,205
261,2025-01-11 20:00:00,21,81,Brinquedo,6,102
262,2025-01-11 21:00:00,117,19,Alimento,5,136
263,2025-01-11 22:00:00,14,174,Móvel,1,188
264,2025-01-11 23:00:00,21,15,Móvel,1,36
265,2025-01-12 00:00:00,15,139,Vestuário,8,154
266,2025-01-12 01:00:00,73,15,Eletrônico,9,88
267,2025-01-12 02:00:00,63,49,Móvel,9,112
268,2025-01-12 03:00:00,56,178,Móvel,8,234
269,2025-01-12 04:00:00,60,124,Vestuário,5,184
270,2025-01-12 05:00:00,111,106,Vestuário,3,217
271,2025-01-12 06:00:00,90,47,Móvel,3,137
272,2025-01-12 07:00:00,108,140,Brinquedo,8,248
273,2025-01-12 08:00:00,42,137,Eletrônico,1,179
274,2025-01-12 09:00:00,64,167,Alimento,7,231
275,2025-01-12 10:00:00,108,84,Móvel,4,192
276,2025-01-12 11:00:00,51,170,Vestuário,7,221
277,2025-01-12 12:00:00,44,114,Eletrônico,7,158
278,2025-01-12 13:00:00,105,26,Móvel,8,131
279,2025-01-12 14:00:00,68,79,Eletrônico,2,147
280,2025-01-12 15:00:00,39,73,Brinquedo,8,112
281,2025-01-12 16:00:00,90,14,Móvel,9,104
282,2025-01-12 17:00:00,93,140,Vestuário,3,233
283,2025-01-12 18:00:00,112,72,Móvel,6,184
284,2025-01-12 19:00:00,114,175,Brinquedo,9,289
285,2025-01-12 20:00:00,10,38,Brinquedo,7,48
286,2025-01-12 21:00:00,21,85,Eletrônico,1,106
287,2025-01-12 22:00:00,119,32,Brinquedo,6,151
288,2025-01-12 23:00:00,19,158,Alimento,6,177
289,2025-01-13 00:00:00,39,150,Brinquedo,2,189
290,2025-01-13 01:00:00,109,152,Brinquedo,7,261
291,2025-01-13 02:00:00,33,142,Brinquedo,3,175
292,2025-01-13 03:00:00,88,167,Alimento,1,255
293,2025-01-13 04:00:00,54,123,Brinquedo,5,177
294,2025-01-13 05:00:00,92,150,Móvel,8,242
295,2025-01-13 06:00:00,101,78,Eletrônico,9,179
296,2025-01-13 07:00:00,69,94,Alimento,6,163
297,2025-01-13 08:00:00,90,149,Móvel,3,239
298,2025-01-13 09:00:00,35,153,Eletrônico,9,188
299,2025-01-13 10:00:00,83,53,Alimento,4,136
300,2025-01-13 11:00:00,10,167,Brinquedo,8,177
301,2025-01-13 12:00:00,86,125,Móvel,7,211
302,2025-01-13 13:00:00,22,101,Vestuário,3,123
303,2025-01-13 14:00:00,26,134,Alimento,9,160
304,2025-01-13 15:00:00,91,83,Eletrônico,4,174
305,2025-01-13 16:00:00,83,11,Alimento,8,94
306,2025-01-13 17:00:00,107,21,Alimento,9,128
307,2025-01-13 18:00:00,63,31,Móvel,5,94
308,2025-01-13 19:00:00,25,151,Móvel,1,176
309,2025-01-13 20:00:00,62,111,Brinquedo,5,173
310,2025-01-13 21:00:00,15,138,Eletrônico,5,153
311,2025-01-13 22:00:00,67,134,Móvel,6,201
312,2025-01-13 23:00:00,108,84,Brinquedo,4,192
313,2025-01-14 00:00:00,83,146,Alimento,6,229
314,2025-01-14 01:00:00,118,70,Eletrônico,8,188
315,2025-01-14 02:00:00,17,32,Vestuário,1,49
316,2025-01-14 03:00:00,39,44,Eletrônico,9,83
317,2025-01-14 04:00:00,33,85,Eletrônico,3,118
318,2025-01-14 05:00:00,17,61,Eletrônico,6,78
319,2025-01-14 06:00:00,18,24,Vestuário,6,42
320,2025-01-14 07:00:00,115,66,Brinquedo,2,181
321,2025-01-14 08:00:00,114,99,Brinquedo,2,213
322,2025-01-14 09:00:00,31,121,Vestuário,7,152
323,2025-01-14 10:00:00,31,133,Móvel,1,164
324,2025-01-14 11:00:00,37,115,Vestuário,9,152
325,2025-01-14 12:00:00,16,27,Brinquedo,7,43
326,2025-01-14 13:00:00,88,50,Eletrônico,9,138
327,2025-01-14 14:00:00,112,175,Eletrônico,8,287
328,2025-01-14 15:00:00,26,70,Móvel,9,96
329,2025-01-14 16:00:00,41,170,Alimento,3,211
330,2025-01-14 17:00:00,50,11,Alimento,2,61
331,2025-01-14 18:00:00,95,156,Brinquedo,8,251
332,2025-01-14 19:00:00,53,123,Eletrônico,5,176
333,2025-01-14 20:00:00,91,139,Móvel,1,230
334,2025-01-14 21:00:00,50,123,Brinquedo,3,173
335,2025-01-14 22:00:00,101,80,Vestuário,3,181
336,2025-01-14 23:00:00,67,152,Móvel,3,219
337,2025-01-15 00:00:00,106,115,Alimento,6,221
338,2025-01-15 01:00:00,105,150,Eletrônico,8,255
339,2025-01-15 02:00:00,100,96,Eletrônico,2,196
340,2025-01-15 03:00:00,116,135,Vestuário,3,251
341,2025-01-15 04:00:00,106,28,Móvel,6,134
342,2025-01-15 05:00:00,115,43,Vestuário,3,158
343,2025-01-15 06:00:00,83,44,Móvel,4,127
344,2025-01-15 07:00:00,110,131,Brinquedo,6,241
345,2025-01-15 08:00:00,95,83,Vestuário,3,178
346,2025-01-15 09:00:00,72,41,Vestuário,3,113
347,2025-01-15 10:00:00,92,36,Vestuário,7,128
348,2025-01-15 11:00:00,88,72,Vestuário,1,160
349,2025-01-15 12:00:00,27,145,Eletrônico,2,172
350,2025-01-15 13:00:00,39,98,Alimento,7,137
351,2025-01-15 14:00:00,80,68,Vestuário,9,148
352,2025-01-15 15:00:00,98,25,Móvel,5,123
353,2025-01-15 16:00:00,94,42,Alimento,7,136
354,2025-01-15 17:00:00,88,70,Vestuário,5,158
355,2025-01-15 18:00:00,79,50,Eletrônico,3,129
356,2025-01-15 19:00:00,82,162,Alimento,2,244
357,2025-01-15 20:00:00,46,147,Alimento,7,193
358,2025-01-15 21:00:00,30,164,Alimento,8,194
359,2025-01-15 22:00:00,72,121,Brinquedo,5,193
360,2025-01-15 23:00:00,110,10,Vestuário,4,120
361,2025-01-16 00:00:00,59,13,Móvel,3,72
362,2025-01-16 01:00:00,25,127,Alimento,1,152
363,2025-01-16 02:00:00,26,135,Vestuário,5,161
364,2025-01-16 03:00:00,65,27,Brinquedo,7,92
365,2025-01-16 04:00:00,59,44,Vestuário,8,103
366,2025-01-16 05:00:00,81,103,Vestuário,8,184
367,2025-01-16 06:00:00,48,164,Brinquedo,6,212
368,2025-01-16 07:00:00,95,19,Alimento,3,114
369,2025-01-16 08:00:00,31,25,Móvel,4,56
370,2025-01-16 09:00:00,109,159,Eletrônico,5,268
371,2025-01-16 10:00:00,111,23,Vestuário,1,134
372,2025-01-16 11:00:00,73,147,Móvel,4,220
373,2025-01-16 12:00:00,65,32,Alimento,7,97
374,2025-01-16 13:00:00,27,60,Móvel,8,87
375,2025-01-16 14:00:00,70,135,Móvel,8,205
376,2025-01-16 15:00:00,11,162,Brinquedo,5,173
377,2025-01-16 16:00:00,60,122,Vestuário,8,182
378,2025-01-16 17:00:00,112,33,Vestuário,3,145
379,2025-01-16 18:00:00,97,156,Alimento,1,253
380,2025-01-16 19:00:00,33,136,Alimento,7,169
381,2025-01-16 20:00:00,48,14,Eletrônico,3,62
382,2025-01-16 21:00:00,30,100,Eletrônico,5,130
383,2025-01-16 22:00:00,58,24,Alimento,3,82
384,2025-01-16 23:00:00,43,60,Vestuário,3,103
385,2025-01-17 00:00:00,80,117,Eletrônico,6,197
386,2025-01-17 01:00:00,87,107,Vestuário,3,194
387,2025-01-17 02:00:00,81,87,Brinquedo,9,168
388,2025-01-17 03:00:00,69,175,Móvel,3,244
389,2025-01-17 04:00:00,16,94,Móvel,4,110
390,2025-01-17 05:00:00,31,102,Alimento,2,133
391,2025-01-17 06:00:00,89,114,Alimento,1,203
392,2025-01-17 07:00:00,88,84,Alimento,7,172
393,2025-01-17 08:00:00,68,168,Brinquedo,8,236
394,2025-01-17 09:00:00,61,29,Brinquedo,4,90
395,2025-01-17 10:00:00,80,113,Eletrônico,3,193
396,2025-01-17 11:00:00,95,164,Eletrônico,8,259
397,2025-01-17 12:00:00,40,60,Vestuário,9,100
398,2025-01-17 13:00:00,27,30,Alimento,4,57
399,2025-01-17 14:00:00,36,173,Móvel,3,209
400,2025-01-17 15:00:00,62,96,Brinquedo,1,158
401,2025-01-17 16:00:00,65,134,Alimento,6,199
402,2025-01-17 17:00:00,86,51,Vestuário,5,137
403,2025-01-17 18:00:00,30,10,Alimento,2,40
404,2025-01-17 19:00:00,13,54,Vestuário,4,67
405,2025-01-17 20:00:00,36,98,Vestuário,7,134
406,2025-01-17 21:00:00,75,154,Vestuário,6,229
407,2025-01-17 22:00:00,28,83,Brinquedo,5,111
408,2025-01-17 23:00:00,36,115,Alimento,4,151
409,2025-01-18 00:00:00,24,98,Brinquedo,7,122
410,2025-01-18 01:00:00,87,135,Brinquedo,4,222
411,2025-01-18 02:00:00,105,110,Móvel,3,215
412,2025-01-18 03:00:00,80,80,Brinquedo,8,160
413,2025-01-18 04:00:00,109,153,Alimento,4,262
414,2025-01-18 05:00:00,19,115,Brinquedo,5,134
415,2025-01-18 06:00:00,88,121,Vestuário,9,209
416,2025-01-18 07:00:00,35,11,Móvel,4,46
417,2025-01-18 08:00:00,65,48,Vestuário,2,113
418,2025-01-18 09:00:00,95,57,Brinquedo,9,152
419,2025-01-18 10:00:00,71,175,Brinquedo,2,246
420,2025-01-18 11:00:00,110,152,Alimento,5,262
421,2025-01-18 12:00:00,22,174,Brinquedo,8,196
422,2025-01-18 13:00:00,20,31,Brinquedo,8,51
423,2025-01-18 14:00:00,102,18,Brinquedo,8,120
424,2025-01-18 15:00:00,68,74,Eletrônico,6,142
425,2025-01-18 16:00:00,112,111,Alimento,9,223
426,2025-01-18 17:00:00,30,54,Alimento,3,84
427,2025-01-18 18:00:00,69,136,Alimento,2,205
428,2025-01-18 19:00:00,55,146,Eletrônico,5,201
429,2025-01-18 20:00:00,37,49,Vestuário,9,86
430,2025-01-18 21:00:00,10,68,Alimento,5,78
431,2025-01-18 22:00:00,26,165,Vestuário,6,191
432,2025-01-18 23:00:00,76,116,Alimento,3,192
433,2025-01-19 00:00:00,35,31,Móvel,8,66
434,2025-01-19 01:00:00,36,48,Brinquedo,1,84
435,2025-01-19 02:00:00,64,58,Eletrônico,2,122
436,2025-01-19 03:00:00,40,62,Móvel,9,102
437,2025-01-19 04:00:00,22,13,Vestuário,9,35
438,2025-01-19 05:00:00,87,41,Eletrônico,9,128
439,2025-01-19 06:00:00,115,146,Brinquedo,3,261
440,2025-01-19 07:00:00,52,158,Brinquedo,6,210
441,2025-01-19 08:00:00,23,26,Vestuário,5,49
442,2025-01-19 09:00:00,103,152,Eletrônico,8,255
443,2025-01-19 10:00:00,115,110,Alimento,3,225
444,2025-01-19 11:00:00,15,45,Alimento,8,60
445,2025-01-19 12:00:00,63,139,Móvel,5,202
446,2025-01-19 13:00:00,69,142,Vestuário,7,211
447,2025-01-19 14:00:00,62,113,Brinquedo,7,175
448,2025-01-19 15:00:00,16,168,Vestuário,5,184
449,2025-01-19 16:00:00,15,57,Alimento,9,72
450,2025-01-19 17:00:00,29,44,Vestuário,7,73
451,2025-01-19 18:00:00,37,173,Móvel,8,210
452,2025-01-19 19:00:00,15,24,Eletrônico,3,39
453,2025-01-19 20:00:00,34,43,Alimento,7,77
454,2025-01-19 21:00:00,114,87,Eletrônico,3,201
455,2025-01-19 22:00:00,42,126,Alimento,4,168
456,2025-01-19 23:00:00,24,86,Vestuário,2,110
457,2025-01-20 00:00:00,108,174,Eletrônico,2,282
458,2025-01-20 01:00:00,44,107,Alimento,4,151
459,2025-01-20 02:00:00,87,48,Alimento,5,135
460,2025-01-20 03:00:00,49,73,Eletrônico,2,122
461,2025-01-20 04:00:00,77,162,Alimento,6,239
462,2025-01-20 05:00:00,15,63,Alimento,8,78
463,2025-01-20 06:00:00,22,48,Alimento,4,70
464,2025-01-20 07:00:00,34,102,Brinquedo,9,136
465,2025-01-20 08:00:00,84,166,Brinquedo,6,250
466,2025-01-20 09:00:00,104,112,Vestuário,1,216
467,2025-01-20 10:00:00,89,72,Brinquedo,8,161
468,2025-01-20 11:00:00,51,91,Brinquedo,9,142
469,2025-01-20 12:00:00,90,58,Eletrônico,7,148
470,2025-01-20 13:00:00,81,33,Vestuário,6,114
471,2025-01-20 14:00:00,111,82,Alimento,2,193
472,2025-01-20 15:00:00,92,31,Alimento,5,123
473,2025-01-20 16:00:00,66,90,Móvel,8,156
474,2025-01-20 17:00:00,46,137,Eletrônico,5,183
475,2025-01-20 18:00:00,34,116,Móvel,3,150
476,2025-01-20 19:00:00,12,34,Eletrônico,5,46
477,2025-01-20 20:00:00,26,42,Móvel,7,68
478,2025-01-20 21:00:00,84,40,Brinquedo,6,124
479,2025-01-20 22:00:00,98,124,Móvel,4,222
480,2025-01-20 23:00:00,15,119,Brinquedo,2,134
481,2025-01-21 00:00:00,116,171,Eletrônico,4,287
482,2025-01-21 01:00:00,89,128,Alimento,6,217
483,2025-01-21 02:00:00,51,15,Brinquedo,5,66
484,2025-01-21 03:00:00,103,115,Alimento,1,218
485,2025-01-21 04:00:00,31,107,Vestuário,9,138
486,2025-01-21 05:00:00,98,114,Móvel,9,212
487,2025-01-21 06:00:00,10,149,Vestuário,8,159
488,2025-01-21 07:00:00,73,134,Alimento,5,207
489,2025-01-21 08:00:00,73,76,Alimento,1,149
490,2025-01-21 09:00:00,59,121,Brinquedo,4,180
491,2025-01-21 10:00:00,56,175,Vestuário,1,231
492,2025-01-21 11:00:00,78,89,Alimento,4,167
493,2025-01-21 12:00:00,33,110,Eletrônico,7,143
494,2025-01-21 13:00:00,46,41,Alimento,5,87
495,2025-01-21 14:00:00,62,56,Eletrônico,7,118
496,2025-01-21 15:00:00,55,11,Eletrônico,6,66
497,2025-01-21 16:00:00,48,171,Vestuário,6,219
498,2025-01-21 17:00:00,15,67,Móvel,1,82
499,2025-01-21 18:00:00,29,144,Brinquedo,7,173
500,2025-01-21 19:00:00,85,144,Vestuário,3,229
501,2025-01-21 20:00:00,26,107,Brinquedo,1,133
502,2025-01-21 21:00:00,92,107,Vestuário,4,199
503,2025-01-21 22:00:00,32,152,Brinquedo,6,184
504,2025-01-21 23:00:00,54,33,Alimento,6,87
505,2025-01-22 00:00:00,76,122,Alimento,8,198
506,2025-01-22 01:00:00,58,94,Brinquedo,5,152
507,2025-01-22 02:00:00,22,19,Alimento,5,41
508,2025-01-22 03:00:00,43,37,Eletrônico,5,80
509,2025-01-22 04:00:00,84,73,Brinquedo,6,157
510,2025-01-22 05:00:00,55,70,Vestuário,6,125
511,2025-01-22 06:00:00,27,25,Brinquedo,6,52
512,2025-01-22 07:00:00,102,80,Móvel,7,182
513,2025-01-22 08:00:00,68,79,Brinquedo,2,147
514,2025-01-22 09:00:00,31,156,Eletrônico,6,187
515,2025-01-22 10:00:00,47,163,Brinquedo,7,210
516,2025-01-22 11:00:00,104,134,Eletrônico,6,238
517,2025-01-22 12:00:00,69,102,Vestuário,6,171
518,2025-01-22 13:00:00,22,53,Eletrônico,4,75
519,2025-01-22 14:00:00,53,154,Móvel,6,207
520,2025-01-22 15:00:00,52,81,Alimento,3,133
521,2025-01-22 16:00:00,11,80,Alimento,8,91
522,2025-01-22 17:00:00,24,101,Vestuário,2,125
523,2025-01-22 18:00:00,106,27,Móvel,8,133
524,2025-01-22 19:00:00,83,113,Alimento,8,196
525,2025-01-22 20:00:00,88,124,Alimento,8,212
526,2025-01-22 21:00:00,20,141,Alimento,9,161
527,2025-01-22 22:00:00,85,70,Brinquedo,9,155
528,2025-01-22 23:00:00,37,108,Alimento,6,145
529,2025-01-23 00:00:00,94,148,Móvel,7,242
530,2025-01-23 01:00:00,111,52,Vestuário,8,163
531,2025-01-23 02:00:00,74,142,Vestuário,2,216
532,2025-01-23 03:00:00,49,29,Alimento,3,78
533,2025-01-23 04:00:00,52,37,Alimento,7,89
534,2025-01-23 05:00:00,24,89,Brinquedo,3,113
535,2025-01-23 06:00:00,42,10,Móvel,9,52
536,2025-01-23 07:00:00,32,18,Eletrônico,1,50
537,2025-01-23 08:00:00,46,69,Brinquedo,4,115
538,2025-01-23 09:00:00,81,177,Vestuário,9,258
539,2025-01-23 10:00:00,98,134,Eletrônico,9,232
540,2025-01-23 11:00:00,42,157,Vestuário,2,199
541,2025-01-23 12:00:00,38,103,Eletrônico,2,141
542,2025-01-23 13:00:00,78,83,Eletrônico,2,161
543,2025-01-23 14:00:00,98,89,Móvel,9,187
544,2025-01-23 15:00:00,47,62,Alimento,1,109
545,2025-01-23 16:00:00,10,177,Brinquedo,8,187
546,2025-01-23 17:00:00,109,130,Eletrônico,8,239
547,2025-01-23 18:00:00,28,48,Brinquedo,4,76
548,2025-01-23 19:00:00,118,95,Vestuário,5,213
549,2025-01-23 20:00:00,109,153,Alimento,4,262
550,2025-01-23 21:00:00,30,92,Alimento,9,122
551,2025-01-23 22:00:00,16,80,Brinquedo,6,96
552,2025-01-23 23:00:00,45,16,Móvel,7,61
553,2025-01-24 00:00:00,69,118,Brinquedo,4,187
554,2025-01-24 01:00:00,64,104,Brinquedo,2,168
555,2025-01-24 02:00:00,58,11,Brinquedo,1,69
556,2025-01-24 03:00:00,95,84,Eletrônico,6,179
557,2025-01-24 04:00:00,59,125,Móvel,5,184
558,2025-01-24 05:00:00,26,53,Móvel,4,79
559,2025-01-24 06:00:00,60,28,Eletrônico,6,88
560,2025-01-24 07:00:00,17,174,Alimento,3,191
561,2025-01-24 08:00:00,26,39,Alimento,5,65
562,2025-01-24 09:00:00,18,175,Brinquedo,1,193
563,2025-01-24 10:00:00,75,138,Brinquedo,7,213
564,2025-01-24 11:00:00,90,43,Vestuário,5,133
565,2025-01-24 12:00:00,13,43,Brinquedo,1,56
566,2025-01-24 13:00:00,115,147,Móvel,3,262
567,2025-01-24 14:00:00,88,165,Brinquedo,2,253
568,2025-01-24 15:00:00,97,163,Eletrônico,1,260
569,2025-01-24 16:00:00,31,59,Eletrônico,5,90
570,2025-01-24 17:00:00,75,52,Móvel,5,127
571,2025-01-24 18:00:00,23,129,Vestuário,3,152
572,2025-01-24 19:00:00,34,124,Brinquedo,2,158
573,2025-01-24 20:00:00,31,60,Alimento,4,91
574,2025-01-24 21:00:00,59,155,Eletrônico,8,214
575,2025-01-24 22:00:00,55,81,Móvel,6,136
576,2025-01-24 23:00:00,75,116,Eletrônico,9,191
577,2025-01-25 00:00:00,103,60,Alimento,1,163
578,2025-01-25 01:00:00,86,160,Alimento,5,246
579,2025-01-25 02:00:00,92,156,Vestuário,2,248
580,2025-01-25 03:00:00,58,108,Vestuário,9,166
581,2025-01-25 04:00:00,51,115,Vestuário,8,166
582,2025-01-25 05:00:00,15,36,Alimento,1,51
583,2025-01-25 06:00:00,16,13,Brinquedo,9,29
584,2025-01-25 07:00:00,24,93,Móvel,4,117
585,2025-01-25 08:00:00,10,65,Vestuário,9,75
586,2025-01-25 09:00:00,108,105,Móvel,8,213
587,2025-01-25 10:00:00,62,112,Vestuário,1,174
588,2025-01-25 11:00:00,119,118,Alimento,4,237
589,2025-01-25 12:00:00,114,98,Alimento,8,212
590,2025-01-25 13:00:00,23,54,Eletrônico,1,77
591,2025-01-25 14:00:00,42,59,Brinquedo,2,101
592,2025-01-25 15:00:00,41,82,Eletrônico,8,123
593,2025-01-25 16:00:00,104,87,Eletrônico,9,191
594,2025-01-25 17:00:00,88,176,Alimento,8,264
595,2025-01-25 18:00:00,51,55,Móvel,1,106
596,2025-01-25 19:00:00,10,109,Brinquedo,3,119
597,2025-01-25 20:00:00,99,166,Brinquedo,8,265
598,2025-01-25 21:00:00,100,96,Móvel,5,196
599,2025-01-25 22:00:00,119,171,Alimento,3,290
600,2025-01-25 23:00:00,107,33,Vestuário,4,140
601,2025-01-26 00:00:00,37,142,Vestuário,5,179
602,2025-01-26 01:00:00,39,135,Brinquedo,7,174
603,2025-01-26 02:00:00,107,176,Eletrônico,3,283
604,2025-01-26 03:00:00,35,163,Eletrônico,7,198
605,2025-01-26 04:00:00,39,156,Alimento,2,195
606,2025-01-26 05:00:00,72,157,Móvel,8,229
607,2025-01-26 06:00:00,24,75,Vestuário,4,99
608,2025-01-26 07:00:00,109,93,Alimento,5,202
609,2025-01-26 08:00:00,15,13,Alimento,8,28
610,2025-01-26 09:00:00,28,140,Alimento,5,168
611,2025-01-26 10:00:00,83,69,Alimento,9,152
612,2025-01-26 11:00:00,52,36,Vestuário,7,88
613,2025-01-26 12:00:00,55,140,Eletrônico,2,195
614,2025-01-26 13:00:00,38,96,Alimento,1,134
615,2025-01-26 14:00:00,103,121,Móvel,9,224
616,2025-01-26 15:00:00,108,70,Alimento,4,178
617,2025-01-26 16:00:00,63,119,Brinquedo,1,182
618,2025-01-26 17:00:00,76,123,Vestuário,5,199
619,2025-01-26 18:00:00,113,70,Eletrônico,9,183
620,2025-01-26 19:00:00,116,136,Brinquedo,9,252
621,2025-01-26 20:00:00,29,141,Vestuário,5,170
622,2025-01-26 21:00:00,85,48,Brinquedo,4,133
623,2025-01-26 22:00:00,83,133,Alimento,2,216
624,2025-01-26 23:00:00,53,179,Vestuário,7,232
625,2025-01-27 00:00:00,35,145,Brinquedo,8,180
626,2025-01-27 01:00:00,87,32,Eletrônico,1,119
627,2025-01-27 02:00:00,71,104,Vestuário,1,175
628,2025-01-27 03:00:00,67,157,Vestuário,8,224
629,2025-01-27 04:00:00,16,73,Vestuário,5,89
630,2025-01-27 05:00:00,90,74,Vestuário,2,164
631,2025-01-27 06:00:00,117,28,Eletrônico,9,145
632,2025-01-27 07:00:00,32,138,Alimento,6,170
633,2025-01-27 08:00:00,78,45,Brinquedo,1,123
634,2025-01-27 09:00:00,70,68,Móvel,2,138
635,2025-01-27 10:00:00,17,132,Alimento,3,149
636,2025-01-27 11:00:00,46,92,Brinquedo,1,138
637,2025-01-27 12:00:00,119,19,Brinquedo,7,138
638,2025-01-27 13:00:00,104,49,Móvel,6,153
639,2025-01-27 14:00:00,65,136,Brinquedo,8,201
640,2025-01-27 15:00:00,76,85,Vestuário,9,161
641,2025-01-27 16:00:00,16,176,Vestuário,5,192
642,2025-01-27 17:00:00,96,85,Brinquedo,4,181
643,2025-01-27 18:00:00,32,14,Móvel,2,46
644,2025-01-27 19:00:00,69,156,Eletrônico,5,225
645,2025-01-27 20:00:00,116,34,Móvel,2,150
646,2025-01-27 21:00:00,38,169,Brinquedo,1,207
647,2025-01-27 22:00:00,99,39,Móvel,1,138
648,2025-01-27 23:00:00,92,176,Eletrônico,8,268
649,2025-01-28 00:00:00,80,18,Vestuário,3,98
650,2025-01-28 01:00:00,96,155,Alimento,9,251
651,2025-01-28 02:00:00,65,86,Alimento,7,151
652,2025-01-28 03:00:00,42,166,Alimento,6,208
653,2025-01-28 04:00:00,18,99,Alimento,5,117
654,2025-01-28 05:00:00,87,23,Eletrônico,7,110
655,2025-01-28 06:00:00,65,132,Móvel,6,197
656,2025-01-28 07:00:00,27,78,Móvel,3,105
657,2025-01-28 08:00:00,58,19,Vestuário,3,77
658,2025-01-28 09:00:00,77,83,Móvel,2,160
659,2025-01-28 10:00:00,84,130,Eletrônico,3,214
660,2025-01-28 11:00:00,32,165,Eletrônico,7,197
661,2025-01-28 12:00:00,56,110,Brinquedo,6,166
662,2025-01-28 13:00:00,58,103,Eletrônico,9,161
663,2025-01-28 14:00:00,47,101,Brinquedo,1,148
664,2025-01-28 15:00:00,87,109,Móvel,2,196
665,2025-01-28 16:00:00,96,124,Vestuário,7,220
666,2025-01-28 17:00:00,104,131,Alimento,3,235
667,2025-01-28 18:00:00,105,110,Brinquedo,9,215
668,2025-01-28 19:00:00,19,172,Eletrônico,1,191
669,2025-01-28 20:00:00,117,53,Eletrônico,6,170
670,2025-01-28 21:00:00,51,48,Móvel,2,99
671,2025-01-28 22:00:00,68,11,Brinquedo,5,79
672,2025-01-28 23:00:00,110,52,Alimento,1,162
673,2025-01-29 00:00:00,26,141,Móvel,7,167
674,2025-01-29 01:00:00,52,155,Alimento,1,207
675,2025-01-29 02:00:00,115,128,Brinquedo,5,243
676,2025-01-29 03:00:00,25,130,Móvel,5,155
677,2025-01-29 04:00:00,43,137,Brinquedo,7,180
678,2025-01-29 05:00:00,86,117,Móvel,8,203
679,2025-01-29 06:00:00,107,12,Alimento,8,119
680,2025-01-29 07:00:00,27,158,Móvel,9,185
681,2025-01-29 08:00:00,94,120,Vestuário,7,214
682,2025-01-29 09:00:00,64,158,Alimento,4,222
683,2025-01-29 10:00:00,49,102,Eletrônico,1,151
684,2025-01-29 11:00:00,24,154,Alimento,6,178
685,2025-01-29 12:00:00,73,85,Móvel,5,158
686,2025-01-29 13:00:00,50,15,Brinquedo,2,65
687,2025-01-29 14:00:00,75,150,Brinquedo,2,225
688,2025-01-29 15:00:00,78,175,Brinquedo,8,253
689,2025-01-29 16:00:00,115,30,Alimento,7,145
690,2025-01-29 17:00:00,92,39,Eletrônico,5,131
691,2025-01-29 18:00:00,35,83,Alimento,6,118
692,2025-01-29 19:00:00,55,52,Alimento,3,107
693,2025-01-29 20:00:00,32,10,Alimento,2,42
694,2025-01-29 21:00:00,110,42,Eletrônico,5,152
695,2025-01-29 22:00:00,119,31,Brinquedo,4,150
696,2025-01-29 23:00:00,34,80,Móvel,7,114
697,2025-01-30 00:00:00,62,68,Vestuário,8,130
698,2025-01-30 01:00:00,13,16,Eletrônico,8,29
699,2025-01-30 02:00:00,49,40,Brinquedo,5,89
700,2025-01-30 03:00:00,28,54,Brinquedo,5,82
701,2025-01-30 04:00:00,39,116,Móvel,1,155
702,2025-01-30 05:00:00,95,96,Vestuário,3,191
703,2025-01-30 06:00:00,109,119,Alimento,5,228
704,2025-01-30 07:00:00,107,64,Vestuário,2,171
705,2025-01-30 08:00:00,54,46,Alimento,3,100
706,2025-01-30 09:00:00,101,65,Vestuário,4,166
707,2025-01-30 10:00:00,43,163,Alimento,2,206
708,2025-01-30 11:00:00,12,14,Alimento,3,26
709,2025-01-30 12:00:00,54,78,Eletrônico,7,132
710,2025-01-30 13:00:00,38,99,Vestuário,7,137
711,2025-01-30 14:00:00,98,47,Eletrônico,2,145
712,2025-01-30 15:00:00,23,126,Móvel,2,149
713,2025-01-30 16:00:00,89,95,Eletrônico,3,184
714,2025-01-30 17:00:00,109,34,Vestuário,5,143
715,2025-01-30 18:00:00,66,32,Brinquedo,7,98
716,2025-01-30 19:00:00,96,92,Móvel,9,188
717,2025-01-30 20:00:00,29,91,Alimento,1,120
718,2025-01-30 21:00:00,14,144,Alimento,1,158
719,2025-01-30 22:00:00,112,155,Eletrônico,2,267
720,2025-01-30 23:00:00,16,166,Móvel,7,182
721,2025-01-31 00:00:00,113,150,Vestuário,2,263
722,2025-01-31 01:00:00,75,21,Eletrônico,8,96
723,2025-01-31 02:00:00,82,159,Vestuário,3,241
724,2025-01-31 03:00:00,85,141,Eletrônico,5,226
725,2025-01-31 04:00:00,13,146,Vestuário,1,159
726,2025-01-31 05:00:00,83,65,Brinquedo,5,148
727,2025-01-31 06:00:00,107,75,Eletrônico,7,182
728,2025-01-31 07:00:00,95,34,Eletrônico,9,129
729,2025-01-31 08:00:00,42,165,Alimento,5,207
730,2025-01-31 09:00:00,51,90,Móvel,7,141
731,2025-01-31 10:00:00,74,66,Vestuário,3,140
732,2025-01-31 11:00:00,55,130,Brinquedo,9,185
733,2025-01-31 12:00:00,50,100,Móvel,8,150
734,2025-01-31 13:00:00,26,62,Móvel,5,88
735,2025-01-31 14:00:00,57,73,Vestuário,8,130
736,2025-01-31 15:00:00,110,170,Vestuário,2,280
737,2025-01-31 16:00:00,11,161,Vestuário,2,172
738,2025-01-31 17:00:00,52,86,Brinquedo,4,138
739,2025-01-31 18:00:00,43,69,Vestuário,4,112
740,2025-01-31 19:00:00,48,94,Eletrônico,9,142
741,2025-01-31 20:00:00,39,61,Móvel,5,100
742,2025-01-31 21:00:00,45,132,Alimento,3,177
743,2025-01-31 22:00:00,86,74,Alimento,9,160
744,2025-01-31 23:00:00,10,60,Eletrônico,2,70
745,2025-02-01 00:00:00,37,35,Vestuário,7,72
746,2025-02-01 01:00:00,65,169,Alimento,2,234
747,2025-02-01 02:00:00,52,15,Brinquedo,9,67
748,2025-02-01 03:00:00,56,20,Brinquedo,7,76
749,2025-02-01 04:00:00,40,106,Eletrônico,5,146
750,2025-02-01 05:00:00,84,14,Alimento,1,98
751,2025-02-01 06:00:00,106,69,Alimento,3,175
752,2025-02-01 07:00:00,42,50,Vestuário,9,92
753,2025-02-01 08:00:00,43,40,Móvel,6,83
754,2025-02-01 09:00:00,84,136,Eletrônico,2,220
755,2025-02-01 10:00:00,64,92,Eletrônico,6,156
756,2025-02-01 11:00:00,97,30,Alimento,5,127
757,2025-02-01 12:00:00,78,60,Brinquedo,4,138
758,2025-02-01 13:00:00,85,134,Eletrônico,2,219
759,2025-02-01 14:00:00,10,18,Vestuário,2,28
760,2025-02-01 15:00:00,100,121,Brinquedo,2,221
761,2025-02-01 16:00:00,52,160,Brinquedo,5,212
762,2025-02-01 17:00:00,63,19,Vestuário,2,82
763,2025-02-01 18:00:00,116,65,Alimento,6,181
764,2025-02-01 19:00:00,40,132,Móvel,2,172
765,2025-02-01 20:00:00,11,99,Alimento,3,110
766,2025-02-01 21:00:00,79,130,Alimento,3,209
767,2025-02-01 22:00:00,47,137,Brinquedo,4,184
768,2025-02-01 23:00:00,69,140,Alimento,3,209
769,2025-02-02 00:00:00,64,172,Alimento,1,236
770,2025-02-02 01:00:00,27,98,Eletrônico,9,125
771,2025-02-02 02:00:00,13,121,Alimento,4,134
772,2025-02-02 03:00:00,49,31,Brinquedo,8,80
773,2025-02-02 04:00:00,19,112,Brinquedo,3,131
774,2025-02-02 05:00:00,42,26,Brinquedo,7,68
775,2025-02-02 06:00:00,110,100,Móvel,8,210
776,2025-02-02 07:00:00,13,156,Alimento,2,169
777,2025-02-02 08:00:00,44,179,Vestuário,5,223
778,2025-02-02 09:00:00,115,161,Vestuário,4,276
779,2025-02-02 10:00:00,68,39,Brinquedo,7,107
780,2025-02-02 11:00:00,43,100,Alimento,3,143
781,2025-02-02 12:00:00,98,47,Alimento,9,145
782,2025-02-02 13:00:00,12,86,Brinquedo,9,98
783,2025-02-02 14:00:00,81,84,Brinquedo,7,165
784,2025-02-02 15:00:00,112,90,Eletrônico,3,202
785,2025-02-02 16:00:00,38,79,Eletrônico,8,117
786,2025-02-02 17:00:00,38,170,Eletrônico,1,208
787,2025-02-02 18:00:00,103,109,Alimento,6,212
788,2025-02-02 19:00:00,111,96,Vestuário,2,207
789,2025-02-02 20:00:00,79,136,Móvel,2,215
790,2025-02-02 21:00:00,73,136,Móvel,8,209
791,2025-02-02 22:00:00,48,49,Eletrônico,3,97
792,2025-02-02 23:00:00,82,105,Vestuário,4,187
793,2025-02-03 00:00:00,52,93,Móvel,8,145
794,2025-02-03 01:00:00,110,165,Alimento,5,275
795,2025-02-03 02:00:00,77,18,Móvel,7,95
796,2025-02-03 03:00:00,73,173,Vestuário,6,246
797,2025-02-03 04:00:00,35,17,Móvel,6,52
798,2025-02-03 05:00:00,89,147,Brinquedo,1,236
799,2025-02-03 06:00:00,76,44,Brinquedo,6,120
800,2025-02-03 07:00:00,26,19,Vestuário,5,45
801,2025-02-03 08:00:00,10,34,Móvel,1,44
802,2025-02-03 09:00:00,88,141,Brinquedo,2,229
803,2025-02-03 10:00:00,62,97,Eletrônico,1,159
804,2025-02-03 11:00:00,94,86,Alimento,3,180
805,2025-02-03 12:00:00,57,49,Móvel,1,106
806,2025-02-03 13:00:00,60,106,Móvel,7,166
807,2025-02-03 14:00:00,52,177,Vestuário,6,229
808,2025-02-03 15:00:00,28,168,Eletrônico,5,196
809,2025-02-03 16:00:00,32,95,Alimento,4,127
810,2025-02-03 17:00:00,20,14,Brinquedo,4,34
811,2025-02-03 18:00:00,48,24,Vestuário,3,72
812,2025-02-03 19:00:00,75,128,Alimento,6,203
813,2025-02-03 20:00:00,64,69,Alimento,2,133
814,2025-02-03 21:00:00,68,35,Eletrônico,1,103
815,2025-02-03 22:00:00,93,128,Alimento,7,221
816,2025-02-03 23:00:00,63,41,Vestuário,3,104
817,2025-02-04 00:00:00,14,45,Vestuário,2,59
818,2025-02-04 01:00:00,112,116,Alimento,8,228
819,2025-02-04 02:00:00,102,12,Alimento,4,114
820,2025-02-04 03:00:00,44,76,Vestuário,3,120
821,2025-02-04 04:00:00,51,51,Móvel,8,102
822,2025-02-04 05:00:00,14,74,Móvel,7,88
823,2025-02-04 06:00:00,74,166,Brinquedo,6,240
824,2025-02-04 07:00:00,73,45,Eletrônico,6,118
825,2025-02-04 08:00:00,94,159,Alimento,9,253
826,2025-02-04 09:00:00,71,176,Alimento,7,247
827,2025-02-04 10:00:00,99,40,Eletrônico,2,139
828,2025-02-04 11:00:00,36,176,Eletrônico,3,212
829,2025-02-04 12:00:00,16,96,Brinquedo,7,112
830,2025-02-04 13:00:00,12,178,Alimento,4,190
831,2025-02-04 14:00:00,60,48,Eletrônico,9,108
832,2025-02-04 15:00:00,11,175,Móvel,5,186
833,2025-02-04 16:00:00,102,178,Vestuário,4,280
834,2025-02-04 17:00:00,28,144,Alimento,8,172
835,2025-02-04 18:00:00,114,124,Alimento,5,238
836,2025-02-04 19:00:00,12,104,Eletrônico,4,116
837,2025-02-04 20:00:00,73,104,Vestuário,8,177
838,2025-02-04 21:00:00,81,122,Móvel,8,203
839,2025-02-04 22:00:00,31,15,Vestuário,9,46
840,2025-02-04 23:00:00,92,43,Alimento,5,135
841,2025-02-05 00:00:00,79,169,Brinquedo,2,248
842,2025-02-05 01:00:00,20,74,Brinquedo,6,94
843,2025-02-05 02:00:00,77,144,Eletrônico,6,221
844,2025-02-05 03:00:00,88,61,Eletrônico,6,149
845,2025-02-05 04:00:00,86,21,Vestuário,1,107
846,2025-02-05 05:00:00,101,170,Vestuário,5,271
847,2025-02-05 06:00:00,15,29,Brinquedo,3,44
848,2025-02-05 07:00:00,25,132,Brinquedo,2,157
849,2025-02-05 08:00:00,13,23,Eletrônico,3,36
850,2025-02-05 09:00:00,53,24,Eletrônico,3,77
851,2025-02-05 10:00:00,90,94,Eletrônico,1,184
852,2025-02-05 11:00:00,61,145,Vestuário,7,206
853,2025-02-05 12:00:00,117,61,Alimento,2,178
854,2025-02-05 13:00:00,77,86,Vestuário,6,163
855,2025-02-05 14:00:00,89,105,Brinquedo,2,194
856,2025-02-05 15:00:00,87,74,Eletrônico,5,161
857,2025-02-05 16:00:00,58,44,Brinquedo,5,102
858,2025-02-05 17:00:00,13,18,Móvel,5,31
859,2025-02-05 18:00:00,47,123,Móvel,8,170
860,2025-02-05 19:00:00,92,14,Móvel,9,106
861,2025-02-05 20:00:00,36,168,Móvel,7,204
862,2025-02-05 21:00:00,33,14,Móvel,9,47
863,2025-02-05 22:00:00,94,175,Brinquedo,6,269
864,2025-02-05 23:00:00,72,173,Brinquedo,2,245
865,2025-02-06 00:00:00,73,114,Eletrônico,1,187
866,2025-02-06 01:00:00,27,143,Alimento,9,170
867,2025-02-06 02:00:00,58,70,Móvel,7,128
868,2025-02-06 03:00:00,118,120,Vestuário,2,238
869,2025-02-06 04:00:00,106,34,Alimento,9,140
870,2025-02-06 05:00:00,45,166,Vestuário,4,211
871,2025-02-06 06:00:00,51,48,Vestuário,3,99
872,2025-02-06 07:00:00,27,95,Eletrônico,7,122
873,2025-02-06 08:00:00,75,179,Móvel,7,254
874,2025-02-06 09:00:00,74,121,Vestuário,3,195
875,2025-02-06 10:00:00,102,38,Móvel,2,140
876,2025-02-06 11:00:00,41,153,Móvel,1,194
877,2025-02-06 12:00:00,65,174,Móvel,8,239
878,2025-02-06 13:00:00,24,61,Eletrônico,9,85
879,2025-02-06 14:00:00,35,163,Eletrônico,5,198
880,2025-02-06 15:00:00,107,142,Eletrônico,6,249
881,2025-02-06 16:00:00,62,139,Eletrônico,1,201
882,2025-02-06 17:00:00,85,173,Eletrônico,7,258
883,2025-02-06 18:00:00,99,63,Brinquedo,5,162
884,2025-02-06 19:00:00,22,106,Brinquedo,1,128
885,2025-02-06 20:00:00,75,144,Alimento,1,219
886,2025-02-06 21:00:00,59,88,Brinquedo,3,147
887,2025-02-06 22:00:00,50,51,Brinquedo,6,101
888,2025-02-06 23:00:00,64,90,Eletrônico,7,154
889,2025-02-07 00:00:00,22,101,Brinquedo,5,123
890,2025-02-07 01:00:00,12,53,Brinquedo,9,65
891,2025-02-07 02:00:00,103,132,Eletrônico,2,235
892,2025-02-07 03:00:00,118,38,Móvel,7,156
893,2025-02-07 04:00:00,92,163,Móvel,2,255
894,2025-02-07 05:00:00,31,89,Brinquedo,3,120
895,2025-02-07 06:00:00,84,128,Vestuário,1,212
896,2025-02-07 07:00:00,16,111,Brinquedo,5,127
897,2025-02-07 08:00:00,26,84,Eletrônico,5,110
898,2025-02-07 09:00:00,89,80,Eletrônico,1,169
899,2025-02-07 10:00:00,79,162,Móvel,1,241
900,2025-02-07 11:00:00,118,26,Brinquedo,4,144
901,2025-02-07 12:00:00,52,126,Vestuário,4,178
902,2025-02-07 13:00:00,30,53,Brinquedo,2,83
903,2025-02-07 14:00:00,13,90,Brinquedo,4,103
904,2025-02-07 15:00:00,94,102,Vestuário,8,196
905,2025-02-07 16:00:00,71,74,Móvel,3,145
906,2025-02-07 17:00:00,76,66,Vestuário,9,142
907,2025-02-07 18:00:00,103,114,Móvel,6,217
908,2025-02-07 19:00:00,53,11,Móvel,9,64
909,2025-02-07 20:00:00,96,86,Eletrônico,6,182
910,2025-02-07 21:00:00,91,108,Vestuário,9,199
911,2025-02-07 22:00:00,94,61,Eletrônico,3,155
912,2025-02-07 23:00:00,49,168,Vestuário,8,217
913,2025-02-08 00:00:00,51,104,Móvel,2,155
914,2025-02-08 01:00:00,67,30,Brinquedo,2,97
915,2025-02-08 02:00:00,58,177,Móvel,5,235
916,2025-02-08 03:00:00,28,23,Vestuário,8,51
917,2025-02-08 04:00:00,18,38,Móvel,8,56
918,2025-02-08 05:00:00,89,89,Móvel,8,178
919,2025-02-08 06:00:00,44,111,Vestuário,7,155
920,2025-02-08 07:00:00,21,151,Eletrônico,6,172
921,2025-02-08 08:00:00,12,154,Móvel,7,166
922,2025-02-08 09:00:00,97,71,Brinquedo,9,168
923,2025-02-08 10:00:00,18,65,Vestuário,6,83
924,2025-02-08 11:00:00,31,17,Alimento,9,48
925,2025-02-08 12:00:00,97,43,Brinquedo,6,140
926,2025-02-08 13:00:00,108,158,Brinquedo,6,266
927,2025-02-08 14:00:00,38,164,Alimento,6,202
928,2025-02-08 15:00:00,98,83,Móvel,9,181
929,2025-02-08 16:00:00,97,66,Vestuário,5,163
930,2025-02-08 17:00:00,52,63,Brinquedo,2,115
931,2025-02-08 18:00:00,40,70,Alimento,9,110
932,2025-02-08 19:00:00,85,130,Vestuário,8,215
933,2025-02-08 20:00:00,11,50,Alimento,3,61
934,2025-02-08 21:00:00,63,100,Brinquedo,9,163
935,2025-02-08 22:00:00,17,125,Alimento,5,142
936,2025-02-08 23:00:00,63,39,Móvel,3,102
937,2025-02-09 00:00:00,104,126,Eletrônico,5,230
938,2025-02-09 01:00:00,17,121,Móvel,7,138
939,2025-02-09 02:00:00,23,78,Brinquedo,7,101
940,2025-02-09 03:00:00,20,48,Brinquedo,8,68
941,2025-02-09 04:00:00,28,136,Brinquedo,9,164
942,2025-02-09 05:00:00,53,142,Brinquedo,3,195
943,2025-02-09 06:00:00,53,70,Vestuário,5,123
944,2025-02-09 07:00:00,17,170,Eletrônico,7,187
945,2025-02-09 08:00:00,106,45,Eletrônico,1,151
946,2025-02-09 09:00:00,85,57,Vestuário,2,142
947,2025-02-09 10:00:00,87,149,Brinquedo,1,236
948,2025-02-09 11:00:00,11,109,Brinquedo,5,120
949,2025-02-09 12:00:00,114,24,Alimento,3,138
950,2025-02-09 13:00:00,114,136,Móvel,8,250
951,2025-02-09 14:00:00,100,36,Vestuário,6,136
952,2025-02-09 15:00:00,15,73,Alimento,9,88
953,2025-02-09 16:00:00,81,116,Eletrônico,3,197
954,2025-02-09 17:00:00,83,172,Móvel,6,255
955,2025-02-09 18:00:00,68,23,Alimento,5,91
956,2025-02-09 19:00:00,48,123,Vestuário,8,171
957,2025-02-09 20:00:00,87,149,Vestuário,1,236
958,2025-02-09 21:00:00,89,119,Brinquedo,8,208
959,2025-02-09 22:00:00,28,103,Alimento,3,131
960,2025-02-09 23:00:00,109,57,Eletrônico,4,166
961,2025-02-10 00:00:00,42,58,Brinquedo,9,100
962,2025-02-10 01:00:00,72,156,Móvel,5,228
963,2025-02-10 02:00:00,38,43,Vestuário,5,81
964,2025-02-10 03:00:00,68,40,Alimento,8,108
965,2025-02-10 04:00:00,79,45,Alimento,2,124
966,2025-02-10 05:00:00,25,45,Eletrônico,1,70
967,2025-02-10 06:00:00,25,54,Alimento,4,79
968,2025-02-10 07:00:00,15,168,Alimento,7,183
969,2025-02-10 08:00:00,67,28,Vestuário,1,95
970,2025-02-10 09:00:00,106,70,Alimento,2,176
971,2025-02-10 10:00:00,100,23,Móvel,9,123
972,2025-02-10 11:00:00,18,65,Brinquedo,9,83
973,2025-02-10 12:00:00,100,41,Móvel,2,141
974,2025-02-10 13:00:00,39,113,Eletrônico,6,152
975,2025-02-10 14:00:00,27,96,Alimento,9,123
976,2025-02-10 15:00:00,114,176,Brinquedo,6,290
977,2025-02-10 16:00:00,95,80,Vestuário,1,175
978,2025-02-10 17:00:00,81,86,Vestuário,9,167
979,2025-02-10 18:00:00,44,119,Brinquedo,4,163
980,2025-02-10 19:00:00,23,26,Alimento,7,49
981,2025-02-10 20:00:00,74,153,Brinquedo,2,227
982,2025-02-10 21:00:00,90,80,Brinquedo,3,170
983,2025-02-10 22:00:00,20,67,Vestuário,2,87
984,2025-02-10 23:00:00,98,37,Móvel,6,135
985,2025-02-11 00:00:00,116,31,Vestuário,9,147
986,2025-02-11 01:00:00,80,177,Móvel,8,257
987,2025-02-11 02:00:00,80,61,Alimento,1,141
988,2025-02-11 03:00:00,12,85,Alimento,4,97
989,2025-02-11 04:00:00,87,20,Alimento,2,107
990,2025-02-11 05:00:00,43,157,Eletrônico,8,200
991,2025-02-11 06:00:00,16,179,Brinquedo,2,195
992,2025-02-11 07:00:00,31,16,Eletrônico,3,47
993,2025-02-11 08:00:00,74,25,Brinquedo,4,99
994,2025-02-11 09:00:00,20,114,Eletrônico,7,134
995,2025-02-11 10:00:00,28,63,Alimento,5,91
996,2025-02-11 11:00:00,30,90,Alimento,3,120
997,2025-02-11 12:00:00,83,173,Alimento,6,256
998,2025-02-11 13:00:00,35,79,Vestuário,6,114
999,2025-02-11 14:00:00,98,164,Vestuário,6,262
1000,2025-02-11 15:00:00,64,113,Eletrônico,4,177
