ID_Pedido,Data_Pedido,Tempo_Separacao,Tempo_Expedicao,Tipo_Produto,Quantidade,Tempo_Total_Processamento
1,2024-01-01 00:00:00,69,162,Vestuário,8,231
2,2024-01-01 00:01:00,20,137,Alimento,1,157
3,2024-01-01 00:02:00,33,47,Alimento,2,80
4,2024-01-01 00:03:00,22,44,Móvel,3,66
5,2024-01-01 00:04:00,48,165,Eletrônico,7,213
6,2024-01-01 00:05:00,80,108,Vestuário,6,188
7,2024-01-01 00:06:00,64,174,Móvel,4,238
8,2024-01-01 00:07:00,40,48,Alimento,7,88
9,2024-01-01 00:08:00,54,168,Vestuário,4,222
10,2024-01-01 00:09:00,76,107,Móvel,1,183
11,2024-01-01 00:10:00,51,93,Eletrônico,2,144
12,2024-01-01 00:11:00,93,166,Eletrônico,5,259
13,2024-01-01 00:12:00,105,42,Vestuário,2,147
14,2024-01-01 00:13:00,36,87,Eletrônico,1,123
15,2024-01-01 00:14:00,87,110,Eletrônico,5,197
16,2024-01-01 00:15:00,99,82,Eletrônico,3,181
17,2024-01-01 00:16:00,65,43,Eletrônico,4,108
18,2024-01-01 00:17:00,89,22,Brinquedo,5,111
19,2024-01-01 00:18:00,101,32,Vestuário,7,133
20,2024-01-01 00:19:00,49,152,Eletrônico,4,201
21,2024-01-01 00:20:00,119,38,Brinquedo,1,157
22,2024-01-01 00:21:00,46,109,Brinquedo,8,155
23,2024-01-01 00:22:00,119,88,Eletrônico,3,207
24,2024-01-01 00:23:00,82,129,Vestuário,2,211
25,2024-01-01 00:24:00,26,79,Brinquedo,4,105
26,2024-01-01 00:25:00,25,141,Vestuário,8,166
27,2024-01-01 00:26:00,13,134,Brinquedo,8,147
28,2024-01-01 00:27:00,112,14,Alimento,6,126
29,2024-01-01 00:28:00,105,104,Eletrônico,5,209
30,2024-01-01 00:29:00,111,45,Brinquedo,7,156
31,2024-01-01 00:30:00,108,69,Vestuário,2,177
32,2024-01-01 00:31:00,43,100,Móvel,5,143
33,2024-01-01 00:32:00,61,97,Brinquedo,3,158
34,2024-01-01 00:33:00,41,42,Brinquedo,2,83
35,2024-01-01 00:34:00,81,57,Móvel,3,138
36,2024-01-01 00:35:00,51,161,Móvel,7,212
37,2024-01-01 00:36:00,41,138,Brinquedo,5,179
38,2024-01-01 00:37:00,110,104,Vestuário,8,214
39,2024-01-01 00:38:00,87,84,Brinquedo,5,171
40,2024-01-01 00:39:00,111,46,Móvel,6,157
41,2024-01-01 00:40:00,78,25,Eletrônico,5,103
42,2024-01-01 00:41:00,47,17,Móvel,4,64
43,2024-01-01 00:42:00,94,121,Alimento,1,215
44,2024-01-01 00:43:00,49,108,Móvel,2,157
45,2024-01-01 00:44:00,47,76,Vestuário,2,123
46,2024-01-01 00:45:00,92,77,Vestuário,1,169
47,2024-01-01 00:46:00,52,178,Eletrônico,4,230
48,2024-01-01 00:47:00,88,164,Vestuário,3,252
49,2024-01-01 00:48:00,119,96,Móvel,9,215
50,2024-01-01 00:49:00,97,113,Vestuário,7,210
51,2024-01-01 00:50:00,83,105,Brinquedo,3,188
52,2024-01-01 00:51:00,26,92,Móvel,3,118
53,2024-01-01 00:52:00,28,156,Vestuário,3,184
54,2024-01-01 00:53:00,79,54,Vestuário,2,133
55,2024-01-01 00:54:00,84,155,Alimento,9,239
56,2024-01-01 00:55:00,47,119,Brinquedo,4,166
57,2024-01-01 00:56:00,42,79,Brinquedo,7,121
58,2024-01-01 00:57:00,62,105,Alimento,7,167
59,2024-01-01 00:58:00,95,115,Móvel,5,210
60,2024-01-01 00:59:00,118,154,Vestuário,4,272
61,2024-01-01 01:00:00,49,119,Vestuário,4,168
62,2024-01-01 01:01:00,87,111,Vestuário,5,198
63,2024-01-01 01:02:00,15,171,Móvel,7,186
64,2024-01-01 01:03:00,11,20,Alimento,5,31
65,2024-01-01 01:04:00,68,165,Alimento,3,233
66,2024-01-01 01:05:00,13,19,Vestuário,2,32
67,2024-01-01 01:06:00,64,164,Vestuário,9,228
68,2024-01-01 01:07:00,75,53,Brinquedo,1,128
69,2024-01-01 01:08:00,110,177,Móvel,5,287
70,2024-01-01 01:09:00,68,29,Alimento,5,97
71,2024-01-01 01:10:00,91,81,Móvel,8,172
72,2024-01-01 01:11:00,60,161,Alimento,6,221
73,2024-01-01 01:12:00,54,87,Vestuário,9,141
74,2024-01-01 01:13:00,86,43,Alimento,3,129
75,2024-01-01 01:14:00,25,167,Eletrônico,9,192
76,2024-01-01 01:15:00,107,130,Alimento,1,237
77,2024-01-01 01:16:00,86,133,Brinquedo,6,219
78,2024-01-01 01:17:00,26,148,Eletrônico,4,174
79,2024-01-01 01:18:00,96,77,Vestuário,2,173
80,2024-01-01 01:19:00,23,116,Móvel,7,139
81,2024-01-01 01:20:00,105,141,Eletrônico,4,246
82,2024-01-01 01:21:00,32,154,Eletrônico,4,186
83,2024-01-01 01:22:00,56,152,Vestuário,5,208
84,2024-01-01 01:23:00,14,179,Brinquedo,3,193
85,2024-01-01 01:24:00,47,151,Eletrônico,5,198
86,2024-01-01 01:25:00,48,91,Eletrônico,8,139
87,2024-01-01 01:26:00,87,61,Alimento,3,148
88,2024-01-01 01:27:00,45,63,Vestuário,1,108
89,2024-01-01 01:28:00,77,39,Vestuário,7,116
90,2024-01-01 01:29:00,33,143,Brinquedo,7,176
91,2024-01-01 01:30:00,53,76,Vestuário,4,129
92,2024-01-01 01:31:00,15,80,Brinquedo,5,95
93,2024-01-01 01:32:00,40,80,Móvel,8,120
94,2024-01-01 01:33:00,47,89,Eletrônico,4,136
95,2024-01-01 01:34:00,74,14,Brinquedo,3,88
96,2024-01-01 01:35:00,46,96,Vestuário,4,142
97,2024-01-01 01:36:00,44,11,Móvel,7,55
98,2024-01-01 01:37:00,106,19,Brinquedo,8,125
99,2024-01-01 01:38:00,64,167,Eletrônico,4,231
100,2024-01-01 01:39:00,21,133,Eletrônico,5,154
101,2024-01-01 01:40:00,99,166,Brinquedo,7,265
102,2024-01-01 01:41:00,63,159,Vestuário,4,222
103,2024-01-01 01:42:00,56,109,Vestuário,8,165
104,2024-01-01 01:43:00,17,153,Eletrônico,3,170
105,2024-01-01 01:44:00,74,159,Eletrônico,5,233
106,2024-01-01 01:45:00,13,26,Vestuário,8,39
107,2024-01-01 01:46:00,26,42,Alimento,1,68
108,2024-01-01 01:47:00,83,59,Móvel,4,142
109,2024-01-01 01:48:00,51,59,Brinquedo,8,110
110,2024-01-01 01:49:00,92,46,Móvel,8,138
111,2024-01-01 01:50:00,25,75,Alimento,1,100
112,2024-01-01 01:51:00,68,34,Brinquedo,9,102
113,2024-01-01 01:52:00,96,79,Vestuário,1,175
114,2024-01-01 01:53:00,21,12,Móvel,6,33
115,2024-01-01 01:54:00,58,72,Vestuário,3,130
116,2024-01-01 01:55:00,90,156,Vestuário,9,246
117,2024-01-01 01:56:00,95,162,Vestuário,6,257
118,2024-01-01 01:57:00,112,43,Eletrônico,2,155
119,2024-01-01 01:58:00,87,121,Vestuário,3,208
120,2024-01-01 01:59:00,64,29,Alimento,5,93
121,2024-01-01 02:00:00,70,155,Vestuário,8,225
122,2024-01-01 02:01:00,42,115,Eletrônico,9,157
123,2024-01-01 02:02:00,69,131,Móvel,2,200
124,2024-01-01 02:03:00,79,52,Eletrônico,9,131
125,2024-01-01 02:04:00,89,152,Móvel,2,241
126,2024-01-01 02:05:00,62,39,Eletrônico,8,101
127,2024-01-01 02:06:00,37,19,Móvel,4,56
128,2024-01-01 02:07:00,47,19,Eletrônico,9,66
129,2024-01-01 02:08:00,45,118,Móvel,3,163
130,2024-01-01 02:09:00,98,104,Brinquedo,9,202
131,2024-01-01 02:10:00,106,46,Móvel,4,152
132,2024-01-01 02:11:00,57,126,Eletrônico,3,183
133,2024-01-01 02:12:00,78,169,Vestuário,1,247
134,2024-01-01 02:13:00,113,75,Eletrônico,9,188
135,2024-01-01 02:14:00,75,117,Brinquedo,2,192
136,2024-01-01 02:15:00,58,28,Móvel,6,86
137,2024-01-01 02:16:00,55,96,Alimento,2,151
138,2024-01-01 02:17:00,51,89,Eletrônico,7,140
139,2024-01-01 02:18:00,13,87,Eletrônico,6,100
140,2024-01-01 02:19:00,53,14,Alimento,6,67
141,2024-01-01 02:20:00,112,105,Vestuário,9,217
142,2024-01-01 02:21:00,95,160,Brinquedo,9,255
143,2024-01-01 02:22:00,19,101,Brinquedo,7,120
144,2024-01-01 02:23:00,77,65,Vestuário,1,142
145,2024-01-01 02:24:00,92,144,Vestuário,1,236
146,2024-01-01 02:25:00,38,129,Móvel,9,167
147,2024-01-01 02:26:00,93,104,Alimento,3,197
148,2024-01-01 02:27:00,70,48,Eletrônico,2,118
149,2024-01-01 02:28:00,22,135,Alimento,8,157
150,2024-01-01 02:29:00,61,111,Vestuário,6,172
151,2024-01-01 02:30:00,91,23,Móvel,4,114
152,2024-01-01 02:31:00,30,155,Móvel,6,185
153,2024-01-01 02:32:00,32,87,Eletrônico,2,119
154,2024-01-01 02:33:00,59,52,Vestuário,7,111
155,2024-01-01 02:34:00,109,59,Eletrônico,3,168
156,2024-01-01 02:35:00,12,127,Vestuário,1,139
157,2024-01-01 02:36:00,55,145,Vestuário,5,200
158,2024-01-01 02:37:00,35,31,Móvel,5,66
159,2024-01-01 02:38:00,39,116,Móvel,2,155
160,2024-01-01 02:39:00,76,158,Vestuário,2,234
161,2024-01-01 02:40:00,16,51,Vestuário,1,67
162,2024-01-01 02:41:00,65,28,Vestuário,1,93
163,2024-01-01 02:42:00,96,28,Móvel,7,124
164,2024-01-01 02:43:00,64,168,Eletrônico,1,232
165,2024-01-01 02:44:00,58,35,Vestuário,4,93
166,2024-01-01 02:45:00,22,98,Eletrônico,5,120
167,2024-01-01 02:46:00,28,51,Eletrônico,3,79
168,2024-01-01 02:47:00,76,26,Alimento,7,102
169,2024-01-01 02:48:00,119,30,Vestuário,4,149
170,2024-01-01 02:49:00,34,83,Vestuário,5,117
171,2024-01-01 02:50:00,59,75,Eletrônico,6,134
172,2024-01-01 02:51:00,68,49,Eletrônico,5,117
173,2024-01-01 02:52:00,24,42,Vestuário,1,66
174,2024-01-01 02:53:00,18,98,Eletrônico,5,116
175,2024-01-01 02:54:00,21,151,Brinquedo,3,172
176,2024-01-01 02:55:00,54,97,Eletrônico,5,151
177,2024-01-01 02:56:00,75,46,Móvel,2,121
178,2024-01-01 02:57:00,104,127,Brinquedo,6,231
179,2024-01-01 02:58:00,15,177,Alimento,8,192
180,2024-01-01 02:59:00,80,99,Brinquedo,8,179
181,2024-01-01 03:00:00,35,171,Vestuário,2,206
182,2024-01-01 03:01:00,72,87,Vestuário,6,159
183,2024-01-01 03:02:00,39,167,Eletrônico,2,206
184,2024-01-01 03:03:00,35,97,Móvel,6,132
185,2024-01-01 03:04:00,24,115,Eletrônico,3,139
186,2024-01-01 03:05:00,21,139,Alimento,7,160
187,2024-01-01 03:06:00,72,86,Móvel,9,158
188,2024-01-01 03:07:00,119,61,Brinquedo,9,180
189,2024-01-01 03:08:00,65,90,Eletrônico,1,155
190,2024-01-01 03:09:00,117,112,Móvel,1,229
191,2024-01-01 03:10:00,58,169,Eletrônico,6,227
192,2024-01-01 03:11:00,52,84,Vestuário,2,136
193,2024-01-01 03:12:00,41,32,Brinquedo,5,73
194,2024-01-01 03:13:00,40,165,Brinquedo,3,205
195,2024-01-01 03:14:00,20,161,Móvel,4,181
196,2024-01-01 03:15:00,64,145,Móvel,1,209
197,2024-01-01 03:16:00,35,14,Eletrônico,8,49
198,2024-01-01 03:17:00,31,134,Alimento,5,165
199,2024-01-01 03:18:00,25,82,Brinquedo,3,107
200,2024-01-01 03:19:00,16,17,Brinquedo,3,33
201,2024-01-01 03:20:00,98,155,Brinquedo,7,253
202,2024-01-01 03:21:00,59,70,Móvel,2,129
203,2024-01-01 03:22:00,99,126,Vestuário,9,225
204,2024-01-01 03:23:00,86,26,Alimento,8,112
205,2024-01-01 03:24:00,54,169,Eletrônico,4,223
206,2024-01-01 03:25:00,117,171,Vestuário,4,288
207,2024-01-01 03:26:00,44,165,Brinquedo,2,209
208,2024-01-01 03:27:00,107,74,Brinquedo,9,181
209,2024-01-01 03:28:00,89,159,Vestuário,6,248
210,2024-01-01 03:29:00,47,126,Eletrônico,9,173
211,2024-01-01 03:30:00,59,87,Alimento,6,146
212,2024-01-01 03:31:00,74,90,Brinquedo,7,164
213,2024-01-01 03:32:00,49,46,Alimento,8,95
214,2024-01-01 03:33:00,95,55,Eletrônico,2,150
215,2024-01-01 03:34:00,77,59,Brinquedo,5,136
216,2024-01-01 03:35:00,11,110,Brinquedo,6,121
217,2024-01-01 03:36:00,66,105,Eletrônico,3,171
218,2024-01-01 03:37:00,110,112,Móvel,1,222
219,2024-01-01 03:38:00,29,125,Vestuário,6,154
220,2024-01-01 03:39:00,100,174,Eletrônico,9,274
221,2024-01-01 03:40:00,12,83,Eletrônico,7,95
222,2024-01-01 03:41:00,81,155,Vestuário,2,236
223,2024-01-01 03:42:00,83,158,Alimento,6,241
224,2024-01-01 03:43:00,18,79,Brinquedo,3,97
225,2024-01-01 03:44:00,10,56,Vestuário,1,66
226,2024-01-01 03:45:00,115,136,Vestuário,4,251
227,2024-01-01 03:46:00,116,50,Móvel,5,166
228,2024-01-01 03:47:00,24,79,Vestuário,7,103
229,2024-01-01 03:48:00,20,107,Alimento,3,127
230,2024-01-01 03:49:00,41,20,Móvel,2,61
231,2024-01-01 03:50:00,54,108,Móvel,4,162
232,2024-01-01 03:51:00,47,15,Eletrônico,6,62
233,2024-01-01 03:52:00,22,119,Brinquedo,5,141
234,2024-01-01 03:53:00,115,12,Brinquedo,4,127
235,2024-01-01 03:54:00,21,132,Vestuário,5,153
236,2024-01-01 03:55:00,23,119,Vestuário,5,142
237,2024-01-01 03:56:00,30,64,Eletrônico,8,94
238,2024-01-01 03:57:00,50,177,Vestuário,2,227
239,2024-01-01 03:58:00,47,65,Alimento,2,112
240,2024-01-01 03:59:00,57,114,Móvel,7,171
241,2024-01-01 04:00:00,14,163,Alimento,4,177
242,2024-01-01 04:01:00,18,77,Vestuário,6,95
243,2024-01-01 04:02:00,59,26,Eletrônico,4,85
244,2024-01-01 04:03:00,86,121,Alimento,4,207
245,2024-01-01 04:04:00,58,118,Alimento,5,176
246,2024-01-01 04:05:00,25,162,Móvel,1,187
247,2024-01-01 04:06:00,17,99,Brinquedo,2,116
248,2024-01-01 04:07:00,75,173,Brinquedo,9,248
249,2024-01-01 04:08:00,45,154,Brinquedo,4,199
250,2024-01-01 04:09:00,94,32,Brinquedo,3,126
251,2024-01-01 04:10:00,90,120,Alimento,7,210
252,2024-01-01 04:11:00,43,138,Móvel,9,181
253,2024-01-01 04:12:00,58,125,Vestuário,8,183
254,2024-01-01 04:13:00,71,144,Vestuário,6,215
255,2024-01-01 04:14:00,11,65,Vestuário,7,76
256,2024-01-01 04:15:00,40,69,Eletrônico,5,109
257,2024-01-01 04:16:00,25,110,Brinquedo,7,135
258,2024-01-01 04:17:00,30,84,Vestuário,7,114
259,2024-01-01 04:18:00,113,16,Brinquedo,9,129
260,2024-01-01 04:19:00,85,174,Vestuário,7,259
261,2024-01-01 04:20:00,67,176,Móvel,5,243
262,2024-01-01 04:21:00,55,172,Brinquedo,9,227
263,2024-01-01 04:22:00,24,56,Brinquedo,5,80
264,2024-01-01 04:23:00,93,155,Brinquedo,4,248
265,2024-01-01 04:24:00,18,163,Vestuário,7,181
266,2024-01-01 04:25:00,85,127,Vestuário,9,212
267,2024-01-01 04:26:00,101,178,Alimento,7,279
268,2024-01-01 04:27:00,93,39,Móvel,7,132
269,2024-01-01 04:28:00,43,154,Móvel,8,197
270,2024-01-01 04:29:00,44,91,Alimento,4,135
271,2024-01-01 04:30:00,85,46,Vestuário,5,131
272,2024-01-01 04:31:00,38,151,Alimento,4,189
273,2024-01-01 04:32:00,65,31,Vestuário,8,96
274,2024-01-01 04:33:00,77,148,Brinquedo,9,225
275,2024-01-01 04:34:00,106,159,Brinquedo,2,265
276,2024-01-01 04:35:00,48,128,Eletrônico,2,176
277,2024-01-01 04:36:00,23,40,Móvel,4,63
278,2024-01-01 04:37:00,88,125,Móvel,5,213
279,2024-01-01 04:38:00,54,86,Móvel,8,140
280,2024-01-01 04:39:00,15,151,Móvel,6,166
281,2024-01-01 04:40:00,77,160,Eletrônico,1,237
282,2024-01-01 04:41:00,35,67,Brinquedo,6,102
283,2024-01-01 04:42:00,107,29,Brinquedo,3,136
284,2024-01-01 04:43:00,82,73,Móvel,8,155
285,2024-01-01 04:44:00,51,57,Eletrônico,2,108
286,2024-01-01 04:45:00,103,139,Brinquedo,4,242
287,2024-01-01 04:46:00,112,30,Brinquedo,9,142
288,2024-01-01 04:47:00,73,124,Eletrônico,6,197
289,2024-01-01 04:48:00,23,160,Alimento,1,183
290,2024-01-01 04:49:00,59,134,Brinquedo,9,193
291,2024-01-01 04:50:00,38,166,Alimento,9,204
292,2024-01-01 04:51:00,24,89,Vestuário,5,113
293,2024-01-01 04:52:00,99,85,Móvel,1,184
294,2024-01-01 04:53:00,119,78,Eletrônico,5,197
295,2024-01-01 04:54:00,64,170,Móvel,7,234
296,2024-01-01 04:55:00,11,76,Móvel,5,87
297,2024-01-01 04:56:00,82,20,Vestuário,1,102
298,2024-01-01 04:57:00,110,91,Vestuário,9,201
299,2024-01-01 04:58:00,40,124,Brinquedo,3,164
300,2024-01-01 04:59:00,33,33,Eletrônico,7,66
301,2024-01-01 05:00:00,40,30,Vestuário,8,70
302,2024-01-01 05:01:00,46,156,Brinquedo,4,202
303,2024-01-01 05:02:00,56,163,Vestuário,5,219
304,2024-01-01 05:03:00,58,179,Vestuário,8,237
305,2024-01-01 05:04:00,19,161,Alimento,7,180
306,2024-01-01 05:05:00,63,104,Eletrônico,1,167
307,2024-01-01 05:06:00,67,54,Vestuário,8,121
308,2024-01-01 05:07:00,46,78,Vestuário,5,124
309,2024-01-01 05:08:00,49,58,Brinquedo,7,107
310,2024-01-01 05:09:00,55,32,Vestuário,9,87
311,2024-01-01 05:10:00,58,122,Alimento,6,180
312,2024-01-01 05:11:00,17,64,Vestuário,4,81
313,2024-01-01 05:12:00,79,45,Móvel,7,124
314,2024-01-01 05:13:00,45,175,Eletrônico,4,220
315,2024-01-01 05:14:00,22,27,Alimento,3,49
316,2024-01-01 05:15:00,72,96,Brinquedo,3,168
317,2024-01-01 05:16:00,100,32,Brinquedo,3,132
318,2024-01-01 05:17:00,70,165,Móvel,4,235
319,2024-01-01 05:18:00,94,107,Vestuário,4,201
320,2024-01-01 05:19:00,99,82,Brinquedo,9,181
321,2024-01-01 05:20:00,44,28,Vestuário,7,72
322,2024-01-01 05:21:00,35,147,Eletrônico,2,182
323,2024-01-01 05:22:00,107,134,Eletrônico,3,241
324,2024-01-01 05:23:00,106,119,Brinquedo,3,225
325,2024-01-01 05:24:00,51,108,Móvel,9,159
326,2024-01-01 05:25:00,101,67,Vestuário,5,168
327,2024-01-01 05:26:00,21,56,Vestuário,1,77
328,2024-01-01 05:27:00,57,64,Alimento,6,121
329,2024-01-01 05:28:00,107,71,Brinquedo,2,178
330,2024-01-01 05:29:00,14,128,Móvel,3,142
331,2024-01-01 05:30:00,96,117,Eletrônico,1,213
332,2024-01-01 05:31:00,68,21,Eletrônico,2,89
333,2024-01-01 05:32:00,26,68,Vestuário,8,94
334,2024-01-01 05:33:00,87,35,Móvel,3,122
335,2024-01-01 05:34:00,47,156,Vestuário,8,203
336,2024-01-01 05:35:00,107,12,Eletrônico,5,119
337,2024-01-01 05:36:00,111,48,Eletrônico,1,159
338,2024-01-01 05:37:00,59,121,Brinquedo,7,180
339,2024-01-01 05:38:00,61,40,Eletrônico,2,101
340,2024-01-01 05:39:00,94,90,Alimento,1,184
341,2024-01-01 05:40:00,86,160,Brinquedo,3,246
342,2024-01-01 05:41:00,37,163,Brinquedo,1,200
343,2024-01-01 05:42:00,70,111,Vestuário,7,181
344,2024-01-01 05:43:00,34,146,Móvel,7,180
345,2024-01-01 05:44:00,114,138,Brinquedo,1,252
346,2024-01-01 05:45:00,116,37,Brinquedo,9,153
347,2024-01-01 05:46:00,67,82,Vestuário,1,149
348,2024-01-01 05:47:00,54,12,Móvel,3,66
349,2024-01-01 05:48:00,27,17,Brinquedo,1,44
350,2024-01-01 05:49:00,111,129,Vestuário,1,240
351,2024-01-01 05:50:00,58,51,Eletrônico,1,109
352,2024-01-01 05:51:00,39,142,Alimento,4,181
353,2024-01-01 05:52:00,101,88,Eletrônico,6,189
354,2024-01-01 05:53:00,24,171,Eletrônico,6,195
355,2024-01-01 05:54:00,18,28,Vestuário,1,46
356,2024-01-01 05:55:00,88,133,Eletrônico,9,221
357,2024-01-01 05:56:00,21,140,Eletrônico,9,161
358,2024-01-01 05:57:00,76,108,Alimento,7,184
359,2024-01-01 05:58:00,37,122,Brinquedo,2,159
360,2024-01-01 05:59:00,81,95,Móvel,1,176
361,2024-01-01 06:00:00,104,119,Alimento,4,223
362,2024-01-01 06:01:00,113,109,Alimento,9,222
363,2024-01-01 06:02:00,55,158,Eletrônico,1,213
364,2024-01-01 06:03:00,20,96,Eletrônico,9,116
365,2024-01-01 06:04:00,82,20,Alimento,9,102
366,2024-01-01 06:05:00,107,126,Móvel,5,233
367,2024-01-01 06:06:00,84,81,Alimento,2,165
368,2024-01-01 06:07:00,33,91,Brinquedo,8,124
369,2024-01-01 06:08:00,59,69,Eletrônico,9,128
370,2024-01-01 06:09:00,85,94,Brinquedo,5,179
371,2024-01-01 06:10:00,87,127,Brinquedo,2,214
372,2024-01-01 06:11:00,109,11,Brinquedo,3,120
373,2024-01-01 06:12:00,63,101,Vestuário,4,164
374,2024-01-01 06:13:00,71,124,Eletrônico,2,195
375,2024-01-01 06:14:00,15,141,Vestuário,6,156
376,2024-01-01 06:15:00,76,36,Vestuário,7,112
377,2024-01-01 06:16:00,106,95,Brinquedo,6,201
378,2024-01-01 06:17:00,12,21,Brinquedo,1,33
379,2024-01-01 06:18:00,13,80,Alimento,3,93
380,2024-01-01 06:19:00,108,157,Alimento,7,265
381,2024-01-01 06:20:00,24,107,Brinquedo,1,131
382,2024-01-01 06:21:00,95,140,Alimento,1,235
383,2024-01-01 06:22:00,46,75,Móvel,2,121
384,2024-01-01 06:23:00,105,48,Móvel,2,153
385,2024-01-01 06:24:00,117,117,Vestuário,8,234
386,2024-01-01 06:25:00,36,40,Vestuário,3,76
387,2024-01-01 06:26:00,76,109,Alimento,7,185
388,2024-01-01 06:27:00,42,18,Móvel,3,60
389,2024-01-01 06:28:00,74,126,Vestuário,4,200
390,2024-01-01 06:29:00,83,87,Brinquedo,4,170
391,2024-01-01 06:30:00,32,93,Eletrônico,5,125
392,2024-01-01 06:31:00,24,80,Móvel,9,104
393,2024-01-01 06:32:00,109,11,Brinquedo,6,120
394,2024-01-01 06:33:00,76,111,Móvel,5,187
395,2024-01-01 06:34:00,46,101,Brinquedo,2,147
396,2024-01-01 06:35:00,75,164,Vestuário,6,239
397,2024-01-01 06:36:00,30,16,Móvel,4,46
398,2024-01-01 06:37:00,51,50,Brinquedo,2,101
399,2024-01-01 06:38:00,74,171,Alimento,5,245
400,2024-01-01 06:39:00,29,132,Móvel,5,161
401,2024-01-01 06:40:00,26,42,Móvel,9,68
402,2024-01-01 06:41:00,26,135,Brinquedo,5,161
403,2024-01-01 06:42:00,71,125,Alimento,2,196
404,2024-01-01 06:43:00,44,40,Brinquedo,4,84
405,2024-01-01 06:44:00,83,57,Eletrônico,6,140
406,2024-01-01 06:45:00,60,162,Alimento,3,222
407,2024-01-01 06:46:00,62,106,Brinquedo,1,168
408,2024-01-01 06:47:00,52,47,Móvel,7,99
409,2024-01-01 06:48:00,98,136,Brinquedo,2,234
410,2024-01-01 06:49:00,65,30,Brinquedo,8,95
411,2024-01-01 06:50:00,92,111,Móvel,9,203
412,2024-01-01 06:51:00,37,13,Móvel,2,50
413,2024-01-01 06:52:00,64,13,Eletrônico,5,77
414,2024-01-01 06:53:00,31,130,Brinquedo,9,161
415,2024-01-01 06:54:00,83,178,Alimento,4,261
416,2024-01-01 06:55:00,102,127,Alimento,9,229
417,2024-01-01 06:56:00,52,94,Brinquedo,4,146
418,2024-01-01 06:57:00,47,121,Brinquedo,8,168
419,2024-01-01 06:58:00,115,12,Eletrônico,1,127
420,2024-01-01 06:59:00,72,120,Alimento,1,192
421,2024-01-01 07:00:00,82,12,Eletrônico,1,94
422,2024-01-01 07:01:00,66,116,Vestuário,9,182
423,2024-01-01 07:02:00,21,142,Brinquedo,2,163
424,2024-01-01 07:03:00,113,152,Brinquedo,7,265
425,2024-01-01 07:04:00,85,151,Eletrônico,4,236
426,2024-01-01 07:05:00,39,33,Vestuário,9,72
427,2024-01-01 07:06:00,25,40,Alimento,8,65
428,2024-01-01 07:07:00,12,135,Brinquedo,6,147
429,2024-01-01 07:08:00,86,104,Vestuário,6,190
430,2024-01-01 07:09:00,111,29,Brinquedo,4,140
431,2024-01-01 07:10:00,70,97,Móvel,2,167
432,2024-01-01 07:11:00,88,114,Vestuário,4,202
433,2024-01-01 07:12:00,96,139,Eletrônico,2,235
434,2024-01-01 07:13:00,38,59,Eletrônico,7,97
435,2024-01-01 07:14:00,16,93,Móvel,1,109
436,2024-01-01 07:15:00,30,10,Móvel,9,40
437,2024-01-01 07:16:00,84,69,Brinquedo,2,153
438,2024-01-01 07:17:00,10,37,Brinquedo,1,47
439,2024-01-01 07:18:00,37,30,Eletrônico,4,67
440,2024-01-01 07:19:00,114,60,Alimento,1,174
441,2024-01-01 07:20:00,102,125,Alimento,2,227
442,2024-01-01 07:21:00,47,80,Eletrônico,1,127
443,2024-01-01 07:22:00,21,177,Móvel,2,198
444,2024-01-01 07:23:00,113,130,Móvel,6,243
445,2024-01-01 07:24:00,86,157,Móvel,5,243
446,2024-01-01 07:25:00,36,132,Vestuário,2,168
447,2024-01-01 07:26:00,12,160,Brinquedo,6,172
448,2024-01-01 07:27:00,96,179,Móvel,7,275
449,2024-01-01 07:28:00,97,172,Vestuário,1,269
450,2024-01-01 07:29:00,50,76,Brinquedo,5,126
451,2024-01-01 07:30:00,98,69,Brinquedo,7,167
452,2024-01-01 07:31:00,100,95,Brinquedo,8,195
453,2024-01-01 07:32:00,50,108,Móvel,7,158
454,2024-01-01 07:33:00,46,88,Vestuário,5,134
455,2024-01-01 07:34:00,11,118,Alimento,8,129
456,2024-01-01 07:35:00,81,140,Vestuário,2,221
457,2024-01-01 07:36:00,96,151,Alimento,9,247
458,2024-01-01 07:37:00,36,106,Móvel,6,142
459,2024-01-01 07:38:00,118,111,Eletrônico,8,229
460,2024-01-01 07:39:00,107,156,Brinquedo,9,263
461,2024-01-01 07:40:00,76,68,Brinquedo,7,144
462,2024-01-01 07:41:00,106,155,Eletrônico,3,261
463,2024-01-01 07:42:00,77,160,Vestuário,1,237
464,2024-01-01 07:43:00,108,77,Alimento,3,185
465,2024-01-01 07:44:00,24,40,Móvel,5,64
466,2024-01-01 07:45:00,55,40,Vestuário,4,95
467,2024-01-01 07:46:00,91,88,Eletrônico,9,179
468,2024-01-01 07:47:00,76,11,Brinquedo,6,87
469,2024-01-01 07:48:00,100,64,Eletrônico,8,164
470,2024-01-01 07:49:00,72,176,Brinquedo,5,248
471,2024-01-01 07:50:00,48,14,Eletrônico,6,62
472,2024-01-01 07:51:00,15,152,Vestuário,1,167
473,2024-01-01 07:52:00,49,61,Móvel,9,110
474,2024-01-01 07:53:00,76,22,Eletrônico,5,98
475,2024-01-01 07:54:00,68,109,Móvel,4,177
476,2024-01-01 07:55:00,23,108,Móvel,7,131
477,2024-01-01 07:56:00,37,11,Vestuário,5,48
478,2024-01-01 07:57:00,72,57,Móvel,9,129
479,2024-01-01 07:58:00,72,89,Eletrônico,3,161
480,2024-01-01 07:59:00,36,24,Brinquedo,3,60
481,2024-01-01 08:00:00,107,76,Móvel,8,183
482,2024-01-01 08:01:00,77,151,Eletrônico,6,228
483,2024-01-01 08:02:00,18,27,Eletrônico,8,45
484,2024-01-01 08:03:00,109,53,Eletrônico,7,162
485,2024-01-01 08:04:00,27,30,Eletrônico,3,57
486,2024-01-01 08:05:00,34,62,Móvel,9,96
487,2024-01-01 08:06:00,24,102,Brinquedo,4,126
488,2024-01-01 08:07:00,29,92,Eletrônico,3,121
489,2024-01-01 08:08:00,36,108,Vestuário,2,144
490,2024-01-01 08:09:00,13,148,Vestuário,9,161
491,2024-01-01 08:10:00,44,18,Eletrônico,4,62
492,2024-01-01 08:11:00,59,33,Móvel,5,92
493,2024-01-01 08:12:00,67,88,Brinquedo,3,155
494,2024-01-01 08:13:00,21,106,Alimento,4,127
495,2024-01-01 08:14:00,36,99,Móvel,1,135
496,2024-01-01 08:15:00,56,95,Eletrônico,2,151
497,2024-01-01 08:16:00,83,45,Móvel,8,128
498,2024-01-01 08:17:00,54,149,Vestuário,4,203
499,2024-01-01 08:18:00,16,172,Alimento,7,188
500,2024-01-01 08:19:00,13,101,Brinquedo,2,114
501,2024-01-01 08:20:00,43,153,Eletrônico,4,196
502,2024-01-01 08:21:00,84,20,Alimento,8,104
503,2024-01-01 08:22:00,48,143,Eletrônico,7,191
504,2024-01-01 08:23:00,31,120,Eletrônico,3,151
505,2024-01-01 08:24:00,89,176,Vestuário,6,265
506,2024-01-01 08:25:00,64,156,Eletrônico,6,220
507,2024-01-01 08:26:00,110,104,Vestuário,1,214
508,2024-01-01 08:27:00,16,158,Vestuário,4,174
509,2024-01-01 08:28:00,117,65,Eletrônico,9,182
510,2024-01-01 08:29:00,97,73,Vestuário,5,170
511,2024-01-01 08:30:00,106,171,Vestuário,5,277
512,2024-01-01 08:31:00,61,64,Alimento,6,125
513,2024-01-01 08:32:00,33,128,Móvel,8,161
514,2024-01-01 08:33:00,115,176,Vestuário,1,291
515,2024-01-01 08:34:00,118,136,Alimento,6,254
516,2024-01-01 08:35:00,102,65,Móvel,2,167
517,2024-01-01 08:36:00,102,109,Móvel,6,211
518,2024-01-01 08:37:00,105,149,Alimento,4,254
519,2024-01-01 08:38:00,34,91,Alimento,3,125
520,2024-01-01 08:39:00,55,75,Móvel,1,130
521,2024-01-01 08:40:00,110,144,Brinquedo,2,254
522,2024-01-01 08:41:00,27,67,Vestuário,8,94
523,2024-01-01 08:42:00,113,82,Móvel,6,195
524,2024-01-01 08:43:00,19,138,Móvel,7,157
525,2024-01-01 08:44:00,11,125,Vestuário,5,136
526,2024-01-01 08:45:00,104,83,Vestuário,9,187
527,2024-01-01 08:46:00,40,79,Brinquedo,6,119
528,2024-01-01 08:47:00,65,21,Móvel,2,86
529,2024-01-01 08:48:00,24,11,Móvel,4,35
530,2024-01-01 08:49:00,106,29,Brinquedo,6,135
531,2024-01-01 08:50:00,49,91,Brinquedo,1,140
532,2024-01-01 08:51:00,33,63,Alimento,5,96
533,2024-01-01 08:52:00,91,55,Eletrônico,2,146
534,2024-01-01 08:53:00,12,14,Vestuário,7,26
535,2024-01-01 08:54:00,119,42,Vestuário,5,161
536,2024-01-01 08:55:00,73,106,Vestuário,2,179
537,2024-01-01 08:56:00,79,177,Alimento,7,256
538,2024-01-01 08:57:00,55,25,Eletrônico,8,80
539,2024-01-01 08:58:00,30,43,Vestuário,1,73
540,2024-01-01 08:59:00,77,80,Móvel,5,157
541,2024-01-01 09:00:00,101,134,Brinquedo,1,235
542,2024-01-01 09:01:00,30,76,Alimento,6,106
543,2024-01-01 09:02:00,115,12,Brinquedo,3,127
544,2024-01-01 09:03:00,34,91,Alimento,8,125
545,2024-01-01 09:04:00,92,95,Eletrônico,7,187
546,2024-01-01 09:05:00,39,132,Vestuário,1,171
547,2024-01-01 09:06:00,16,140,Brinquedo,7,156
548,2024-01-01 09:07:00,16,28,Vestuário,6,44
549,2024-01-01 09:08:00,91,54,Eletrônico,6,145
550,2024-01-01 09:09:00,55,169,Alimento,8,224
551,2024-01-01 09:10:00,53,170,Eletrônico,9,223
552,2024-01-01 09:11:00,73,28,Brinquedo,6,101
553,2024-01-01 09:12:00,98,67,Eletrônico,1,165
554,2024-01-01 09:13:00,77,169,Alimento,7,246
555,2024-01-01 09:14:00,67,24,Brinquedo,1,91
556,2024-01-01 09:15:00,69,175,Alimento,4,244
557,2024-01-01 09:16:00,51,112,Vestuário,9,163
558,2024-01-01 09:17:00,82,123,Alimento,5,205
559,2024-01-01 09:18:00,119,90,Vestuário,5,209
560,2024-01-01 09:19:00,55,179,Brinquedo,4,234
561,2024-01-01 09:20:00,75,102,Eletrônico,3,177
562,2024-01-01 09:21:00,13,137,Eletrônico,5,150
563,2024-01-01 09:22:00,114,174,Vestuário,1,288
564,2024-01-01 09:23:00,94,117,Alimento,7,211
565,2024-01-01 09:24:00,64,153,Vestuário,5,217
566,2024-01-01 09:25:00,71,51,Brinquedo,4,122
567,2024-01-01 09:26:00,69,95,Brinquedo,8,164
568,2024-01-01 09:27:00,68,36,Vestuário,6,104
569,2024-01-01 09:28:00,108,161,Alimento,4,269
570,2024-01-01 09:29:00,119,78,Vestuário,2,197
571,2024-01-01 09:30:00,85,47,Eletrônico,1,132
572,2024-01-01 09:31:00,10,74,Brinquedo,8,84
573,2024-01-01 09:32:00,114,17,Vestuário,3,131
574,2024-01-01 09:33:00,86,146,Vestuário,1,232
575,2024-01-01 09:34:00,35,45,Brinquedo,2,80
576,2024-01-01 09:35:00,60,30,Móvel,8,90
577,2024-01-01 09:36:00,14,55,Móvel,7,69
578,2024-01-01 09:37:00,80,153,Brinquedo,8,233
579,2024-01-01 09:38:00,22,112,Eletrônico,9,134
580,2024-01-01 09:39:00,37,98,Vestuário,1,135
581,2024-01-01 09:40:00,66,79,Móvel,6,145
582,2024-01-01 09:41:00,118,142,Alimento,7,260
583,2024-01-01 09:42:00,43,52,Vestuário,7,95
584,2024-01-01 09:43:00,32,154,Alimento,2,186
585,2024-01-01 09:44:00,48,56,Vestuário,1,104
586,2024-01-01 09:45:00,43,110,Vestuário,2,153
587,2024-01-01 09:46:00,16,91,Brinquedo,1,107
588,2024-01-01 09:47:00,19,170,Vestuário,3,189
589,2024-01-01 09:48:00,10,41,Móvel,6,51
590,2024-01-01 09:49:00,113,72,Eletrônico,1,185
591,2024-01-01 09:50:00,51,71,Brinquedo,8,122
592,2024-01-01 09:51:00,45,99,Alimento,5,144
593,2024-01-01 09:52:00,13,116,Alimento,5,129
594,2024-01-01 09:53:00,41,92,Vestuário,3,133
595,2024-01-01 09:54:00,114,31,Vestuário,8,145
596,2024-01-01 09:55:00,119,156,Eletrônico,3,275
597,2024-01-01 09:56:00,77,159,Brinquedo,7,236
598,2024-01-01 09:57:00,12,10,Eletrônico,4,22
599,2024-01-01 09:58:00,24,129,Vestuário,7,153
600,2024-01-01 09:59:00,110,24,Vestuário,6,134
601,2024-01-01 10:00:00,97,87,Vestuário,5,184
602,2024-01-01 10:01:00,58,176,Eletrônico,6,234
603,2024-01-01 10:02:00,107,125,Eletrônico,3,232
604,2024-01-01 10:03:00,32,106,Vestuário,1,138
605,2024-01-01 10:04:00,52,127,Móvel,5,179
606,2024-01-01 10:05:00,111,89,Vestuário,5,200
607,2024-01-01 10:06:00,57,38,Móvel,7,95
608,2024-01-01 10:07:00,60,146,Vestuário,7,206
609,2024-01-01 10:08:00,61,154,Móvel,7,215
610,2024-01-01 10:09:00,101,168,Vestuário,9,269
611,2024-01-01 10:10:00,77,69,Brinquedo,8,146
612,2024-01-01 10:11:00,86,162,Eletrônico,6,248
613,2024-01-01 10:12:00,33,24,Brinquedo,3,57
614,2024-01-01 10:13:00,83,45,Vestuário,7,128
615,2024-01-01 10:14:00,119,105,Eletrônico,9,224
616,2024-01-01 10:15:00,69,18,Móvel,8,87
617,2024-01-01 10:16:00,92,31,Alimento,7,123
618,2024-01-01 10:17:00,18,108,Móvel,6,126
619,2024-01-01 10:18:00,115,81,Eletrônico,5,196
620,2024-01-01 10:19:00,80,30,Brinquedo,4,110
621,2024-01-01 10:20:00,103,26,Eletrônico,4,129
622,2024-01-01 10:21:00,111,72,Móvel,4,183
623,2024-01-01 10:22:00,93,58,Móvel,1,151
624,2024-01-01 10:23:00,27,130,Brinquedo,1,157
625,2024-01-01 10:24:00,21,116,Alimento,6,137
626,2024-01-01 10:25:00,34,29,Eletrônico,2,63
627,2024-01-01 10:26:00,109,91,Brinquedo,7,200
628,2024-01-01 10:27:00,100,145,Vestuário,5,245
629,2024-01-01 10:28:00,73,101,Móvel,1,174
630,2024-01-01 10:29:00,17,133,Vestuário,2,150
631,2024-01-01 10:30:00,33,62,Vestuário,7,95
632,2024-01-01 10:31:00,117,127,Móvel,8,244
633,2024-01-01 10:32:00,40,66,Alimento,3,106
634,2024-01-01 10:33:00,100,96,Alimento,6,196
635,2024-01-01 10:34:00,92,59,Vestuário,1,151
636,2024-01-01 10:35:00,47,92,Vestuário,7,139
637,2024-01-01 10:36:00,103,16,Brinquedo,6,119
638,2024-01-01 10:37:00,104,13,Vestuário,1,117
639,2024-01-01 10:38:00,79,40,Móvel,2,119
640,2024-01-01 10:39:00,87,72,Eletrônico,3,159
641,2024-01-01 10:40:00,69,57,Vestuário,8,126
642,2024-01-01 10:41:00,67,153,Alimento,2,220
643,2024-01-01 10:42:00,79,118,Vestuário,7,197
644,2024-01-01 10:43:00,22,30,Eletrônico,8,52
645,2024-01-01 10:44:00,55,105,Alimento,3,160
646,2024-01-01 10:45:00,16,144,Eletrônico,8,160
647,2024-01-01 10:46:00,28,91,Móvel,9,119
648,2024-01-01 10:47:00,68,42,Vestuário,6,110
649,2024-01-01 10:48:00,89,43,Móvel,8,132
650,2024-01-01 10:49:00,99,26,Eletrônico,2,125
651,2024-01-01 10:50:00,41,173,Móvel,7,214
652,2024-01-01 10:51:00,22,59,Alimento,4,81
653,2024-01-01 10:52:00,94,44,Vestuário,7,138
654,2024-01-01 10:53:00,38,87,Brinquedo,7,125
655,2024-01-01 10:54:00,67,80,Vestuário,5,147
656,2024-01-01 10:55:00,61,61,Brinquedo,9,122
657,2024-01-01 10:56:00,87,125,Eletrônico,9,212
658,2024-01-01 10:57:00,44,23,Móvel,6,67
659,2024-01-01 10:58:00,103,109,Alimento,5,212
660,2024-01-01 10:59:00,55,130,Móvel,3,185
661,2024-01-01 11:00:00,101,54,Alimento,9,155
662,2024-01-01 11:01:00,62,147,Móvel,4,209
663,2024-01-01 11:02:00,30,166,Brinquedo,7,196
664,2024-01-01 11:03:00,59,142,Móvel,7,201
665,2024-01-01 11:04:00,119,13,Vestuário,7,132
666,2024-01-01 11:05:00,17,57,Móvel,6,74
667,2024-01-01 11:06:00,41,156,Brinquedo,6,197
668,2024-01-01 11:07:00,116,89,Móvel,1,205
669,2024-01-01 11:08:00,100,120,Móvel,3,220
670,2024-01-01 11:09:00,98,113,Vestuário,2,211
671,2024-01-01 11:10:00,61,12,Móvel,5,73
672,2024-01-01 11:11:00,43,43,Brinquedo,8,86
673,2024-01-01 11:12:00,38,168,Alimento,5,206
674,2024-01-01 11:13:00,32,137,Vestuário,7,169
675,2024-01-01 11:14:00,30,49,Alimento,3,79
676,2024-01-01 11:15:00,54,69,Vestuário,7,123
677,2024-01-01 11:16:00,64,79,Vestuário,7,143
678,2024-01-01 11:17:00,29,162,Brinquedo,9,191
679,2024-01-01 11:18:00,16,123,Eletrônico,2,139
680,2024-01-01 11:19:00,80,99,Móvel,4,179
681,2024-01-01 11:20:00,13,140,Alimento,8,153
682,2024-01-01 11:21:00,110,120,Móvel,9,230
683,2024-01-01 11:22:00,37,154,Eletrônico,6,191
684,2024-01-01 11:23:00,49,63,Eletrônico,9,112
685,2024-01-01 11:24:00,25,119,Móvel,7,144
686,2024-01-01 11:25:00,43,22,Vestuário,7,65
687,2024-01-01 11:26:00,64,165,Móvel,1,229
688,2024-01-01 11:27:00,37,59,Móvel,4,96
689,2024-01-01 11:28:00,45,50,Alimento,1,95
690,2024-01-01 11:29:00,36,178,Vestuário,2,214
691,2024-01-01 11:30:00,90,118,Alimento,9,208
692,2024-01-01 11:31:00,67,110,Brinquedo,2,177
693,2024-01-01 11:32:00,33,96,Alimento,1,129
694,2024-01-01 11:33:00,11,40,Vestuário,3,51
695,2024-01-01 11:34:00,48,51,Brinquedo,8,99
696,2024-01-01 11:35:00,115,89,Móvel,1,204
697,2024-01-01 11:36:00,19,170,Eletrônico,7,189
698,2024-01-01 11:37:00,76,130,Eletrônico,8,206
699,2024-01-01 11:38:00,53,134,Vestuário,5,187
700,2024-01-01 11:39:00,32,101,Eletrônico,8,133
701,2024-01-01 11:40:00,41,150,Brinquedo,5,191
702,2024-01-01 11:41:00,73,81,Alimento,8,154
703,2024-01-01 11:42:00,69,110,Móvel,2,179
704,2024-01-01 11:43:00,38,97,Eletrônico,2,135
705,2024-01-01 11:44:00,13,46,Móvel,2,59
706,2024-01-01 11:45:00,34,73,Móvel,4,107
707,2024-01-01 11:46:00,32,54,Vestuário,3,86
708,2024-01-01 11:47:00,61,13,Móvel,8,74
709,2024-01-01 11:48:00,21,96,Alimento,4,117
710,2024-01-01 11:49:00,81,147,Móvel,6,228
711,2024-01-01 11:50:00,18,46,Móvel,3,64
712,2024-01-01 11:51:00,86,21,Eletrônico,5,107
713,2024-01-01 11:52:00,40,128,Brinquedo,7,168
714,2024-01-01 11:53:00,10,67,Vestuário,6,77
715,2024-01-01 11:54:00,98,66,Eletrônico,2,164
716,2024-01-01 11:55:00,41,129,Brinquedo,4,170
717,2024-01-01 11:56:00,72,93,Eletrônico,8,165
718,2024-01-01 11:57:00,18,70,Eletrônico,6,88
719,2024-01-01 11:58:00,114,83,Vestuário,3,197
720,2024-01-01 11:59:00,90,21,Eletrônico,9,111
721,2024-01-01 12:00:00,76,127,Móvel,9,203
722,2024-01-01 12:01:00,12,52,Brinquedo,9,64
723,2024-01-01 12:02:00,36,151,Vestuário,4,187
724,2024-01-01 12:03:00,100,35,Vestuário,5,135
725,2024-01-01 12:04:00,23,179,Eletrônico,8,202
726,2024-01-01 12:05:00,99,156,Eletrônico,4,255
727,2024-01-01 12:06:00,32,21,Brinquedo,8,53
728,2024-01-01 12:07:00,15,114,Alimento,8,129
729,2024-01-01 12:08:00,57,176,Brinquedo,3,233
730,2024-01-01 12:09:00,106,71,Alimento,7,177
731,2024-01-01 12:10:00,25,116,Eletrônico,4,141
732,2024-01-01 12:11:00,57,161,Vestuário,7,218
733,2024-01-01 12:12:00,19,55,Alimento,1,74
734,2024-01-01 12:13:00,80,112,Eletrônico,7,192
735,2024-01-01 12:14:00,104,14,Brinquedo,4,118
736,2024-01-01 12:15:00,118,39,Alimento,5,157
737,2024-01-01 12:16:00,23,111,Vestuário,9,134
738,2024-01-01 12:17:00,39,63,Móvel,9,102
739,2024-01-01 12:18:00,31,19,Alimento,7,50
740,2024-01-01 12:19:00,70,72,Eletrônico,7,142
741,2024-01-01 12:20:00,31,72,Alimento,5,103
742,2024-01-01 12:21:00,58,82,Alimento,3,140
743,2024-01-01 12:22:00,34,85,Brinquedo,3,119
744,2024-01-01 12:23:00,28,52,Brinquedo,6,80
745,2024-01-01 12:24:00,111,98,Móvel,1,209
746,2024-01-01 12:25:00,116,30,Eletrônico,5,146
747,2024-01-01 12:26:00,55,135,Brinquedo,8,190
748,2024-01-01 12:27:00,80,25,Brinquedo,5,105
749,2024-01-01 12:28:00,64,158,Vestuário,4,222
750,2024-01-01 12:29:00,27,44,Brinquedo,1,71
751,2024-01-01 12:30:00,17,166,Brinquedo,6,183
752,2024-01-01 12:31:00,97,135,Móvel,3,232
753,2024-01-01 12:32:00,52,90,Móvel,8,142
754,2024-01-01 12:33:00,17,132,Móvel,6,149
755,2024-01-01 12:34:00,114,130,Brinquedo,7,244
756,2024-01-01 12:35:00,98,140,Alimento,1,238
757,2024-01-01 12:36:00,15,95,Vestuário,2,110
758,2024-01-01 12:37:00,109,152,Vestuário,2,261
759,2024-01-01 12:38:00,28,48,Móvel,7,76
760,2024-01-01 12:39:00,92,11,Eletrônico,8,103
761,2024-01-01 12:40:00,92,32,Brinquedo,8,124
762,2024-01-01 12:41:00,27,40,Eletrônico,2,67
763,2024-01-01 12:42:00,59,157,Eletrônico,8,216
764,2024-01-01 12:43:00,94,122,Brinquedo,3,216
765,2024-01-01 12:44:00,86,131,Móvel,8,217
766,2024-01-01 12:45:00,42,140,Vestuário,2,182
767,2024-01-01 12:46:00,114,122,Alimento,3,236
768,2024-01-01 12:47:00,48,179,Móvel,8,227
769,2024-01-01 12:48:00,112,57,Brinquedo,7,169
770,2024-01-01 12:49:00,106,21,Vestuário,7,127
771,2024-01-01 12:50:00,47,73,Vestuário,4,120
772,2024-01-01 12:51:00,44,83,Vestuário,6,127
773,2024-01-01 12:52:00,82,122,Móvel,4,204
774,2024-01-01 12:53:00,111,121,Alimento,6,232
775,2024-01-01 12:54:00,10,88,Brinquedo,9,98
776,2024-01-01 12:55:00,57,161,Vestuário,5,218
777,2024-01-01 12:56:00,16,61,Eletrônico,1,77
778,2024-01-01 12:57:00,112,50,Vestuário,3,162
779,2024-01-01 12:58:00,119,124,Alimento,9,243
780,2024-01-01 12:59:00,63,77,Móvel,1,140
781,2024-01-01 13:00:00,79,125,Alimento,9,204
782,2024-01-01 13:01:00,99,44,Móvel,2,143
783,2024-01-01 13:02:00,25,77,Móvel,7,102
784,2024-01-01 13:03:00,50,81,Brinquedo,4,131
785,2024-01-01 13:04:00,14,88,Móvel,7,102
786,2024-01-01 13:05:00,12,97,Alimento,6,109
787,2024-01-01 13:06:00,80,80,Eletrônico,4,160
788,2024-01-01 13:07:00,77,21,Alimento,5,98
789,2024-01-01 13:08:00,19,18,Vestuário,9,37
790,2024-01-01 13:09:00,48,161,Alimento,2,209
791,2024-01-01 13:10:00,119,76,Vestuário,1,195
792,2024-01-01 13:11:00,105,143,Móvel,4,248
793,2024-01-01 13:12:00,68,52,Móvel,1,120
794,2024-01-01 13:13:00,63,121,Alimento,3,184
795,2024-01-01 13:14:00,24,90,Alimento,5,114
796,2024-01-01 13:15:00,52,126,Brinquedo,1,178
797,2024-01-01 13:16:00,43,14,Eletrônico,8,57
798,2024-01-01 13:17:00,22,84,Eletrônico,7,106
799,2024-01-01 13:18:00,99,61,Eletrônico,9,160
800,2024-01-01 13:19:00,85,37,Eletrônico,7,122
801,2024-01-01 13:20:00,31,172,Vestuário,6,203
802,2024-01-01 13:21:00,19,127,Vestuário,4,146
803,2024-01-01 13:22:00,99,81,Vestuário,9,180
804,2024-01-01 13:23:00,24,140,Vestuário,3,164
805,2024-01-01 13:24:00,10,101,Brinquedo,9,111
806,2024-01-01 13:25:00,96,56,Alimento,2,152
807,2024-01-01 13:26:00,106,178,Alimento,1,284
808,2024-01-01 13:27:00,72,172,Móvel,4,244
809,2024-01-01 13:28:00,57,48,Alimento,2,105
810,2024-01-01 13:29:00,49,27,Alimento,4,76
811,2024-01-01 13:30:00,22,21,Brinquedo,3,43
812,2024-01-01 13:31:00,78,115,Alimento,1,193
813,2024-01-01 13:32:00,106,141,Vestuário,4,247
814,2024-01-01 13:33:00,104,36,Vestuário,1,140
815,2024-01-01 13:34:00,100,27,Móvel,5,127
816,2024-01-01 13:35:00,94,27,Alimento,7,121
817,2024-01-01 13:36:00,71,101,Vestuário,5,172
818,2024-01-01 13:37:00,80,54,Brinquedo,9,134
819,2024-01-01 13:38:00,68,178,Eletrônico,8,246
820,2024-01-01 13:39:00,93,158,Brinquedo,7,251
821,2024-01-01 13:40:00,88,88,Brinquedo,2,176
822,2024-01-01 13:41:00,51,70,Alimento,6,121
823,2024-01-01 13:42:00,52,117,Brinquedo,5,169
824,2024-01-01 13:43:00,61,18,Vestuário,4,79
825,2024-01-01 13:44:00,77,79,Vestuário,8,156
826,2024-01-01 13:45:00,24,124,Eletrônico,7,148
827,2024-01-01 13:46:00,39,71,Eletrônico,8,110
828,2024-01-01 13:47:00,19,79,Móvel,3,98
829,2024-01-01 13:48:00,69,105,Vestuário,4,174
830,2024-01-01 13:49:00,52,157,Vestuário,4,209
831,2024-01-01 13:50:00,79,36,Móvel,5,115
832,2024-01-01 13:51:00,39,138,Alimento,3,177
833,2024-01-01 13:52:00,66,74,Vestuário,4,140
834,2024-01-01 13:53:00,50,12,Brinquedo,6,62
835,2024-01-01 13:54:00,34,96,Brinquedo,2,130
836,2024-01-01 13:55:00,28,19,Alimento,4,47
837,2024-01-01 13:56:00,26,106,Alimento,7,132
838,2024-01-01 13:57:00,98,154,Eletrônico,2,252
839,2024-01-01 13:58:00,54,123,Móvel,8,177
840,2024-01-01 13:59:00,88,78,Vestuário,7,166
841,2024-01-01 14:00:00,24,82,Móvel,3,106
842,2024-01-01 14:01:00,42,79,Eletrônico,5,121
843,2024-01-01 14:02:00,92,71,Vestuário,5,163
844,2024-01-01 14:03:00,81,22,Móvel,2,103
845,2024-01-01 14:04:00,90,19,Brinquedo,6,109
846,2024-01-01 14:05:00,78,68,Alimento,4,146
847,2024-01-01 14:06:00,41,11,Alimento,4,52
848,2024-01-01 14:07:00,13,75,Vestuário,1,88
849,2024-01-01 14:08:00,21,173,Brinquedo,4,194
850,2024-01-01 14:09:00,31,42,Eletrônico,1,73
851,2024-01-01 14:10:00,26,78,Vestuário,3,104
852,2024-01-01 14:11:00,22,35,Eletrônico,9,57
853,2024-01-01 14:12:00,108,151,Móvel,5,259
854,2024-01-01 14:13:00,62,45,Brinquedo,8,107
855,2024-01-01 14:14:00,84,104,Vestuário,1,188
856,2024-01-01 14:15:00,48,144,Alimento,4,192
857,2024-01-01 14:16:00,115,29,Alimento,6,144
858,2024-01-01 14:17:00,118,82,Brinquedo,4,200
859,2024-01-01 14:18:00,103,91,Brinquedo,5,194
860,2024-01-01 14:19:00,12,131,Móvel,1,143
861,2024-01-01 14:20:00,40,75,Alimento,7,115
862,2024-01-01 14:21:00,66,82,Móvel,7,148
863,2024-01-01 14:22:00,96,70,Móvel,6,166
864,2024-01-01 14:23:00,34,114,Alimento,8,148
865,2024-01-01 14:24:00,69,115,Móvel,5,184
866,2024-01-01 14:25:00,62,72,Brinquedo,4,134
867,2024-01-01 14:26:00,35,40,Alimento,8,75
868,2024-01-01 14:27:00,49,156,Brinquedo,8,205
869,2024-01-01 14:28:00,72,106,Móvel,8,178
870,2024-01-01 14:29:00,21,116,Móvel,6,137
871,2024-01-01 14:30:00,39,90,Eletrônico,7,129
872,2024-01-01 14:31:00,46,113,Vestuário,2,159
873,2024-01-01 14:32:00,28,20,Alimento,8,48
874,2024-01-01 14:33:00,87,62,Móvel,2,149
875,2024-01-01 14:34:00,62,28,Brinquedo,1,90
876,2024-01-01 14:35:00,78,173,Brinquedo,5,251
877,2024-01-01 14:36:00,110,134,Vestuário,7,244
878,2024-01-01 14:37:00,42,72,Eletrônico,9,114
879,2024-01-01 14:38:00,52,94,Móvel,2,146
880,2024-01-01 14:39:00,55,88,Alimento,1,143
881,2024-01-01 14:40:00,66,172,Brinquedo,3,238
882,2024-01-01 14:41:00,39,50,Móvel,9,89
883,2024-01-01 14:42:00,22,17,Alimento,6,39
884,2024-01-01 14:43:00,88,98,Eletrônico,5,186
885,2024-01-01 14:44:00,65,170,Eletrônico,5,235
886,2024-01-01 14:45:00,116,30,Vestuário,6,146
887,2024-01-01 14:46:00,36,133,Vestuário,9,169
888,2024-01-01 14:47:00,87,154,Eletrônico,2,241
889,2024-01-01 14:48:00,27,96,Vestuário,4,123
890,2024-01-01 14:49:00,73,10,Alimento,2,83
891,2024-01-01 14:50:00,109,114,Brinquedo,7,223
892,2024-01-01 14:51:00,64,47,Vestuário,5,111
893,2024-01-01 14:52:00,20,89,Brinquedo,3,109
894,2024-01-01 14:53:00,102,87,Eletrônico,3,189
895,2024-01-01 14:54:00,39,166,Eletrônico,9,205
896,2024-01-01 14:55:00,41,123,Alimento,7,164
897,2024-01-01 14:56:00,18,81,Vestuário,1,99
898,2024-01-01 14:57:00,55,35,Eletrônico,2,90
899,2024-01-01 14:58:00,80,80,Alimento,7,160
900,2024-01-01 14:59:00,83,104,Alimento,4,187
901,2024-01-01 15:00:00,85,126,Brinquedo,6,211
902,2024-01-01 15:01:00,25,102,Brinquedo,1,127
903,2024-01-01 15:02:00,98,29,Vestuário,8,127
904,2024-01-01 15:03:00,63,113,Alimento,1,176
905,2024-01-01 15:04:00,27,151,Eletrônico,2,178
906,2024-01-01 15:05:00,38,23,Eletrônico,9,61
907,2024-01-01 15:06:00,88,109,Eletrônico,3,197
908,2024-01-01 15:07:00,61,69,Eletrônico,9,130
909,2024-01-01 15:08:00,63,124,Brinquedo,9,187
910,2024-01-01 15:09:00,66,115,Alimento,9,181
911,2024-01-01 15:10:00,15,44,Móvel,3,59
912,2024-01-01 15:11:00,88,110,Eletrônico,6,198
913,2024-01-01 15:12:00,97,114,Vestuário,8,211
914,2024-01-01 15:13:00,106,141,Móvel,6,247
915,2024-01-01 15:14:00,15,87,Eletrônico,6,102
916,2024-01-01 15:15:00,91,95,Vestuário,1,186
917,2024-01-01 15:16:00,11,132,Brinquedo,2,143
918,2024-01-01 15:17:00,84,102,Brinquedo,2,186
919,2024-01-01 15:18:00,33,102,Eletrônico,1,135
920,2024-01-01 15:19:00,37,129,Eletrônico,5,166
921,2024-01-01 15:20:00,11,171,Brinquedo,2,182
922,2024-01-01 15:21:00,89,31,Brinquedo,1,120
923,2024-01-01 15:22:00,17,87,Vestuário,4,104
924,2024-01-01 15:23:00,13,92,Móvel,9,105
925,2024-01-01 15:24:00,16,148,Brinquedo,3,164
926,2024-01-01 15:25:00,68,18,Brinquedo,5,86
927,2024-01-01 15:26:00,114,87,Eletrônico,9,201
928,2024-01-01 15:27:00,103,107,Alimento,9,210
929,2024-01-01 15:28:00,71,29,Móvel,9,100
930,2024-01-01 15:29:00,37,23,Alimento,7,60
931,2024-01-01 15:30:00,62,140,Móvel,1,202
932,2024-01-01 15:31:00,57,110,Vestuário,9,167
933,2024-01-01 15:32:00,84,91,Alimento,5,175
934,2024-01-01 15:33:00,89,174,Alimento,4,263
935,2024-01-01 15:34:00,104,168,Alimento,2,272
936,2024-01-01 15:35:00,28,127,Alimento,3,155
937,2024-01-01 15:36:00,83,52,Brinquedo,9,135
938,2024-01-01 15:37:00,69,14,Vestuário,9,83
939,2024-01-01 15:38:00,46,113,Móvel,4,159
940,2024-01-01 15:39:00,11,73,Eletrônico,1,84
941,2024-01-01 15:40:00,93,167,Alimento,1,260
942,2024-01-01 15:41:00,27,151,Eletrônico,5,178
943,2024-01-01 15:42:00,30,173,Brinquedo,9,203
944,2024-01-01 15:43:00,63,61,Vestuário,6,124
945,2024-01-01 15:44:00,12,85,Eletrônico,7,97
946,2024-01-01 15:45:00,66,16,Brinquedo,6,82
947,2024-01-01 15:46:00,70,103,Brinquedo,7,173
948,2024-01-01 15:47:00,73,14,Brinquedo,5,87
949,2024-01-01 15:48:00,73,26,Eletrônico,5,99
950,2024-01-01 15:49:00,47,97,Móvel,8,144
951,2024-01-01 15:50:00,98,154,Eletrônico,5,252
952,2024-01-01 15:51:00,96,79,Eletrônico,7,175
953,2024-01-01 15:52:00,38,87,Vestuário,7,125
954,2024-01-01 15:53:00,45,29,Móvel,8,74
955,2024-01-01 15:54:00,66,52,Móvel,2,118
956,2024-01-01 15:55:00,76,17,Alimento,8,93
957,2024-01-01 15:56:00,81,68,Vestuário,5,149
958,2024-01-01 15:57:00,52,86,Brinquedo,4,138
959,2024-01-01 15:58:00,107,44,Alimento,9,151
960,2024-01-01 15:59:00,47,146,Brinquedo,6,193
961,2024-01-01 16:00:00,20,114,Móvel,2,134
962,2024-01-01 16:01:00,110,152,Eletrônico,6,262
963,2024-01-01 16:02:00,52,46,Eletrônico,9,98
964,2024-01-01 16:03:00,88,142,Eletrônico,8,230
965,2024-01-01 16:04:00,86,131,Alimento,6,217
966,2024-01-01 16:05:00,42,155,Vestuário,8,197
967,2024-01-01 16:06:00,12,152,Alimento,1,164
968,2024-01-01 16:07:00,65,124,Brinquedo,1,189
969,2024-01-01 16:08:00,35,99,Móvel,4,134
970,2024-01-01 16:09:00,14,67,Brinquedo,5,81
971,2024-01-01 16:10:00,66,128,Vestuário,7,194
972,2024-01-01 16:11:00,58,109,Vestuário,7,167
973,2024-01-01 16:12:00,67,117,Móvel,6,184
974,2024-01-01 16:13:00,86,90,Eletrônico,6,176
975,2024-01-01 16:14:00,99,48,Alimento,7,147
976,2024-01-01 16:15:00,12,54,Eletrônico,1,66
977,2024-01-01 16:16:00,34,100,Alimento,6,134
978,2024-01-01 16:17:00,20,76,Eletrônico,9,96
979,2024-01-01 16:18:00,80,82,Vestuário,3,162
980,2024-01-01 16:19:00,72,58,Eletrônico,2,130
981,2024-01-01 16:20:00,72,31,Eletrônico,4,103
982,2024-01-01 16:21:00,80,19,Móvel,1,99
983,2024-01-01 16:22:00,110,10,Brinquedo,8,120
984,2024-01-01 16:23:00,28,47,Móvel,9,75
985,2024-01-01 16:24:00,91,47,Eletrônico,6,138
986,2024-01-01 16:25:00,88,168,Móvel,6,256
987,2024-01-01 16:26:00,60,87,Móvel,4,147
988,2024-01-01 16:27:00,11,72,Alimento,3,83
989,2024-01-01 16:28:00,61,156,Alimento,9,217
990,2024-01-01 16:29:00,87,123,Móvel,1,210
991,2024-01-01 16:30:00,43,118,Móvel,5,161
992,2024-01-01 16:31:00,13,41,Vestuário,1,54
993,2024-01-01 16:32:00,72,172,Brinquedo,6,244
994,2024-01-01 16:33:00,99,92,Eletrônico,4,191
995,2024-01-01 16:34:00,37,125,Eletrônico,7,162
996,2024-01-01 16:35:00,58,103,Móvel,3,161
997,2024-01-01 16:36:00,119,104,Brinquedo,7,223
998,2024-01-01 16:37:00,43,17,Brinquedo,9,60
999,2024-01-01 16:38:00,94,142,Brinquedo,7,236
1000,2024-01-01 16:39:00,12,95,Alimento,7,107
1001,2024-01-01 16:40:00,83,29,Vestuário,6,112
1002,2024-01-01 16:41:00,104,68,Eletrônico,7,172
1003,2024-01-01 16:42:00,45,159,Vestuário,4,204
1004,2024-01-01 16:43:00,110,164,Brinquedo,8,274
1005,2024-01-01 16:44:00,53,96,Móvel,1,149
1006,2024-01-01 16:45:00,22,84,Brinquedo,2,106
1007,2024-01-01 16:46:00,47,67,Brinquedo,7,114
1008,2024-01-01 16:47:00,43,159,Eletrônico,5,202
1009,2024-01-01 16:48:00,80,160,Brinquedo,7,240
1010,2024-01-01 16:49:00,97,98,Móvel,9,195
1011,2024-01-01 16:50:00,116,112,Brinquedo,9,228
1012,2024-01-01 16:51:00,24,91,Móvel,9,115
1013,2024-01-01 16:52:00,78,42,Brinquedo,8,120
1014,2024-01-01 16:53:00,90,79,Eletrônico,7,169
1015,2024-01-01 16:54:00,69,15,Móvel,5,84
1016,2024-01-01 16:55:00,37,175,Brinquedo,1,212
1017,2024-01-01 16:56:00,59,75,Vestuário,3,134
1018,2024-01-01 16:57:00,87,127,Brinquedo,8,214
1019,2024-01-01 16:58:00,58,164,Brinquedo,9,222
1020,2024-01-01 16:59:00,80,107,Vestuário,3,187
1021,2024-01-01 17:00:00,35,126,Móvel,4,161
1022,2024-01-01 17:01:00,84,48,Vestuário,5,132
1023,2024-01-01 17:02:00,105,170,Vestuário,9,275
1024,2024-01-01 17:03:00,102,133,Eletrônico,5,235
1025,2024-01-01 17:04:00,71,163,Vestuário,8,234
1026,2024-01-01 17:05:00,98,148,Alimento,9,246
1027,2024-01-01 17:06:00,102,100,Móvel,3,202
1028,2024-01-01 17:07:00,104,29,Brinquedo,5,133
1029,2024-01-01 17:08:00,25,86,Brinquedo,2,111
1030,2024-01-01 17:09:00,82,91,Brinquedo,4,173
1031,2024-01-01 17:10:00,53,20,Alimento,1,73
1032,2024-01-01 17:11:00,73,145,Alimento,6,218
1033,2024-01-01 17:12:00,118,42,Móvel,2,160
1034,2024-01-01 17:13:00,35,47,Móvel,8,82
1035,2024-01-01 17:14:00,111,81,Eletrônico,5,192
1036,2024-01-01 17:15:00,106,116,Eletrônico,8,222
1037,2024-01-01 17:16:00,67,148,Alimento,1,215
1038,2024-01-01 17:17:00,109,142,Móvel,9,251
1039,2024-01-01 17:18:00,37,83,Eletrônico,8,120
1040,2024-01-01 17:19:00,73,71,Vestuário,1,144
1041,2024-01-01 17:20:00,90,148,Alimento,1,238
1042,2024-01-01 17:21:00,46,143,Vestuário,7,189
1043,2024-01-01 17:22:00,115,127,Alimento,9,242
1044,2024-01-01 17:23:00,91,137,Vestuário,9,228
1045,2024-01-01 17:24:00,53,62,Brinquedo,6,115
1046,2024-01-01 17:25:00,75,65,Vestuário,6,140
1047,2024-01-01 17:26:00,53,91,Eletrônico,4,144
1048,2024-01-01 17:27:00,98,122,Eletrônico,1,220
1049,2024-01-01 17:28:00,43,75,Vestuário,7,118
1050,2024-01-01 17:29:00,55,77,Móvel,1,132
1051,2024-01-01 17:30:00,65,73,Móvel,3,138
1052,2024-01-01 17:31:00,13,83,Eletrônico,9,96
1053,2024-01-01 17:32:00,61,170,Móvel,7,231
1054,2024-01-01 17:33:00,88,127,Eletrônico,6,215
1055,2024-01-01 17:34:00,62,162,Vestuário,7,224
1056,2024-01-01 17:35:00,12,97,Alimento,7,109
1057,2024-01-01 17:36:00,108,46,Alimento,7,154
1058,2024-01-01 17:37:00,51,136,Brinquedo,7,187
1059,2024-01-01 17:38:00,91,134,Eletrônico,3,225
1060,2024-01-01 17:39:00,101,116,Vestuário,7,217
1061,2024-01-01 17:40:00,17,50,Alimento,1,67
1062,2024-01-01 17:41:00,16,84,Brinquedo,4,100
1063,2024-01-01 17:42:00,51,141,Brinquedo,2,192
1064,2024-01-01 17:43:00,105,119,Móvel,8,224
1065,2024-01-01 17:44:00,76,60,Vestuário,8,136
1066,2024-01-01 17:45:00,93,54,Brinquedo,2,147
1067,2024-01-01 17:46:00,17,151,Eletrônico,6,168
1068,2024-01-01 17:47:00,44,28,Eletrônico,9,72
1069,2024-01-01 17:48:00,27,82,Vestuário,5,109
1070,2024-01-01 17:49:00,18,40,Alimento,3,58
1071,2024-01-01 17:50:00,112,64,Eletrônico,3,176
1072,2024-01-01 17:51:00,50,173,Alimento,3,223
1073,2024-01-01 17:52:00,50,46,Móvel,7,96
1074,2024-01-01 17:53:00,86,137,Móvel,3,223
1075,2024-01-01 17:54:00,62,102,Alimento,2,164
1076,2024-01-01 17:55:00,25,97,Móvel,1,122
1077,2024-01-01 17:56:00,100,75,Móvel,8,175
1078,2024-01-01 17:57:00,101,49,Eletrônico,6,150
1079,2024-01-01 17:58:00,11,89,Eletrônico,2,100
1080,2024-01-01 17:59:00,98,82,Eletrônico,4,180
1081,2024-01-01 18:00:00,55,36,Móvel,6,91
1082,2024-01-01 18:01:00,36,175,Móvel,4,211
1083,2024-01-01 18:02:00,103,101,Vestuário,7,204
1084,2024-01-01 18:03:00,96,141,Eletrônico,7,237
1085,2024-01-01 18:04:00,64,55,Vestuário,7,119
1086,2024-01-01 18:05:00,56,75,Brinquedo,1,131
1087,2024-01-01 18:06:00,89,70,Brinquedo,5,159
1088,2024-01-01 18:07:00,94,30,Eletrônico,7,124
1089,2024-01-01 18:08:00,115,163,Móvel,2,278
1090,2024-01-01 18:09:00,98,24,Móvel,6,122
1091,2024-01-01 18:10:00,98,141,Brinquedo,2,239
1092,2024-01-01 18:11:00,73,28,Móvel,4,101
1093,2024-01-01 18:12:00,93,54,Alimento,5,147
1094,2024-01-01 18:13:00,116,17,Brinquedo,5,133
1095,2024-01-01 18:14:00,93,163,Móvel,8,256
1096,2024-01-01 18:15:00,106,163,Alimento,9,269
1097,2024-01-01 18:16:00,70,23,Vestuário,8,93
1098,2024-01-01 18:17:00,16,100,Eletrônico,5,116
1099,2024-01-01 18:18:00,85,23,Eletrônico,4,108
1100,2024-01-01 18:19:00,67,168,Eletrônico,3,235
1101,2024-01-01 18:20:00,52,141,Vestuário,8,193
1102,2024-01-01 18:21:00,31,26,Eletrônico,5,57
1103,2024-01-01 18:22:00,26,99,Móvel,1,125
1104,2024-01-01 18:23:00,94,81,Eletrônico,9,175
1105,2024-01-01 18:24:00,20,88,Eletrônico,5,108
1106,2024-01-01 18:25:00,118,134,Vestuário,1,252
1107,2024-01-01 18:26:00,110,84,Alimento,3,194
1108,2024-01-01 18:27:00,109,99,Vestuário,4,208
1109,2024-01-01 18:28:00,68,169,Alimento,2,237
1110,2024-01-01 18:29:00,69,126,Alimento,2,195
1111,2024-01-01 18:30:00,11,64,Eletrônico,4,75
1112,2024-01-01 18:31:00,10,125,Vestuário,2,135
1113,2024-01-01 18:32:00,66,28,Eletrônico,4,94
1114,2024-01-01 18:33:00,113,131,Vestuário,7,244
1115,2024-01-01 18:34:00,110,14,Móvel,4,124
1116,2024-01-01 18:35:00,101,72,Móvel,9,173
1117,2024-01-01 18:36:00,22,112,Móvel,4,134
1118,2024-01-01 18:37:00,12,24,Vestuário,1,36
1119,2024-01-01 18:38:00,110,120,Alimento,4,230
1120,2024-01-01 18:39:00,104,35,Vestuário,6,139
1121,2024-01-01 18:40:00,82,145,Vestuário,9,227
1122,2024-01-01 18:41:00,23,85,Eletrônico,7,108
1123,2024-01-01 18:42:00,34,17,Brinquedo,5,51
1124,2024-01-01 18:43:00,56,74,Móvel,9,130
1125,2024-01-01 18:44:00,14,157,Móvel,2,171
1126,2024-01-01 18:45:00,93,20,Brinquedo,9,113
1127,2024-01-01 18:46:00,68,29,Vestuário,4,97
1128,2024-01-01 18:47:00,61,19,Vestuário,4,80
1129,2024-01-01 18:48:00,42,152,Eletrônico,8,194
1130,2024-01-01 18:49:00,77,115,Brinquedo,5,192
1131,2024-01-01 18:50:00,25,92,Alimento,7,117
1132,2024-01-01 18:51:00,25,39,Eletrônico,7,64
1133,2024-01-01 18:52:00,48,13,Vestuário,5,61
1134,2024-01-01 18:53:00,14,121,Eletrônico,3,135
1135,2024-01-01 18:54:00,36,122,Móvel,5,158
1136,2024-01-01 18:55:00,52,71,Eletrônico,7,123
1137,2024-01-01 18:56:00,74,42,Brinquedo,1,116
1138,2024-01-01 18:57:00,10,46,Alimento,6,56
1139,2024-01-01 18:58:00,21,30,Móvel,8,51
1140,2024-01-01 18:59:00,52,56,Alimento,6,108
1141,2024-01-01 19:00:00,108,124,Brinquedo,5,232
1142,2024-01-01 19:01:00,68,59,Móvel,1,127
1143,2024-01-01 19:02:00,68,116,Brinquedo,9,184
1144,2024-01-01 19:03:00,35,151,Eletrônico,5,186
1145,2024-01-01 19:04:00,59,33,Alimento,1,92
1146,2024-01-01 19:05:00,10,143,Vestuário,5,153
1147,2024-01-01 19:06:00,82,107,Eletrônico,9,189
1148,2024-01-01 19:07:00,35,29,Móvel,9,64
1149,2024-01-01 19:08:00,68,42,Vestuário,9,110
1150,2024-01-01 19:09:00,78,35,Móvel,6,113
1151,2024-01-01 19:10:00,107,153,Alimento,9,260
1152,2024-01-01 19:11:00,108,72,Móvel,1,180
1153,2024-01-01 19:12:00,57,137,Brinquedo,7,194
1154,2024-01-01 19:13:00,21,125,Brinquedo,9,146
1155,2024-01-01 19:14:00,111,130,Eletrônico,5,241
1156,2024-01-01 19:15:00,24,106,Alimento,8,130
1157,2024-01-01 19:16:00,77,24,Alimento,7,101
1158,2024-01-01 19:17:00,56,172,Eletrônico,8,228
1159,2024-01-01 19:18:00,48,111,Brinquedo,3,159
1160,2024-01-01 19:19:00,31,70,Vestuário,9,101
1161,2024-01-01 19:20:00,66,30,Vestuário,5,96
1162,2024-01-01 19:21:00,75,155,Brinquedo,6,230
1163,2024-01-01 19:22:00,65,151,Brinquedo,9,216
1164,2024-01-01 19:23:00,11,63,Eletrônico,3,74
1165,2024-01-01 19:24:00,100,128,Alimento,4,228
1166,2024-01-01 19:25:00,85,118,Alimento,5,203
1167,2024-01-01 19:26:00,68,60,Móvel,7,128
1168,2024-01-01 19:27:00,50,107,Móvel,9,157
1169,2024-01-01 19:28:00,48,73,Móvel,7,121
1170,2024-01-01 19:29:00,82,106,Eletrônico,5,188
1171,2024-01-01 19:30:00,33,20,Eletrônico,9,53
1172,2024-01-01 19:31:00,63,77,Eletrônico,3,140
1173,2024-01-01 19:32:00,47,46,Móvel,4,93
1174,2024-01-01 19:33:00,11,103,Vestuário,9,114
1175,2024-01-01 19:34:00,45,133,Brinquedo,4,178
1176,2024-01-01 19:35:00,82,64,Eletrônico,5,146
1177,2024-01-01 19:36:00,115,89,Eletrônico,9,204
1178,2024-01-01 19:37:00,59,98,Móvel,2,157
1179,2024-01-01 19:38:00,16,39,Móvel,8,55
1180,2024-01-01 19:39:00,14,66,Brinquedo,8,80
1181,2024-01-01 19:40:00,60,108,Brinquedo,2,168
1182,2024-01-01 19:41:00,37,158,Alimento,1,195
1183,2024-01-01 19:42:00,34,161,Móvel,7,195
1184,2024-01-01 19:43:00,19,98,Alimento,4,117
1185,2024-01-01 19:44:00,22,79,Móvel,3,101
1186,2024-01-01 19:45:00,37,106,Brinquedo,7,143
1187,2024-01-01 19:46:00,35,61,Brinquedo,2,96
1188,2024-01-01 19:47:00,117,37,Alimento,7,154
1189,2024-01-01 19:48:00,107,13,Móvel,3,120
1190,2024-01-01 19:49:00,98,43,Alimento,3,141
1191,2024-01-01 19:50:00,82,105,Vestuário,5,187
1192,2024-01-01 19:51:00,71,85,Brinquedo,6,156
1193,2024-01-01 19:52:00,64,150,Eletrônico,3,214
1194,2024-01-01 19:53:00,105,124,Brinquedo,9,229
1195,2024-01-01 19:54:00,117,33,Eletrônico,3,150
1196,2024-01-01 19:55:00,55,125,Eletrônico,6,180
1197,2024-01-01 19:56:00,96,64,Eletrônico,8,160
1198,2024-01-01 19:57:00,77,173,Eletrônico,7,250
1199,2024-01-01 19:58:00,20,82,Brinquedo,7,102
1200,2024-01-01 19:59:00,61,163,Eletrônico,8,224
1201,2024-01-01 20:00:00,31,25,Eletrônico,2,56
1202,2024-01-01 20:01:00,41,19,Móvel,6,60
1203,2024-01-01 20:02:00,10,88,Brinquedo,9,98
1204,2024-01-01 20:03:00,94,80,Móvel,2,174
1205,2024-01-01 20:04:00,62,78,Móvel,7,140
1206,2024-01-01 20:05:00,70,20,Alimento,3,90
1207,2024-01-01 20:06:00,64,166,Brinquedo,9,230
1208,2024-01-01 20:07:00,28,52,Vestuário,5,80
1209,2024-01-01 20:08:00,87,11,Móvel,8,98
1210,2024-01-01 20:09:00,75,88,Vestuário,2,163
1211,2024-01-01 20:10:00,53,166,Vestuário,6,219
1212,2024-01-01 20:11:00,91,87,Brinquedo,2,178
1213,2024-01-01 20:12:00,55,103,Alimento,6,158
1214,2024-01-01 20:13:00,117,76,Móvel,9,193
1215,2024-01-01 20:14:00,43,104,Vestuário,1,147
1216,2024-01-01 20:15:00,118,11,Móvel,8,129
1217,2024-01-01 20:16:00,87,176,Eletrônico,9,263
1218,2024-01-01 20:17:00,30,107,Alimento,1,137
1219,2024-01-01 20:18:00,29,85,Alimento,2,114
1220,2024-01-01 20:19:00,108,53,Brinquedo,4,161
1221,2024-01-01 20:20:00,26,23,Vestuário,4,49
1222,2024-01-01 20:21:00,56,60,Móvel,9,116
1223,2024-01-01 20:22:00,71,102,Brinquedo,1,173
1224,2024-01-01 20:23:00,111,166,Vestuário,2,277
1225,2024-01-01 20:24:00,108,101,Alimento,2,209
1226,2024-01-01 20:25:00,89,113,Alimento,5,202
1227,2024-01-01 20:26:00,34,153,Móvel,5,187
1228,2024-01-01 20:27:00,110,65,Vestuário,1,175
1229,2024-01-01 20:28:00,14,62,Alimento,2,76
1230,2024-01-01 20:29:00,34,66,Brinquedo,8,100
1231,2024-01-01 20:30:00,79,28,Vestuário,3,107
1232,2024-01-01 20:31:00,119,146,Móvel,5,265
1233,2024-01-01 20:32:00,114,105,Móvel,3,219
1234,2024-01-01 20:33:00,72,154,Móvel,1,226
1235,2024-01-01 20:34:00,70,129,Alimento,4,199
1236,2024-01-01 20:35:00,41,99,Móvel,1,140
1237,2024-01-01 20:36:00,52,70,Móvel,3,122
1238,2024-01-01 20:37:00,66,99,Brinquedo,6,165
1239,2024-01-01 20:38:00,21,61,Brinquedo,5,82
1240,2024-01-01 20:39:00,103,114,Móvel,1,217
1241,2024-01-01 20:40:00,117,117,Alimento,2,234
1242,2024-01-01 20:41:00,95,131,Vestuário,7,226
1243,2024-01-01 20:42:00,96,99,Brinquedo,1,195
1244,2024-01-01 20:43:00,47,89,Eletrônico,5,136
1245,2024-01-01 20:44:00,80,112,Eletrônico,9,192
1246,2024-01-01 20:45:00,47,128,Brinquedo,9,175
1247,2024-01-01 20:46:00,107,68,Brinquedo,5,175
1248,2024-01-01 20:47:00,43,19,Alimento,4,62
1249,2024-01-01 20:48:00,46,14,Brinquedo,7,60
1250,2024-01-01 20:49:00,118,138,Alimento,4,256
1251,2024-01-01 20:50:00,47,99,Vestuário,1,146
1252,2024-01-01 20:51:00,22,80,Vestuário,6,102
1253,2024-01-01 20:52:00,61,164,Alimento,1,225
1254,2024-01-01 20:53:00,112,73,Vestuário,7,185
1255,2024-01-01 20:54:00,28,179,Vestuário,2,207
1256,2024-01-01 20:55:00,53,86,Eletrônico,6,139
1257,2024-01-01 20:56:00,34,145,Alimento,4,179
1258,2024-01-01 20:57:00,103,27,Vestuário,6,130
1259,2024-01-01 20:58:00,59,140,Vestuário,2,199
1260,2024-01-01 20:59:00,75,119,Alimento,4,194
1261,2024-01-01 21:00:00,35,151,Eletrônico,3,186
1262,2024-01-01 21:01:00,37,173,Alimento,4,210
1263,2024-01-01 21:02:00,36,14,Móvel,4,50
1264,2024-01-01 21:03:00,80,88,Eletrônico,2,168
1265,2024-01-01 21:04:00,20,151,Vestuário,3,171
1266,2024-01-01 21:05:00,106,21,Brinquedo,1,127
1267,2024-01-01 21:06:00,99,145,Brinquedo,1,244
1268,2024-01-01 21:07:00,69,73,Eletrônico,6,142
1269,2024-01-01 21:08:00,66,167,Móvel,3,233
1270,2024-01-01 21:09:00,102,78,Eletrônico,7,180
1271,2024-01-01 21:10:00,30,39,Vestuário,1,69
1272,2024-01-01 21:11:00,35,10,Vestuário,2,45
1273,2024-01-01 21:12:00,84,70,Móvel,3,154
1274,2024-01-01 21:13:00,84,163,Alimento,2,247
1275,2024-01-01 21:14:00,88,85,Eletrônico,2,173
1276,2024-01-01 21:15:00,24,87,Vestuário,7,111
1277,2024-01-01 21:16:00,72,47,Vestuário,5,119
1278,2024-01-01 21:17:00,28,24,Móvel,8,52
1279,2024-01-01 21:18:00,94,115,Eletrônico,9,209
1280,2024-01-01 21:19:00,32,20,Brinquedo,1,52
1281,2024-01-01 21:20:00,29,138,Alimento,1,167
1282,2024-01-01 21:21:00,53,21,Móvel,6,74
1283,2024-01-01 21:22:00,76,112,Eletrônico,7,188
1284,2024-01-01 21:23:00,65,169,Móvel,8,234
1285,2024-01-01 21:24:00,46,11,Eletrônico,1,57
1286,2024-01-01 21:25:00,102,110,Móvel,4,212
1287,2024-01-01 21:26:00,78,162,Eletrônico,9,240
1288,2024-01-01 21:27:00,109,22,Brinquedo,9,131
1289,2024-01-01 21:28:00,22,78,Alimento,1,100
1290,2024-01-01 21:29:00,50,117,Alimento,1,167
1291,2024-01-01 21:30:00,112,131,Brinquedo,2,243
1292,2024-01-01 21:31:00,59,114,Vestuário,9,173
1293,2024-01-01 21:32:00,78,144,Eletrônico,1,222
1294,2024-01-01 21:33:00,54,27,Móvel,6,81
1295,2024-01-01 21:34:00,68,110,Móvel,8,178
1296,2024-01-01 21:35:00,83,147,Eletrônico,4,230
1297,2024-01-01 21:36:00,14,81,Eletrônico,1,95
1298,2024-01-01 21:37:00,16,18,Alimento,1,34
1299,2024-01-01 21:38:00,91,36,Vestuário,9,127
1300,2024-01-01 21:39:00,45,33,Alimento,8,78
1301,2024-01-01 21:40:00,82,159,Brinquedo,7,241
1302,2024-01-01 21:41:00,66,91,Vestuário,5,157
1303,2024-01-01 21:42:00,106,23,Alimento,6,129
1304,2024-01-01 21:43:00,109,121,Móvel,4,230
1305,2024-01-01 21:44:00,13,99,Alimento,9,112
1306,2024-01-01 21:45:00,52,44,Móvel,7,96
1307,2024-01-01 21:46:00,40,97,Brinquedo,1,137
1308,2024-01-01 21:47:00,71,20,Brinquedo,5,91
1309,2024-01-01 21:48:00,94,133,Eletrônico,8,227
1310,2024-01-01 21:49:00,17,15,Vestuário,1,32
1311,2024-01-01 21:50:00,44,132,Eletrônico,4,176
1312,2024-01-01 21:51:00,64,58,Móvel,2,122
1313,2024-01-01 21:52:00,23,80,Vestuário,5,103
1314,2024-01-01 21:53:00,116,91,Móvel,6,207
1315,2024-01-01 21:54:00,65,63,Brinquedo,3,128
1316,2024-01-01 21:55:00,114,114,Vestuário,6,228
1317,2024-01-01 21:56:00,76,144,Eletrônico,4,220
1318,2024-01-01 21:57:00,19,150,Móvel,6,169
1319,2024-01-01 21:58:00,102,59,Brinquedo,1,161
1320,2024-01-01 21:59:00,77,131,Alimento,1,208
1321,2024-01-01 22:00:00,98,117,Eletrônico,5,215
1322,2024-01-01 22:01:00,103,11,Móvel,5,114
1323,2024-01-01 22:02:00,23,80,Móvel,3,103
1324,2024-01-01 22:03:00,24,113,Eletrônico,4,137
1325,2024-01-01 22:04:00,110,74,Brinquedo,4,184
1326,2024-01-01 22:05:00,91,90,Eletrônico,8,181
1327,2024-01-01 22:06:00,27,68,Alimento,3,95
1328,2024-01-01 22:07:00,30,27,Móvel,7,57
1329,2024-01-01 22:08:00,25,117,Móvel,6,142
1330,2024-01-01 22:09:00,70,132,Eletrônico,4,202
1331,2024-01-01 22:10:00,112,26,Vestuário,2,138
1332,2024-01-01 22:11:00,56,15,Brinquedo,8,71
1333,2024-01-01 22:12:00,11,69,Eletrônico,7,80
1334,2024-01-01 22:13:00,21,108,Brinquedo,2,129
1335,2024-01-01 22:14:00,33,142,Móvel,8,175
1336,2024-01-01 22:15:00,47,24,Eletrônico,7,71
1337,2024-01-01 22:16:00,107,23,Eletrônico,3,130
1338,2024-01-01 22:17:00,39,152,Eletrônico,2,191
1339,2024-01-01 22:18:00,33,153,Alimento,2,186
1340,2024-01-01 22:19:00,75,166,Vestuário,1,241
1341,2024-01-01 22:20:00,92,45,Brinquedo,6,137
1342,2024-01-01 22:21:00,22,27,Alimento,9,49
1343,2024-01-01 22:22:00,29,154,Móvel,5,183
1344,2024-01-01 22:23:00,25,79,Vestuário,5,104
1345,2024-01-01 22:24:00,43,39,Móvel,6,82
1346,2024-01-01 22:25:00,75,69,Eletrônico,6,144
1347,2024-01-01 22:26:00,19,41,Vestuário,5,60
1348,2024-01-01 22:27:00,58,66,Alimento,2,124
1349,2024-01-01 22:28:00,18,89,Vestuário,4,107
1350,2024-01-01 22:29:00,73,45,Alimento,4,118
1351,2024-01-01 22:30:00,12,107,Alimento,8,119
1352,2024-01-01 22:31:00,71,48,Vestuário,8,119
1353,2024-01-01 22:32:00,40,105,Brinquedo,7,145
1354,2024-01-01 22:33:00,51,49,Vestuário,4,100
1355,2024-01-01 22:34:00,48,90,Móvel,6,138
1356,2024-01-01 22:35:00,45,99,Eletrônico,6,144
1357,2024-01-01 22:36:00,68,73,Móvel,6,141
1358,2024-01-01 22:37:00,13,154,Brinquedo,4,167
1359,2024-01-01 22:38:00,57,146,Eletrônico,9,203
1360,2024-01-01 22:39:00,43,144,Eletrônico,8,187
1361,2024-01-01 22:40:00,44,49,Brinquedo,4,93
1362,2024-01-01 22:41:00,71,128,Brinquedo,3,199
1363,2024-01-01 22:42:00,38,127,Eletrônico,3,165
1364,2024-01-01 22:43:00,26,92,Alimento,8,118
1365,2024-01-01 22:44:00,13,75,Eletrônico,2,88
1366,2024-01-01 22:45:00,77,165,Vestuário,2,242
1367,2024-01-01 22:46:00,52,145,Eletrônico,4,197
1368,2024-01-01 22:47:00,77,97,Móvel,5,174
1369,2024-01-01 22:48:00,39,117,Eletrônico,7,156
1370,2024-01-01 22:49:00,72,103,Móvel,8,175
1371,2024-01-01 22:50:00,43,72,Brinquedo,1,115
1372,2024-01-01 22:51:00,77,38,Eletrônico,1,115
1373,2024-01-01 22:52:00,31,95,Alimento,1,126
1374,2024-01-01 22:53:00,19,124,Alimento,6,143
1375,2024-01-01 22:54:00,85,152,Vestuário,2,237
1376,2024-01-01 22:55:00,61,85,Brinquedo,7,146
1377,2024-01-01 22:56:00,118,173,Brinquedo,4,291
1378,2024-01-01 22:57:00,65,33,Vestuário,7,98
1379,2024-01-01 22:58:00,67,106,Vestuário,7,173
1380,2024-01-01 22:59:00,25,147,Eletrônico,1,172
1381,2024-01-01 23:00:00,68,178,Móvel,9,246
1382,2024-01-01 23:01:00,114,19,Brinquedo,8,133
1383,2024-01-01 23:02:00,55,175,Brinquedo,7,230
1384,2024-01-01 23:03:00,63,138,Alimento,9,201
1385,2024-01-01 23:04:00,70,120,Móvel,5,190
1386,2024-01-01 23:05:00,11,88,Eletrônico,1,99
1387,2024-01-01 23:06:00,14,175,Vestuário,1,189
1388,2024-01-01 23:07:00,32,126,Eletrônico,6,158
1389,2024-01-01 23:08:00,108,10,Eletrônico,9,118
1390,2024-01-01 23:09:00,89,54,Móvel,4,143
1391,2024-01-01 23:10:00,98,101,Móvel,2,199
1392,2024-01-01 23:11:00,71,54,Alimento,1,125
1393,2024-01-01 23:12:00,73,84,Vestuário,5,157
1394,2024-01-01 23:13:00,11,16,Móvel,4,27
1395,2024-01-01 23:14:00,73,132,Eletrônico,6,205
1396,2024-01-01 23:15:00,24,178,Alimento,5,202
1397,2024-01-01 23:16:00,65,64,Móvel,9,129
1398,2024-01-01 23:17:00,95,108,Brinquedo,3,203
1399,2024-01-01 23:18:00,23,17,Brinquedo,7,40
1400,2024-01-01 23:19:00,79,18,Alimento,3,97
1401,2024-01-01 23:20:00,85,50,Brinquedo,8,135
1402,2024-01-01 23:21:00,52,14,Móvel,5,66
1403,2024-01-01 23:22:00,51,27,Brinquedo,3,78
1404,2024-01-01 23:23:00,97,85,Brinquedo,4,182
1405,2024-01-01 23:24:00,78,169,Alimento,8,247
1406,2024-01-01 23:25:00,62,39,Eletrônico,7,101
1407,2024-01-01 23:26:00,25,77,Vestuário,5,102
1408,2024-01-01 23:27:00,115,19,Eletrônico,1,134
1409,2024-01-01 23:28:00,42,137,Alimento,4,179
1410,2024-01-01 23:29:00,55,178,Alimento,9,233
1411,2024-01-01 23:30:00,49,100,Brinquedo,4,149
1412,2024-01-01 23:31:00,55,129,Móvel,1,184
1413,2024-01-01 23:32:00,21,165,Móvel,8,186
1414,2024-01-01 23:33:00,46,70,Eletrônico,4,116
1415,2024-01-01 23:34:00,19,45,Alimento,4,64
1416,2024-01-01 23:35:00,71,11,Alimento,8,82
1417,2024-01-01 23:36:00,110,113,Eletrônico,2,223
1418,2024-01-01 23:37:00,22,111,Brinquedo,7,133
1419,2024-01-01 23:38:00,109,82,Vestuário,8,191
1420,2024-01-01 23:39:00,68,50,Móvel,2,118
1421,2024-01-01 23:40:00,117,165,Móvel,3,282
1422,2024-01-01 23:41:00,26,99,Alimento,2,125
1423,2024-01-01 23:42:00,25,29,Alimento,7,54
1424,2024-01-01 23:43:00,55,127,Brinquedo,6,182
1425,2024-01-01 23:44:00,30,102,Alimento,9,132
1426,2024-01-01 23:45:00,67,87,Vestuário,8,154
1427,2024-01-01 23:46:00,20,153,Móvel,8,173
1428,2024-01-01 23:47:00,62,31,Alimento,2,93
1429,2024-01-01 23:48:00,31,34,Vestuário,9,65
1430,2024-01-01 23:49:00,43,66,Alimento,7,109
1431,2024-01-01 23:50:00,109,106,Brinquedo,3,215
1432,2024-01-01 23:51:00,40,75,Eletrônico,4,115
1433,2024-01-01 23:52:00,32,106,Brinquedo,8,138
1434,2024-01-01 23:53:00,28,108,Brinquedo,1,136
1435,2024-01-01 23:54:00,28,20,Alimento,2,48
1436,2024-01-01 23:55:00,98,121,Alimento,9,219
1437,2024-01-01 23:56:00,51,12,Móvel,8,63
1438,2024-01-01 23:57:00,79,143,Brinquedo,1,222
1439,2024-01-01 23:58:00,64,168,Alimento,5,232
1440,2024-01-01 23:59:00,26,17,Vestuário,5,43
1441,2024-01-02 00:00:00,53,92,Eletrônico,7,145
1442,2024-01-02 00:01:00,103,27,Vestuário,6,130
1443,2024-01-02 00:02:00,26,46,Eletrônico,5,72
1444,2024-01-02 00:03:00,43,11,Vestuário,7,54
1445,2024-01-02 00:04:00,103,155,Alimento,7,258
1446,2024-01-02 00:05:00,60,86,Brinquedo,8,146
1447,2024-01-02 00:06:00,34,47,Móvel,2,81
1448,2024-01-02 00:07:00,72,29,Eletrônico,8,101
1449,2024-01-02 00:08:00,20,153,Móvel,9,173
1450,2024-01-02 00:09:00,31,82,Brinquedo,5,113
1451,2024-01-02 00:10:00,93,17,Móvel,2,110
1452,2024-01-02 00:11:00,53,86,Vestuário,9,139
1453,2024-01-02 00:12:00,111,126,Eletrônico,7,237
1454,2024-01-02 00:13:00,91,31,Móvel,3,122
1455,2024-01-02 00:14:00,40,77,Alimento,6,117
1456,2024-01-02 00:15:00,27,71,Eletrônico,7,98
1457,2024-01-02 00:16:00,91,57,Vestuário,8,148
1458,2024-01-02 00:17:00,11,65,Móvel,8,76
1459,2024-01-02 00:18:00,14,92,Alimento,1,106
1460,2024-01-02 00:19:00,16,25,Eletrônico,5,41
1461,2024-01-02 00:20:00,102,131,Vestuário,3,233
1462,2024-01-02 00:21:00,88,12,Móvel,5,100
1463,2024-01-02 00:22:00,50,117,Vestuário,6,167
1464,2024-01-02 00:23:00,85,129,Alimento,5,214
1465,2024-01-02 00:24:00,68,157,Brinquedo,9,225
1466,2024-01-02 00:25:00,34,101,Eletrônico,6,135
1467,2024-01-02 00:26:00,61,121,Brinquedo,6,182
1468,2024-01-02 00:27:00,76,172,Alimento,1,248
1469,2024-01-02 00:28:00,46,44,Eletrônico,4,90
1470,2024-01-02 00:29:00,83,161,Alimento,1,244
1471,2024-01-02 00:30:00,18,39,Móvel,5,57
1472,2024-01-02 00:31:00,108,165,Brinquedo,3,273
1473,2024-01-02 00:32:00,96,124,Alimento,2,220
1474,2024-01-02 00:33:00,65,163,Alimento,6,228
1475,2024-01-02 00:34:00,23,53,Brinquedo,3,76
1476,2024-01-02 00:35:00,50,56,Vestuário,3,106
1477,2024-01-02 00:36:00,98,120,Vestuário,4,218
1478,2024-01-02 00:37:00,113,92,Brinquedo,4,205
1479,2024-01-02 00:38:00,100,18,Móvel,3,118
1480,2024-01-02 00:39:00,119,171,Vestuário,6,290
1481,2024-01-02 00:40:00,110,167,Móvel,8,277
1482,2024-01-02 00:41:00,46,78,Móvel,8,124
1483,2024-01-02 00:42:00,45,96,Móvel,3,141
1484,2024-01-02 00:43:00,61,95,Alimento,7,156
1485,2024-01-02 00:44:00,59,171,Alimento,1,230
1486,2024-01-02 00:45:00,114,35,Brinquedo,2,149
1487,2024-01-02 00:46:00,75,32,Brinquedo,5,107
1488,2024-01-02 00:47:00,94,59,Vestuário,9,153
1489,2024-01-02 00:48:00,118,82,Alimento,8,200
1490,2024-01-02 00:49:00,25,85,Móvel,5,110
1491,2024-01-02 00:50:00,85,124,Brinquedo,6,209
1492,2024-01-02 00:51:00,66,177,Móvel,5,243
1493,2024-01-02 00:52:00,113,56,Alimento,6,169
1494,2024-01-02 00:53:00,51,92,Eletrônico,5,143
1495,2024-01-02 00:54:00,63,38,Móvel,2,101
1496,2024-01-02 00:55:00,37,140,Móvel,4,177
1497,2024-01-02 00:56:00,77,167,Alimento,2,244
1498,2024-01-02 00:57:00,89,41,Brinquedo,6,130
1499,2024-01-02 00:58:00,110,26,Móvel,1,136
1500,2024-01-02 00:59:00,51,17,Brinquedo,7,68
1501,2024-01-02 01:00:00,68,174,Eletrônico,9,242
1502,2024-01-02 01:01:00,73,161,Eletrônico,6,234
1503,2024-01-02 01:02:00,95,19,Vestuário,3,114
1504,2024-01-02 01:03:00,13,109,Brinquedo,6,122
1505,2024-01-02 01:04:00,60,63,Móvel,3,123
1506,2024-01-02 01:05:00,29,32,Vestuário,1,61
1507,2024-01-02 01:06:00,91,12,Alimento,3,103
1508,2024-01-02 01:07:00,95,116,Móvel,5,211
1509,2024-01-02 01:08:00,92,149,Vestuário,3,241
1510,2024-01-02 01:09:00,26,141,Eletrônico,6,167
1511,2024-01-02 01:10:00,36,22,Vestuário,1,58
1512,2024-01-02 01:11:00,106,22,Móvel,8,128
1513,2024-01-02 01:12:00,91,43,Brinquedo,9,134
1514,2024-01-02 01:13:00,12,122,Eletrônico,4,134
1515,2024-01-02 01:14:00,31,36,Eletrônico,3,67
1516,2024-01-02 01:15:00,79,46,Brinquedo,2,125
1517,2024-01-02 01:16:00,86,95,Vestuário,2,181
1518,2024-01-02 01:17:00,102,24,Alimento,2,126
1519,2024-01-02 01:18:00,58,18,Brinquedo,1,76
1520,2024-01-02 01:19:00,52,118,Móvel,6,170
1521,2024-01-02 01:20:00,99,28,Eletrônico,3,127
1522,2024-01-02 01:21:00,101,96,Vestuário,7,197
1523,2024-01-02 01:22:00,44,58,Eletrônico,7,102
1524,2024-01-02 01:23:00,117,109,Vestuário,4,226
1525,2024-01-02 01:24:00,52,164,Vestuário,5,216
1526,2024-01-02 01:25:00,70,122,Vestuário,9,192
1527,2024-01-02 01:26:00,99,14,Vestuário,7,113
1528,2024-01-02 01:27:00,52,139,Vestuário,6,191
1529,2024-01-02 01:28:00,64,150,Alimento,7,214
1530,2024-01-02 01:29:00,73,73,Alimento,3,146
1531,2024-01-02 01:30:00,81,98,Alimento,9,179
1532,2024-01-02 01:31:00,115,39,Alimento,2,154
1533,2024-01-02 01:32:00,63,51,Alimento,8,114
1534,2024-01-02 01:33:00,28,92,Brinquedo,7,120
1535,2024-01-02 01:34:00,16,85,Brinquedo,3,101
1536,2024-01-02 01:35:00,97,161,Vestuário,5,258
1537,2024-01-02 01:36:00,10,135,Vestuário,5,145
1538,2024-01-02 01:37:00,71,156,Alimento,5,227
1539,2024-01-02 01:38:00,77,178,Brinquedo,8,255
1540,2024-01-02 01:39:00,112,95,Brinquedo,5,207
1541,2024-01-02 01:40:00,77,116,Eletrônico,2,193
1542,2024-01-02 01:41:00,93,20,Alimento,6,113
1543,2024-01-02 01:42:00,52,133,Eletrônico,9,185
1544,2024-01-02 01:43:00,13,90,Brinquedo,1,103
1545,2024-01-02 01:44:00,90,88,Móvel,7,178
1546,2024-01-02 01:45:00,36,36,Móvel,2,72
1547,2024-01-02 01:46:00,62,120,Móvel,7,182
1548,2024-01-02 01:47:00,104,54,Móvel,5,158
1549,2024-01-02 01:48:00,71,98,Vestuário,6,169
1550,2024-01-02 01:49:00,25,37,Vestuário,4,62
1551,2024-01-02 01:50:00,100,140,Móvel,8,240
1552,2024-01-02 01:51:00,72,108,Vestuário,2,180
1553,2024-01-02 01:52:00,69,84,Alimento,7,153
1554,2024-01-02 01:53:00,23,116,Móvel,5,139
1555,2024-01-02 01:54:00,106,86,Vestuário,3,192
1556,2024-01-02 01:55:00,74,127,Eletrônico,3,201
1557,2024-01-02 01:56:00,106,97,Brinquedo,6,203
1558,2024-01-02 01:57:00,13,112,Vestuário,7,125
1559,2024-01-02 01:58:00,22,90,Eletrônico,1,112
1560,2024-01-02 01:59:00,84,138,Brinquedo,5,222
1561,2024-01-02 02:00:00,19,106,Vestuário,5,125
1562,2024-01-02 02:01:00,89,90,Brinquedo,9,179
1563,2024-01-02 02:02:00,49,57,Alimento,6,106
1564,2024-01-02 02:03:00,75,45,Eletrônico,6,120
1565,2024-01-02 02:04:00,57,137,Brinquedo,4,194
1566,2024-01-02 02:05:00,14,127,Vestuário,9,141
1567,2024-01-02 02:06:00,51,13,Brinquedo,5,64
1568,2024-01-02 02:07:00,91,94,Eletrônico,3,185
1569,2024-01-02 02:08:00,60,82,Móvel,3,142
1570,2024-01-02 02:09:00,90,124,Brinquedo,8,214
1571,2024-01-02 02:10:00,79,80,Vestuário,1,159
1572,2024-01-02 02:11:00,23,140,Vestuário,6,163
1573,2024-01-02 02:12:00,83,102,Alimento,4,185
1574,2024-01-02 02:13:00,82,87,Móvel,8,169
1575,2024-01-02 02:14:00,13,149,Eletrônico,3,162
1576,2024-01-02 02:15:00,39,67,Móvel,3,106
1577,2024-01-02 02:16:00,24,16,Brinquedo,2,40
1578,2024-01-02 02:17:00,109,137,Vestuário,1,246
1579,2024-01-02 02:18:00,38,33,Brinquedo,4,71
1580,2024-01-02 02:19:00,14,119,Vestuário,8,133
1581,2024-01-02 02:20:00,21,63,Vestuário,3,84
1582,2024-01-02 02:21:00,30,34,Móvel,4,64
1583,2024-01-02 02:22:00,116,136,Eletrônico,5,252
1584,2024-01-02 02:23:00,64,57,Alimento,5,121
1585,2024-01-02 02:24:00,23,105,Brinquedo,5,128
1586,2024-01-02 02:25:00,114,167,Vestuário,5,281
1587,2024-01-02 02:26:00,73,163,Alimento,4,236
1588,2024-01-02 02:27:00,17,99,Alimento,1,116
1589,2024-01-02 02:28:00,80,41,Alimento,7,121
1590,2024-01-02 02:29:00,58,20,Alimento,4,78
1591,2024-01-02 02:30:00,62,58,Brinquedo,9,120
1592,2024-01-02 02:31:00,75,77,Vestuário,1,152
1593,2024-01-02 02:32:00,82,118,Móvel,2,200
1594,2024-01-02 02:33:00,55,167,Brinquedo,5,222
1595,2024-01-02 02:34:00,38,78,Alimento,1,116
1596,2024-01-02 02:35:00,41,125,Vestuário,8,166
1597,2024-01-02 02:36:00,23,40,Eletrônico,1,63
1598,2024-01-02 02:37:00,50,30,Alimento,5,80
1599,2024-01-02 02:38:00,37,49,Eletrônico,6,86
1600,2024-01-02 02:39:00,73,136,Vestuário,3,209
1601,2024-01-02 02:40:00,111,137,Brinquedo,8,248
1602,2024-01-02 02:41:00,106,124,Vestuário,8,230
1603,2024-01-02 02:42:00,75,13,Vestuário,2,88
1604,2024-01-02 02:43:00,106,105,Eletrônico,2,211
1605,2024-01-02 02:44:00,42,43,Eletrônico,5,85
1606,2024-01-02 02:45:00,29,176,Alimento,2,205
1607,2024-01-02 02:46:00,25,33,Alimento,2,58
1608,2024-01-02 02:47:00,54,106,Eletrônico,5,160
1609,2024-01-02 02:48:00,85,130,Brinquedo,6,215
1610,2024-01-02 02:49:00,24,158,Alimento,2,182
1611,2024-01-02 02:50:00,47,119,Eletrônico,2,166
1612,2024-01-02 02:51:00,35,10,Brinquedo,3,45
1613,2024-01-02 02:52:00,25,100,Vestuário,8,125
1614,2024-01-02 02:53:00,89,154,Eletrônico,4,243
1615,2024-01-02 02:54:00,26,43,Vestuário,3,69
1616,2024-01-02 02:55:00,39,61,Vestuário,7,100
1617,2024-01-02 02:56:00,30,146,Vestuário,6,176
1618,2024-01-02 02:57:00,19,129,Móvel,1,148
1619,2024-01-02 02:58:00,47,107,Eletrônico,2,154
1620,2024-01-02 02:59:00,71,170,Brinquedo,6,241
1621,2024-01-02 03:00:00,15,124,Eletrônico,4,139
1622,2024-01-02 03:01:00,68,47,Brinquedo,1,115
1623,2024-01-02 03:02:00,111,28,Eletrônico,1,139
1624,2024-01-02 03:03:00,100,39,Vestuário,6,139
1625,2024-01-02 03:04:00,64,134,Vestuário,4,198
1626,2024-01-02 03:05:00,16,92,Vestuário,8,108
1627,2024-01-02 03:06:00,44,56,Eletrônico,1,100
1628,2024-01-02 03:07:00,63,165,Brinquedo,8,228
1629,2024-01-02 03:08:00,99,59,Vestuário,2,158
1630,2024-01-02 03:09:00,10,144,Eletrônico,3,154
1631,2024-01-02 03:10:00,100,90,Vestuário,4,190
1632,2024-01-02 03:11:00,65,81,Vestuário,4,146
1633,2024-01-02 03:12:00,107,62,Brinquedo,3,169
1634,2024-01-02 03:13:00,110,130,Eletrônico,5,240
1635,2024-01-02 03:14:00,82,37,Vestuário,8,119
1636,2024-01-02 03:15:00,113,95,Móvel,1,208
1637,2024-01-02 03:16:00,110,124,Alimento,9,234
1638,2024-01-02 03:17:00,25,24,Eletrônico,2,49
1639,2024-01-02 03:18:00,75,157,Alimento,1,232
1640,2024-01-02 03:19:00,18,93,Móvel,4,111
1641,2024-01-02 03:20:00,87,115,Vestuário,6,202
1642,2024-01-02 03:21:00,43,162,Vestuário,6,205
1643,2024-01-02 03:22:00,23,72,Eletrônico,8,95
1644,2024-01-02 03:23:00,95,144,Móvel,5,239
1645,2024-01-02 03:24:00,117,41,Móvel,2,158
1646,2024-01-02 03:25:00,37,155,Móvel,1,192
1647,2024-01-02 03:26:00,22,89,Alimento,3,111
1648,2024-01-02 03:27:00,10,57,Móvel,4,67
1649,2024-01-02 03:28:00,77,151,Vestuário,8,228
1650,2024-01-02 03:29:00,16,128,Móvel,8,144
1651,2024-01-02 03:30:00,77,126,Vestuário,8,203
1652,2024-01-02 03:31:00,41,110,Móvel,2,151
1653,2024-01-02 03:32:00,29,140,Móvel,2,169
1654,2024-01-02 03:33:00,69,65,Vestuário,2,134
1655,2024-01-02 03:34:00,105,66,Brinquedo,7,171
1656,2024-01-02 03:35:00,31,155,Eletrônico,2,186
1657,2024-01-02 03:36:00,87,84,Brinquedo,9,171
1658,2024-01-02 03:37:00,44,123,Brinquedo,2,167
1659,2024-01-02 03:38:00,119,20,Brinquedo,3,139
1660,2024-01-02 03:39:00,19,14,Móvel,5,33
1661,2024-01-02 03:40:00,73,108,Alimento,2,181
1662,2024-01-02 03:41:00,78,81,Alimento,9,159
1663,2024-01-02 03:42:00,22,51,Eletrônico,9,73
1664,2024-01-02 03:43:00,118,153,Alimento,7,271
1665,2024-01-02 03:44:00,80,106,Eletrônico,4,186
1666,2024-01-02 03:45:00,27,154,Alimento,9,181
1667,2024-01-02 03:46:00,76,52,Eletrônico,4,128
1668,2024-01-02 03:47:00,12,43,Alimento,4,55
1669,2024-01-02 03:48:00,97,94,Eletrônico,9,191
1670,2024-01-02 03:49:00,104,165,Brinquedo,3,269
1671,2024-01-02 03:50:00,54,94,Vestuário,7,148
1672,2024-01-02 03:51:00,85,62,Alimento,1,147
1673,2024-01-02 03:52:00,110,27,Eletrônico,9,137
1674,2024-01-02 03:53:00,77,143,Brinquedo,7,220
1675,2024-01-02 03:54:00,11,147,Eletrônico,3,158
1676,2024-01-02 03:55:00,52,98,Eletrônico,9,150
1677,2024-01-02 03:56:00,81,85,Móvel,6,166
1678,2024-01-02 03:57:00,93,177,Móvel,8,270
1679,2024-01-02 03:58:00,59,67,Alimento,7,126
1680,2024-01-02 03:59:00,72,63,Eletrônico,6,135
1681,2024-01-02 04:00:00,117,128,Eletrônico,5,245
1682,2024-01-02 04:01:00,28,130,Alimento,3,158
1683,2024-01-02 04:02:00,54,165,Móvel,3,219
1684,2024-01-02 04:03:00,95,179,Brinquedo,9,274
1685,2024-01-02 04:04:00,17,45,Brinquedo,4,62
1686,2024-01-02 04:05:00,55,67,Móvel,3,122
1687,2024-01-02 04:06:00,45,124,Alimento,3,169
1688,2024-01-02 04:07:00,62,36,Brinquedo,3,98
1689,2024-01-02 04:08:00,103,43,Brinquedo,8,146
1690,2024-01-02 04:09:00,42,56,Eletrônico,5,98
1691,2024-01-02 04:10:00,112,39,Eletrônico,5,151
1692,2024-01-02 04:11:00,25,76,Vestuário,8,101
1693,2024-01-02 04:12:00,63,129,Alimento,6,192
1694,2024-01-02 04:13:00,78,80,Vestuário,3,158
1695,2024-01-02 04:14:00,111,30,Alimento,6,141
1696,2024-01-02 04:15:00,92,111,Eletrônico,8,203
1697,2024-01-02 04:16:00,66,86,Brinquedo,8,152
1698,2024-01-02 04:17:00,54,71,Móvel,2,125
1699,2024-01-02 04:18:00,82,134,Eletrônico,5,216
1700,2024-01-02 04:19:00,62,59,Vestuário,1,121
1701,2024-01-02 04:20:00,20,76,Vestuário,3,96
1702,2024-01-02 04:21:00,48,152,Brinquedo,5,200
1703,2024-01-02 04:22:00,83,107,Vestuário,6,190
1704,2024-01-02 04:23:00,76,52,Alimento,5,128
1705,2024-01-02 04:24:00,82,120,Eletrônico,3,202
1706,2024-01-02 04:25:00,96,10,Brinquedo,7,106
1707,2024-01-02 04:26:00,36,77,Brinquedo,7,113
1708,2024-01-02 04:27:00,42,18,Eletrônico,6,60
1709,2024-01-02 04:28:00,15,63,Eletrônico,1,78
1710,2024-01-02 04:29:00,32,92,Eletrônico,3,124
1711,2024-01-02 04:30:00,85,71,Móvel,6,156
1712,2024-01-02 04:31:00,118,17,Vestuário,3,135
1713,2024-01-02 04:32:00,31,134,Alimento,1,165
1714,2024-01-02 04:33:00,42,174,Eletrônico,6,216
1715,2024-01-02 04:34:00,112,149,Eletrônico,8,261
1716,2024-01-02 04:35:00,52,47,Brinquedo,1,99
1717,2024-01-02 04:36:00,63,119,Alimento,1,182
1718,2024-01-02 04:37:00,70,50,Eletrônico,5,120
1719,2024-01-02 04:38:00,104,171,Eletrônico,8,275
1720,2024-01-02 04:39:00,69,121,Alimento,9,190
1721,2024-01-02 04:40:00,51,112,Eletrônico,4,163
1722,2024-01-02 04:41:00,21,173,Eletrônico,8,194
1723,2024-01-02 04:42:00,97,176,Alimento,1,273
1724,2024-01-02 04:43:00,83,20,Móvel,3,103
1725,2024-01-02 04:44:00,44,83,Alimento,1,127
1726,2024-01-02 04:45:00,109,161,Brinquedo,6,270
1727,2024-01-02 04:46:00,92,37,Brinquedo,6,129
1728,2024-01-02 04:47:00,90,32,Vestuário,5,122
1729,2024-01-02 04:48:00,110,112,Brinquedo,6,222
1730,2024-01-02 04:49:00,96,165,Móvel,3,261
1731,2024-01-02 04:50:00,18,147,Eletrônico,3,165
1732,2024-01-02 04:51:00,67,38,Alimento,9,105
1733,2024-01-02 04:52:00,90,34,Brinquedo,4,124
1734,2024-01-02 04:53:00,85,166,Vestuário,7,251
1735,2024-01-02 04:54:00,114,146,Brinquedo,2,260
1736,2024-01-02 04:55:00,65,111,Vestuário,1,176
1737,2024-01-02 04:56:00,11,103,Alimento,6,114
1738,2024-01-02 04:57:00,113,164,Alimento,8,277
1739,2024-01-02 04:58:00,52,36,Vestuário,5,88
1740,2024-01-02 04:59:00,102,37,Alimento,2,139
1741,2024-01-02 05:00:00,23,86,Eletrônico,2,109
1742,2024-01-02 05:01:00,32,100,Eletrônico,7,132
1743,2024-01-02 05:02:00,111,86,Móvel,6,197
1744,2024-01-02 05:03:00,19,109,Eletrônico,7,128
1745,2024-01-02 05:04:00,113,78,Brinquedo,2,191
1746,2024-01-02 05:05:00,21,56,Eletrônico,5,77
1747,2024-01-02 05:06:00,80,165,Brinquedo,2,245
1748,2024-01-02 05:07:00,82,11,Brinquedo,1,93
1749,2024-01-02 05:08:00,113,78,Vestuário,1,191
1750,2024-01-02 05:09:00,30,119,Móvel,9,149
1751,2024-01-02 05:10:00,23,66,Eletrônico,2,89
1752,2024-01-02 05:11:00,84,101,Brinquedo,8,185
1753,2024-01-02 05:12:00,57,81,Brinquedo,8,138
1754,2024-01-02 05:13:00,72,109,Alimento,1,181
1755,2024-01-02 05:14:00,64,119,Eletrônico,8,183
1756,2024-01-02 05:15:00,49,151,Brinquedo,5,200
1757,2024-01-02 05:16:00,113,161,Brinquedo,8,274
1758,2024-01-02 05:17:00,96,27,Móvel,1,123
1759,2024-01-02 05:18:00,76,56,Alimento,6,132
1760,2024-01-02 05:19:00,67,26,Eletrônico,3,93
1761,2024-01-02 05:20:00,64,41,Alimento,5,105
1762,2024-01-02 05:21:00,109,45,Eletrônico,2,154
1763,2024-01-02 05:22:00,27,52,Móvel,2,79
1764,2024-01-02 05:23:00,50,127,Móvel,9,177
1765,2024-01-02 05:24:00,99,63,Móvel,2,162
1766,2024-01-02 05:25:00,20,179,Móvel,5,199
1767,2024-01-02 05:26:00,79,173,Alimento,1,252
1768,2024-01-02 05:27:00,69,91,Alimento,8,160
1769,2024-01-02 05:28:00,15,167,Eletrônico,3,182
1770,2024-01-02 05:29:00,63,60,Móvel,6,123
1771,2024-01-02 05:30:00,10,78,Alimento,1,88
1772,2024-01-02 05:31:00,88,169,Alimento,3,257
1773,2024-01-02 05:32:00,46,57,Alimento,6,103
1774,2024-01-02 05:33:00,90,20,Móvel,6,110
1775,2024-01-02 05:34:00,67,46,Alimento,1,113
1776,2024-01-02 05:35:00,102,106,Brinquedo,2,208
1777,2024-01-02 05:36:00,60,102,Brinquedo,9,162
1778,2024-01-02 05:37:00,61,32,Brinquedo,4,93
1779,2024-01-02 05:38:00,53,146,Vestuário,8,199
1780,2024-01-02 05:39:00,97,60,Eletrônico,8,157
1781,2024-01-02 05:40:00,100,124,Móvel,3,224
1782,2024-01-02 05:41:00,90,62,Vestuário,2,152
1783,2024-01-02 05:42:00,91,38,Brinquedo,3,129
1784,2024-01-02 05:43:00,113,39,Vestuário,2,152
1785,2024-01-02 05:44:00,26,103,Vestuário,6,129
1786,2024-01-02 05:45:00,69,137,Alimento,8,206
1787,2024-01-02 05:46:00,21,79,Móvel,7,100
1788,2024-01-02 05:47:00,48,86,Alimento,5,134
1789,2024-01-02 05:48:00,32,155,Vestuário,5,187
1790,2024-01-02 05:49:00,107,134,Vestuário,7,241
1791,2024-01-02 05:50:00,67,126,Móvel,4,193
1792,2024-01-02 05:51:00,100,47,Eletrônico,6,147
1793,2024-01-02 05:52:00,44,56,Eletrônico,5,100
1794,2024-01-02 05:53:00,97,172,Móvel,6,269
1795,2024-01-02 05:54:00,77,15,Vestuário,6,92
1796,2024-01-02 05:55:00,107,142,Eletrônico,1,249
1797,2024-01-02 05:56:00,69,31,Vestuário,1,100
1798,2024-01-02 05:57:00,57,164,Móvel,7,221
1799,2024-01-02 05:58:00,89,148,Alimento,8,237
1800,2024-01-02 05:59:00,106,83,Alimento,9,189
1801,2024-01-02 06:00:00,17,138,Eletrônico,6,155
1802,2024-01-02 06:01:00,47,36,Brinquedo,7,83
1803,2024-01-02 06:02:00,70,112,Alimento,1,182
1804,2024-01-02 06:03:00,16,93,Eletrônico,6,109
1805,2024-01-02 06:04:00,15,99,Móvel,8,114
1806,2024-01-02 06:05:00,58,80,Brinquedo,2,138
1807,2024-01-02 06:06:00,102,63,Vestuário,3,165
1808,2024-01-02 06:07:00,65,60,Eletrônico,3,125
1809,2024-01-02 06:08:00,88,166,Móvel,2,254
1810,2024-01-02 06:09:00,79,108,Móvel,1,187
1811,2024-01-02 06:10:00,99,130,Alimento,8,229
1812,2024-01-02 06:11:00,25,53,Brinquedo,6,78
1813,2024-01-02 06:12:00,80,59,Brinquedo,3,139
1814,2024-01-02 06:13:00,55,95,Alimento,3,150
1815,2024-01-02 06:14:00,64,113,Eletrônico,5,177
1816,2024-01-02 06:15:00,53,84,Móvel,4,137
1817,2024-01-02 06:16:00,16,73,Eletrônico,2,89
1818,2024-01-02 06:17:00,40,19,Vestuário,2,59
1819,2024-01-02 06:18:00,109,58,Brinquedo,4,167
1820,2024-01-02 06:19:00,69,122,Alimento,5,191
1821,2024-01-02 06:20:00,19,81,Móvel,9,100
1822,2024-01-02 06:21:00,37,53,Brinquedo,7,90
1823,2024-01-02 06:22:00,52,85,Alimento,3,137
1824,2024-01-02 06:23:00,27,25,Vestuário,9,52
1825,2024-01-02 06:24:00,62,167,Móvel,4,229
1826,2024-01-02 06:25:00,86,24,Brinquedo,7,110
1827,2024-01-02 06:26:00,11,99,Móvel,9,110
1828,2024-01-02 06:27:00,110,61,Vestuário,7,171
1829,2024-01-02 06:28:00,116,155,Vestuário,1,271
1830,2024-01-02 06:29:00,16,32,Alimento,7,48
1831,2024-01-02 06:30:00,110,43,Móvel,4,153
1832,2024-01-02 06:31:00,51,163,Móvel,7,214
1833,2024-01-02 06:32:00,94,114,Alimento,8,208
1834,2024-01-02 06:33:00,31,130,Eletrônico,1,161
1835,2024-01-02 06:34:00,40,96,Móvel,2,136
1836,2024-01-02 06:35:00,13,40,Eletrônico,6,53
1837,2024-01-02 06:36:00,108,136,Alimento,9,244
1838,2024-01-02 06:37:00,113,73,Brinquedo,6,186
1839,2024-01-02 06:38:00,52,143,Brinquedo,6,195
1840,2024-01-02 06:39:00,110,131,Móvel,6,241
1841,2024-01-02 06:40:00,62,96,Alimento,1,158
1842,2024-01-02 06:41:00,33,95,Brinquedo,5,128
1843,2024-01-02 06:42:00,53,40,Móvel,4,93
1844,2024-01-02 06:43:00,59,84,Alimento,7,143
1845,2024-01-02 06:44:00,47,125,Móvel,2,172
1846,2024-01-02 06:45:00,79,96,Eletrônico,8,175
1847,2024-01-02 06:46:00,66,126,Alimento,8,192
1848,2024-01-02 06:47:00,60,96,Vestuário,6,156
1849,2024-01-02 06:48:00,16,134,Brinquedo,9,150
1850,2024-01-02 06:49:00,72,76,Brinquedo,3,148
1851,2024-01-02 06:50:00,66,107,Vestuário,9,173
1852,2024-01-02 06:51:00,32,41,Brinquedo,3,73
1853,2024-01-02 06:52:00,47,76,Eletrônico,3,123
1854,2024-01-02 06:53:00,62,41,Vestuário,4,103
1855,2024-01-02 06:54:00,88,102,Alimento,5,190
1856,2024-01-02 06:55:00,47,37,Brinquedo,2,84
1857,2024-01-02 06:56:00,18,58,Eletrônico,4,76
1858,2024-01-02 06:57:00,58,151,Vestuário,9,209
1859,2024-01-02 06:58:00,47,153,Eletrônico,3,200
1860,2024-01-02 06:59:00,43,26,Alimento,9,69
1861,2024-01-02 07:00:00,62,162,Brinquedo,6,224
1862,2024-01-02 07:01:00,115,36,Alimento,7,151
1863,2024-01-02 07:02:00,113,77,Móvel,2,190
1864,2024-01-02 07:03:00,115,28,Móvel,3,143
1865,2024-01-02 07:04:00,119,85,Brinquedo,3,204
1866,2024-01-02 07:05:00,33,131,Eletrônico,8,164
1867,2024-01-02 07:06:00,33,85,Vestuário,7,118
1868,2024-01-02 07:07:00,68,139,Brinquedo,2,207
1869,2024-01-02 07:08:00,19,105,Eletrônico,7,124
1870,2024-01-02 07:09:00,96,154,Alimento,4,250
1871,2024-01-02 07:10:00,87,64,Móvel,1,151
1872,2024-01-02 07:11:00,110,134,Eletrônico,6,244
1873,2024-01-02 07:12:00,55,126,Vestuário,8,181
1874,2024-01-02 07:13:00,78,134,Eletrônico,8,212
1875,2024-01-02 07:14:00,80,58,Eletrônico,8,138
1876,2024-01-02 07:15:00,26,71,Eletrônico,8,97
1877,2024-01-02 07:16:00,111,85,Eletrônico,1,196
1878,2024-01-02 07:17:00,50,129,Brinquedo,2,179
1879,2024-01-02 07:18:00,31,160,Vestuário,4,191
1880,2024-01-02 07:19:00,70,39,Eletrônico,2,109
1881,2024-01-02 07:20:00,97,156,Alimento,6,253
1882,2024-01-02 07:21:00,108,83,Brinquedo,8,191
1883,2024-01-02 07:22:00,83,111,Móvel,7,194
1884,2024-01-02 07:23:00,32,176,Eletrônico,4,208
1885,2024-01-02 07:24:00,105,172,Eletrônico,5,277
1886,2024-01-02 07:25:00,75,171,Móvel,9,246
1887,2024-01-02 07:26:00,20,148,Alimento,2,168
1888,2024-01-02 07:27:00,58,76,Móvel,1,134
1889,2024-01-02 07:28:00,85,100,Alimento,5,185
1890,2024-01-02 07:29:00,21,177,Brinquedo,4,198
1891,2024-01-02 07:30:00,80,28,Alimento,7,108
1892,2024-01-02 07:31:00,106,122,Móvel,9,228
1893,2024-01-02 07:32:00,49,93,Brinquedo,4,142
1894,2024-01-02 07:33:00,85,62,Brinquedo,2,147
1895,2024-01-02 07:34:00,103,142,Brinquedo,2,245
1896,2024-01-02 07:35:00,47,33,Vestuário,6,80
1897,2024-01-02 07:36:00,11,168,Eletrônico,4,179
1898,2024-01-02 07:37:00,64,46,Brinquedo,8,110
1899,2024-01-02 07:38:00,114,10,Vestuário,4,124
1900,2024-01-02 07:39:00,77,109,Móvel,1,186
1901,2024-01-02 07:40:00,39,101,Vestuário,3,140
1902,2024-01-02 07:41:00,78,71,Eletrônico,2,149
1903,2024-01-02 07:42:00,16,136,Eletrônico,2,152
1904,2024-01-02 07:43:00,87,168,Alimento,5,255
1905,2024-01-02 07:44:00,33,27,Alimento,1,60
1906,2024-01-02 07:45:00,107,97,Eletrônico,4,204
1907,2024-01-02 07:46:00,50,130,Vestuário,7,180
1908,2024-01-02 07:47:00,52,80,Eletrônico,8,132
1909,2024-01-02 07:48:00,76,68,Eletrônico,5,144
1910,2024-01-02 07:49:00,108,36,Móvel,1,144
1911,2024-01-02 07:50:00,11,148,Alimento,7,159
1912,2024-01-02 07:51:00,63,32,Móvel,3,95
1913,2024-01-02 07:52:00,93,103,Vestuário,1,196
1914,2024-01-02 07:53:00,96,60,Alimento,1,156
1915,2024-01-02 07:54:00,112,93,Eletrônico,3,205
1916,2024-01-02 07:55:00,31,141,Eletrônico,6,172
1917,2024-01-02 07:56:00,13,139,Alimento,9,152
1918,2024-01-02 07:57:00,24,80,Eletrônico,5,104
1919,2024-01-02 07:58:00,108,11,Eletrônico,6,119
1920,2024-01-02 07:59:00,101,153,Móvel,6,254
1921,2024-01-02 08:00:00,74,27,Móvel,9,101
1922,2024-01-02 08:01:00,77,40,Alimento,2,117
1923,2024-01-02 08:02:00,28,128,Alimento,9,156
1924,2024-01-02 08:03:00,46,92,Eletrônico,3,138
1925,2024-01-02 08:04:00,43,139,Brinquedo,9,182
1926,2024-01-02 08:05:00,33,39,Vestuário,1,72
1927,2024-01-02 08:06:00,23,13,Eletrônico,6,36
1928,2024-01-02 08:07:00,13,177,Vestuário,1,190
1929,2024-01-02 08:08:00,86,157,Alimento,8,243
1930,2024-01-02 08:09:00,117,100,Eletrônico,9,217
1931,2024-01-02 08:10:00,112,29,Eletrônico,2,141
1932,2024-01-02 08:11:00,58,162,Brinquedo,5,220
1933,2024-01-02 08:12:00,44,47,Alimento,3,91
1934,2024-01-02 08:13:00,103,173,Vestuário,9,276
1935,2024-01-02 08:14:00,78,178,Eletrônico,7,256
1936,2024-01-02 08:15:00,105,84,Alimento,3,189
1937,2024-01-02 08:16:00,44,108,Brinquedo,2,152
1938,2024-01-02 08:17:00,114,131,Brinquedo,7,245
1939,2024-01-02 08:18:00,81,179,Móvel,7,260
1940,2024-01-02 08:19:00,12,45,Eletrônico,8,57
1941,2024-01-02 08:20:00,70,71,Eletrônico,1,141
1942,2024-01-02 08:21:00,101,100,Brinquedo,9,201
1943,2024-01-02 08:22:00,86,145,Móvel,6,231
1944,2024-01-02 08:23:00,67,51,Alimento,9,118
1945,2024-01-02 08:24:00,17,142,Móvel,7,159
1946,2024-01-02 08:25:00,31,121,Vestuário,2,152
1947,2024-01-02 08:26:00,67,58,Brinquedo,6,125
1948,2024-01-02 08:27:00,16,48,Vestuário,2,64
1949,2024-01-02 08:28:00,45,33,Móvel,2,78
1950,2024-01-02 08:29:00,67,155,Móvel,2,222
1951,2024-01-02 08:30:00,11,177,Brinquedo,6,188
1952,2024-01-02 08:31:00,44,92,Brinquedo,2,136
1953,2024-01-02 08:32:00,51,33,Móvel,8,84
1954,2024-01-02 08:33:00,25,85,Brinquedo,9,110
1955,2024-01-02 08:34:00,119,121,Eletrônico,5,240
1956,2024-01-02 08:35:00,81,73,Alimento,7,154
1957,2024-01-02 08:36:00,19,93,Brinquedo,5,112
1958,2024-01-02 08:37:00,96,54,Vestuário,1,150
1959,2024-01-02 08:38:00,73,98,Alimento,7,171
1960,2024-01-02 08:39:00,100,156,Brinquedo,3,256
1961,2024-01-02 08:40:00,29,140,Alimento,4,169
1962,2024-01-02 08:41:00,51,86,Alimento,8,137
1963,2024-01-02 08:42:00,19,34,Vestuário,8,53
1964,2024-01-02 08:43:00,18,132,Móvel,2,150
1965,2024-01-02 08:44:00,37,90,Eletrônico,8,127
1966,2024-01-02 08:45:00,91,135,Brinquedo,7,226
1967,2024-01-02 08:46:00,106,128,Alimento,5,234
1968,2024-01-02 08:47:00,50,43,Eletrônico,3,93
1969,2024-01-02 08:48:00,84,19,Vestuário,2,103
1970,2024-01-02 08:49:00,42,51,Brinquedo,4,93
1971,2024-01-02 08:50:00,45,152,Vestuário,6,197
1972,2024-01-02 08:51:00,68,123,Eletrônico,7,191
1973,2024-01-02 08:52:00,21,105,Brinquedo,5,126
1974,2024-01-02 08:53:00,28,126,Eletrônico,1,154
1975,2024-01-02 08:54:00,64,22,Eletrônico,5,86
1976,2024-01-02 08:55:00,35,78,Alimento,2,113
1977,2024-01-02 08:56:00,95,122,Brinquedo,6,217
1978,2024-01-02 08:57:00,39,108,Eletrônico,4,147
1979,2024-01-02 08:58:00,62,79,Eletrônico,4,141
1980,2024-01-02 08:59:00,60,58,Eletrônico,3,118
1981,2024-01-02 09:00:00,100,14,Vestuário,7,114
1982,2024-01-02 09:01:00,84,15,Vestuário,4,99
1983,2024-01-02 09:02:00,37,86,Brinquedo,6,123
1984,2024-01-02 09:03:00,89,109,Vestuário,9,198
1985,2024-01-02 09:04:00,111,56,Vestuário,1,167
1986,2024-01-02 09:05:00,91,127,Móvel,7,218
1987,2024-01-02 09:06:00,13,97,Vestuário,7,110
1988,2024-01-02 09:07:00,93,129,Alimento,1,222
1989,2024-01-02 09:08:00,79,23,Brinquedo,4,102
1990,2024-01-02 09:09:00,96,40,Brinquedo,6,136
1991,2024-01-02 09:10:00,48,113,Alimento,4,161
1992,2024-01-02 09:11:00,107,135,Vestuário,7,242
1993,2024-01-02 09:12:00,60,147,Alimento,3,207
1994,2024-01-02 09:13:00,62,40,Eletrônico,3,102
1995,2024-01-02 09:14:00,54,24,Eletrônico,3,78
1996,2024-01-02 09:15:00,36,102,Brinquedo,6,138
1997,2024-01-02 09:16:00,82,139,Alimento,9,221
1998,2024-01-02 09:17:00,93,75,Móvel,3,168
1999,2024-01-02 09:18:00,113,62,Alimento,5,175
2000,2024-01-02 09:19:00,32,117,Brinquedo,6,149
2001,2024-01-02 09:20:00,33,37,Vestuário,9,70
2002,2024-01-02 09:21:00,94,73,Móvel,2,167
2003,2024-01-02 09:22:00,115,168,Móvel,4,283
2004,2024-01-02 09:23:00,91,129,Móvel,6,220
2005,2024-01-02 09:24:00,24,109,Vestuário,1,133
2006,2024-01-02 09:25:00,85,63,Brinquedo,6,148
2007,2024-01-02 09:26:00,27,155,Alimento,2,182
2008,2024-01-02 09:27:00,97,100,Vestuário,8,197
2009,2024-01-02 09:28:00,96,61,Alimento,7,157
2010,2024-01-02 09:29:00,80,73,Vestuário,3,153
2011,2024-01-02 09:30:00,29,15,Vestuário,8,44
2012,2024-01-02 09:31:00,46,83,Móvel,5,129
2013,2024-01-02 09:32:00,79,60,Móvel,6,139
2014,2024-01-02 09:33:00,62,142,Brinquedo,9,204
2015,2024-01-02 09:34:00,33,66,Móvel,1,99
2016,2024-01-02 09:35:00,84,140,Alimento,9,224
2017,2024-01-02 09:36:00,110,56,Brinquedo,8,166
2018,2024-01-02 09:37:00,98,101,Alimento,1,199
2019,2024-01-02 09:38:00,11,129,Brinquedo,2,140
2020,2024-01-02 09:39:00,42,76,Brinquedo,3,118
2021,2024-01-02 09:40:00,31,175,Brinquedo,8,206
2022,2024-01-02 09:41:00,79,140,Brinquedo,9,219
2023,2024-01-02 09:42:00,55,178,Alimento,5,233
2024,2024-01-02 09:43:00,98,54,Móvel,1,152
2025,2024-01-02 09:44:00,49,25,Móvel,9,74
2026,2024-01-02 09:45:00,100,171,Eletrônico,7,271
2027,2024-01-02 09:46:00,116,37,Brinquedo,2,153
2028,2024-01-02 09:47:00,21,107,Móvel,1,128
2029,2024-01-02 09:48:00,108,99,Alimento,9,207
2030,2024-01-02 09:49:00,66,54,Vestuário,3,120
2031,2024-01-02 09:50:00,74,25,Brinquedo,6,99
2032,2024-01-02 09:51:00,84,45,Eletrônico,4,129
2033,2024-01-02 09:52:00,16,105,Vestuário,9,121
2034,2024-01-02 09:53:00,51,178,Vestuário,3,229
2035,2024-01-02 09:54:00,101,80,Móvel,1,181
2036,2024-01-02 09:55:00,30,131,Alimento,6,161
2037,2024-01-02 09:56:00,95,160,Móvel,8,255
2038,2024-01-02 09:57:00,117,122,Alimento,8,239
2039,2024-01-02 09:58:00,54,137,Alimento,6,191
2040,2024-01-02 09:59:00,59,87,Alimento,2,146
2041,2024-01-02 10:00:00,26,148,Eletrônico,3,174
2042,2024-01-02 10:01:00,64,53,Vestuário,5,117
2043,2024-01-02 10:02:00,58,151,Móvel,2,209
2044,2024-01-02 10:03:00,52,12,Vestuário,4,64
2045,2024-01-02 10:04:00,118,55,Móvel,7,173
2046,2024-01-02 10:05:00,78,118,Vestuário,8,196
2047,2024-01-02 10:06:00,24,99,Alimento,3,123
2048,2024-01-02 10:07:00,58,21,Brinquedo,3,79
2049,2024-01-02 10:08:00,16,34,Brinquedo,7,50
2050,2024-01-02 10:09:00,39,11,Brinquedo,3,50
2051,2024-01-02 10:10:00,94,124,Eletrônico,2,218
2052,2024-01-02 10:11:00,82,96,Móvel,1,178
2053,2024-01-02 10:12:00,58,27,Vestuário,9,85
2054,2024-01-02 10:13:00,115,151,Vestuário,8,266
2055,2024-01-02 10:14:00,23,49,Móvel,3,72
2056,2024-01-02 10:15:00,33,90,Alimento,4,123
2057,2024-01-02 10:16:00,20,96,Brinquedo,8,116
2058,2024-01-02 10:17:00,82,49,Brinquedo,7,131
2059,2024-01-02 10:18:00,89,163,Móvel,8,252
2060,2024-01-02 10:19:00,83,169,Vestuário,5,252
2061,2024-01-02 10:20:00,33,170,Brinquedo,4,203
2062,2024-01-02 10:21:00,29,105,Vestuário,7,134
2063,2024-01-02 10:22:00,66,126,Brinquedo,2,192
2064,2024-01-02 10:23:00,22,177,Brinquedo,8,199
2065,2024-01-02 10:24:00,33,66,Vestuário,1,99
2066,2024-01-02 10:25:00,42,95,Móvel,5,137
2067,2024-01-02 10:26:00,76,53,Brinquedo,4,129
2068,2024-01-02 10:27:00,50,61,Móvel,7,111
2069,2024-01-02 10:28:00,40,95,Brinquedo,2,135
2070,2024-01-02 10:29:00,92,80,Brinquedo,4,172
2071,2024-01-02 10:30:00,73,48,Móvel,3,121
2072,2024-01-02 10:31:00,118,36,Eletrônico,9,154
2073,2024-01-02 10:32:00,48,56,Eletrônico,8,104
2074,2024-01-02 10:33:00,112,46,Vestuário,2,158
2075,2024-01-02 10:34:00,89,13,Brinquedo,1,102
2076,2024-01-02 10:35:00,45,95,Vestuário,7,140
2077,2024-01-02 10:36:00,102,134,Móvel,3,236
2078,2024-01-02 10:37:00,64,13,Brinquedo,1,77
2079,2024-01-02 10:38:00,100,130,Vestuário,2,230
2080,2024-01-02 10:39:00,97,79,Eletrônico,5,176
2081,2024-01-02 10:40:00,69,174,Brinquedo,8,243
2082,2024-01-02 10:41:00,46,31,Eletrônico,8,77
2083,2024-01-02 10:42:00,84,172,Alimento,6,256
2084,2024-01-02 10:43:00,35,83,Móvel,3,118
2085,2024-01-02 10:44:00,63,117,Eletrônico,8,180
2086,2024-01-02 10:45:00,31,22,Brinquedo,5,53
2087,2024-01-02 10:46:00,30,83,Brinquedo,3,113
2088,2024-01-02 10:47:00,84,156,Vestuário,2,240
2089,2024-01-02 10:48:00,92,97,Eletrônico,9,189
2090,2024-01-02 10:49:00,25,109,Brinquedo,5,134
2091,2024-01-02 10:50:00,62,143,Eletrônico,7,205
2092,2024-01-02 10:51:00,114,100,Vestuário,2,214
2093,2024-01-02 10:52:00,16,167,Vestuário,3,183
2094,2024-01-02 10:53:00,37,79,Eletrônico,1,116
2095,2024-01-02 10:54:00,109,136,Móvel,4,245
2096,2024-01-02 10:55:00,83,34,Vestuário,9,117
2097,2024-01-02 10:56:00,70,103,Vestuário,1,173
2098,2024-01-02 10:57:00,66,141,Alimento,3,207
2099,2024-01-02 10:58:00,80,112,Alimento,4,192
2100,2024-01-02 10:59:00,104,178,Móvel,8,282
2101,2024-01-02 11:00:00,31,161,Vestuário,5,192
2102,2024-01-02 11:01:00,56,174,Eletrônico,8,230
2103,2024-01-02 11:02:00,15,87,Brinquedo,1,102
2104,2024-01-02 11:03:00,29,46,Vestuário,9,75
2105,2024-01-02 11:04:00,105,120,Brinquedo,5,225
2106,2024-01-02 11:05:00,41,80,Móvel,8,121
2107,2024-01-02 11:06:00,117,118,Vestuário,7,235
2108,2024-01-02 11:07:00,42,69,Alimento,9,111
2109,2024-01-02 11:08:00,16,12,Vestuário,1,28
2110,2024-01-02 11:09:00,41,140,Alimento,8,181
2111,2024-01-02 11:10:00,92,134,Vestuário,2,226
2112,2024-01-02 11:11:00,118,49,Alimento,7,167
2113,2024-01-02 11:12:00,14,19,Brinquedo,8,33
2114,2024-01-02 11:13:00,82,10,Eletrônico,8,92
2115,2024-01-02 11:14:00,48,55,Móvel,4,103
2116,2024-01-02 11:15:00,46,15,Brinquedo,7,61
2117,2024-01-02 11:16:00,37,71,Vestuário,6,108
2118,2024-01-02 11:17:00,86,37,Brinquedo,1,123
2119,2024-01-02 11:18:00,39,133,Eletrônico,2,172
2120,2024-01-02 11:19:00,44,135,Móvel,2,179
2121,2024-01-02 11:20:00,31,118,Brinquedo,6,149
2122,2024-01-02 11:21:00,78,171,Eletrônico,8,249
2123,2024-01-02 11:22:00,76,89,Alimento,7,165
2124,2024-01-02 11:23:00,57,127,Eletrônico,9,184
2125,2024-01-02 11:24:00,71,171,Alimento,3,242
2126,2024-01-02 11:25:00,100,29,Brinquedo,2,129
2127,2024-01-02 11:26:00,22,145,Alimento,8,167
2128,2024-01-02 11:27:00,28,58,Móvel,5,86
2129,2024-01-02 11:28:00,87,12,Eletrônico,7,99
2130,2024-01-02 11:29:00,78,113,Brinquedo,7,191
2131,2024-01-02 11:30:00,58,22,Eletrônico,5,80
2132,2024-01-02 11:31:00,19,148,Vestuário,7,167
2133,2024-01-02 11:32:00,15,91,Móvel,9,106
2134,2024-01-02 11:33:00,33,40,Móvel,4,73
2135,2024-01-02 11:34:00,113,53,Móvel,1,166
2136,2024-01-02 11:35:00,92,83,Vestuário,3,175
2137,2024-01-02 11:36:00,68,20,Móvel,9,88
2138,2024-01-02 11:37:00,32,34,Brinquedo,2,66
2139,2024-01-02 11:38:00,35,135,Eletrônico,3,170
2140,2024-01-02 11:39:00,36,87,Vestuário,8,123
2141,2024-01-02 11:40:00,117,166,Vestuário,2,283
2142,2024-01-02 11:41:00,107,96,Vestuário,5,203
2143,2024-01-02 11:42:00,79,57,Móvel,6,136
2144,2024-01-02 11:43:00,95,80,Vestuário,4,175
2145,2024-01-02 11:44:00,51,71,Eletrônico,2,122
2146,2024-01-02 11:45:00,37,64,Alimento,1,101
2147,2024-01-02 11:46:00,92,37,Brinquedo,1,129
2148,2024-01-02 11:47:00,55,155,Brinquedo,5,210
2149,2024-01-02 11:48:00,93,161,Alimento,6,254
2150,2024-01-02 11:49:00,90,100,Alimento,5,190
2151,2024-01-02 11:50:00,44,14,Eletrônico,8,58
2152,2024-01-02 11:51:00,61,78,Brinquedo,3,139
2153,2024-01-02 11:52:00,29,124,Eletrônico,7,153
2154,2024-01-02 11:53:00,23,49,Móvel,3,72
2155,2024-01-02 11:54:00,113,80,Brinquedo,4,193
2156,2024-01-02 11:55:00,51,135,Brinquedo,2,186
2157,2024-01-02 11:56:00,112,29,Alimento,6,141
2158,2024-01-02 11:57:00,73,136,Móvel,9,209
2159,2024-01-02 11:58:00,40,59,Móvel,6,99
2160,2024-01-02 11:59:00,80,90,Móvel,9,170
2161,2024-01-02 12:00:00,119,160,Brinquedo,4,279
2162,2024-01-02 12:01:00,102,99,Vestuário,2,201
2163,2024-01-02 12:02:00,40,133,Eletrônico,2,173
2164,2024-01-02 12:03:00,108,81,Alimento,5,189
2165,2024-01-02 12:04:00,21,177,Alimento,4,198
2166,2024-01-02 12:05:00,119,39,Alimento,7,158
2167,2024-01-02 12:06:00,55,100,Eletrônico,8,155
2168,2024-01-02 12:07:00,73,90,Alimento,7,163
2169,2024-01-02 12:08:00,38,27,Móvel,9,65
2170,2024-01-02 12:09:00,103,14,Eletrônico,7,117
2171,2024-01-02 12:10:00,84,119,Vestuário,6,203
2172,2024-01-02 12:11:00,96,35,Brinquedo,5,131
2173,2024-01-02 12:12:00,113,45,Eletrônico,4,158
2174,2024-01-02 12:13:00,47,53,Alimento,5,100
2175,2024-01-02 12:14:00,30,152,Brinquedo,9,182
2176,2024-01-02 12:15:00,72,43,Brinquedo,1,115
2177,2024-01-02 12:16:00,76,13,Brinquedo,7,89
2178,2024-01-02 12:17:00,119,144,Móvel,3,263
2179,2024-01-02 12:18:00,72,132,Eletrônico,8,204
2180,2024-01-02 12:19:00,102,73,Eletrônico,8,175
2181,2024-01-02 12:20:00,10,76,Vestuário,6,86
2182,2024-01-02 12:21:00,63,40,Alimento,5,103
2183,2024-01-02 12:22:00,83,123,Alimento,7,206
2184,2024-01-02 12:23:00,117,108,Eletrônico,4,225
2185,2024-01-02 12:24:00,55,28,Alimento,8,83
2186,2024-01-02 12:25:00,71,173,Eletrônico,2,244
2187,2024-01-02 12:26:00,117,133,Alimento,1,250
2188,2024-01-02 12:27:00,115,143,Móvel,1,258
2189,2024-01-02 12:28:00,113,98,Brinquedo,8,211
2190,2024-01-02 12:29:00,15,177,Vestuário,1,192
2191,2024-01-02 12:30:00,89,151,Vestuário,8,240
2192,2024-01-02 12:31:00,69,39,Brinquedo,8,108
2193,2024-01-02 12:32:00,80,119,Brinquedo,5,199
2194,2024-01-02 12:33:00,119,162,Alimento,7,281
2195,2024-01-02 12:34:00,42,73,Brinquedo,7,115
2196,2024-01-02 12:35:00,85,87,Móvel,9,172
2197,2024-01-02 12:36:00,112,34,Brinquedo,1,146
2198,2024-01-02 12:37:00,100,40,Alimento,1,140
2199,2024-01-02 12:38:00,106,136,Eletrônico,9,242
2200,2024-01-02 12:39:00,73,107,Brinquedo,5,180
2201,2024-01-02 12:40:00,60,12,Vestuário,1,72
2202,2024-01-02 12:41:00,24,63,Brinquedo,3,87
2203,2024-01-02 12:42:00,41,103,Móvel,1,144
2204,2024-01-02 12:43:00,20,39,Alimento,2,59
2205,2024-01-02 12:44:00,92,86,Alimento,3,178
2206,2024-01-02 12:45:00,92,81,Brinquedo,2,173
2207,2024-01-02 12:46:00,32,166,Alimento,2,198
2208,2024-01-02 12:47:00,66,33,Eletrônico,2,99
2209,2024-01-02 12:48:00,94,173,Móvel,8,267
2210,2024-01-02 12:49:00,57,75,Vestuário,9,132
2211,2024-01-02 12:50:00,65,169,Alimento,2,234
2212,2024-01-02 12:51:00,92,161,Eletrônico,9,253
2213,2024-01-02 12:52:00,36,18,Vestuário,8,54
2214,2024-01-02 12:53:00,116,105,Eletrônico,6,221
2215,2024-01-02 12:54:00,66,35,Alimento,5,101
2216,2024-01-02 12:55:00,44,176,Móvel,8,220
2217,2024-01-02 12:56:00,57,136,Móvel,3,193
2218,2024-01-02 12:57:00,103,79,Vestuário,5,182
2219,2024-01-02 12:58:00,115,138,Alimento,9,253
2220,2024-01-02 12:59:00,101,36,Vestuário,8,137
2221,2024-01-02 13:00:00,79,53,Brinquedo,5,132
2222,2024-01-02 13:01:00,18,110,Alimento,5,128
2223,2024-01-02 13:02:00,116,145,Alimento,6,261
2224,2024-01-02 13:03:00,20,71,Móvel,7,91
2225,2024-01-02 13:04:00,77,43,Brinquedo,9,120
2226,2024-01-02 13:05:00,73,66,Alimento,2,139
2227,2024-01-02 13:06:00,69,18,Brinquedo,3,87
2228,2024-01-02 13:07:00,106,48,Alimento,5,154
2229,2024-01-02 13:08:00,34,154,Eletrônico,4,188
2230,2024-01-02 13:09:00,101,63,Vestuário,9,164
2231,2024-01-02 13:10:00,53,150,Brinquedo,6,203
2232,2024-01-02 13:11:00,117,41,Alimento,6,158
2233,2024-01-02 13:12:00,21,130,Brinquedo,5,151
2234,2024-01-02 13:13:00,79,56,Vestuário,6,135
2235,2024-01-02 13:14:00,30,80,Móvel,6,110
2236,2024-01-02 13:15:00,107,172,Alimento,2,279
2237,2024-01-02 13:16:00,104,51,Brinquedo,1,155
2238,2024-01-02 13:17:00,93,14,Brinquedo,2,107
2239,2024-01-02 13:18:00,19,18,Eletrônico,3,37
2240,2024-01-02 13:19:00,78,159,Alimento,1,237
2241,2024-01-02 13:20:00,24,76,Móvel,8,100
2242,2024-01-02 13:21:00,82,148,Brinquedo,5,230
2243,2024-01-02 13:22:00,114,83,Móvel,8,197
2244,2024-01-02 13:23:00,27,64,Alimento,9,91
2245,2024-01-02 13:24:00,70,55,Móvel,5,125
2246,2024-01-02 13:25:00,11,25,Brinquedo,6,36
2247,2024-01-02 13:26:00,81,114,Móvel,4,195
2248,2024-01-02 13:27:00,15,153,Eletrônico,3,168
2249,2024-01-02 13:28:00,95,29,Brinquedo,3,124
2250,2024-01-02 13:29:00,61,111,Alimento,3,172
2251,2024-01-02 13:30:00,85,45,Eletrônico,8,130
2252,2024-01-02 13:31:00,12,141,Eletrônico,2,153
2253,2024-01-02 13:32:00,106,40,Eletrônico,9,146
2254,2024-01-02 13:33:00,48,131,Vestuário,5,179
2255,2024-01-02 13:34:00,18,104,Vestuário,2,122
2256,2024-01-02 13:35:00,57,159,Vestuário,2,216
2257,2024-01-02 13:36:00,13,143,Vestuário,7,156
2258,2024-01-02 13:37:00,82,128,Alimento,4,210
2259,2024-01-02 13:38:00,39,178,Vestuário,3,217
2260,2024-01-02 13:39:00,37,173,Alimento,5,210
2261,2024-01-02 13:40:00,107,96,Alimento,5,203
2262,2024-01-02 13:41:00,115,140,Eletrônico,2,255
2263,2024-01-02 13:42:00,94,81,Móvel,4,175
2264,2024-01-02 13:43:00,71,160,Vestuário,8,231
2265,2024-01-02 13:44:00,64,126,Brinquedo,1,190
2266,2024-01-02 13:45:00,44,116,Móvel,4,160
2267,2024-01-02 13:46:00,13,12,Alimento,8,25
2268,2024-01-02 13:47:00,115,149,Brinquedo,3,264
2269,2024-01-02 13:48:00,27,136,Vestuário,2,163
2270,2024-01-02 13:49:00,40,29,Brinquedo,3,69
2271,2024-01-02 13:50:00,21,54,Brinquedo,3,75
2272,2024-01-02 13:51:00,53,109,Alimento,1,162
2273,2024-01-02 13:52:00,14,105,Eletrônico,1,119
2274,2024-01-02 13:53:00,89,71,Eletrônico,9,160
2275,2024-01-02 13:54:00,112,158,Alimento,7,270
2276,2024-01-02 13:55:00,106,163,Móvel,4,269
2277,2024-01-02 13:56:00,32,28,Eletrônico,4,60
2278,2024-01-02 13:57:00,96,89,Alimento,2,185
2279,2024-01-02 13:58:00,61,144,Eletrônico,3,205
2280,2024-01-02 13:59:00,95,101,Eletrônico,7,196
2281,2024-01-02 14:00:00,103,80,Móvel,1,183
2282,2024-01-02 14:01:00,19,157,Móvel,5,176
2283,2024-01-02 14:02:00,17,109,Móvel,3,126
2284,2024-01-02 14:03:00,17,135,Vestuário,5,152
2285,2024-01-02 14:04:00,29,93,Alimento,3,122
2286,2024-01-02 14:05:00,69,149,Eletrônico,4,218
2287,2024-01-02 14:06:00,25,121,Alimento,1,146
2288,2024-01-02 14:07:00,57,66,Brinquedo,9,123
2289,2024-01-02 14:08:00,111,130,Alimento,3,241
2290,2024-01-02 14:09:00,72,164,Alimento,5,236
2291,2024-01-02 14:10:00,70,32,Alimento,3,102
2292,2024-01-02 14:11:00,30,48,Alimento,5,78
2293,2024-01-02 14:12:00,97,23,Móvel,9,120
2294,2024-01-02 14:13:00,30,171,Eletrônico,8,201
2295,2024-01-02 14:14:00,54,158,Alimento,6,212
2296,2024-01-02 14:15:00,52,88,Brinquedo,9,140
2297,2024-01-02 14:16:00,24,84,Alimento,6,108
2298,2024-01-02 14:17:00,38,42,Móvel,4,80
2299,2024-01-02 14:18:00,78,127,Móvel,5,205
2300,2024-01-02 14:19:00,98,110,Eletrônico,6,208
2301,2024-01-02 14:20:00,26,91,Móvel,4,117
2302,2024-01-02 14:21:00,77,95,Móvel,8,172
2303,2024-01-02 14:22:00,85,150,Móvel,9,235
2304,2024-01-02 14:23:00,104,165,Vestuário,5,269
2305,2024-01-02 14:24:00,33,166,Móvel,6,199
2306,2024-01-02 14:25:00,73,128,Eletrônico,8,201
2307,2024-01-02 14:26:00,52,178,Eletrônico,8,230
2308,2024-01-02 14:27:00,88,92,Eletrônico,1,180
2309,2024-01-02 14:28:00,93,140,Brinquedo,8,233
2310,2024-01-02 14:29:00,54,117,Alimento,8,171
2311,2024-01-02 14:30:00,85,132,Móvel,3,217
2312,2024-01-02 14:31:00,84,165,Vestuário,7,249
2313,2024-01-02 14:32:00,72,132,Vestuário,6,204
2314,2024-01-02 14:33:00,61,62,Alimento,3,123
2315,2024-01-02 14:34:00,77,21,Vestuário,7,98
2316,2024-01-02 14:35:00,47,112,Brinquedo,2,159
2317,2024-01-02 14:36:00,65,28,Brinquedo,8,93
2318,2024-01-02 14:37:00,20,85,Brinquedo,9,105
2319,2024-01-02 14:38:00,48,23,Móvel,7,71
2320,2024-01-02 14:39:00,57,109,Eletrônico,1,166
2321,2024-01-02 14:40:00,66,144,Alimento,6,210
2322,2024-01-02 14:41:00,111,153,Vestuário,8,264
2323,2024-01-02 14:42:00,107,161,Brinquedo,8,268
2324,2024-01-02 14:43:00,36,168,Móvel,9,204
2325,2024-01-02 14:44:00,12,167,Vestuário,8,179
2326,2024-01-02 14:45:00,106,81,Brinquedo,1,187
2327,2024-01-02 14:46:00,58,25,Vestuário,7,83
2328,2024-01-02 14:47:00,57,160,Vestuário,5,217
2329,2024-01-02 14:48:00,22,111,Vestuário,6,133
2330,2024-01-02 14:49:00,55,164,Eletrônico,8,219
2331,2024-01-02 14:50:00,72,59,Brinquedo,3,131
2332,2024-01-02 14:51:00,62,69,Brinquedo,8,131
2333,2024-01-02 14:52:00,62,12,Eletrônico,7,74
2334,2024-01-02 14:53:00,31,107,Brinquedo,4,138
2335,2024-01-02 14:54:00,27,12,Brinquedo,1,39
2336,2024-01-02 14:55:00,119,89,Vestuário,2,208
2337,2024-01-02 14:56:00,53,171,Brinquedo,9,224
2338,2024-01-02 14:57:00,43,47,Eletrônico,3,90
2339,2024-01-02 14:58:00,25,177,Brinquedo,7,202
2340,2024-01-02 14:59:00,83,129,Brinquedo,2,212
2341,2024-01-02 15:00:00,90,155,Eletrônico,8,245
2342,2024-01-02 15:01:00,72,33,Alimento,5,105
2343,2024-01-02 15:02:00,74,42,Eletrônico,5,116
2344,2024-01-02 15:03:00,23,83,Alimento,1,106
2345,2024-01-02 15:04:00,31,162,Eletrônico,2,193
2346,2024-01-02 15:05:00,37,134,Alimento,2,171
2347,2024-01-02 15:06:00,89,141,Móvel,9,230
2348,2024-01-02 15:07:00,26,105,Móvel,1,131
2349,2024-01-02 15:08:00,37,66,Alimento,5,103
2350,2024-01-02 15:09:00,36,18,Móvel,9,54
2351,2024-01-02 15:10:00,14,171,Brinquedo,5,185
2352,2024-01-02 15:11:00,78,155,Eletrônico,1,233
2353,2024-01-02 15:12:00,47,40,Alimento,6,87
2354,2024-01-02 15:13:00,82,92,Móvel,4,174
2355,2024-01-02 15:14:00,102,144,Alimento,8,246
2356,2024-01-02 15:15:00,99,54,Eletrônico,9,153
2357,2024-01-02 15:16:00,104,76,Eletrônico,4,180
2358,2024-01-02 15:17:00,35,99,Vestuário,5,134
2359,2024-01-02 15:18:00,101,115,Móvel,4,216
2360,2024-01-02 15:19:00,109,74,Eletrônico,8,183
2361,2024-01-02 15:20:00,45,20,Brinquedo,3,65
2362,2024-01-02 15:21:00,16,66,Brinquedo,9,82
2363,2024-01-02 15:22:00,83,78,Brinquedo,9,161
2364,2024-01-02 15:23:00,51,112,Móvel,6,163
2365,2024-01-02 15:24:00,18,19,Móvel,3,37
2366,2024-01-02 15:25:00,104,59,Vestuário,4,163
2367,2024-01-02 15:26:00,119,72,Brinquedo,3,191
2368,2024-01-02 15:27:00,76,147,Alimento,6,223
2369,2024-01-02 15:28:00,41,88,Móvel,8,129
2370,2024-01-02 15:29:00,79,164,Vestuário,6,243
2371,2024-01-02 15:30:00,36,165,Alimento,2,201
2372,2024-01-02 15:31:00,118,122,Eletrônico,3,240
2373,2024-01-02 15:32:00,45,102,Vestuário,9,147
2374,2024-01-02 15:33:00,43,161,Brinquedo,3,204
2375,2024-01-02 15:34:00,112,81,Brinquedo,3,193
2376,2024-01-02 15:35:00,77,32,Móvel,5,109
2377,2024-01-02 15:36:00,117,176,Brinquedo,9,293
2378,2024-01-02 15:37:00,20,41,Alimento,7,61
2379,2024-01-02 15:38:00,45,148,Eletrônico,4,193
2380,2024-01-02 15:39:00,42,151,Alimento,2,193
2381,2024-01-02 15:40:00,17,10,Móvel,1,27
2382,2024-01-02 15:41:00,96,67,Vestuário,6,163
2383,2024-01-02 15:42:00,27,142,Vestuário,6,169
2384,2024-01-02 15:43:00,89,131,Eletrônico,9,220
2385,2024-01-02 15:44:00,72,36,Brinquedo,3,108
2386,2024-01-02 15:45:00,14,84,Móvel,4,98
2387,2024-01-02 15:46:00,14,57,Vestuário,1,71
2388,2024-01-02 15:47:00,118,79,Eletrônico,3,197
2389,2024-01-02 15:48:00,35,72,Vestuário,3,107
2390,2024-01-02 15:49:00,91,172,Vestuário,1,263
2391,2024-01-02 15:50:00,59,67,Móvel,3,126
2392,2024-01-02 15:51:00,49,66,Móvel,2,115
2393,2024-01-02 15:52:00,51,78,Vestuário,3,129
2394,2024-01-02 15:53:00,83,51,Vestuário,3,134
2395,2024-01-02 15:54:00,75,58,Vestuário,4,133
2396,2024-01-02 15:55:00,25,22,Móvel,7,47
2397,2024-01-02 15:56:00,78,169,Alimento,4,247
2398,2024-01-02 15:57:00,90,122,Vestuário,7,212
2399,2024-01-02 15:58:00,107,82,Vestuário,3,189
2400,2024-01-02 15:59:00,102,21,Eletrônico,3,123
2401,2024-01-02 16:00:00,72,78,Vestuário,1,150
2402,2024-01-02 16:01:00,46,78,Vestuário,8,124
2403,2024-01-02 16:02:00,57,109,Brinquedo,2,166
2404,2024-01-02 16:03:00,85,101,Alimento,4,186
2405,2024-01-02 16:04:00,94,112,Móvel,1,206
2406,2024-01-02 16:05:00,51,64,Vestuário,6,115
2407,2024-01-02 16:06:00,34,21,Móvel,7,55
2408,2024-01-02 16:07:00,78,94,Alimento,5,172
2409,2024-01-02 16:08:00,110,33,Móvel,7,143
2410,2024-01-02 16:09:00,22,41,Móvel,7,63
2411,2024-01-02 16:10:00,70,76,Vestuário,5,146
2412,2024-01-02 16:11:00,14,17,Móvel,2,31
2413,2024-01-02 16:12:00,52,12,Brinquedo,2,64
2414,2024-01-02 16:13:00,81,150,Eletrônico,3,231
2415,2024-01-02 16:14:00,83,59,Vestuário,4,142
2416,2024-01-02 16:15:00,44,72,Eletrônico,2,116
2417,2024-01-02 16:16:00,46,15,Vestuário,8,61
2418,2024-01-02 16:17:00,20,137,Eletrônico,3,157
2419,2024-01-02 16:18:00,81,177,Alimento,5,258
2420,2024-01-02 16:19:00,95,144,Brinquedo,8,239
2421,2024-01-02 16:20:00,31,98,Brinquedo,4,129
2422,2024-01-02 16:21:00,20,33,Brinquedo,3,53
2423,2024-01-02 16:22:00,62,122,Brinquedo,8,184
2424,2024-01-02 16:23:00,65,30,Vestuário,8,95
2425,2024-01-02 16:24:00,112,22,Eletrônico,9,134
2426,2024-01-02 16:25:00,74,109,Eletrônico,3,183
2427,2024-01-02 16:26:00,90,95,Brinquedo,5,185
2428,2024-01-02 16:27:00,44,158,Eletrônico,2,202
2429,2024-01-02 16:28:00,91,16,Eletrônico,4,107
2430,2024-01-02 16:29:00,57,21,Eletrônico,9,78
2431,2024-01-02 16:30:00,40,48,Móvel,4,88
2432,2024-01-02 16:31:00,25,77,Vestuário,1,102
2433,2024-01-02 16:32:00,33,73,Vestuário,9,106
2434,2024-01-02 16:33:00,91,141,Eletrônico,9,232
2435,2024-01-02 16:34:00,51,167,Eletrônico,1,218
2436,2024-01-02 16:35:00,51,132,Móvel,1,183
2437,2024-01-02 16:36:00,82,127,Eletrônico,3,209
2438,2024-01-02 16:37:00,79,14,Eletrônico,3,93
2439,2024-01-02 16:38:00,83,26,Eletrônico,3,109
2440,2024-01-02 16:39:00,115,46,Vestuário,7,161
2441,2024-01-02 16:40:00,60,42,Vestuário,6,102
2442,2024-01-02 16:41:00,110,99,Vestuário,1,209
2443,2024-01-02 16:42:00,15,97,Móvel,4,112
2444,2024-01-02 16:43:00,56,70,Móvel,5,126
2445,2024-01-02 16:44:00,42,110,Vestuário,2,152
2446,2024-01-02 16:45:00,113,79,Eletrônico,1,192
2447,2024-01-02 16:46:00,71,49,Alimento,1,120
2448,2024-01-02 16:47:00,38,146,Eletrônico,9,184
2449,2024-01-02 16:48:00,18,155,Brinquedo,8,173
2450,2024-01-02 16:49:00,78,147,Móvel,7,225
2451,2024-01-02 16:50:00,25,90,Alimento,9,115
2452,2024-01-02 16:51:00,68,50,Alimento,5,118
2453,2024-01-02 16:52:00,108,160,Móvel,6,268
2454,2024-01-02 16:53:00,58,21,Eletrônico,1,79
2455,2024-01-02 16:54:00,107,141,Brinquedo,6,248
2456,2024-01-02 16:55:00,31,26,Alimento,6,57
2457,2024-01-02 16:56:00,89,103,Eletrônico,2,192
2458,2024-01-02 16:57:00,75,138,Brinquedo,3,213
2459,2024-01-02 16:58:00,12,38,Brinquedo,4,50
2460,2024-01-02 16:59:00,32,37,Eletrônico,4,69
2461,2024-01-02 17:00:00,42,131,Alimento,2,173
2462,2024-01-02 17:01:00,81,156,Alimento,3,237
2463,2024-01-02 17:02:00,20,14,Eletrônico,4,34
2464,2024-01-02 17:03:00,19,160,Eletrônico,1,179
2465,2024-01-02 17:04:00,103,51,Móvel,8,154
2466,2024-01-02 17:05:00,17,147,Móvel,6,164
2467,2024-01-02 17:06:00,59,86,Brinquedo,6,145
2468,2024-01-02 17:07:00,10,108,Móvel,4,118
2469,2024-01-02 17:08:00,12,10,Vestuário,1,22
2470,2024-01-02 17:09:00,112,93,Alimento,6,205
2471,2024-01-02 17:10:00,37,57,Vestuário,7,94
2472,2024-01-02 17:11:00,108,109,Brinquedo,4,217
2473,2024-01-02 17:12:00,37,41,Móvel,3,78
2474,2024-01-02 17:13:00,95,108,Brinquedo,6,203
2475,2024-01-02 17:14:00,54,99,Alimento,5,153
2476,2024-01-02 17:15:00,82,61,Eletrônico,4,143
2477,2024-01-02 17:16:00,117,25,Brinquedo,3,142
2478,2024-01-02 17:17:00,78,65,Móvel,5,143
2479,2024-01-02 17:18:00,16,166,Eletrônico,4,182
2480,2024-01-02 17:19:00,77,130,Alimento,6,207
2481,2024-01-02 17:20:00,82,39,Móvel,4,121
2482,2024-01-02 17:21:00,101,44,Vestuário,8,145
2483,2024-01-02 17:22:00,70,42,Alimento,6,112
2484,2024-01-02 17:23:00,63,101,Brinquedo,8,164
2485,2024-01-02 17:24:00,12,40,Móvel,6,52
2486,2024-01-02 17:25:00,91,83,Vestuário,1,174
2487,2024-01-02 17:26:00,92,63,Eletrônico,3,155
2488,2024-01-02 17:27:00,28,68,Vestuário,9,96
2489,2024-01-02 17:28:00,84,149,Alimento,5,233
2490,2024-01-02 17:29:00,85,17,Eletrônico,1,102
2491,2024-01-02 17:30:00,70,52,Móvel,7,122
2492,2024-01-02 17:31:00,91,178,Móvel,8,269
2493,2024-01-02 17:32:00,106,68,Eletrônico,2,174
2494,2024-01-02 17:33:00,89,93,Alimento,5,182
2495,2024-01-02 17:34:00,111,83,Vestuário,9,194
2496,2024-01-02 17:35:00,56,120,Eletrônico,5,176
2497,2024-01-02 17:36:00,17,79,Eletrônico,9,96
2498,2024-01-02 17:37:00,64,117,Vestuário,7,181
2499,2024-01-02 17:38:00,80,109,Eletrônico,1,189
2500,2024-01-02 17:39:00,69,104,Eletrônico,1,173
2501,2024-01-02 17:40:00,38,164,Brinquedo,6,202
2502,2024-01-02 17:41:00,113,77,Alimento,6,190
2503,2024-01-02 17:42:00,85,132,Móvel,7,217
2504,2024-01-02 17:43:00,118,77,Alimento,3,195
2505,2024-01-02 17:44:00,115,151,Brinquedo,6,266
2506,2024-01-02 17:45:00,69,53,Móvel,2,122
2507,2024-01-02 17:46:00,39,140,Móvel,4,179
2508,2024-01-02 17:47:00,80,29,Móvel,8,109
2509,2024-01-02 17:48:00,93,32,Vestuário,2,125
2510,2024-01-02 17:49:00,103,121,Vestuário,2,224
2511,2024-01-02 17:50:00,93,104,Vestuário,8,197
2512,2024-01-02 17:51:00,31,131,Móvel,7,162
2513,2024-01-02 17:52:00,39,125,Brinquedo,6,164
2514,2024-01-02 17:53:00,16,102,Brinquedo,4,118
2515,2024-01-02 17:54:00,30,21,Eletrônico,9,51
2516,2024-01-02 17:55:00,68,157,Vestuário,9,225
2517,2024-01-02 17:56:00,51,17,Eletrônico,1,68
2518,2024-01-02 17:57:00,100,131,Alimento,1,231
2519,2024-01-02 17:58:00,113,150,Móvel,2,263
2520,2024-01-02 17:59:00,48,137,Móvel,7,185
2521,2024-01-02 18:00:00,109,15,Brinquedo,5,124
2522,2024-01-02 18:01:00,44,53,Eletrônico,4,97
2523,2024-01-02 18:02:00,89,150,Brinquedo,5,239
2524,2024-01-02 18:03:00,26,88,Eletrônico,5,114
2525,2024-01-02 18:04:00,29,120,Eletrônico,6,149
2526,2024-01-02 18:05:00,23,31,Vestuário,8,54
2527,2024-01-02 18:06:00,44,11,Móvel,8,55
2528,2024-01-02 18:07:00,107,171,Alimento,4,278
2529,2024-01-02 18:08:00,91,68,Vestuário,4,159
2530,2024-01-02 18:09:00,33,138,Eletrônico,6,171
2531,2024-01-02 18:10:00,15,34,Alimento,2,49
2532,2024-01-02 18:11:00,46,65,Vestuário,9,111
2533,2024-01-02 18:12:00,17,175,Alimento,9,192
2534,2024-01-02 18:13:00,57,116,Vestuário,7,173
2535,2024-01-02 18:14:00,61,160,Móvel,7,221
2536,2024-01-02 18:15:00,61,94,Móvel,3,155
2537,2024-01-02 18:16:00,59,132,Alimento,8,191
2538,2024-01-02 18:17:00,82,166,Vestuário,7,248
2539,2024-01-02 18:18:00,28,172,Brinquedo,3,200
2540,2024-01-02 18:19:00,85,49,Eletrônico,8,134
2541,2024-01-02 18:20:00,110,94,Eletrônico,5,204
2542,2024-01-02 18:21:00,77,94,Vestuário,5,171
2543,2024-01-02 18:22:00,47,12,Alimento,7,59
2544,2024-01-02 18:23:00,51,121,Eletrônico,7,172
2545,2024-01-02 18:24:00,79,53,Alimento,9,132
2546,2024-01-02 18:25:00,115,21,Eletrônico,7,136
2547,2024-01-02 18:26:00,72,12,Vestuário,9,84
2548,2024-01-02 18:27:00,116,23,Móvel,2,139
2549,2024-01-02 18:28:00,56,136,Vestuário,2,192
2550,2024-01-02 18:29:00,113,125,Vestuário,7,238
2551,2024-01-02 18:30:00,32,171,Vestuário,3,203
2552,2024-01-02 18:31:00,97,38,Brinquedo,4,135
2553,2024-01-02 18:32:00,69,141,Eletrônico,7,210
2554,2024-01-02 18:33:00,117,91,Alimento,1,208
2555,2024-01-02 18:34:00,58,86,Alimento,9,144
2556,2024-01-02 18:35:00,39,116,Vestuário,8,155
2557,2024-01-02 18:36:00,101,61,Móvel,9,162
2558,2024-01-02 18:37:00,105,141,Alimento,5,246
2559,2024-01-02 18:38:00,52,51,Vestuário,4,103
2560,2024-01-02 18:39:00,84,34,Móvel,9,118
2561,2024-01-02 18:40:00,106,126,Eletrônico,8,232
2562,2024-01-02 18:41:00,71,94,Alimento,2,165
2563,2024-01-02 18:42:00,68,135,Vestuário,3,203
2564,2024-01-02 18:43:00,48,162,Móvel,9,210
2565,2024-01-02 18:44:00,95,120,Eletrônico,4,215
2566,2024-01-02 18:45:00,65,14,Móvel,5,79
2567,2024-01-02 18:46:00,113,167,Vestuário,2,280
2568,2024-01-02 18:47:00,38,145,Móvel,1,183
2569,2024-01-02 18:48:00,80,76,Alimento,6,156
2570,2024-01-02 18:49:00,116,23,Eletrônico,2,139
2571,2024-01-02 18:50:00,91,169,Móvel,8,260
2572,2024-01-02 18:51:00,110,26,Alimento,9,136
2573,2024-01-02 18:52:00,51,121,Vestuário,5,172
2574,2024-01-02 18:53:00,85,156,Alimento,3,241
2575,2024-01-02 18:54:00,67,57,Brinquedo,5,124
2576,2024-01-02 18:55:00,97,171,Móvel,4,268
2577,2024-01-02 18:56:00,57,78,Brinquedo,9,135
2578,2024-01-02 18:57:00,69,135,Alimento,5,204
2579,2024-01-02 18:58:00,95,140,Brinquedo,9,235
2580,2024-01-02 18:59:00,46,72,Brinquedo,6,118
2581,2024-01-02 19:00:00,19,134,Vestuário,3,153
2582,2024-01-02 19:01:00,117,121,Eletrônico,6,238
2583,2024-01-02 19:02:00,44,150,Vestuário,9,194
2584,2024-01-02 19:03:00,73,88,Eletrônico,9,161
2585,2024-01-02 19:04:00,44,87,Vestuário,6,131
2586,2024-01-02 19:05:00,34,143,Brinquedo,4,177
2587,2024-01-02 19:06:00,53,118,Brinquedo,5,171
2588,2024-01-02 19:07:00,103,171,Eletrônico,8,274
2589,2024-01-02 19:08:00,29,148,Móvel,2,177
2590,2024-01-02 19:09:00,71,112,Eletrônico,9,183
2591,2024-01-02 19:10:00,10,104,Alimento,6,114
2592,2024-01-02 19:11:00,20,130,Eletrônico,6,150
2593,2024-01-02 19:12:00,12,108,Vestuário,5,120
2594,2024-01-02 19:13:00,68,87,Vestuário,7,155
2595,2024-01-02 19:14:00,21,111,Vestuário,2,132
2596,2024-01-02 19:15:00,51,149,Móvel,5,200
2597,2024-01-02 19:16:00,36,111,Brinquedo,4,147
2598,2024-01-02 19:17:00,17,146,Eletrônico,8,163
2599,2024-01-02 19:18:00,12,171,Móvel,4,183
2600,2024-01-02 19:19:00,37,178,Eletrônico,8,215
2601,2024-01-02 19:20:00,66,99,Eletrônico,8,165
2602,2024-01-02 19:21:00,58,91,Alimento,6,149
2603,2024-01-02 19:22:00,11,155,Brinquedo,2,166
2604,2024-01-02 19:23:00,38,137,Alimento,2,175
2605,2024-01-02 19:24:00,61,64,Móvel,9,125
2606,2024-01-02 19:25:00,20,142,Alimento,1,162
2607,2024-01-02 19:26:00,37,179,Brinquedo,9,216
2608,2024-01-02 19:27:00,36,149,Eletrônico,7,185
2609,2024-01-02 19:28:00,69,121,Alimento,3,190
2610,2024-01-02 19:29:00,27,58,Alimento,6,85
2611,2024-01-02 19:30:00,86,149,Alimento,7,235
2612,2024-01-02 19:31:00,115,110,Alimento,2,225
2613,2024-01-02 19:32:00,48,15,Alimento,4,63
2614,2024-01-02 19:33:00,112,33,Móvel,7,145
2615,2024-01-02 19:34:00,85,12,Alimento,8,97
2616,2024-01-02 19:35:00,85,118,Eletrônico,8,203
2617,2024-01-02 19:36:00,16,124,Brinquedo,3,140
2618,2024-01-02 19:37:00,63,145,Móvel,4,208
2619,2024-01-02 19:38:00,52,129,Eletrônico,7,181
2620,2024-01-02 19:39:00,114,75,Eletrônico,2,189
2621,2024-01-02 19:40:00,110,128,Brinquedo,8,238
2622,2024-01-02 19:41:00,108,65,Brinquedo,5,173
2623,2024-01-02 19:42:00,95,30,Vestuário,4,125
2624,2024-01-02 19:43:00,107,119,Eletrônico,3,226
2625,2024-01-02 19:44:00,51,60,Móvel,8,111
2626,2024-01-02 19:45:00,118,91,Vestuário,6,209
2627,2024-01-02 19:46:00,34,17,Eletrônico,5,51
2628,2024-01-02 19:47:00,66,31,Eletrônico,1,97
2629,2024-01-02 19:48:00,98,41,Móvel,4,139
2630,2024-01-02 19:49:00,108,32,Brinquedo,6,140
2631,2024-01-02 19:50:00,29,77,Móvel,9,106
2632,2024-01-02 19:51:00,93,39,Móvel,2,132
2633,2024-01-02 19:52:00,106,82,Eletrônico,1,188
2634,2024-01-02 19:53:00,83,32,Eletrônico,8,115
2635,2024-01-02 19:54:00,10,99,Vestuário,6,109
2636,2024-01-02 19:55:00,50,31,Eletrônico,5,81
2637,2024-01-02 19:56:00,87,168,Eletrônico,8,255
2638,2024-01-02 19:57:00,32,134,Alimento,4,166
2639,2024-01-02 19:58:00,33,111,Alimento,9,144
2640,2024-01-02 19:59:00,91,125,Móvel,6,216
2641,2024-01-02 20:00:00,21,146,Brinquedo,6,167
2642,2024-01-02 20:01:00,90,108,Eletrônico,4,198
2643,2024-01-02 20:02:00,71,58,Móvel,6,129
2644,2024-01-02 20:03:00,59,143,Brinquedo,4,202
2645,2024-01-02 20:04:00,33,151,Alimento,9,184
2646,2024-01-02 20:05:00,75,56,Móvel,4,131
2647,2024-01-02 20:06:00,45,109,Alimento,3,154
2648,2024-01-02 20:07:00,43,147,Móvel,6,190
2649,2024-01-02 20:08:00,109,116,Eletrônico,8,225
2650,2024-01-02 20:09:00,73,31,Vestuário,9,104
2651,2024-01-02 20:10:00,68,132,Alimento,2,200
2652,2024-01-02 20:11:00,99,90,Alimento,1,189
2653,2024-01-02 20:12:00,42,119,Alimento,7,161
2654,2024-01-02 20:13:00,43,82,Alimento,5,125
2655,2024-01-02 20:14:00,106,163,Móvel,7,269
2656,2024-01-02 20:15:00,103,172,Alimento,8,275
2657,2024-01-02 20:16:00,74,111,Alimento,4,185
2658,2024-01-02 20:17:00,94,104,Móvel,8,198
2659,2024-01-02 20:18:00,88,38,Brinquedo,3,126
2660,2024-01-02 20:19:00,28,41,Móvel,9,69
2661,2024-01-02 20:20:00,40,178,Brinquedo,6,218
2662,2024-01-02 20:21:00,35,129,Alimento,6,164
2663,2024-01-02 20:22:00,102,170,Eletrônico,5,272
2664,2024-01-02 20:23:00,22,59,Eletrônico,5,81
2665,2024-01-02 20:24:00,119,16,Brinquedo,2,135
2666,2024-01-02 20:25:00,75,107,Eletrônico,1,182
2667,2024-01-02 20:26:00,79,31,Móvel,3,110
2668,2024-01-02 20:27:00,32,139,Móvel,3,171
2669,2024-01-02 20:28:00,48,107,Eletrônico,3,155
2670,2024-01-02 20:29:00,77,44,Vestuário,1,121
2671,2024-01-02 20:30:00,88,87,Móvel,9,175
2672,2024-01-02 20:31:00,71,110,Alimento,2,181
2673,2024-01-02 20:32:00,40,113,Vestuário,1,153
2674,2024-01-02 20:33:00,52,21,Vestuário,5,73
2675,2024-01-02 20:34:00,48,103,Brinquedo,4,151
2676,2024-01-02 20:35:00,109,129,Brinquedo,1,238
2677,2024-01-02 20:36:00,52,100,Móvel,7,152
2678,2024-01-02 20:37:00,62,170,Móvel,9,232
2679,2024-01-02 20:38:00,63,51,Vestuário,7,114
2680,2024-01-02 20:39:00,101,71,Brinquedo,6,172
2681,2024-01-02 20:40:00,10,101,Alimento,2,111
2682,2024-01-02 20:41:00,86,111,Eletrônico,5,197
2683,2024-01-02 20:42:00,38,23,Alimento,3,61
2684,2024-01-02 20:43:00,25,33,Móvel,1,58
2685,2024-01-02 20:44:00,10,34,Vestuário,3,44
2686,2024-01-02 20:45:00,91,14,Brinquedo,9,105
2687,2024-01-02 20:46:00,51,153,Móvel,1,204
2688,2024-01-02 20:47:00,109,112,Vestuário,8,221
2689,2024-01-02 20:48:00,68,139,Eletrônico,8,207
2690,2024-01-02 20:49:00,75,14,Alimento,4,89
2691,2024-01-02 20:50:00,82,121,Móvel,8,203
2692,2024-01-02 20:51:00,68,18,Vestuário,4,86
2693,2024-01-02 20:52:00,89,127,Alimento,1,216
2694,2024-01-02 20:53:00,103,45,Brinquedo,5,148
2695,2024-01-02 20:54:00,28,164,Eletrônico,9,192
2696,2024-01-02 20:55:00,54,68,Eletrônico,6,122
2697,2024-01-02 20:56:00,29,164,Eletrônico,3,193
2698,2024-01-02 20:57:00,58,167,Vestuário,3,225
2699,2024-01-02 20:58:00,47,109,Alimento,9,156
2700,2024-01-02 20:59:00,75,172,Móvel,9,247
2701,2024-01-02 21:00:00,114,70,Alimento,4,184
2702,2024-01-02 21:01:00,35,19,Eletrônico,5,54
2703,2024-01-02 21:02:00,116,92,Brinquedo,1,208
2704,2024-01-02 21:03:00,25,163,Alimento,6,188
2705,2024-01-02 21:04:00,84,131,Vestuário,2,215
2706,2024-01-02 21:05:00,10,57,Alimento,4,67
2707,2024-01-02 21:06:00,72,39,Vestuário,4,111
2708,2024-01-02 21:07:00,109,137,Vestuário,4,246
2709,2024-01-02 21:08:00,37,79,Vestuário,8,116
2710,2024-01-02 21:09:00,11,22,Móvel,9,33
2711,2024-01-02 21:10:00,88,166,Alimento,5,254
2712,2024-01-02 21:11:00,90,115,Móvel,1,205
2713,2024-01-02 21:12:00,29,135,Eletrônico,2,164
2714,2024-01-02 21:13:00,23,112,Móvel,4,135
2715,2024-01-02 21:14:00,16,115,Vestuário,5,131
2716,2024-01-02 21:15:00,74,39,Brinquedo,3,113
2717,2024-01-02 21:16:00,36,159,Móvel,6,195
2718,2024-01-02 21:17:00,25,148,Eletrônico,7,173
2719,2024-01-02 21:18:00,65,35,Alimento,1,100
2720,2024-01-02 21:19:00,94,88,Eletrônico,3,182
2721,2024-01-02 21:20:00,25,117,Brinquedo,9,142
2722,2024-01-02 21:21:00,39,112,Eletrônico,3,151
2723,2024-01-02 21:22:00,32,126,Alimento,2,158
2724,2024-01-02 21:23:00,71,140,Móvel,1,211
2725,2024-01-02 21:24:00,102,59,Brinquedo,2,161
2726,2024-01-02 21:25:00,48,152,Eletrônico,4,200
2727,2024-01-02 21:26:00,35,51,Vestuário,7,86
2728,2024-01-02 21:27:00,118,126,Móvel,9,244
2729,2024-01-02 21:28:00,112,82,Vestuário,9,194
2730,2024-01-02 21:29:00,79,89,Móvel,7,168
2731,2024-01-02 21:30:00,48,176,Alimento,7,224
2732,2024-01-02 21:31:00,59,178,Alimento,6,237
2733,2024-01-02 21:32:00,21,133,Eletrônico,1,154
2734,2024-01-02 21:33:00,31,43,Alimento,5,74
2735,2024-01-02 21:34:00,20,28,Vestuário,6,48
2736,2024-01-02 21:35:00,118,97,Móvel,9,215
2737,2024-01-02 21:36:00,73,100,Vestuário,3,173
2738,2024-01-02 21:37:00,84,74,Eletrônico,4,158
2739,2024-01-02 21:38:00,55,47,Móvel,9,102
2740,2024-01-02 21:39:00,41,78,Brinquedo,5,119
2741,2024-01-02 21:40:00,16,143,Eletrônico,6,159
2742,2024-01-02 21:41:00,26,26,Alimento,6,52
2743,2024-01-02 21:42:00,58,60,Brinquedo,1,118
2744,2024-01-02 21:43:00,44,66,Eletrônico,4,110
2745,2024-01-02 21:44:00,81,16,Alimento,4,97
2746,2024-01-02 21:45:00,51,123,Alimento,2,174
2747,2024-01-02 21:46:00,107,110,Móvel,9,217
2748,2024-01-02 21:47:00,13,77,Alimento,4,90
2749,2024-01-02 21:48:00,37,42,Vestuário,9,79
2750,2024-01-02 21:49:00,109,38,Vestuário,5,147
2751,2024-01-02 21:50:00,24,157,Eletrônico,1,181
2752,2024-01-02 21:51:00,107,157,Eletrônico,9,264
2753,2024-01-02 21:52:00,112,149,Móvel,9,261
2754,2024-01-02 21:53:00,87,123,Brinquedo,4,210
2755,2024-01-02 21:54:00,106,44,Eletrônico,3,150
2756,2024-01-02 21:55:00,22,31,Vestuário,9,53
2757,2024-01-02 21:56:00,72,57,Eletrônico,2,129
2758,2024-01-02 21:57:00,70,171,Brinquedo,2,241
2759,2024-01-02 21:58:00,116,38,Brinquedo,7,154
2760,2024-01-02 21:59:00,31,122,Eletrônico,6,153
2761,2024-01-02 22:00:00,65,23,Eletrônico,6,88
2762,2024-01-02 22:01:00,30,146,Brinquedo,3,176
2763,2024-01-02 22:02:00,56,132,Móvel,2,188
2764,2024-01-02 22:03:00,23,44,Vestuário,6,67
2765,2024-01-02 22:04:00,93,72,Eletrônico,2,165
2766,2024-01-02 22:05:00,93,23,Alimento,8,116
2767,2024-01-02 22:06:00,51,132,Eletrônico,4,183
2768,2024-01-02 22:07:00,23,48,Eletrônico,6,71
2769,2024-01-02 22:08:00,95,120,Eletrônico,3,215
2770,2024-01-02 22:09:00,56,39,Móvel,3,95
2771,2024-01-02 22:10:00,66,15,Vestuário,9,81
2772,2024-01-02 22:11:00,91,26,Brinquedo,9,117
2773,2024-01-02 22:12:00,81,147,Eletrônico,6,228
2774,2024-01-02 22:13:00,27,148,Alimento,7,175
2775,2024-01-02 22:14:00,47,37,Alimento,4,84
2776,2024-01-02 22:15:00,104,90,Móvel,4,194
2777,2024-01-02 22:16:00,34,129,Eletrônico,4,163
2778,2024-01-02 22:17:00,40,75,Vestuário,5,115
2779,2024-01-02 22:18:00,114,117,Vestuário,9,231
2780,2024-01-02 22:19:00,99,51,Vestuário,1,150
2781,2024-01-02 22:20:00,71,121,Vestuário,2,192
2782,2024-01-02 22:21:00,114,138,Móvel,7,252
2783,2024-01-02 22:22:00,59,39,Alimento,5,98
2784,2024-01-02 22:23:00,51,148,Brinquedo,3,199
2785,2024-01-02 22:24:00,28,139,Alimento,2,167
2786,2024-01-02 22:25:00,43,119,Eletrônico,2,162
2787,2024-01-02 22:26:00,73,124,Brinquedo,8,197
2788,2024-01-02 22:27:00,109,88,Móvel,7,197
2789,2024-01-02 22:28:00,74,24,Eletrônico,9,98
2790,2024-01-02 22:29:00,90,43,Eletrônico,7,133
2791,2024-01-02 22:30:00,41,85,Móvel,5,126
2792,2024-01-02 22:31:00,74,117,Brinquedo,1,191
2793,2024-01-02 22:32:00,16,166,Eletrônico,5,182
2794,2024-01-02 22:33:00,105,174,Móvel,2,279
2795,2024-01-02 22:34:00,48,91,Alimento,1,139
2796,2024-01-02 22:35:00,68,53,Vestuário,9,121
2797,2024-01-02 22:36:00,113,35,Eletrônico,8,148
2798,2024-01-02 22:37:00,103,52,Alimento,4,155
2799,2024-01-02 22:38:00,103,63,Eletrônico,2,166
2800,2024-01-02 22:39:00,97,111,Eletrônico,7,208
2801,2024-01-02 22:40:00,110,128,Alimento,8,238
2802,2024-01-02 22:41:00,66,86,Vestuário,2,152
2803,2024-01-02 22:42:00,71,92,Eletrônico,3,163
2804,2024-01-02 22:43:00,89,91,Móvel,8,180
2805,2024-01-02 22:44:00,113,11,Móvel,9,124
2806,2024-01-02 22:45:00,64,73,Alimento,7,137
2807,2024-01-02 22:46:00,103,38,Brinquedo,5,141
2808,2024-01-02 22:47:00,103,58,Móvel,4,161
2809,2024-01-02 22:48:00,91,63,Alimento,9,154
2810,2024-01-02 22:49:00,49,39,Eletrônico,5,88
2811,2024-01-02 22:50:00,38,112,Brinquedo,7,150
2812,2024-01-02 22:51:00,39,81,Alimento,4,120
2813,2024-01-02 22:52:00,80,160,Alimento,9,240
2814,2024-01-02 22:53:00,75,143,Brinquedo,6,218
2815,2024-01-02 22:54:00,11,132,Vestuário,9,143
2816,2024-01-02 22:55:00,80,165,Eletrônico,4,245
2817,2024-01-02 22:56:00,108,104,Móvel,4,212
2818,2024-01-02 22:57:00,21,81,Móvel,2,102
2819,2024-01-02 22:58:00,40,115,Móvel,5,155
2820,2024-01-02 22:59:00,107,134,Eletrônico,9,241
2821,2024-01-02 23:00:00,24,98,Eletrônico,3,122
2822,2024-01-02 23:01:00,97,170,Vestuário,5,267
2823,2024-01-02 23:02:00,114,91,Eletrônico,4,205
2824,2024-01-02 23:03:00,20,39,Móvel,6,59
2825,2024-01-02 23:04:00,40,49,Vestuário,9,89
2826,2024-01-02 23:05:00,73,39,Alimento,9,112
2827,2024-01-02 23:06:00,52,32,Alimento,9,84
2828,2024-01-02 23:07:00,36,79,Móvel,3,115
2829,2024-01-02 23:08:00,35,48,Brinquedo,8,83
2830,2024-01-02 23:09:00,57,68,Alimento,7,125
2831,2024-01-02 23:10:00,64,59,Vestuário,3,123
2832,2024-01-02 23:11:00,80,34,Brinquedo,7,114
2833,2024-01-02 23:12:00,40,141,Brinquedo,3,181
2834,2024-01-02 23:13:00,101,62,Vestuário,9,163
2835,2024-01-02 23:14:00,77,39,Alimento,6,116
2836,2024-01-02 23:15:00,100,179,Alimento,7,279
2837,2024-01-02 23:16:00,112,31,Eletrônico,3,143
2838,2024-01-02 23:17:00,44,158,Vestuário,1,202
2839,2024-01-02 23:18:00,115,43,Eletrônico,3,158
2840,2024-01-02 23:19:00,16,85,Vestuário,1,101
2841,2024-01-02 23:20:00,88,23,Alimento,4,111
2842,2024-01-02 23:21:00,106,153,Brinquedo,5,259
2843,2024-01-02 23:22:00,83,107,Móvel,3,190
2844,2024-01-02 23:23:00,90,25,Móvel,2,115
2845,2024-01-02 23:24:00,25,125,Brinquedo,7,150
2846,2024-01-02 23:25:00,23,123,Móvel,9,146
2847,2024-01-02 23:26:00,92,152,Vestuário,6,244
2848,2024-01-02 23:27:00,95,111,Eletrônico,7,206
2849,2024-01-02 23:28:00,88,47,Vestuário,1,135
2850,2024-01-02 23:29:00,39,106,Eletrônico,1,145
2851,2024-01-02 23:30:00,41,120,Brinquedo,6,161
2852,2024-01-02 23:31:00,52,76,Alimento,7,128
2853,2024-01-02 23:32:00,93,13,Vestuário,8,106
2854,2024-01-02 23:33:00,74,128,Alimento,3,202
2855,2024-01-02 23:34:00,70,132,Vestuário,1,202
2856,2024-01-02 23:35:00,28,117,Brinquedo,3,145
2857,2024-01-02 23:36:00,40,54,Brinquedo,2,94
2858,2024-01-02 23:37:00,47,154,Alimento,9,201
2859,2024-01-02 23:38:00,104,107,Móvel,1,211
2860,2024-01-02 23:39:00,61,82,Alimento,8,143
2861,2024-01-02 23:40:00,105,28,Alimento,8,133
2862,2024-01-02 23:41:00,37,64,Brinquedo,2,101
2863,2024-01-02 23:42:00,89,44,Vestuário,4,133
2864,2024-01-02 23:43:00,116,32,Eletrônico,3,148
2865,2024-01-02 23:44:00,37,40,Brinquedo,6,77
2866,2024-01-02 23:45:00,109,151,Alimento,6,260
2867,2024-01-02 23:46:00,59,118,Brinquedo,3,177
2868,2024-01-02 23:47:00,54,144,Eletrônico,5,198
2869,2024-01-02 23:48:00,90,107,Eletrônico,9,197
2870,2024-01-02 23:49:00,65,21,Vestuário,6,86
2871,2024-01-02 23:50:00,54,98,Alimento,5,152
2872,2024-01-02 23:51:00,25,107,Eletrônico,3,132
2873,2024-01-02 23:52:00,61,39,Alimento,6,100
2874,2024-01-02 23:53:00,57,133,Alimento,9,190
2875,2024-01-02 23:54:00,56,13,Eletrônico,9,69
2876,2024-01-02 23:55:00,99,146,Vestuário,1,245
2877,2024-01-02 23:56:00,48,100,Móvel,1,148
2878,2024-01-02 23:57:00,112,95,Eletrônico,8,207
2879,2024-01-02 23:58:00,67,154,Eletrônico,8,221
2880,2024-01-02 23:59:00,79,157,Eletrônico,3,236
2881,2024-01-03 00:00:00,85,35,Eletrônico,2,120
2882,2024-01-03 00:01:00,118,26,Eletrônico,1,144
2883,2024-01-03 00:02:00,102,79,Brinquedo,6,181
2884,2024-01-03 00:03:00,22,151,Móvel,2,173
2885,2024-01-03 00:04:00,67,97,Eletrônico,3,164
2886,2024-01-03 00:05:00,74,93,Eletrônico,1,167
2887,2024-01-03 00:06:00,38,98,Vestuário,8,136
2888,2024-01-03 00:07:00,72,71,Móvel,2,143
2889,2024-01-03 00:08:00,94,167,Móvel,1,261
2890,2024-01-03 00:09:00,106,165,Alimento,4,271
2891,2024-01-03 00:10:00,49,114,Brinquedo,1,163
2892,2024-01-03 00:11:00,90,159,Eletrônico,8,249
2893,2024-01-03 00:12:00,20,44,Brinquedo,2,64
2894,2024-01-03 00:13:00,38,75,Eletrônico,4,113
2895,2024-01-03 00:14:00,98,115,Alimento,9,213
2896,2024-01-03 00:15:00,39,50,Vestuário,2,89
2897,2024-01-03 00:16:00,42,165,Móvel,8,207
2898,2024-01-03 00:17:00,71,64,Móvel,3,135
2899,2024-01-03 00:18:00,38,174,Móvel,9,212
2900,2024-01-03 00:19:00,55,114,Vestuário,7,169
2901,2024-01-03 00:20:00,96,101,Móvel,9,197
2902,2024-01-03 00:21:00,78,171,Vestuário,6,249
2903,2024-01-03 00:22:00,30,23,Alimento,3,53
2904,2024-01-03 00:23:00,14,171,Alimento,5,185
2905,2024-01-03 00:24:00,77,67,Vestuário,4,144
2906,2024-01-03 00:25:00,64,123,Vestuário,2,187
2907,2024-01-03 00:26:00,110,112,Brinquedo,2,222
2908,2024-01-03 00:27:00,15,175,Brinquedo,2,190
2909,2024-01-03 00:28:00,85,141,Eletrônico,5,226
2910,2024-01-03 00:29:00,36,58,Vestuário,3,94
2911,2024-01-03 00:30:00,39,129,Alimento,2,168
2912,2024-01-03 00:31:00,91,104,Brinquedo,5,195
2913,2024-01-03 00:32:00,18,104,Brinquedo,4,122
2914,2024-01-03 00:33:00,29,47,Móvel,9,76
2915,2024-01-03 00:34:00,100,156,Eletrônico,5,256
2916,2024-01-03 00:35:00,109,141,Eletrônico,4,250
2917,2024-01-03 00:36:00,102,131,Brinquedo,4,233
2918,2024-01-03 00:37:00,60,82,Brinquedo,6,142
2919,2024-01-03 00:38:00,119,170,Brinquedo,4,289
2920,2024-01-03 00:39:00,59,167,Brinquedo,7,226
2921,2024-01-03 00:40:00,14,151,Alimento,7,165
2922,2024-01-03 00:41:00,20,55,Alimento,9,75
2923,2024-01-03 00:42:00,20,52,Alimento,4,72
2924,2024-01-03 00:43:00,90,95,Brinquedo,8,185
2925,2024-01-03 00:44:00,25,161,Alimento,5,186
2926,2024-01-03 00:45:00,59,38,Móvel,5,97
2927,2024-01-03 00:46:00,15,141,Eletrônico,5,156
2928,2024-01-03 00:47:00,58,145,Vestuário,2,203
2929,2024-01-03 00:48:00,104,143,Móvel,6,247
2930,2024-01-03 00:49:00,62,23,Móvel,7,85
2931,2024-01-03 00:50:00,36,119,Eletrônico,1,155
2932,2024-01-03 00:51:00,92,125,Vestuário,3,217
2933,2024-01-03 00:52:00,114,48,Alimento,4,162
2934,2024-01-03 00:53:00,107,43,Eletrônico,1,150
2935,2024-01-03 00:54:00,87,98,Brinquedo,9,185
2936,2024-01-03 00:55:00,86,148,Eletrônico,6,234
2937,2024-01-03 00:56:00,57,152,Vestuário,5,209
2938,2024-01-03 00:57:00,13,159,Eletrônico,6,172
2939,2024-01-03 00:58:00,30,139,Móvel,5,169
2940,2024-01-03 00:59:00,39,107,Eletrônico,5,146
2941,2024-01-03 01:00:00,79,156,Brinquedo,7,235
2942,2024-01-03 01:01:00,32,23,Móvel,4,55
2943,2024-01-03 01:02:00,89,51,Móvel,7,140
2944,2024-01-03 01:03:00,43,125,Brinquedo,2,168
2945,2024-01-03 01:04:00,61,57,Brinquedo,9,118
2946,2024-01-03 01:05:00,112,94,Móvel,9,206
2947,2024-01-03 01:06:00,104,116,Móvel,8,220
2948,2024-01-03 01:07:00,17,52,Móvel,1,69
2949,2024-01-03 01:08:00,13,133,Alimento,7,146
2950,2024-01-03 01:09:00,66,59,Eletrônico,1,125
2951,2024-01-03 01:10:00,55,119,Vestuário,2,174
2952,2024-01-03 01:11:00,117,120,Brinquedo,5,237
2953,2024-01-03 01:12:00,66,31,Vestuário,7,97
2954,2024-01-03 01:13:00,83,51,Móvel,9,134
2955,2024-01-03 01:14:00,88,63,Vestuário,6,151
2956,2024-01-03 01:15:00,104,78,Móvel,8,182
2957,2024-01-03 01:16:00,119,51,Móvel,3,170
2958,2024-01-03 01:17:00,117,81,Alimento,8,198
2959,2024-01-03 01:18:00,96,78,Alimento,8,174
2960,2024-01-03 01:19:00,60,119,Alimento,5,179
2961,2024-01-03 01:20:00,68,81,Alimento,8,149
2962,2024-01-03 01:21:00,78,90,Móvel,8,168
2963,2024-01-03 01:22:00,87,42,Vestuário,2,129
2964,2024-01-03 01:23:00,17,77,Brinquedo,4,94
2965,2024-01-03 01:24:00,15,160,Móvel,1,175
2966,2024-01-03 01:25:00,72,21,Brinquedo,9,93
2967,2024-01-03 01:26:00,116,59,Vestuário,5,175
2968,2024-01-03 01:27:00,26,118,Móvel,5,144
2969,2024-01-03 01:28:00,79,94,Brinquedo,1,173
2970,2024-01-03 01:29:00,61,152,Móvel,2,213
2971,2024-01-03 01:30:00,67,114,Móvel,1,181
2972,2024-01-03 01:31:00,117,40,Brinquedo,9,157
2973,2024-01-03 01:32:00,55,178,Móvel,3,233
2974,2024-01-03 01:33:00,41,90,Vestuário,2,131
2975,2024-01-03 01:34:00,86,116,Eletrônico,9,202
2976,2024-01-03 01:35:00,31,71,Eletrônico,5,102
2977,2024-01-03 01:36:00,89,113,Brinquedo,5,202
2978,2024-01-03 01:37:00,38,113,Móvel,2,151
2979,2024-01-03 01:38:00,70,152,Móvel,7,222
2980,2024-01-03 01:39:00,37,29,Móvel,1,66
2981,2024-01-03 01:40:00,85,28,Vestuário,1,113
2982,2024-01-03 01:41:00,38,116,Alimento,1,154
2983,2024-01-03 01:42:00,57,110,Eletrônico,5,167
2984,2024-01-03 01:43:00,63,30,Brinquedo,3,93
2985,2024-01-03 01:44:00,59,62,Brinquedo,3,121
2986,2024-01-03 01:45:00,92,18,Alimento,4,110
2987,2024-01-03 01:46:00,108,156,Brinquedo,2,264
2988,2024-01-03 01:47:00,28,98,Vestuário,1,126
2989,2024-01-03 01:48:00,50,138,Brinquedo,4,188
2990,2024-01-03 01:49:00,115,97,Móvel,5,212
2991,2024-01-03 01:50:00,118,147,Vestuário,8,265
2992,2024-01-03 01:51:00,110,48,Alimento,2,158
2993,2024-01-03 01:52:00,97,70,Vestuário,6,167
2994,2024-01-03 01:53:00,54,108,Móvel,8,162
2995,2024-01-03 01:54:00,96,16,Eletrônico,3,112
2996,2024-01-03 01:55:00,105,43,Móvel,6,148
2997,2024-01-03 01:56:00,65,179,Brinquedo,3,244
2998,2024-01-03 01:57:00,69,77,Alimento,8,146
2999,2024-01-03 01:58:00,33,174,Vestuário,7,207
3000,2024-01-03 01:59:00,31,134,Alimento,5,165
3001,2024-01-03 02:00:00,50,70,Vestuário,3,120
3002,2024-01-03 02:01:00,20,72,Vestuário,6,92
3003,2024-01-03 02:02:00,59,117,Vestuário,2,176
3004,2024-01-03 02:03:00,104,97,Brinquedo,4,201
3005,2024-01-03 02:04:00,17,68,Brinquedo,8,85
3006,2024-01-03 02:05:00,38,90,Vestuário,8,128
3007,2024-01-03 02:06:00,79,47,Brinquedo,6,126
3008,2024-01-03 02:07:00,53,162,Brinquedo,9,215
3009,2024-01-03 02:08:00,108,97,Móvel,4,205
3010,2024-01-03 02:09:00,22,54,Alimento,5,76
3011,2024-01-03 02:10:00,16,13,Brinquedo,6,29
3012,2024-01-03 02:11:00,20,53,Alimento,5,73
3013,2024-01-03 02:12:00,112,141,Brinquedo,3,253
3014,2024-01-03 02:13:00,24,174,Móvel,5,198
3015,2024-01-03 02:14:00,33,73,Móvel,4,106
3016,2024-01-03 02:15:00,75,178,Vestuário,4,253
3017,2024-01-03 02:16:00,94,111,Móvel,4,205
3018,2024-01-03 02:17:00,111,11,Vestuário,9,122
3019,2024-01-03 02:18:00,28,110,Vestuário,3,138
3020,2024-01-03 02:19:00,35,131,Brinquedo,1,166
3021,2024-01-03 02:20:00,38,12,Vestuário,1,50
3022,2024-01-03 02:21:00,22,128,Móvel,6,150
3023,2024-01-03 02:22:00,111,31,Alimento,3,142
3024,2024-01-03 02:23:00,17,72,Alimento,6,89
3025,2024-01-03 02:24:00,119,93,Móvel,6,212
3026,2024-01-03 02:25:00,58,85,Alimento,7,143
3027,2024-01-03 02:26:00,58,150,Móvel,9,208
3028,2024-01-03 02:27:00,32,149,Móvel,6,181
3029,2024-01-03 02:28:00,94,42,Vestuário,5,136
3030,2024-01-03 02:29:00,26,93,Vestuário,7,119
3031,2024-01-03 02:30:00,38,34,Vestuário,5,72
3032,2024-01-03 02:31:00,69,52,Brinquedo,3,121
3033,2024-01-03 02:32:00,98,137,Móvel,2,235
3034,2024-01-03 02:33:00,13,20,Alimento,1,33
3035,2024-01-03 02:34:00,59,31,Alimento,9,90
3036,2024-01-03 02:35:00,75,148,Móvel,4,223
3037,2024-01-03 02:36:00,70,75,Eletrônico,2,145
3038,2024-01-03 02:37:00,42,104,Eletrônico,7,146
3039,2024-01-03 02:38:00,24,78,Móvel,5,102
3040,2024-01-03 02:39:00,79,165,Brinquedo,9,244
3041,2024-01-03 02:40:00,44,30,Vestuário,4,74
3042,2024-01-03 02:41:00,61,49,Móvel,8,110
3043,2024-01-03 02:42:00,67,39,Eletrônico,6,106
3044,2024-01-03 02:43:00,95,121,Brinquedo,1,216
3045,2024-01-03 02:44:00,30,147,Vestuário,7,177
3046,2024-01-03 02:45:00,119,142,Eletrônico,9,261
3047,2024-01-03 02:46:00,70,169,Vestuário,8,239
3048,2024-01-03 02:47:00,89,109,Brinquedo,6,198
3049,2024-01-03 02:48:00,57,179,Alimento,8,236
3050,2024-01-03 02:49:00,29,43,Vestuário,4,72
3051,2024-01-03 02:50:00,88,59,Eletrônico,5,147
3052,2024-01-03 02:51:00,95,125,Alimento,9,220
3053,2024-01-03 02:52:00,10,164,Eletrônico,6,174
3054,2024-01-03 02:53:00,77,91,Brinquedo,3,168
3055,2024-01-03 02:54:00,92,18,Alimento,9,110
3056,2024-01-03 02:55:00,45,129,Alimento,3,174
3057,2024-01-03 02:56:00,118,179,Móvel,8,297
3058,2024-01-03 02:57:00,96,82,Móvel,2,178
3059,2024-01-03 02:58:00,46,62,Brinquedo,8,108
3060,2024-01-03 02:59:00,118,112,Alimento,9,230
3061,2024-01-03 03:00:00,119,27,Vestuário,8,146
3062,2024-01-03 03:01:00,46,106,Alimento,8,152
3063,2024-01-03 03:02:00,27,64,Eletrônico,6,91
3064,2024-01-03 03:03:00,52,130,Brinquedo,1,182
3065,2024-01-03 03:04:00,112,70,Vestuário,2,182
3066,2024-01-03 03:05:00,39,74,Brinquedo,4,113
3067,2024-01-03 03:06:00,111,20,Alimento,1,131
3068,2024-01-03 03:07:00,24,12,Eletrônico,4,36
3069,2024-01-03 03:08:00,54,24,Vestuário,3,78
3070,2024-01-03 03:09:00,57,105,Vestuário,8,162
3071,2024-01-03 03:10:00,17,79,Alimento,6,96
3072,2024-01-03 03:11:00,28,105,Vestuário,5,133
3073,2024-01-03 03:12:00,35,89,Alimento,8,124
3074,2024-01-03 03:13:00,23,88,Brinquedo,6,111
3075,2024-01-03 03:14:00,39,35,Móvel,5,74
3076,2024-01-03 03:15:00,13,43,Móvel,3,56
3077,2024-01-03 03:16:00,24,157,Alimento,8,181
3078,2024-01-03 03:17:00,31,40,Eletrônico,3,71
3079,2024-01-03 03:18:00,114,146,Vestuário,4,260
3080,2024-01-03 03:19:00,83,95,Vestuário,9,178
3081,2024-01-03 03:20:00,90,15,Brinquedo,7,105
3082,2024-01-03 03:21:00,97,17,Alimento,4,114
3083,2024-01-03 03:22:00,89,155,Brinquedo,8,244
3084,2024-01-03 03:23:00,82,102,Brinquedo,1,184
3085,2024-01-03 03:24:00,60,112,Vestuário,8,172
3086,2024-01-03 03:25:00,95,125,Eletrônico,7,220
3087,2024-01-03 03:26:00,21,122,Brinquedo,7,143
3088,2024-01-03 03:27:00,57,64,Eletrônico,3,121
3089,2024-01-03 03:28:00,90,173,Brinquedo,9,263
3090,2024-01-03 03:29:00,73,111,Vestuário,9,184
3091,2024-01-03 03:30:00,32,172,Alimento,5,204
3092,2024-01-03 03:31:00,75,101,Brinquedo,9,176
3093,2024-01-03 03:32:00,64,19,Brinquedo,2,83
3094,2024-01-03 03:33:00,44,93,Móvel,8,137
3095,2024-01-03 03:34:00,11,102,Móvel,2,113
3096,2024-01-03 03:35:00,91,117,Vestuário,6,208
3097,2024-01-03 03:36:00,10,71,Eletrônico,9,81
3098,2024-01-03 03:37:00,59,98,Alimento,1,157
3099,2024-01-03 03:38:00,53,46,Vestuário,5,99
3100,2024-01-03 03:39:00,46,13,Vestuário,8,59
3101,2024-01-03 03:40:00,59,120,Móvel,1,179
3102,2024-01-03 03:41:00,77,137,Vestuário,2,214
3103,2024-01-03 03:42:00,96,149,Alimento,3,245
3104,2024-01-03 03:43:00,84,94,Móvel,3,178
3105,2024-01-03 03:44:00,46,148,Móvel,3,194
3106,2024-01-03 03:45:00,11,76,Alimento,5,87
3107,2024-01-03 03:46:00,23,165,Vestuário,6,188
3108,2024-01-03 03:47:00,99,88,Brinquedo,1,187
3109,2024-01-03 03:48:00,19,151,Brinquedo,3,170
3110,2024-01-03 03:49:00,65,160,Eletrônico,6,225
3111,2024-01-03 03:50:00,45,117,Alimento,9,162
3112,2024-01-03 03:51:00,52,107,Brinquedo,9,159
3113,2024-01-03 03:52:00,116,10,Eletrônico,2,126
3114,2024-01-03 03:53:00,60,132,Vestuário,2,192
3115,2024-01-03 03:54:00,88,73,Alimento,6,161
3116,2024-01-03 03:55:00,63,139,Alimento,1,202
3117,2024-01-03 03:56:00,69,22,Eletrônico,8,91
3118,2024-01-03 03:57:00,79,140,Móvel,6,219
3119,2024-01-03 03:58:00,60,40,Vestuário,7,100
3120,2024-01-03 03:59:00,55,41,Vestuário,4,96
3121,2024-01-03 04:00:00,111,76,Alimento,6,187
3122,2024-01-03 04:01:00,62,64,Eletrônico,8,126
3123,2024-01-03 04:02:00,34,38,Brinquedo,7,72
3124,2024-01-03 04:03:00,20,50,Vestuário,8,70
3125,2024-01-03 04:04:00,88,35,Eletrônico,7,123
3126,2024-01-03 04:05:00,59,124,Brinquedo,3,183
3127,2024-01-03 04:06:00,114,134,Brinquedo,8,248
3128,2024-01-03 04:07:00,110,153,Eletrônico,9,263
3129,2024-01-03 04:08:00,114,69,Brinquedo,4,183
3130,2024-01-03 04:09:00,44,148,Vestuário,8,192
3131,2024-01-03 04:10:00,15,45,Alimento,2,60
3132,2024-01-03 04:11:00,10,46,Eletrônico,5,56
3133,2024-01-03 04:12:00,75,11,Móvel,5,86
3134,2024-01-03 04:13:00,96,67,Móvel,7,163
3135,2024-01-03 04:14:00,47,82,Vestuário,2,129
3136,2024-01-03 04:15:00,67,21,Eletrônico,5,88
3137,2024-01-03 04:16:00,19,62,Móvel,8,81
3138,2024-01-03 04:17:00,106,157,Alimento,3,263
3139,2024-01-03 04:18:00,57,85,Vestuário,8,142
3140,2024-01-03 04:19:00,52,151,Brinquedo,8,203
3141,2024-01-03 04:20:00,79,58,Eletrônico,2,137
3142,2024-01-03 04:21:00,61,79,Brinquedo,8,140
3143,2024-01-03 04:22:00,28,36,Eletrônico,7,64
3144,2024-01-03 04:23:00,78,91,Vestuário,7,169
3145,2024-01-03 04:24:00,104,49,Vestuário,1,153
3146,2024-01-03 04:25:00,96,63,Brinquedo,3,159
3147,2024-01-03 04:26:00,75,166,Móvel,2,241
3148,2024-01-03 04:27:00,62,138,Vestuário,8,200
3149,2024-01-03 04:28:00,65,72,Eletrônico,1,137
3150,2024-01-03 04:29:00,17,144,Alimento,3,161
3151,2024-01-03 04:30:00,113,109,Móvel,3,222
3152,2024-01-03 04:31:00,64,35,Móvel,5,99
3153,2024-01-03 04:32:00,107,170,Móvel,2,277
3154,2024-01-03 04:33:00,55,145,Vestuário,2,200
3155,2024-01-03 04:34:00,30,164,Vestuário,1,194
3156,2024-01-03 04:35:00,103,122,Brinquedo,6,225
3157,2024-01-03 04:36:00,41,33,Alimento,6,74
3158,2024-01-03 04:37:00,13,111,Alimento,6,124
3159,2024-01-03 04:38:00,45,170,Vestuário,6,215
3160,2024-01-03 04:39:00,57,158,Alimento,4,215
3161,2024-01-03 04:40:00,47,74,Brinquedo,3,121
3162,2024-01-03 04:41:00,56,106,Móvel,2,162
3163,2024-01-03 04:42:00,113,12,Vestuário,3,125
3164,2024-01-03 04:43:00,57,103,Vestuário,8,160
3165,2024-01-03 04:44:00,116,143,Alimento,1,259
3166,2024-01-03 04:45:00,69,71,Móvel,5,140
3167,2024-01-03 04:46:00,60,114,Eletrônico,3,174
3168,2024-01-03 04:47:00,70,118,Brinquedo,7,188
3169,2024-01-03 04:48:00,78,166,Alimento,2,244
3170,2024-01-03 04:49:00,65,86,Brinquedo,5,151
3171,2024-01-03 04:50:00,16,136,Móvel,6,152
3172,2024-01-03 04:51:00,70,52,Eletrônico,4,122
3173,2024-01-03 04:52:00,69,115,Eletrônico,4,184
3174,2024-01-03 04:53:00,113,151,Eletrônico,1,264
3175,2024-01-03 04:54:00,80,172,Vestuário,1,252
3176,2024-01-03 04:55:00,109,56,Vestuário,5,165
3177,2024-01-03 04:56:00,117,45,Vestuário,1,162
3178,2024-01-03 04:57:00,10,18,Eletrônico,2,28
3179,2024-01-03 04:58:00,81,79,Eletrônico,4,160
3180,2024-01-03 04:59:00,16,62,Móvel,2,78
3181,2024-01-03 05:00:00,35,97,Brinquedo,4,132
3182,2024-01-03 05:01:00,39,129,Móvel,4,168
3183,2024-01-03 05:02:00,69,127,Eletrônico,8,196
3184,2024-01-03 05:03:00,39,137,Brinquedo,1,176
3185,2024-01-03 05:04:00,27,11,Vestuário,9,38
3186,2024-01-03 05:05:00,73,78,Brinquedo,7,151
3187,2024-01-03 05:06:00,26,141,Alimento,4,167
3188,2024-01-03 05:07:00,22,119,Eletrônico,4,141
3189,2024-01-03 05:08:00,75,130,Brinquedo,3,205
3190,2024-01-03 05:09:00,97,26,Eletrônico,7,123
3191,2024-01-03 05:10:00,31,67,Alimento,1,98
3192,2024-01-03 05:11:00,116,92,Brinquedo,2,208
3193,2024-01-03 05:12:00,102,49,Brinquedo,5,151
3194,2024-01-03 05:13:00,69,44,Brinquedo,6,113
3195,2024-01-03 05:14:00,30,63,Vestuário,9,93
3196,2024-01-03 05:15:00,27,54,Eletrônico,8,81
3197,2024-01-03 05:16:00,57,104,Vestuário,1,161
3198,2024-01-03 05:17:00,102,65,Eletrônico,4,167
3199,2024-01-03 05:18:00,86,47,Alimento,7,133
3200,2024-01-03 05:19:00,14,19,Vestuário,7,33
3201,2024-01-03 05:20:00,13,146,Alimento,4,159
3202,2024-01-03 05:21:00,80,32,Brinquedo,3,112
3203,2024-01-03 05:22:00,54,46,Brinquedo,3,100
3204,2024-01-03 05:23:00,100,78,Brinquedo,3,178
3205,2024-01-03 05:24:00,115,143,Eletrônico,3,258
3206,2024-01-03 05:25:00,22,151,Vestuário,2,173
3207,2024-01-03 05:26:00,19,146,Vestuário,1,165
3208,2024-01-03 05:27:00,108,130,Brinquedo,4,238
3209,2024-01-03 05:28:00,28,53,Brinquedo,5,81
3210,2024-01-03 05:29:00,114,108,Eletrônico,6,222
3211,2024-01-03 05:30:00,67,116,Vestuário,1,183
3212,2024-01-03 05:31:00,22,179,Brinquedo,3,201
3213,2024-01-03 05:32:00,81,41,Móvel,2,122
3214,2024-01-03 05:33:00,47,129,Alimento,7,176
3215,2024-01-03 05:34:00,32,126,Alimento,7,158
3216,2024-01-03 05:35:00,34,125,Vestuário,5,159
3217,2024-01-03 05:36:00,86,45,Eletrônico,1,131
3218,2024-01-03 05:37:00,119,149,Eletrônico,5,268
3219,2024-01-03 05:38:00,50,168,Brinquedo,6,218
3220,2024-01-03 05:39:00,95,96,Móvel,6,191
3221,2024-01-03 05:40:00,36,169,Alimento,1,205
3222,2024-01-03 05:41:00,110,64,Alimento,6,174
3223,2024-01-03 05:42:00,85,32,Brinquedo,3,117
3224,2024-01-03 05:43:00,96,127,Móvel,6,223
3225,2024-01-03 05:44:00,82,146,Brinquedo,4,228
3226,2024-01-03 05:45:00,21,19,Brinquedo,7,40
3227,2024-01-03 05:46:00,43,16,Alimento,7,59
3228,2024-01-03 05:47:00,14,64,Móvel,9,78
3229,2024-01-03 05:48:00,72,170,Eletrônico,9,242
3230,2024-01-03 05:49:00,64,163,Alimento,4,227
3231,2024-01-03 05:50:00,119,80,Eletrônico,7,199
3232,2024-01-03 05:51:00,92,152,Móvel,7,244
3233,2024-01-03 05:52:00,84,35,Alimento,3,119
3234,2024-01-03 05:53:00,88,81,Brinquedo,7,169
3235,2024-01-03 05:54:00,42,41,Alimento,2,83
3236,2024-01-03 05:55:00,87,15,Móvel,4,102
3237,2024-01-03 05:56:00,79,102,Eletrônico,8,181
3238,2024-01-03 05:57:00,99,73,Móvel,2,172
3239,2024-01-03 05:58:00,65,134,Brinquedo,5,199
3240,2024-01-03 05:59:00,108,87,Alimento,3,195
3241,2024-01-03 06:00:00,117,124,Eletrônico,6,241
3242,2024-01-03 06:01:00,17,63,Alimento,5,80
3243,2024-01-03 06:02:00,32,156,Alimento,1,188
3244,2024-01-03 06:03:00,77,102,Eletrônico,8,179
3245,2024-01-03 06:04:00,87,79,Móvel,5,166
3246,2024-01-03 06:05:00,56,68,Brinquedo,1,124
3247,2024-01-03 06:06:00,34,12,Eletrônico,4,46
3248,2024-01-03 06:07:00,27,28,Vestuário,3,55
3249,2024-01-03 06:08:00,114,133,Vestuário,1,247
3250,2024-01-03 06:09:00,28,127,Alimento,9,155
3251,2024-01-03 06:10:00,60,109,Móvel,2,169
3252,2024-01-03 06:11:00,92,16,Móvel,2,108
3253,2024-01-03 06:12:00,92,88,Vestuário,6,180
3254,2024-01-03 06:13:00,57,95,Brinquedo,7,152
3255,2024-01-03 06:14:00,14,104,Alimento,6,118
3256,2024-01-03 06:15:00,54,176,Móvel,2,230
3257,2024-01-03 06:16:00,104,159,Brinquedo,1,263
3258,2024-01-03 06:17:00,20,174,Eletrônico,4,194
3259,2024-01-03 06:18:00,118,33,Vestuário,2,151
3260,2024-01-03 06:19:00,101,151,Alimento,6,252
3261,2024-01-03 06:20:00,58,166,Eletrônico,6,224
3262,2024-01-03 06:21:00,79,70,Alimento,4,149
3263,2024-01-03 06:22:00,72,113,Alimento,4,185
3264,2024-01-03 06:23:00,92,77,Alimento,9,169
3265,2024-01-03 06:24:00,35,112,Brinquedo,9,147
3266,2024-01-03 06:25:00,105,83,Eletrônico,3,188
3267,2024-01-03 06:26:00,117,151,Vestuário,6,268
3268,2024-01-03 06:27:00,97,39,Eletrônico,3,136
3269,2024-01-03 06:28:00,36,107,Eletrônico,7,143
3270,2024-01-03 06:29:00,97,153,Brinquedo,5,250
3271,2024-01-03 06:30:00,105,73,Eletrônico,6,178
3272,2024-01-03 06:31:00,26,27,Vestuário,6,53
3273,2024-01-03 06:32:00,10,143,Vestuário,3,153
3274,2024-01-03 06:33:00,27,59,Alimento,5,86
3275,2024-01-03 06:34:00,72,74,Eletrônico,1,146
3276,2024-01-03 06:35:00,39,155,Brinquedo,6,194
3277,2024-01-03 06:36:00,76,43,Móvel,4,119
3278,2024-01-03 06:37:00,65,147,Eletrônico,9,212
3279,2024-01-03 06:38:00,69,105,Eletrônico,3,174
3280,2024-01-03 06:39:00,116,47,Brinquedo,4,163
3281,2024-01-03 06:40:00,15,110,Alimento,8,125
3282,2024-01-03 06:41:00,22,139,Móvel,6,161
3283,2024-01-03 06:42:00,42,162,Alimento,1,204
3284,2024-01-03 06:43:00,54,175,Brinquedo,6,229
3285,2024-01-03 06:44:00,15,78,Brinquedo,7,93
3286,2024-01-03 06:45:00,35,176,Brinquedo,4,211
3287,2024-01-03 06:46:00,116,27,Vestuário,5,143
3288,2024-01-03 06:47:00,84,50,Alimento,9,134
3289,2024-01-03 06:48:00,97,101,Brinquedo,2,198
3290,2024-01-03 06:49:00,117,35,Brinquedo,2,152
3291,2024-01-03 06:50:00,101,128,Brinquedo,6,229
3292,2024-01-03 06:51:00,33,97,Alimento,7,130
3293,2024-01-03 06:52:00,35,66,Móvel,8,101
3294,2024-01-03 06:53:00,43,87,Eletrônico,5,130
3295,2024-01-03 06:54:00,82,92,Brinquedo,2,174
3296,2024-01-03 06:55:00,87,169,Eletrônico,8,256
3297,2024-01-03 06:56:00,105,177,Eletrônico,6,282
3298,2024-01-03 06:57:00,93,11,Vestuário,8,104
3299,2024-01-03 06:58:00,76,54,Eletrônico,4,130
3300,2024-01-03 06:59:00,70,141,Móvel,6,211
3301,2024-01-03 07:00:00,22,147,Móvel,4,169
3302,2024-01-03 07:01:00,87,102,Vestuário,2,189
3303,2024-01-03 07:02:00,59,58,Móvel,8,117
3304,2024-01-03 07:03:00,39,31,Eletrônico,3,70
3305,2024-01-03 07:04:00,74,62,Eletrônico,6,136
3306,2024-01-03 07:05:00,101,63,Brinquedo,4,164
3307,2024-01-03 07:06:00,85,127,Eletrônico,8,212
3308,2024-01-03 07:07:00,40,130,Alimento,8,170
3309,2024-01-03 07:08:00,107,115,Brinquedo,9,222
3310,2024-01-03 07:09:00,116,52,Eletrônico,2,168
3311,2024-01-03 07:10:00,45,61,Brinquedo,8,106
3312,2024-01-03 07:11:00,97,41,Móvel,7,138
3313,2024-01-03 07:12:00,27,41,Brinquedo,1,68
3314,2024-01-03 07:13:00,40,24,Brinquedo,2,64
3315,2024-01-03 07:14:00,82,159,Alimento,4,241
3316,2024-01-03 07:15:00,94,28,Vestuário,5,122
3317,2024-01-03 07:16:00,70,26,Vestuário,2,96
3318,2024-01-03 07:17:00,42,28,Vestuário,2,70
3319,2024-01-03 07:18:00,44,44,Vestuário,3,88
3320,2024-01-03 07:19:00,35,108,Alimento,9,143
3321,2024-01-03 07:20:00,103,112,Vestuário,5,215
3322,2024-01-03 07:21:00,29,103,Vestuário,1,132
3323,2024-01-03 07:22:00,83,155,Alimento,2,238
3324,2024-01-03 07:23:00,90,70,Móvel,9,160
3325,2024-01-03 07:24:00,10,158,Alimento,8,168
3326,2024-01-03 07:25:00,26,34,Alimento,1,60
3327,2024-01-03 07:26:00,13,134,Vestuário,5,147
3328,2024-01-03 07:27:00,58,49,Vestuário,1,107
3329,2024-01-03 07:28:00,77,116,Vestuário,1,193
3330,2024-01-03 07:29:00,95,55,Eletrônico,3,150
3331,2024-01-03 07:30:00,44,17,Móvel,8,61
3332,2024-01-03 07:31:00,108,48,Alimento,8,156
3333,2024-01-03 07:32:00,48,141,Móvel,5,189
3334,2024-01-03 07:33:00,80,165,Vestuário,7,245
3335,2024-01-03 07:34:00,109,47,Eletrônico,2,156
3336,2024-01-03 07:35:00,119,75,Vestuário,2,194
3337,2024-01-03 07:36:00,108,123,Alimento,6,231
3338,2024-01-03 07:37:00,45,143,Brinquedo,9,188
3339,2024-01-03 07:38:00,51,133,Vestuário,6,184
3340,2024-01-03 07:39:00,107,106,Eletrônico,4,213
3341,2024-01-03 07:40:00,15,67,Móvel,5,82
3342,2024-01-03 07:41:00,119,111,Vestuário,7,230
3343,2024-01-03 07:42:00,19,24,Móvel,6,43
3344,2024-01-03 07:43:00,104,177,Eletrônico,3,281
3345,2024-01-03 07:44:00,98,38,Vestuário,7,136
3346,2024-01-03 07:45:00,60,95,Alimento,5,155
3347,2024-01-03 07:46:00,55,88,Eletrônico,9,143
3348,2024-01-03 07:47:00,85,155,Eletrônico,5,240
3349,2024-01-03 07:48:00,19,158,Brinquedo,6,177
3350,2024-01-03 07:49:00,70,99,Vestuário,4,169
3351,2024-01-03 07:50:00,77,165,Alimento,1,242
3352,2024-01-03 07:51:00,87,135,Vestuário,1,222
3353,2024-01-03 07:52:00,16,36,Brinquedo,2,52
3354,2024-01-03 07:53:00,49,55,Alimento,5,104
3355,2024-01-03 07:54:00,78,122,Brinquedo,9,200
3356,2024-01-03 07:55:00,114,121,Alimento,8,235
3357,2024-01-03 07:56:00,45,109,Brinquedo,2,154
3358,2024-01-03 07:57:00,30,165,Brinquedo,9,195
3359,2024-01-03 07:58:00,61,150,Eletrônico,8,211
3360,2024-01-03 07:59:00,80,112,Móvel,4,192
3361,2024-01-03 08:00:00,92,79,Brinquedo,6,171
3362,2024-01-03 08:01:00,111,174,Móvel,8,285
3363,2024-01-03 08:02:00,79,10,Móvel,5,89
3364,2024-01-03 08:03:00,36,61,Brinquedo,9,97
3365,2024-01-03 08:04:00,24,64,Alimento,4,88
3366,2024-01-03 08:05:00,54,28,Eletrônico,3,82
3367,2024-01-03 08:06:00,16,124,Vestuário,4,140
3368,2024-01-03 08:07:00,37,100,Móvel,1,137
3369,2024-01-03 08:08:00,98,149,Brinquedo,5,247
3370,2024-01-03 08:09:00,30,163,Brinquedo,4,193
3371,2024-01-03 08:10:00,41,169,Alimento,9,210
3372,2024-01-03 08:11:00,50,23,Brinquedo,8,73
3373,2024-01-03 08:12:00,28,21,Móvel,4,49
3374,2024-01-03 08:13:00,43,139,Alimento,2,182
3375,2024-01-03 08:14:00,90,105,Brinquedo,4,195
3376,2024-01-03 08:15:00,65,38,Eletrônico,1,103
3377,2024-01-03 08:16:00,105,95,Brinquedo,1,200
3378,2024-01-03 08:17:00,33,110,Alimento,2,143
3379,2024-01-03 08:18:00,63,116,Brinquedo,6,179
3380,2024-01-03 08:19:00,51,118,Móvel,1,169
3381,2024-01-03 08:20:00,39,176,Brinquedo,4,215
3382,2024-01-03 08:21:00,98,156,Eletrônico,9,254
3383,2024-01-03 08:22:00,49,11,Móvel,3,60
3384,2024-01-03 08:23:00,15,164,Móvel,3,179
3385,2024-01-03 08:24:00,58,84,Vestuário,3,142
3386,2024-01-03 08:25:00,95,175,Brinquedo,3,270
3387,2024-01-03 08:26:00,49,41,Alimento,3,90
3388,2024-01-03 08:27:00,106,36,Móvel,6,142
3389,2024-01-03 08:28:00,43,155,Brinquedo,9,198
3390,2024-01-03 08:29:00,92,95,Alimento,7,187
3391,2024-01-03 08:30:00,74,147,Brinquedo,5,221
3392,2024-01-03 08:31:00,21,173,Eletrônico,9,194
3393,2024-01-03 08:32:00,37,162,Alimento,3,199
3394,2024-01-03 08:33:00,12,57,Vestuário,7,69
3395,2024-01-03 08:34:00,114,104,Eletrônico,6,218
3396,2024-01-03 08:35:00,58,69,Eletrônico,6,127
3397,2024-01-03 08:36:00,39,159,Móvel,1,198
3398,2024-01-03 08:37:00,21,12,Eletrônico,2,33
3399,2024-01-03 08:38:00,117,166,Alimento,7,283
3400,2024-01-03 08:39:00,50,110,Vestuário,2,160
3401,2024-01-03 08:40:00,38,123,Vestuário,3,161
3402,2024-01-03 08:41:00,74,112,Brinquedo,6,186
3403,2024-01-03 08:42:00,27,159,Móvel,4,186
3404,2024-01-03 08:43:00,39,65,Alimento,4,104
3405,2024-01-03 08:44:00,27,24,Brinquedo,5,51
3406,2024-01-03 08:45:00,47,50,Brinquedo,1,97
3407,2024-01-03 08:46:00,13,52,Eletrônico,2,65
3408,2024-01-03 08:47:00,63,111,Móvel,5,174
3409,2024-01-03 08:48:00,78,110,Eletrônico,9,188
3410,2024-01-03 08:49:00,17,164,Vestuário,8,181
3411,2024-01-03 08:50:00,105,76,Alimento,7,181
3412,2024-01-03 08:51:00,88,13,Alimento,4,101
3413,2024-01-03 08:52:00,106,26,Brinquedo,7,132
3414,2024-01-03 08:53:00,99,42,Brinquedo,2,141
3415,2024-01-03 08:54:00,42,70,Eletrônico,2,112
3416,2024-01-03 08:55:00,108,55,Alimento,2,163
3417,2024-01-03 08:56:00,118,177,Móvel,6,295
3418,2024-01-03 08:57:00,23,127,Vestuário,8,150
3419,2024-01-03 08:58:00,102,28,Móvel,8,130
3420,2024-01-03 08:59:00,59,85,Eletrônico,7,144
3421,2024-01-03 09:00:00,70,64,Eletrônico,3,134
3422,2024-01-03 09:01:00,61,171,Alimento,4,232
3423,2024-01-03 09:02:00,49,175,Brinquedo,3,224
3424,2024-01-03 09:03:00,17,33,Móvel,9,50
3425,2024-01-03 09:04:00,73,10,Vestuário,2,83
3426,2024-01-03 09:05:00,91,65,Alimento,9,156
3427,2024-01-03 09:06:00,112,12,Alimento,1,124
3428,2024-01-03 09:07:00,40,87,Móvel,3,127
3429,2024-01-03 09:08:00,44,99,Eletrônico,9,143
3430,2024-01-03 09:09:00,76,48,Vestuário,9,124
3431,2024-01-03 09:10:00,48,66,Móvel,9,114
3432,2024-01-03 09:11:00,103,139,Móvel,5,242
3433,2024-01-03 09:12:00,13,115,Alimento,5,128
3434,2024-01-03 09:13:00,32,176,Eletrônico,7,208
3435,2024-01-03 09:14:00,45,48,Móvel,6,93
3436,2024-01-03 09:15:00,41,152,Alimento,6,193
3437,2024-01-03 09:16:00,14,72,Vestuário,1,86
3438,2024-01-03 09:17:00,96,129,Alimento,7,225
3439,2024-01-03 09:18:00,31,111,Eletrônico,3,142
3440,2024-01-03 09:19:00,77,160,Móvel,5,237
3441,2024-01-03 09:20:00,27,53,Alimento,4,80
3442,2024-01-03 09:21:00,108,177,Vestuário,1,285
3443,2024-01-03 09:22:00,36,96,Vestuário,8,132
3444,2024-01-03 09:23:00,101,95,Vestuário,5,196
3445,2024-01-03 09:24:00,86,94,Alimento,8,180
3446,2024-01-03 09:25:00,80,83,Vestuário,6,163
3447,2024-01-03 09:26:00,27,176,Vestuário,3,203
3448,2024-01-03 09:27:00,86,14,Brinquedo,2,100
3449,2024-01-03 09:28:00,81,172,Móvel,8,253
3450,2024-01-03 09:29:00,43,120,Alimento,2,163
3451,2024-01-03 09:30:00,47,117,Móvel,2,164
3452,2024-01-03 09:31:00,41,10,Eletrônico,3,51
3453,2024-01-03 09:32:00,21,96,Móvel,4,117
3454,2024-01-03 09:33:00,84,66,Eletrônico,9,150
3455,2024-01-03 09:34:00,10,144,Eletrônico,6,154
3456,2024-01-03 09:35:00,82,50,Eletrônico,5,132
3457,2024-01-03 09:36:00,74,78,Eletrônico,9,152
3458,2024-01-03 09:37:00,73,123,Alimento,5,196
3459,2024-01-03 09:38:00,85,102,Alimento,8,187
3460,2024-01-03 09:39:00,19,65,Eletrônico,7,84
3461,2024-01-03 09:40:00,33,20,Alimento,7,53
3462,2024-01-03 09:41:00,47,171,Vestuário,8,218
3463,2024-01-03 09:42:00,38,41,Alimento,8,79
3464,2024-01-03 09:43:00,47,70,Móvel,3,117
3465,2024-01-03 09:44:00,22,18,Alimento,3,40
3466,2024-01-03 09:45:00,57,127,Vestuário,5,184
3467,2024-01-03 09:46:00,29,57,Alimento,1,86
3468,2024-01-03 09:47:00,83,51,Eletrônico,4,134
3469,2024-01-03 09:48:00,87,59,Alimento,1,146
3470,2024-01-03 09:49:00,76,59,Eletrônico,2,135
3471,2024-01-03 09:50:00,71,41,Móvel,7,112
3472,2024-01-03 09:51:00,114,174,Eletrônico,7,288
3473,2024-01-03 09:52:00,109,22,Alimento,1,131
3474,2024-01-03 09:53:00,47,34,Vestuário,1,81
3475,2024-01-03 09:54:00,55,113,Alimento,3,168
3476,2024-01-03 09:55:00,27,154,Eletrônico,3,181
3477,2024-01-03 09:56:00,46,47,Eletrônico,6,93
3478,2024-01-03 09:57:00,36,61,Eletrônico,5,97
3479,2024-01-03 09:58:00,117,63,Móvel,9,180
3480,2024-01-03 09:59:00,16,122,Vestuário,6,138
3481,2024-01-03 10:00:00,110,12,Móvel,3,122
3482,2024-01-03 10:01:00,105,108,Vestuário,5,213
3483,2024-01-03 10:02:00,44,37,Alimento,8,81
3484,2024-01-03 10:03:00,106,114,Móvel,6,220
3485,2024-01-03 10:04:00,15,87,Alimento,5,102
3486,2024-01-03 10:05:00,108,168,Brinquedo,2,276
3487,2024-01-03 10:06:00,51,53,Móvel,8,104
3488,2024-01-03 10:07:00,115,74,Alimento,4,189
3489,2024-01-03 10:08:00,97,30,Brinquedo,8,127
3490,2024-01-03 10:09:00,28,62,Alimento,9,90
3491,2024-01-03 10:10:00,20,100,Brinquedo,6,120
3492,2024-01-03 10:11:00,11,41,Brinquedo,4,52
3493,2024-01-03 10:12:00,94,79,Vestuário,1,173
3494,2024-01-03 10:13:00,78,69,Eletrônico,2,147
3495,2024-01-03 10:14:00,91,71,Móvel,5,162
3496,2024-01-03 10:15:00,69,105,Brinquedo,4,174
3497,2024-01-03 10:16:00,14,162,Brinquedo,3,176
3498,2024-01-03 10:17:00,62,149,Brinquedo,3,211
3499,2024-01-03 10:18:00,109,141,Brinquedo,7,250
3500,2024-01-03 10:19:00,114,26,Vestuário,2,140
3501,2024-01-03 10:20:00,45,121,Brinquedo,4,166
3502,2024-01-03 10:21:00,12,168,Alimento,5,180
3503,2024-01-03 10:22:00,56,173,Móvel,1,229
3504,2024-01-03 10:23:00,49,47,Móvel,9,96
3505,2024-01-03 10:24:00,18,82,Eletrônico,3,100
3506,2024-01-03 10:25:00,104,18,Eletrônico,8,122
3507,2024-01-03 10:26:00,107,85,Vestuário,5,192
3508,2024-01-03 10:27:00,107,109,Eletrônico,8,216
3509,2024-01-03 10:28:00,28,105,Eletrônico,6,133
3510,2024-01-03 10:29:00,39,71,Eletrônico,4,110
3511,2024-01-03 10:30:00,33,32,Alimento,2,65
3512,2024-01-03 10:31:00,32,64,Brinquedo,6,96
3513,2024-01-03 10:32:00,36,39,Móvel,8,75
3514,2024-01-03 10:33:00,106,157,Vestuário,8,263
3515,2024-01-03 10:34:00,35,129,Brinquedo,7,164
3516,2024-01-03 10:35:00,80,155,Brinquedo,3,235
3517,2024-01-03 10:36:00,37,84,Eletrônico,2,121
3518,2024-01-03 10:37:00,37,81,Móvel,9,118
3519,2024-01-03 10:38:00,19,123,Brinquedo,8,142
3520,2024-01-03 10:39:00,66,119,Eletrônico,9,185
3521,2024-01-03 10:40:00,15,140,Brinquedo,8,155
3522,2024-01-03 10:41:00,92,65,Brinquedo,3,157
3523,2024-01-03 10:42:00,89,111,Alimento,3,200
3524,2024-01-03 10:43:00,72,30,Vestuário,9,102
3525,2024-01-03 10:44:00,79,85,Móvel,1,164
3526,2024-01-03 10:45:00,67,161,Móvel,7,228
3527,2024-01-03 10:46:00,31,111,Vestuário,8,142
3528,2024-01-03 10:47:00,13,86,Móvel,6,99
3529,2024-01-03 10:48:00,82,133,Eletrônico,4,215
3530,2024-01-03 10:49:00,15,121,Vestuário,7,136
3531,2024-01-03 10:50:00,42,36,Alimento,5,78
3532,2024-01-03 10:51:00,75,29,Alimento,4,104
3533,2024-01-03 10:52:00,77,121,Brinquedo,7,198
3534,2024-01-03 10:53:00,115,132,Móvel,3,247
3535,2024-01-03 10:54:00,49,13,Vestuário,3,62
3536,2024-01-03 10:55:00,103,153,Eletrônico,7,256
3537,2024-01-03 10:56:00,111,83,Brinquedo,2,194
3538,2024-01-03 10:57:00,43,94,Vestuário,7,137
3539,2024-01-03 10:58:00,19,33,Brinquedo,7,52
3540,2024-01-03 10:59:00,73,130,Eletrônico,9,203
3541,2024-01-03 11:00:00,111,82,Alimento,5,193
3542,2024-01-03 11:01:00,46,134,Vestuário,5,180
3543,2024-01-03 11:02:00,103,17,Eletrônico,2,120
3544,2024-01-03 11:03:00,100,79,Brinquedo,6,179
3545,2024-01-03 11:04:00,111,31,Brinquedo,3,142
3546,2024-01-03 11:05:00,118,36,Alimento,9,154
3547,2024-01-03 11:06:00,76,51,Brinquedo,4,127
3548,2024-01-03 11:07:00,42,92,Brinquedo,5,134
3549,2024-01-03 11:08:00,45,113,Alimento,5,158
3550,2024-01-03 11:09:00,118,149,Brinquedo,2,267
3551,2024-01-03 11:10:00,15,134,Móvel,8,149
3552,2024-01-03 11:11:00,16,99,Alimento,1,115
3553,2024-01-03 11:12:00,40,17,Móvel,7,57
3554,2024-01-03 11:13:00,98,24,Móvel,9,122
3555,2024-01-03 11:14:00,58,39,Alimento,3,97
3556,2024-01-03 11:15:00,75,125,Móvel,9,200
3557,2024-01-03 11:16:00,108,70,Vestuário,3,178
3558,2024-01-03 11:17:00,36,173,Brinquedo,3,209
3559,2024-01-03 11:18:00,16,113,Móvel,4,129
3560,2024-01-03 11:19:00,63,87,Alimento,2,150
3561,2024-01-03 11:20:00,119,132,Móvel,2,251
3562,2024-01-03 11:21:00,22,135,Móvel,3,157
3563,2024-01-03 11:22:00,19,160,Móvel,7,179
3564,2024-01-03 11:23:00,13,66,Alimento,6,79
3565,2024-01-03 11:24:00,57,83,Brinquedo,5,140
3566,2024-01-03 11:25:00,47,108,Alimento,4,155
3567,2024-01-03 11:26:00,118,25,Alimento,2,143
3568,2024-01-03 11:27:00,52,28,Móvel,4,80
3569,2024-01-03 11:28:00,118,26,Alimento,9,144
3570,2024-01-03 11:29:00,42,159,Vestuário,3,201
3571,2024-01-03 11:30:00,54,136,Vestuário,3,190
3572,2024-01-03 11:31:00,117,128,Eletrônico,3,245
3573,2024-01-03 11:32:00,90,51,Móvel,1,141
3574,2024-01-03 11:33:00,61,63,Vestuário,5,124
3575,2024-01-03 11:34:00,82,141,Alimento,1,223
3576,2024-01-03 11:35:00,28,172,Brinquedo,2,200
3577,2024-01-03 11:36:00,42,142,Móvel,1,184
3578,2024-01-03 11:37:00,57,148,Eletrônico,6,205
3579,2024-01-03 11:38:00,49,80,Vestuário,5,129
3580,2024-01-03 11:39:00,92,109,Alimento,7,201
3581,2024-01-03 11:40:00,103,172,Móvel,7,275
3582,2024-01-03 11:41:00,22,156,Alimento,5,178
3583,2024-01-03 11:42:00,88,84,Brinquedo,6,172
3584,2024-01-03 11:43:00,93,88,Vestuário,3,181
3585,2024-01-03 11:44:00,48,172,Vestuário,5,220
3586,2024-01-03 11:45:00,87,36,Alimento,3,123
3587,2024-01-03 11:46:00,104,115,Vestuário,6,219
3588,2024-01-03 11:47:00,117,155,Brinquedo,8,272
3589,2024-01-03 11:48:00,36,131,Eletrônico,2,167
3590,2024-01-03 11:49:00,73,66,Brinquedo,5,139
3591,2024-01-03 11:50:00,76,125,Vestuário,6,201
3592,2024-01-03 11:51:00,17,30,Vestuário,6,47
3593,2024-01-03 11:52:00,71,172,Brinquedo,9,243
3594,2024-01-03 11:53:00,105,77,Brinquedo,6,182
3595,2024-01-03 11:54:00,54,172,Brinquedo,4,226
3596,2024-01-03 11:55:00,69,94,Alimento,6,163
3597,2024-01-03 11:56:00,79,33,Móvel,1,112
3598,2024-01-03 11:57:00,104,127,Brinquedo,7,231
3599,2024-01-03 11:58:00,43,126,Móvel,7,169
3600,2024-01-03 11:59:00,115,72,Vestuário,7,187
3601,2024-01-03 12:00:00,23,109,Eletrônico,1,132
3602,2024-01-03 12:01:00,19,118,Eletrônico,3,137
3603,2024-01-03 12:02:00,76,99,Eletrônico,1,175
3604,2024-01-03 12:03:00,24,174,Móvel,1,198
3605,2024-01-03 12:04:00,102,145,Brinquedo,1,247
3606,2024-01-03 12:05:00,45,69,Brinquedo,3,114
3607,2024-01-03 12:06:00,31,136,Alimento,5,167
3608,2024-01-03 12:07:00,101,69,Alimento,7,170
3609,2024-01-03 12:08:00,86,163,Eletrônico,8,249
3610,2024-01-03 12:09:00,30,158,Brinquedo,8,188
3611,2024-01-03 12:10:00,65,41,Vestuário,5,106
3612,2024-01-03 12:11:00,110,108,Móvel,5,218
3613,2024-01-03 12:12:00,54,149,Vestuário,7,203
3614,2024-01-03 12:13:00,59,120,Eletrônico,3,179
3615,2024-01-03 12:14:00,88,121,Móvel,5,209
3616,2024-01-03 12:15:00,24,124,Eletrônico,3,148
3617,2024-01-03 12:16:00,35,57,Vestuário,8,92
3618,2024-01-03 12:17:00,13,34,Brinquedo,7,47
3619,2024-01-03 12:18:00,62,167,Brinquedo,9,229
3620,2024-01-03 12:19:00,65,40,Alimento,1,105
3621,2024-01-03 12:20:00,21,126,Vestuário,8,147
3622,2024-01-03 12:21:00,57,68,Vestuário,8,125
3623,2024-01-03 12:22:00,107,63,Móvel,5,170
3624,2024-01-03 12:23:00,58,116,Alimento,8,174
3625,2024-01-03 12:24:00,77,97,Alimento,4,174
3626,2024-01-03 12:25:00,25,110,Brinquedo,3,135
3627,2024-01-03 12:26:00,20,92,Vestuário,5,112
3628,2024-01-03 12:27:00,64,50,Alimento,3,114
3629,2024-01-03 12:28:00,35,143,Vestuário,1,178
3630,2024-01-03 12:29:00,112,104,Alimento,4,216
3631,2024-01-03 12:30:00,17,56,Alimento,8,73
3632,2024-01-03 12:31:00,92,120,Alimento,5,212
3633,2024-01-03 12:32:00,14,25,Vestuário,5,39
3634,2024-01-03 12:33:00,42,77,Móvel,3,119
3635,2024-01-03 12:34:00,23,61,Alimento,7,84
3636,2024-01-03 12:35:00,70,42,Eletrônico,8,112
3637,2024-01-03 12:36:00,73,83,Móvel,3,156
3638,2024-01-03 12:37:00,104,17,Brinquedo,3,121
3639,2024-01-03 12:38:00,16,42,Eletrônico,3,58
3640,2024-01-03 12:39:00,103,65,Alimento,4,168
3641,2024-01-03 12:40:00,20,106,Alimento,8,126
3642,2024-01-03 12:41:00,107,125,Móvel,2,232
3643,2024-01-03 12:42:00,96,36,Móvel,9,132
3644,2024-01-03 12:43:00,68,156,Móvel,1,224
3645,2024-01-03 12:44:00,89,38,Alimento,7,127
3646,2024-01-03 12:45:00,118,37,Eletrônico,3,155
3647,2024-01-03 12:46:00,68,168,Eletrônico,3,236
3648,2024-01-03 12:47:00,20,14,Alimento,4,34
3649,2024-01-03 12:48:00,51,74,Alimento,9,125
3650,2024-01-03 12:49:00,65,46,Vestuário,8,111
3651,2024-01-03 12:50:00,49,142,Alimento,2,191
3652,2024-01-03 12:51:00,63,27,Alimento,3,90
3653,2024-01-03 12:52:00,37,83,Vestuário,2,120
3654,2024-01-03 12:53:00,82,74,Alimento,2,156
3655,2024-01-03 12:54:00,52,112,Eletrônico,5,164
3656,2024-01-03 12:55:00,115,19,Vestuário,1,134
3657,2024-01-03 12:56:00,108,120,Brinquedo,5,228
3658,2024-01-03 12:57:00,16,59,Brinquedo,2,75
3659,2024-01-03 12:58:00,54,110,Vestuário,8,164
3660,2024-01-03 12:59:00,40,152,Eletrônico,6,192
3661,2024-01-03 13:00:00,114,11,Vestuário,9,125
3662,2024-01-03 13:01:00,87,117,Alimento,4,204
3663,2024-01-03 13:02:00,60,141,Brinquedo,6,201
3664,2024-01-03 13:03:00,116,118,Alimento,4,234
3665,2024-01-03 13:04:00,38,78,Eletrônico,8,116
3666,2024-01-03 13:05:00,93,115,Eletrônico,4,208
3667,2024-01-03 13:06:00,55,14,Eletrônico,2,69
3668,2024-01-03 13:07:00,86,26,Móvel,7,112
3669,2024-01-03 13:08:00,87,23,Vestuário,4,110
3670,2024-01-03 13:09:00,63,173,Vestuário,6,236
3671,2024-01-03 13:10:00,12,145,Eletrônico,2,157
3672,2024-01-03 13:11:00,46,178,Eletrônico,8,224
3673,2024-01-03 13:12:00,110,141,Vestuário,5,251
3674,2024-01-03 13:13:00,91,130,Eletrônico,2,221
3675,2024-01-03 13:14:00,82,143,Brinquedo,5,225
3676,2024-01-03 13:15:00,50,91,Vestuário,9,141
3677,2024-01-03 13:16:00,51,13,Alimento,3,64
3678,2024-01-03 13:17:00,119,29,Alimento,1,148
3679,2024-01-03 13:18:00,50,159,Móvel,8,209
3680,2024-01-03 13:19:00,116,42,Vestuário,9,158
3681,2024-01-03 13:20:00,58,148,Alimento,5,206
3682,2024-01-03 13:21:00,63,92,Móvel,2,155
3683,2024-01-03 13:22:00,99,21,Vestuário,1,120
3684,2024-01-03 13:23:00,62,164,Eletrônico,8,226
3685,2024-01-03 13:24:00,19,117,Vestuário,3,136
3686,2024-01-03 13:25:00,79,42,Eletrônico,4,121
3687,2024-01-03 13:26:00,24,41,Brinquedo,9,65
3688,2024-01-03 13:27:00,37,142,Vestuário,1,179
3689,2024-01-03 13:28:00,80,100,Alimento,9,180
3690,2024-01-03 13:29:00,61,159,Vestuário,1,220
3691,2024-01-03 13:30:00,69,37,Vestuário,7,106
3692,2024-01-03 13:31:00,40,100,Móvel,4,140
3693,2024-01-03 13:32:00,90,80,Alimento,2,170
3694,2024-01-03 13:33:00,55,83,Móvel,3,138
3695,2024-01-03 13:34:00,35,146,Vestuário,8,181
3696,2024-01-03 13:35:00,28,167,Brinquedo,9,195
3697,2024-01-03 13:36:00,106,105,Móvel,7,211
3698,2024-01-03 13:37:00,47,152,Alimento,3,199
3699,2024-01-03 13:38:00,56,26,Alimento,5,82
3700,2024-01-03 13:39:00,107,155,Alimento,4,262
3701,2024-01-03 13:40:00,50,163,Vestuário,3,213
3702,2024-01-03 13:41:00,73,78,Alimento,4,151
3703,2024-01-03 13:42:00,56,43,Vestuário,6,99
3704,2024-01-03 13:43:00,50,128,Alimento,2,178
3705,2024-01-03 13:44:00,71,160,Brinquedo,9,231
3706,2024-01-03 13:45:00,104,43,Móvel,1,147
3707,2024-01-03 13:46:00,86,14,Eletrônico,2,100
3708,2024-01-03 13:47:00,32,88,Brinquedo,1,120
3709,2024-01-03 13:48:00,57,140,Eletrônico,7,197
3710,2024-01-03 13:49:00,94,144,Brinquedo,3,238
3711,2024-01-03 13:50:00,112,73,Vestuário,3,185
3712,2024-01-03 13:51:00,37,70,Eletrônico,8,107
3713,2024-01-03 13:52:00,105,96,Vestuário,8,201
3714,2024-01-03 13:53:00,96,66,Eletrônico,2,162
3715,2024-01-03 13:54:00,115,43,Móvel,7,158
3716,2024-01-03 13:55:00,40,31,Alimento,3,71
3717,2024-01-03 13:56:00,115,164,Alimento,2,279
3718,2024-01-03 13:57:00,99,40,Brinquedo,9,139
3719,2024-01-03 13:58:00,76,68,Vestuário,1,144
3720,2024-01-03 13:59:00,72,160,Eletrônico,3,232
3721,2024-01-03 14:00:00,30,112,Móvel,6,142
3722,2024-01-03 14:01:00,70,141,Alimento,1,211
3723,2024-01-03 14:02:00,25,119,Eletrônico,8,144
3724,2024-01-03 14:03:00,57,12,Eletrônico,5,69
3725,2024-01-03 14:04:00,78,131,Alimento,8,209
3726,2024-01-03 14:05:00,47,113,Alimento,2,160
3727,2024-01-03 14:06:00,62,154,Móvel,9,216
3728,2024-01-03 14:07:00,44,177,Brinquedo,7,221
3729,2024-01-03 14:08:00,33,113,Brinquedo,9,146
3730,2024-01-03 14:09:00,91,139,Alimento,6,230
3731,2024-01-03 14:10:00,103,134,Brinquedo,5,237
3732,2024-01-03 14:11:00,119,109,Eletrônico,8,228
3733,2024-01-03 14:12:00,108,57,Móvel,3,165
3734,2024-01-03 14:13:00,48,178,Móvel,9,226
3735,2024-01-03 14:14:00,75,105,Vestuário,6,180
3736,2024-01-03 14:15:00,115,121,Alimento,6,236
3737,2024-01-03 14:16:00,19,173,Vestuário,7,192
3738,2024-01-03 14:17:00,72,146,Eletrônico,7,218
3739,2024-01-03 14:18:00,58,44,Móvel,9,102
3740,2024-01-03 14:19:00,26,154,Alimento,9,180
3741,2024-01-03 14:20:00,59,85,Móvel,6,144
3742,2024-01-03 14:21:00,86,102,Brinquedo,1,188
3743,2024-01-03 14:22:00,100,131,Vestuário,8,231
3744,2024-01-03 14:23:00,24,28,Vestuário,8,52
3745,2024-01-03 14:24:00,84,82,Alimento,9,166
3746,2024-01-03 14:25:00,41,119,Vestuário,3,160
3747,2024-01-03 14:26:00,54,77,Móvel,5,131
3748,2024-01-03 14:27:00,102,126,Eletrônico,5,228
3749,2024-01-03 14:28:00,83,91,Vestuário,1,174
3750,2024-01-03 14:29:00,104,133,Móvel,9,237
3751,2024-01-03 14:30:00,90,89,Brinquedo,8,179
3752,2024-01-03 14:31:00,49,46,Brinquedo,1,95
3753,2024-01-03 14:32:00,53,86,Brinquedo,7,139
3754,2024-01-03 14:33:00,96,86,Móvel,6,182
3755,2024-01-03 14:34:00,79,122,Eletrônico,6,201
3756,2024-01-03 14:35:00,29,166,Vestuário,5,195
3757,2024-01-03 14:36:00,73,120,Vestuário,3,193
3758,2024-01-03 14:37:00,109,108,Vestuário,8,217
3759,2024-01-03 14:38:00,94,122,Alimento,2,216
3760,2024-01-03 14:39:00,39,166,Vestuário,6,205
3761,2024-01-03 14:40:00,106,27,Móvel,7,133
3762,2024-01-03 14:41:00,64,67,Alimento,2,131
3763,2024-01-03 14:42:00,118,34,Eletrônico,3,152
3764,2024-01-03 14:43:00,24,35,Eletrônico,6,59
3765,2024-01-03 14:44:00,40,55,Brinquedo,9,95
3766,2024-01-03 14:45:00,76,78,Brinquedo,9,154
3767,2024-01-03 14:46:00,88,92,Alimento,2,180
3768,2024-01-03 14:47:00,32,59,Alimento,9,91
3769,2024-01-03 14:48:00,74,13,Móvel,3,87
3770,2024-01-03 14:49:00,103,164,Brinquedo,5,267
3771,2024-01-03 14:50:00,76,97,Alimento,1,173
3772,2024-01-03 14:51:00,104,48,Brinquedo,3,152
3773,2024-01-03 14:52:00,70,90,Eletrônico,9,160
3774,2024-01-03 14:53:00,91,145,Alimento,7,236
3775,2024-01-03 14:54:00,74,132,Eletrônico,1,206
3776,2024-01-03 14:55:00,35,57,Móvel,4,92
3777,2024-01-03 14:56:00,81,93,Móvel,3,174
3778,2024-01-03 14:57:00,46,122,Móvel,3,168
3779,2024-01-03 14:58:00,16,123,Vestuário,6,139
3780,2024-01-03 14:59:00,77,148,Vestuário,1,225
3781,2024-01-03 15:00:00,107,120,Brinquedo,9,227
3782,2024-01-03 15:01:00,76,62,Brinquedo,5,138
3783,2024-01-03 15:02:00,90,78,Móvel,5,168
3784,2024-01-03 15:03:00,87,124,Vestuário,5,211
3785,2024-01-03 15:04:00,15,86,Brinquedo,2,101
3786,2024-01-03 15:05:00,92,36,Brinquedo,6,128
3787,2024-01-03 15:06:00,51,139,Alimento,6,190
3788,2024-01-03 15:07:00,33,175,Móvel,9,208
3789,2024-01-03 15:08:00,84,57,Vestuário,2,141
3790,2024-01-03 15:09:00,75,134,Eletrônico,5,209
3791,2024-01-03 15:10:00,36,142,Brinquedo,1,178
3792,2024-01-03 15:11:00,115,85,Alimento,8,200
3793,2024-01-03 15:12:00,54,19,Brinquedo,5,73
3794,2024-01-03 15:13:00,13,144,Vestuário,1,157
3795,2024-01-03 15:14:00,66,160,Móvel,6,226
3796,2024-01-03 15:15:00,74,146,Vestuário,3,220
3797,2024-01-03 15:16:00,30,24,Alimento,4,54
3798,2024-01-03 15:17:00,33,90,Vestuário,8,123
3799,2024-01-03 15:18:00,84,155,Alimento,9,239
3800,2024-01-03 15:19:00,108,91,Eletrônico,1,199
3801,2024-01-03 15:20:00,80,136,Eletrônico,7,216
3802,2024-01-03 15:21:00,91,69,Eletrônico,8,160
3803,2024-01-03 15:22:00,55,66,Móvel,2,121
3804,2024-01-03 15:23:00,29,47,Móvel,4,76
3805,2024-01-03 15:24:00,36,42,Eletrônico,7,78
3806,2024-01-03 15:25:00,54,154,Vestuário,1,208
3807,2024-01-03 15:26:00,43,174,Brinquedo,8,217
3808,2024-01-03 15:27:00,17,90,Móvel,7,107
3809,2024-01-03 15:28:00,86,73,Brinquedo,5,159
3810,2024-01-03 15:29:00,31,52,Brinquedo,7,83
3811,2024-01-03 15:30:00,119,142,Eletrônico,2,261
3812,2024-01-03 15:31:00,79,138,Alimento,4,217
3813,2024-01-03 15:32:00,18,150,Vestuário,7,168
3814,2024-01-03 15:33:00,87,57,Brinquedo,9,144
3815,2024-01-03 15:34:00,13,48,Móvel,6,61
3816,2024-01-03 15:35:00,89,72,Brinquedo,9,161
3817,2024-01-03 15:36:00,94,128,Eletrônico,5,222
3818,2024-01-03 15:37:00,65,160,Vestuário,4,225
3819,2024-01-03 15:38:00,85,166,Brinquedo,1,251
3820,2024-01-03 15:39:00,85,132,Eletrônico,2,217
3821,2024-01-03 15:40:00,81,18,Alimento,8,99
3822,2024-01-03 15:41:00,62,36,Móvel,6,98
3823,2024-01-03 15:42:00,67,90,Brinquedo,8,157
3824,2024-01-03 15:43:00,45,161,Alimento,3,206
3825,2024-01-03 15:44:00,108,171,Alimento,6,279
3826,2024-01-03 15:45:00,20,123,Brinquedo,1,143
3827,2024-01-03 15:46:00,38,30,Alimento,7,68
3828,2024-01-03 15:47:00,64,113,Vestuário,5,177
3829,2024-01-03 15:48:00,69,89,Brinquedo,3,158
3830,2024-01-03 15:49:00,40,135,Móvel,6,175
3831,2024-01-03 15:50:00,94,57,Eletrônico,2,151
3832,2024-01-03 15:51:00,23,84,Brinquedo,7,107
3833,2024-01-03 15:52:00,62,17,Brinquedo,5,79
3834,2024-01-03 15:53:00,87,167,Móvel,3,254
3835,2024-01-03 15:54:00,35,22,Eletrônico,3,57
3836,2024-01-03 15:55:00,80,136,Móvel,3,216
3837,2024-01-03 15:56:00,46,58,Eletrônico,4,104
3838,2024-01-03 15:57:00,41,35,Vestuário,8,76
3839,2024-01-03 15:58:00,81,20,Vestuário,8,101
3840,2024-01-03 15:59:00,63,74,Brinquedo,5,137
3841,2024-01-03 16:00:00,93,48,Eletrônico,5,141
3842,2024-01-03 16:01:00,81,171,Eletrônico,2,252
3843,2024-01-03 16:02:00,112,61,Eletrônico,4,173
3844,2024-01-03 16:03:00,39,86,Vestuário,1,125
3845,2024-01-03 16:04:00,99,75,Brinquedo,3,174
3846,2024-01-03 16:05:00,59,70,Eletrônico,6,129
3847,2024-01-03 16:06:00,65,175,Alimento,8,240
3848,2024-01-03 16:07:00,108,131,Vestuário,9,239
3849,2024-01-03 16:08:00,117,108,Brinquedo,5,225
3850,2024-01-03 16:09:00,83,40,Eletrônico,8,123
3851,2024-01-03 16:10:00,43,76,Móvel,5,119
3852,2024-01-03 16:11:00,39,57,Móvel,6,96
3853,2024-01-03 16:12:00,38,101,Brinquedo,3,139
3854,2024-01-03 16:13:00,61,68,Brinquedo,1,129
3855,2024-01-03 16:14:00,51,129,Brinquedo,7,180
3856,2024-01-03 16:15:00,16,20,Móvel,6,36
3857,2024-01-03 16:16:00,23,28,Vestuário,8,51
3858,2024-01-03 16:17:00,68,177,Móvel,3,245
3859,2024-01-03 16:18:00,94,125,Móvel,9,219
3860,2024-01-03 16:19:00,60,12,Vestuário,8,72
3861,2024-01-03 16:20:00,117,134,Eletrônico,2,251
3862,2024-01-03 16:21:00,65,90,Móvel,2,155
3863,2024-01-03 16:22:00,52,55,Vestuário,7,107
3864,2024-01-03 16:23:00,91,133,Móvel,2,224
3865,2024-01-03 16:24:00,114,67,Vestuário,1,181
3866,2024-01-03 16:25:00,72,101,Móvel,2,173
3867,2024-01-03 16:26:00,70,168,Brinquedo,5,238
3868,2024-01-03 16:27:00,17,34,Eletrônico,8,51
3869,2024-01-03 16:28:00,111,58,Alimento,9,169
3870,2024-01-03 16:29:00,49,109,Eletrônico,5,158
3871,2024-01-03 16:30:00,24,159,Alimento,5,183
3872,2024-01-03 16:31:00,99,139,Móvel,7,238
3873,2024-01-03 16:32:00,25,92,Eletrônico,5,117
3874,2024-01-03 16:33:00,61,112,Eletrônico,6,173
3875,2024-01-03 16:34:00,35,81,Vestuário,6,116
3876,2024-01-03 16:35:00,81,10,Brinquedo,7,91
3877,2024-01-03 16:36:00,93,103,Vestuário,5,196
3878,2024-01-03 16:37:00,78,53,Alimento,4,131
3879,2024-01-03 16:38:00,40,54,Vestuário,8,94
3880,2024-01-03 16:39:00,84,119,Móvel,3,203
3881,2024-01-03 16:40:00,71,82,Alimento,9,153
3882,2024-01-03 16:41:00,59,37,Vestuário,8,96
3883,2024-01-03 16:42:00,111,39,Móvel,5,150
3884,2024-01-03 16:43:00,114,124,Brinquedo,1,238
3885,2024-01-03 16:44:00,100,87,Alimento,2,187
3886,2024-01-03 16:45:00,100,62,Vestuário,7,162
3887,2024-01-03 16:46:00,74,96,Móvel,3,170
3888,2024-01-03 16:47:00,58,88,Vestuário,8,146
3889,2024-01-03 16:48:00,30,132,Brinquedo,1,162
3890,2024-01-03 16:49:00,53,103,Alimento,1,156
3891,2024-01-03 16:50:00,30,163,Eletrônico,2,193
3892,2024-01-03 16:51:00,65,159,Alimento,2,224
3893,2024-01-03 16:52:00,44,168,Móvel,1,212
3894,2024-01-03 16:53:00,18,149,Alimento,9,167
3895,2024-01-03 16:54:00,79,172,Vestuário,4,251
3896,2024-01-03 16:55:00,34,138,Alimento,6,172
3897,2024-01-03 16:56:00,102,19,Vestuário,8,121
3898,2024-01-03 16:57:00,49,96,Eletrônico,3,145
3899,2024-01-03 16:58:00,10,153,Brinquedo,8,163
3900,2024-01-03 16:59:00,102,140,Eletrônico,9,242
3901,2024-01-03 17:00:00,64,60,Brinquedo,2,124
3902,2024-01-03 17:01:00,29,116,Eletrônico,1,145
3903,2024-01-03 17:02:00,112,101,Alimento,2,213
3904,2024-01-03 17:03:00,67,17,Alimento,9,84
3905,2024-01-03 17:04:00,57,147,Brinquedo,2,204
3906,2024-01-03 17:05:00,43,40,Móvel,1,83
3907,2024-01-03 17:06:00,110,147,Brinquedo,5,257
3908,2024-01-03 17:07:00,14,15,Vestuário,7,29
3909,2024-01-03 17:08:00,12,67,Vestuário,6,79
3910,2024-01-03 17:09:00,51,149,Brinquedo,7,200
3911,2024-01-03 17:10:00,78,140,Brinquedo,4,218
3912,2024-01-03 17:11:00,90,140,Brinquedo,2,230
3913,2024-01-03 17:12:00,25,143,Móvel,2,168
3914,2024-01-03 17:13:00,13,134,Brinquedo,9,147
3915,2024-01-03 17:14:00,66,99,Vestuário,3,165
3916,2024-01-03 17:15:00,89,179,Móvel,3,268
3917,2024-01-03 17:16:00,42,143,Vestuário,7,185
3918,2024-01-03 17:17:00,20,105,Eletrônico,6,125
3919,2024-01-03 17:18:00,34,135,Móvel,7,169
3920,2024-01-03 17:19:00,114,116,Brinquedo,2,230
3921,2024-01-03 17:20:00,90,136,Móvel,2,226
3922,2024-01-03 17:21:00,70,134,Eletrônico,8,204
3923,2024-01-03 17:22:00,109,20,Vestuário,8,129
3924,2024-01-03 17:23:00,72,14,Eletrônico,5,86
3925,2024-01-03 17:24:00,27,158,Vestuário,1,185
3926,2024-01-03 17:25:00,113,141,Brinquedo,1,254
3927,2024-01-03 17:26:00,110,64,Alimento,2,174
3928,2024-01-03 17:27:00,25,24,Móvel,9,49
3929,2024-01-03 17:28:00,97,151,Alimento,9,248
3930,2024-01-03 17:29:00,87,19,Alimento,2,106
3931,2024-01-03 17:30:00,59,150,Alimento,7,209
3932,2024-01-03 17:31:00,14,92,Vestuário,5,106
3933,2024-01-03 17:32:00,61,159,Brinquedo,7,220
3934,2024-01-03 17:33:00,42,121,Vestuário,6,163
3935,2024-01-03 17:34:00,60,131,Vestuário,4,191
3936,2024-01-03 17:35:00,43,49,Móvel,1,92
3937,2024-01-03 17:36:00,116,174,Vestuário,3,290
3938,2024-01-03 17:37:00,50,124,Vestuário,6,174
3939,2024-01-03 17:38:00,108,135,Vestuário,4,243
3940,2024-01-03 17:39:00,102,133,Móvel,6,235
3941,2024-01-03 17:40:00,38,39,Eletrônico,7,77
3942,2024-01-03 17:41:00,110,110,Eletrônico,2,220
3943,2024-01-03 17:42:00,91,121,Móvel,6,212
3944,2024-01-03 17:43:00,53,78,Eletrônico,7,131
3945,2024-01-03 17:44:00,44,139,Eletrônico,1,183
3946,2024-01-03 17:45:00,97,144,Alimento,1,241
3947,2024-01-03 17:46:00,21,172,Brinquedo,6,193
3948,2024-01-03 17:47:00,74,175,Vestuário,9,249
3949,2024-01-03 17:48:00,99,144,Móvel,2,243
3950,2024-01-03 17:49:00,81,118,Móvel,1,199
3951,2024-01-03 17:50:00,105,83,Eletrônico,4,188
3952,2024-01-03 17:51:00,89,91,Alimento,1,180
3953,2024-01-03 17:52:00,98,151,Alimento,7,249
3954,2024-01-03 17:53:00,40,67,Brinquedo,4,107
3955,2024-01-03 17:54:00,117,135,Eletrônico,8,252
3956,2024-01-03 17:55:00,80,18,Eletrônico,5,98
3957,2024-01-03 17:56:00,21,73,Móvel,5,94
3958,2024-01-03 17:57:00,66,44,Eletrônico,5,110
3959,2024-01-03 17:58:00,92,22,Brinquedo,6,114
3960,2024-01-03 17:59:00,73,41,Móvel,8,114
3961,2024-01-03 18:00:00,38,138,Móvel,2,176
3962,2024-01-03 18:01:00,50,167,Alimento,9,217
3963,2024-01-03 18:02:00,74,66,Móvel,8,140
3964,2024-01-03 18:03:00,118,111,Alimento,4,229
3965,2024-01-03 18:04:00,96,98,Alimento,1,194
3966,2024-01-03 18:05:00,97,174,Vestuário,9,271
3967,2024-01-03 18:06:00,94,149,Alimento,8,243
3968,2024-01-03 18:07:00,55,115,Móvel,3,170
3969,2024-01-03 18:08:00,101,119,Móvel,6,220
3970,2024-01-03 18:09:00,19,140,Brinquedo,6,159
3971,2024-01-03 18:10:00,103,163,Brinquedo,6,266
3972,2024-01-03 18:11:00,29,152,Eletrônico,6,181
3973,2024-01-03 18:12:00,79,34,Móvel,6,113
3974,2024-01-03 18:13:00,76,43,Alimento,2,119
3975,2024-01-03 18:14:00,21,66,Alimento,6,87
3976,2024-01-03 18:15:00,53,137,Vestuário,1,190
3977,2024-01-03 18:16:00,110,94,Alimento,3,204
3978,2024-01-03 18:17:00,60,36,Móvel,1,96
3979,2024-01-03 18:18:00,117,69,Vestuário,1,186
3980,2024-01-03 18:19:00,47,34,Alimento,7,81
3981,2024-01-03 18:20:00,47,172,Brinquedo,4,219
3982,2024-01-03 18:21:00,82,40,Brinquedo,7,122
3983,2024-01-03 18:22:00,81,136,Brinquedo,5,217
3984,2024-01-03 18:23:00,78,126,Brinquedo,1,204
3985,2024-01-03 18:24:00,36,101,Móvel,7,137
3986,2024-01-03 18:25:00,28,132,Alimento,6,160
3987,2024-01-03 18:26:00,116,177,Móvel,8,293
3988,2024-01-03 18:27:00,101,59,Brinquedo,7,160
3989,2024-01-03 18:28:00,107,72,Móvel,3,179
3990,2024-01-03 18:29:00,103,51,Brinquedo,4,154
3991,2024-01-03 18:30:00,41,104,Vestuário,1,145
3992,2024-01-03 18:31:00,109,162,Alimento,1,271
3993,2024-01-03 18:32:00,34,29,Eletrônico,6,63
3994,2024-01-03 18:33:00,48,53,Eletrônico,4,101
3995,2024-01-03 18:34:00,29,163,Vestuário,8,192
3996,2024-01-03 18:35:00,101,110,Vestuário,9,211
3997,2024-01-03 18:36:00,109,62,Alimento,6,171
3998,2024-01-03 18:37:00,94,78,Eletrônico,6,172
3999,2024-01-03 18:38:00,99,166,Móvel,8,265
4000,2024-01-03 18:39:00,44,99,Alimento,3,143
4001,2024-01-03 18:40:00,22,79,Eletrônico,4,101
4002,2024-01-03 18:41:00,48,151,Eletrônico,7,199
4003,2024-01-03 18:42:00,40,60,Vestuário,9,100
4004,2024-01-03 18:43:00,102,34,Brinquedo,3,136
4005,2024-01-03 18:44:00,39,139,Vestuário,2,178
4006,2024-01-03 18:45:00,11,112,Eletrônico,2,123
4007,2024-01-03 18:46:00,14,32,Brinquedo,8,46
4008,2024-01-03 18:47:00,48,49,Brinquedo,9,97
4009,2024-01-03 18:48:00,67,43,Alimento,5,110
4010,2024-01-03 18:49:00,110,139,Móvel,8,249
4011,2024-01-03 18:50:00,106,23,Móvel,8,129
4012,2024-01-03 18:51:00,72,102,Eletrônico,8,174
4013,2024-01-03 18:52:00,66,156,Móvel,8,222
4014,2024-01-03 18:53:00,24,137,Vestuário,6,161
4015,2024-01-03 18:54:00,83,115,Alimento,4,198
4016,2024-01-03 18:55:00,60,27,Brinquedo,4,87
4017,2024-01-03 18:56:00,97,18,Móvel,5,115
4018,2024-01-03 18:57:00,68,60,Alimento,1,128
4019,2024-01-03 18:58:00,32,25,Móvel,9,57
4020,2024-01-03 18:59:00,62,168,Alimento,1,230
4021,2024-01-03 19:00:00,45,87,Vestuário,7,132
4022,2024-01-03 19:01:00,117,19,Brinquedo,1,136
4023,2024-01-03 19:02:00,49,141,Eletrônico,5,190
4024,2024-01-03 19:03:00,36,86,Vestuário,1,122
4025,2024-01-03 19:04:00,52,86,Eletrônico,1,138
4026,2024-01-03 19:05:00,30,163,Vestuário,2,193
4027,2024-01-03 19:06:00,17,43,Eletrônico,9,60
4028,2024-01-03 19:07:00,54,47,Alimento,2,101
4029,2024-01-03 19:08:00,90,173,Alimento,4,263
4030,2024-01-03 19:09:00,24,96,Eletrônico,7,120
4031,2024-01-03 19:10:00,48,140,Eletrônico,8,188
4032,2024-01-03 19:11:00,109,107,Eletrônico,7,216
4033,2024-01-03 19:12:00,41,162,Eletrônico,4,203
4034,2024-01-03 19:13:00,34,94,Alimento,7,128
4035,2024-01-03 19:14:00,100,125,Eletrônico,5,225
4036,2024-01-03 19:15:00,15,74,Vestuário,7,89
4037,2024-01-03 19:16:00,102,34,Móvel,9,136
4038,2024-01-03 19:17:00,28,45,Móvel,1,73
4039,2024-01-03 19:18:00,85,50,Eletrônico,8,135
4040,2024-01-03 19:19:00,32,65,Alimento,8,97
4041,2024-01-03 19:20:00,29,139,Eletrônico,5,168
4042,2024-01-03 19:21:00,92,152,Eletrônico,7,244
4043,2024-01-03 19:22:00,99,62,Vestuário,8,161
4044,2024-01-03 19:23:00,36,11,Brinquedo,5,47
4045,2024-01-03 19:24:00,11,52,Brinquedo,6,63
4046,2024-01-03 19:25:00,19,132,Móvel,7,151
4047,2024-01-03 19:26:00,26,110,Brinquedo,6,136
4048,2024-01-03 19:27:00,50,84,Vestuário,4,134
4049,2024-01-03 19:28:00,12,161,Alimento,8,173
4050,2024-01-03 19:29:00,78,176,Eletrônico,3,254
4051,2024-01-03 19:30:00,54,18,Eletrônico,2,72
4052,2024-01-03 19:31:00,24,22,Alimento,5,46
4053,2024-01-03 19:32:00,90,160,Brinquedo,9,250
4054,2024-01-03 19:33:00,37,52,Eletrônico,5,89
4055,2024-01-03 19:34:00,48,70,Móvel,4,118
4056,2024-01-03 19:35:00,56,41,Móvel,8,97
4057,2024-01-03 19:36:00,91,179,Alimento,5,270
4058,2024-01-03 19:37:00,60,136,Vestuário,8,196
4059,2024-01-03 19:38:00,31,45,Alimento,6,76
4060,2024-01-03 19:39:00,72,67,Brinquedo,5,139
4061,2024-01-03 19:40:00,61,154,Vestuário,2,215
4062,2024-01-03 19:41:00,40,102,Brinquedo,8,142
4063,2024-01-03 19:42:00,41,130,Móvel,9,171
4064,2024-01-03 19:43:00,54,172,Eletrônico,7,226
4065,2024-01-03 19:44:00,38,81,Eletrônico,9,119
4066,2024-01-03 19:45:00,91,22,Vestuário,1,113
4067,2024-01-03 19:46:00,67,101,Alimento,4,168
4068,2024-01-03 19:47:00,11,73,Móvel,9,84
4069,2024-01-03 19:48:00,53,101,Brinquedo,1,154
4070,2024-01-03 19:49:00,21,149,Vestuário,9,170
4071,2024-01-03 19:50:00,36,157,Brinquedo,8,193
4072,2024-01-03 19:51:00,115,30,Brinquedo,3,145
4073,2024-01-03 19:52:00,66,81,Móvel,1,147
4074,2024-01-03 19:53:00,50,153,Vestuário,4,203
4075,2024-01-03 19:54:00,39,65,Vestuário,9,104
4076,2024-01-03 19:55:00,10,52,Móvel,2,62
4077,2024-01-03 19:56:00,109,122,Vestuário,9,231
4078,2024-01-03 19:57:00,62,83,Alimento,2,145
4079,2024-01-03 19:58:00,37,69,Eletrônico,7,106
4080,2024-01-03 19:59:00,63,100,Alimento,2,163
4081,2024-01-03 20:00:00,37,87,Eletrônico,6,124
4082,2024-01-03 20:01:00,117,119,Eletrônico,1,236
4083,2024-01-03 20:02:00,89,28,Alimento,5,117
4084,2024-01-03 20:03:00,21,107,Móvel,5,128
4085,2024-01-03 20:04:00,52,159,Eletrônico,9,211
4086,2024-01-03 20:05:00,44,25,Alimento,4,69
4087,2024-01-03 20:06:00,106,141,Móvel,5,247
4088,2024-01-03 20:07:00,86,151,Alimento,7,237
4089,2024-01-03 20:08:00,45,61,Eletrônico,3,106
4090,2024-01-03 20:09:00,78,130,Móvel,6,208
4091,2024-01-03 20:10:00,74,139,Móvel,6,213
4092,2024-01-03 20:11:00,90,65,Móvel,4,155
4093,2024-01-03 20:12:00,11,169,Vestuário,6,180
4094,2024-01-03 20:13:00,60,81,Móvel,2,141
4095,2024-01-03 20:14:00,26,92,Móvel,8,118
4096,2024-01-03 20:15:00,36,121,Alimento,2,157
4097,2024-01-03 20:16:00,118,56,Brinquedo,6,174
4098,2024-01-03 20:17:00,45,49,Alimento,5,94
4099,2024-01-03 20:18:00,63,132,Alimento,9,195
4100,2024-01-03 20:19:00,96,88,Alimento,7,184
4101,2024-01-03 20:20:00,47,135,Brinquedo,6,182
4102,2024-01-03 20:21:00,36,99,Brinquedo,5,135
4103,2024-01-03 20:22:00,73,160,Vestuário,2,233
4104,2024-01-03 20:23:00,17,10,Alimento,4,27
4105,2024-01-03 20:24:00,102,40,Móvel,7,142
4106,2024-01-03 20:25:00,69,103,Móvel,4,172
4107,2024-01-03 20:26:00,97,94,Eletrônico,6,191
4108,2024-01-03 20:27:00,90,35,Eletrônico,5,125
4109,2024-01-03 20:28:00,107,28,Vestuário,9,135
4110,2024-01-03 20:29:00,75,128,Vestuário,3,203
4111,2024-01-03 20:30:00,16,11,Brinquedo,5,27
4112,2024-01-03 20:31:00,27,85,Vestuário,3,112
4113,2024-01-03 20:32:00,64,83,Eletrônico,4,147
4114,2024-01-03 20:33:00,99,66,Brinquedo,1,165
4115,2024-01-03 20:34:00,79,167,Brinquedo,5,246
4116,2024-01-03 20:35:00,66,45,Alimento,7,111
4117,2024-01-03 20:36:00,83,37,Vestuário,6,120
4118,2024-01-03 20:37:00,93,99,Brinquedo,4,192
4119,2024-01-03 20:38:00,50,163,Brinquedo,9,213
4120,2024-01-03 20:39:00,49,72,Vestuário,5,121
4121,2024-01-03 20:40:00,17,21,Móvel,4,38
4122,2024-01-03 20:41:00,13,65,Móvel,7,78
4123,2024-01-03 20:42:00,112,78,Brinquedo,1,190
4124,2024-01-03 20:43:00,64,121,Brinquedo,4,185
4125,2024-01-03 20:44:00,30,22,Vestuário,3,52
4126,2024-01-03 20:45:00,44,71,Brinquedo,1,115
4127,2024-01-03 20:46:00,103,142,Vestuário,4,245
4128,2024-01-03 20:47:00,25,120,Vestuário,4,145
4129,2024-01-03 20:48:00,14,86,Alimento,4,100
4130,2024-01-03 20:49:00,48,166,Vestuário,7,214
4131,2024-01-03 20:50:00,58,14,Vestuário,9,72
4132,2024-01-03 20:51:00,110,43,Vestuário,1,153
4133,2024-01-03 20:52:00,86,119,Vestuário,8,205
4134,2024-01-03 20:53:00,91,172,Alimento,3,263
4135,2024-01-03 20:54:00,96,89,Alimento,5,185
4136,2024-01-03 20:55:00,106,33,Alimento,8,139
4137,2024-01-03 20:56:00,109,176,Alimento,5,285
4138,2024-01-03 20:57:00,93,69,Vestuário,4,162
4139,2024-01-03 20:58:00,35,112,Móvel,1,147
4140,2024-01-03 20:59:00,24,31,Alimento,2,55
4141,2024-01-03 21:00:00,27,75,Brinquedo,9,102
4142,2024-01-03 21:01:00,48,64,Eletrônico,5,112
4143,2024-01-03 21:02:00,84,138,Brinquedo,1,222
4144,2024-01-03 21:03:00,62,74,Móvel,7,136
4145,2024-01-03 21:04:00,111,16,Móvel,1,127
4146,2024-01-03 21:05:00,105,159,Móvel,4,264
4147,2024-01-03 21:06:00,28,39,Vestuário,5,67
4148,2024-01-03 21:07:00,114,73,Eletrônico,9,187
4149,2024-01-03 21:08:00,84,96,Eletrônico,6,180
4150,2024-01-03 21:09:00,101,47,Alimento,7,148
4151,2024-01-03 21:10:00,52,49,Brinquedo,3,101
4152,2024-01-03 21:11:00,100,99,Brinquedo,2,199
4153,2024-01-03 21:12:00,48,39,Brinquedo,9,87
4154,2024-01-03 21:13:00,21,176,Vestuário,3,197
4155,2024-01-03 21:14:00,41,177,Brinquedo,4,218
4156,2024-01-03 21:15:00,71,45,Móvel,2,116
4157,2024-01-03 21:16:00,64,63,Móvel,9,127
4158,2024-01-03 21:17:00,96,11,Alimento,8,107
4159,2024-01-03 21:18:00,88,73,Alimento,9,161
4160,2024-01-03 21:19:00,96,95,Vestuário,9,191
4161,2024-01-03 21:20:00,14,30,Vestuário,3,44
4162,2024-01-03 21:21:00,65,161,Eletrônico,7,226
4163,2024-01-03 21:22:00,98,25,Eletrônico,9,123
4164,2024-01-03 21:23:00,65,104,Brinquedo,9,169
4165,2024-01-03 21:24:00,51,171,Vestuário,5,222
4166,2024-01-03 21:25:00,78,77,Eletrônico,7,155
4167,2024-01-03 21:26:00,50,12,Vestuário,6,62
4168,2024-01-03 21:27:00,85,17,Vestuário,7,102
4169,2024-01-03 21:28:00,41,114,Móvel,3,155
4170,2024-01-03 21:29:00,25,175,Alimento,4,200
4171,2024-01-03 21:30:00,22,39,Eletrônico,9,61
4172,2024-01-03 21:31:00,27,119,Brinquedo,9,146
4173,2024-01-03 21:32:00,112,137,Eletrônico,9,249
4174,2024-01-03 21:33:00,114,177,Vestuário,4,291
4175,2024-01-03 21:34:00,53,79,Vestuário,7,132
4176,2024-01-03 21:35:00,38,156,Alimento,8,194
4177,2024-01-03 21:36:00,35,97,Móvel,5,132
4178,2024-01-03 21:37:00,31,78,Brinquedo,5,109
4179,2024-01-03 21:38:00,68,82,Vestuário,4,150
4180,2024-01-03 21:39:00,57,17,Vestuário,8,74
4181,2024-01-03 21:40:00,75,35,Alimento,3,110
4182,2024-01-03 21:41:00,11,86,Vestuário,1,97
4183,2024-01-03 21:42:00,96,127,Alimento,9,223
4184,2024-01-03 21:43:00,42,132,Eletrônico,6,174
4185,2024-01-03 21:44:00,28,167,Brinquedo,9,195
4186,2024-01-03 21:45:00,92,71,Alimento,6,163
4187,2024-01-03 21:46:00,21,12,Brinquedo,8,33
4188,2024-01-03 21:47:00,117,30,Vestuário,8,147
4189,2024-01-03 21:48:00,43,152,Eletrônico,4,195
4190,2024-01-03 21:49:00,117,111,Móvel,9,228
4191,2024-01-03 21:50:00,77,97,Móvel,1,174
4192,2024-01-03 21:51:00,48,83,Brinquedo,5,131
4193,2024-01-03 21:52:00,67,80,Vestuário,1,147
4194,2024-01-03 21:53:00,111,63,Brinquedo,9,174
4195,2024-01-03 21:54:00,110,136,Vestuário,5,246
4196,2024-01-03 21:55:00,100,149,Móvel,8,249
4197,2024-01-03 21:56:00,84,88,Eletrônico,8,172
4198,2024-01-03 21:57:00,81,76,Brinquedo,2,157
4199,2024-01-03 21:58:00,40,80,Brinquedo,6,120
4200,2024-01-03 21:59:00,17,157,Brinquedo,5,174
4201,2024-01-03 22:00:00,39,138,Eletrônico,1,177
4202,2024-01-03 22:01:00,18,50,Móvel,2,68
4203,2024-01-03 22:02:00,87,46,Móvel,9,133
4204,2024-01-03 22:03:00,95,45,Móvel,4,140
4205,2024-01-03 22:04:00,44,57,Alimento,8,101
4206,2024-01-03 22:05:00,69,102,Móvel,9,171
4207,2024-01-03 22:06:00,29,179,Brinquedo,5,208
4208,2024-01-03 22:07:00,59,59,Brinquedo,4,118
4209,2024-01-03 22:08:00,42,118,Brinquedo,5,160
4210,2024-01-03 22:09:00,24,72,Brinquedo,9,96
4211,2024-01-03 22:10:00,75,162,Vestuário,3,237
4212,2024-01-03 22:11:00,24,85,Alimento,8,109
4213,2024-01-03 22:12:00,91,12,Alimento,3,103
4214,2024-01-03 22:13:00,86,71,Móvel,6,157
4215,2024-01-03 22:14:00,59,54,Brinquedo,1,113
4216,2024-01-03 22:15:00,83,60,Alimento,1,143
4217,2024-01-03 22:16:00,33,45,Brinquedo,5,78
4218,2024-01-03 22:17:00,84,160,Brinquedo,7,244
4219,2024-01-03 22:18:00,10,127,Alimento,8,137
4220,2024-01-03 22:19:00,25,72,Vestuário,2,97
4221,2024-01-03 22:20:00,92,155,Móvel,2,247
4222,2024-01-03 22:21:00,23,18,Vestuário,9,41
4223,2024-01-03 22:22:00,62,34,Eletrônico,2,96
4224,2024-01-03 22:23:00,110,34,Móvel,8,144
4225,2024-01-03 22:24:00,80,160,Brinquedo,8,240
4226,2024-01-03 22:25:00,28,91,Móvel,7,119
4227,2024-01-03 22:26:00,90,169,Alimento,7,259
4228,2024-01-03 22:27:00,70,112,Eletrônico,9,182
4229,2024-01-03 22:28:00,40,63,Alimento,7,103
4230,2024-01-03 22:29:00,28,138,Vestuário,1,166
4231,2024-01-03 22:30:00,20,84,Vestuário,9,104
4232,2024-01-03 22:31:00,55,37,Alimento,2,92
4233,2024-01-03 22:32:00,48,110,Eletrônico,7,158
4234,2024-01-03 22:33:00,107,53,Móvel,9,160
4235,2024-01-03 22:34:00,36,168,Brinquedo,7,204
4236,2024-01-03 22:35:00,51,172,Eletrônico,1,223
4237,2024-01-03 22:36:00,25,120,Móvel,2,145
4238,2024-01-03 22:37:00,32,177,Brinquedo,4,209
4239,2024-01-03 22:38:00,98,50,Alimento,9,148
4240,2024-01-03 22:39:00,101,76,Eletrônico,5,177
4241,2024-01-03 22:40:00,23,45,Eletrônico,6,68
4242,2024-01-03 22:41:00,95,76,Móvel,7,171
4243,2024-01-03 22:42:00,49,141,Eletrônico,8,190
4244,2024-01-03 22:43:00,67,114,Móvel,8,181
4245,2024-01-03 22:44:00,91,160,Alimento,1,251
4246,2024-01-03 22:45:00,93,113,Móvel,6,206
4247,2024-01-03 22:46:00,113,116,Brinquedo,3,229
4248,2024-01-03 22:47:00,100,100,Eletrônico,3,200
4249,2024-01-03 22:48:00,113,24,Vestuário,9,137
4250,2024-01-03 22:49:00,71,146,Eletrônico,1,217
4251,2024-01-03 22:50:00,78,123,Alimento,5,201
4252,2024-01-03 22:51:00,82,96,Móvel,6,178
4253,2024-01-03 22:52:00,44,120,Brinquedo,6,164
4254,2024-01-03 22:53:00,45,107,Eletrônico,3,152
4255,2024-01-03 22:54:00,109,116,Brinquedo,2,225
4256,2024-01-03 22:55:00,38,144,Alimento,9,182
4257,2024-01-03 22:56:00,37,58,Eletrônico,9,95
4258,2024-01-03 22:57:00,53,142,Vestuário,3,195
4259,2024-01-03 22:58:00,22,145,Eletrônico,3,167
4260,2024-01-03 22:59:00,84,34,Móvel,1,118
4261,2024-01-03 23:00:00,32,24,Alimento,4,56
4262,2024-01-03 23:01:00,71,63,Alimento,5,134
4263,2024-01-03 23:02:00,116,36,Eletrônico,3,152
4264,2024-01-03 23:03:00,31,108,Vestuário,6,139
4265,2024-01-03 23:04:00,25,77,Alimento,5,102
4266,2024-01-03 23:05:00,48,67,Brinquedo,4,115
4267,2024-01-03 23:06:00,47,22,Móvel,4,69
4268,2024-01-03 23:07:00,20,55,Móvel,4,75
4269,2024-01-03 23:08:00,41,48,Móvel,9,89
4270,2024-01-03 23:09:00,78,138,Alimento,7,216
4271,2024-01-03 23:10:00,83,173,Alimento,5,256
4272,2024-01-03 23:11:00,24,98,Alimento,1,122
4273,2024-01-03 23:12:00,42,118,Vestuário,4,160
4274,2024-01-03 23:13:00,38,56,Eletrônico,7,94
4275,2024-01-03 23:14:00,64,150,Brinquedo,7,214
4276,2024-01-03 23:15:00,39,104,Móvel,5,143
4277,2024-01-03 23:16:00,101,57,Eletrônico,1,158
4278,2024-01-03 23:17:00,100,94,Vestuário,1,194
4279,2024-01-03 23:18:00,48,56,Alimento,1,104
4280,2024-01-03 23:19:00,37,34,Brinquedo,1,71
4281,2024-01-03 23:20:00,75,131,Alimento,7,206
4282,2024-01-03 23:21:00,22,57,Vestuário,8,79
4283,2024-01-03 23:22:00,37,69,Alimento,9,106
4284,2024-01-03 23:23:00,20,71,Eletrônico,2,91
4285,2024-01-03 23:24:00,108,136,Brinquedo,3,244
4286,2024-01-03 23:25:00,117,170,Eletrônico,2,287
4287,2024-01-03 23:26:00,47,71,Vestuário,6,118
4288,2024-01-03 23:27:00,88,31,Eletrônico,6,119
4289,2024-01-03 23:28:00,12,20,Brinquedo,9,32
4290,2024-01-03 23:29:00,62,38,Brinquedo,9,100
4291,2024-01-03 23:30:00,21,138,Brinquedo,9,159
4292,2024-01-03 23:31:00,81,142,Vestuário,8,223
4293,2024-01-03 23:32:00,73,14,Móvel,1,87
4294,2024-01-03 23:33:00,32,74,Vestuário,3,106
4295,2024-01-03 23:34:00,30,136,Brinquedo,2,166
4296,2024-01-03 23:35:00,54,120,Vestuário,7,174
4297,2024-01-03 23:36:00,51,123,Vestuário,7,174
4298,2024-01-03 23:37:00,12,164,Brinquedo,4,176
4299,2024-01-03 23:38:00,79,98,Eletrônico,1,177
4300,2024-01-03 23:39:00,97,121,Brinquedo,2,218
4301,2024-01-03 23:40:00,34,179,Móvel,9,213
4302,2024-01-03 23:41:00,36,85,Eletrônico,4,121
4303,2024-01-03 23:42:00,96,13,Vestuário,4,109
4304,2024-01-03 23:43:00,118,26,Alimento,4,144
4305,2024-01-03 23:44:00,48,60,Vestuário,5,108
4306,2024-01-03 23:45:00,77,143,Alimento,3,220
4307,2024-01-03 23:46:00,110,96,Eletrônico,5,206
4308,2024-01-03 23:47:00,69,140,Eletrônico,9,209
4309,2024-01-03 23:48:00,115,102,Eletrônico,6,217
4310,2024-01-03 23:49:00,80,25,Alimento,5,105
4311,2024-01-03 23:50:00,31,168,Móvel,2,199
4312,2024-01-03 23:51:00,40,178,Vestuário,8,218
4313,2024-01-03 23:52:00,17,114,Vestuário,7,131
4314,2024-01-03 23:53:00,81,147,Brinquedo,7,228
4315,2024-01-03 23:54:00,81,33,Móvel,2,114
4316,2024-01-03 23:55:00,28,24,Brinquedo,6,52
4317,2024-01-03 23:56:00,36,97,Alimento,1,133
4318,2024-01-03 23:57:00,30,157,Vestuário,2,187
4319,2024-01-03 23:58:00,67,155,Eletrônico,5,222
4320,2024-01-03 23:59:00,42,129,Móvel,9,171
4321,2024-01-04 00:00:00,85,51,Eletrônico,2,136
4322,2024-01-04 00:01:00,51,83,Eletrônico,3,134
4323,2024-01-04 00:02:00,83,95,Brinquedo,2,178
4324,2024-01-04 00:03:00,93,54,Móvel,6,147
4325,2024-01-04 00:04:00,18,87,Brinquedo,6,105
4326,2024-01-04 00:05:00,83,126,Alimento,4,209
4327,2024-01-04 00:06:00,52,116,Brinquedo,6,168
4328,2024-01-04 00:07:00,101,30,Eletrônico,1,131
4329,2024-01-04 00:08:00,25,164,Brinquedo,2,189
4330,2024-01-04 00:09:00,109,127,Móvel,7,236
4331,2024-01-04 00:10:00,107,166,Eletrônico,3,273
4332,2024-01-04 00:11:00,61,92,Brinquedo,6,153
4333,2024-01-04 00:12:00,118,63,Alimento,7,181
4334,2024-01-04 00:13:00,64,105,Eletrônico,9,169
4335,2024-01-04 00:14:00,15,33,Eletrônico,4,48
4336,2024-01-04 00:15:00,98,27,Alimento,7,125
4337,2024-01-04 00:16:00,83,161,Eletrônico,6,244
4338,2024-01-04 00:17:00,94,32,Vestuário,3,126
4339,2024-01-04 00:18:00,64,108,Brinquedo,4,172
4340,2024-01-04 00:19:00,20,105,Móvel,2,125
4341,2024-01-04 00:20:00,45,59,Brinquedo,2,104
4342,2024-01-04 00:21:00,96,76,Eletrônico,6,172
4343,2024-01-04 00:22:00,91,147,Alimento,7,238
4344,2024-01-04 00:23:00,37,132,Móvel,7,169
4345,2024-01-04 00:24:00,97,177,Brinquedo,8,274
4346,2024-01-04 00:25:00,82,177,Alimento,8,259
4347,2024-01-04 00:26:00,94,114,Vestuário,1,208
4348,2024-01-04 00:27:00,78,90,Alimento,2,168
4349,2024-01-04 00:28:00,35,57,Vestuário,6,92
4350,2024-01-04 00:29:00,84,133,Alimento,4,217
4351,2024-01-04 00:30:00,81,46,Brinquedo,2,127
4352,2024-01-04 00:31:00,15,168,Móvel,9,183
4353,2024-01-04 00:32:00,78,109,Alimento,6,187
4354,2024-01-04 00:33:00,12,174,Vestuário,9,186
4355,2024-01-04 00:34:00,102,62,Vestuário,5,164
4356,2024-01-04 00:35:00,107,68,Móvel,7,175
4357,2024-01-04 00:36:00,96,85,Vestuário,5,181
4358,2024-01-04 00:37:00,97,39,Vestuário,9,136
4359,2024-01-04 00:38:00,47,164,Alimento,7,211
4360,2024-01-04 00:39:00,61,146,Móvel,4,207
4361,2024-01-04 00:40:00,41,34,Móvel,8,75
4362,2024-01-04 00:41:00,68,101,Brinquedo,1,169
4363,2024-01-04 00:42:00,107,28,Eletrônico,6,135
4364,2024-01-04 00:43:00,111,108,Eletrônico,8,219
4365,2024-01-04 00:44:00,43,168,Eletrônico,4,211
4366,2024-01-04 00:45:00,68,63,Eletrônico,5,131
4367,2024-01-04 00:46:00,51,58,Brinquedo,2,109
4368,2024-01-04 00:47:00,63,87,Brinquedo,7,150
4369,2024-01-04 00:48:00,46,14,Móvel,8,60
4370,2024-01-04 00:49:00,55,21,Eletrônico,7,76
4371,2024-01-04 00:50:00,96,99,Brinquedo,6,195
4372,2024-01-04 00:51:00,84,127,Vestuário,5,211
4373,2024-01-04 00:52:00,15,149,Brinquedo,6,164
4374,2024-01-04 00:53:00,45,112,Móvel,9,157
4375,2024-01-04 00:54:00,114,178,Móvel,2,292
4376,2024-01-04 00:55:00,20,18,Brinquedo,4,38
4377,2024-01-04 00:56:00,58,30,Móvel,9,88
4378,2024-01-04 00:57:00,18,89,Brinquedo,8,107
4379,2024-01-04 00:58:00,39,166,Brinquedo,3,205
4380,2024-01-04 00:59:00,84,82,Eletrônico,9,166
4381,2024-01-04 01:00:00,13,175,Brinquedo,1,188
4382,2024-01-04 01:01:00,41,119,Alimento,5,160
4383,2024-01-04 01:02:00,89,167,Eletrônico,8,256
4384,2024-01-04 01:03:00,92,164,Brinquedo,7,256
4385,2024-01-04 01:04:00,18,163,Brinquedo,1,181
4386,2024-01-04 01:05:00,28,60,Alimento,7,88
4387,2024-01-04 01:06:00,55,111,Eletrônico,7,166
4388,2024-01-04 01:07:00,49,23,Alimento,1,72
4389,2024-01-04 01:08:00,106,159,Alimento,7,265
4390,2024-01-04 01:09:00,42,92,Móvel,4,134
4391,2024-01-04 01:10:00,87,86,Brinquedo,3,173
4392,2024-01-04 01:11:00,72,10,Eletrônico,8,82
4393,2024-01-04 01:12:00,57,51,Alimento,8,108
4394,2024-01-04 01:13:00,93,104,Alimento,2,197
4395,2024-01-04 01:14:00,35,71,Vestuário,9,106
4396,2024-01-04 01:15:00,111,46,Vestuário,7,157
4397,2024-01-04 01:16:00,95,169,Alimento,2,264
4398,2024-01-04 01:17:00,28,154,Brinquedo,4,182
4399,2024-01-04 01:18:00,82,78,Vestuário,5,160
4400,2024-01-04 01:19:00,19,125,Eletrônico,5,144
4401,2024-01-04 01:20:00,90,117,Móvel,3,207
4402,2024-01-04 01:21:00,22,24,Alimento,2,46
4403,2024-01-04 01:22:00,113,62,Brinquedo,4,175
4404,2024-01-04 01:23:00,114,124,Eletrônico,6,238
4405,2024-01-04 01:24:00,85,35,Móvel,2,120
4406,2024-01-04 01:25:00,46,65,Móvel,8,111
4407,2024-01-04 01:26:00,119,51,Brinquedo,8,170
4408,2024-01-04 01:27:00,114,135,Móvel,5,249
4409,2024-01-04 01:28:00,63,46,Eletrônico,9,109
4410,2024-01-04 01:29:00,61,88,Móvel,1,149
4411,2024-01-04 01:30:00,98,47,Móvel,7,145
4412,2024-01-04 01:31:00,37,57,Brinquedo,5,94
4413,2024-01-04 01:32:00,81,33,Móvel,9,114
4414,2024-01-04 01:33:00,65,26,Vestuário,2,91
4415,2024-01-04 01:34:00,56,45,Eletrônico,6,101
4416,2024-01-04 01:35:00,24,17,Vestuário,1,41
4417,2024-01-04 01:36:00,109,173,Móvel,8,282
4418,2024-01-04 01:37:00,88,116,Vestuário,2,204
4419,2024-01-04 01:38:00,91,161,Vestuário,2,252
4420,2024-01-04 01:39:00,103,170,Eletrônico,4,273
4421,2024-01-04 01:40:00,34,152,Eletrônico,3,186
4422,2024-01-04 01:41:00,116,26,Vestuário,2,142
4423,2024-01-04 01:42:00,76,116,Vestuário,7,192
4424,2024-01-04 01:43:00,74,25,Móvel,6,99
4425,2024-01-04 01:44:00,97,98,Vestuário,8,195
4426,2024-01-04 01:45:00,10,101,Eletrônico,8,111
4427,2024-01-04 01:46:00,91,154,Móvel,5,245
4428,2024-01-04 01:47:00,36,56,Eletrônico,4,92
4429,2024-01-04 01:48:00,42,95,Móvel,9,137
4430,2024-01-04 01:49:00,89,149,Alimento,2,238
4431,2024-01-04 01:50:00,17,144,Brinquedo,6,161
4432,2024-01-04 01:51:00,68,65,Eletrônico,3,133
4433,2024-01-04 01:52:00,45,93,Móvel,5,138
4434,2024-01-04 01:53:00,99,114,Alimento,4,213
4435,2024-01-04 01:54:00,25,171,Brinquedo,1,196
4436,2024-01-04 01:55:00,78,125,Brinquedo,8,203
4437,2024-01-04 01:56:00,117,88,Vestuário,2,205
4438,2024-01-04 01:57:00,43,128,Móvel,1,171
4439,2024-01-04 01:58:00,38,58,Eletrônico,5,96
4440,2024-01-04 01:59:00,16,48,Alimento,2,64
4441,2024-01-04 02:00:00,10,152,Eletrônico,3,162
4442,2024-01-04 02:01:00,119,103,Eletrônico,4,222
4443,2024-01-04 02:02:00,118,113,Brinquedo,6,231
4444,2024-01-04 02:03:00,19,97,Brinquedo,1,116
4445,2024-01-04 02:04:00,76,55,Alimento,7,131
4446,2024-01-04 02:05:00,93,179,Alimento,5,272
4447,2024-01-04 02:06:00,19,48,Móvel,5,67
4448,2024-01-04 02:07:00,71,29,Alimento,6,100
4449,2024-01-04 02:08:00,53,165,Eletrônico,2,218
4450,2024-01-04 02:09:00,54,164,Vestuário,8,218
4451,2024-01-04 02:10:00,30,142,Brinquedo,9,172
4452,2024-01-04 02:11:00,71,163,Vestuário,5,234
4453,2024-01-04 02:12:00,74,68,Eletrônico,9,142
4454,2024-01-04 02:13:00,79,60,Vestuário,6,139
4455,2024-01-04 02:14:00,17,150,Vestuário,7,167
4456,2024-01-04 02:15:00,116,177,Vestuário,4,293
4457,2024-01-04 02:16:00,89,24,Móvel,3,113
4458,2024-01-04 02:17:00,69,25,Móvel,1,94
4459,2024-01-04 02:18:00,61,33,Móvel,3,94
4460,2024-01-04 02:19:00,56,67,Vestuário,9,123
4461,2024-01-04 02:20:00,93,79,Móvel,5,172
4462,2024-01-04 02:21:00,110,83,Eletrônico,5,193
4463,2024-01-04 02:22:00,39,40,Móvel,3,79
4464,2024-01-04 02:23:00,111,64,Móvel,2,175
4465,2024-01-04 02:24:00,63,135,Móvel,1,198
4466,2024-01-04 02:25:00,89,169,Brinquedo,7,258
4467,2024-01-04 02:26:00,97,46,Brinquedo,8,143
4468,2024-01-04 02:27:00,24,49,Alimento,1,73
4469,2024-01-04 02:28:00,82,162,Eletrônico,3,244
4470,2024-01-04 02:29:00,74,61,Eletrônico,9,135
4471,2024-01-04 02:30:00,50,97,Brinquedo,9,147
4472,2024-01-04 02:31:00,14,72,Brinquedo,9,86
4473,2024-01-04 02:32:00,59,177,Eletrônico,5,236
4474,2024-01-04 02:33:00,69,141,Vestuário,6,210
4475,2024-01-04 02:34:00,97,16,Vestuário,4,113
4476,2024-01-04 02:35:00,108,51,Móvel,1,159
4477,2024-01-04 02:36:00,104,12,Eletrônico,8,116
4478,2024-01-04 02:37:00,72,55,Vestuário,9,127
4479,2024-01-04 02:38:00,64,157,Eletrônico,8,221
4480,2024-01-04 02:39:00,44,115,Eletrônico,5,159
4481,2024-01-04 02:40:00,51,158,Móvel,3,209
4482,2024-01-04 02:41:00,73,93,Alimento,2,166
4483,2024-01-04 02:42:00,83,176,Brinquedo,8,259
4484,2024-01-04 02:43:00,25,153,Alimento,7,178
4485,2024-01-04 02:44:00,14,94,Eletrônico,7,108
4486,2024-01-04 02:45:00,74,146,Alimento,1,220
4487,2024-01-04 02:46:00,106,71,Eletrônico,6,177
4488,2024-01-04 02:47:00,67,54,Vestuário,9,121
4489,2024-01-04 02:48:00,98,69,Alimento,3,167
4490,2024-01-04 02:49:00,117,136,Alimento,6,253
4491,2024-01-04 02:50:00,95,99,Alimento,3,194
4492,2024-01-04 02:51:00,75,123,Vestuário,7,198
4493,2024-01-04 02:52:00,116,125,Vestuário,8,241
4494,2024-01-04 02:53:00,32,97,Móvel,6,129
4495,2024-01-04 02:54:00,64,99,Eletrônico,5,163
4496,2024-01-04 02:55:00,68,175,Vestuário,9,243
4497,2024-01-04 02:56:00,48,126,Móvel,2,174
4498,2024-01-04 02:57:00,13,89,Brinquedo,4,102
4499,2024-01-04 02:58:00,65,37,Eletrônico,3,102
4500,2024-01-04 02:59:00,44,27,Móvel,1,71
4501,2024-01-04 03:00:00,27,165,Móvel,2,192
4502,2024-01-04 03:01:00,29,20,Brinquedo,2,49
4503,2024-01-04 03:02:00,102,51,Alimento,7,153
4504,2024-01-04 03:03:00,110,67,Vestuário,7,177
4505,2024-01-04 03:04:00,81,56,Alimento,1,137
4506,2024-01-04 03:05:00,22,119,Eletrônico,4,141
4507,2024-01-04 03:06:00,107,142,Vestuário,1,249
4508,2024-01-04 03:07:00,42,101,Brinquedo,2,143
4509,2024-01-04 03:08:00,47,30,Brinquedo,1,77
4510,2024-01-04 03:09:00,62,135,Alimento,7,197
4511,2024-01-04 03:10:00,73,71,Brinquedo,3,144
4512,2024-01-04 03:11:00,60,92,Alimento,9,152
4513,2024-01-04 03:12:00,68,97,Eletrônico,5,165
4514,2024-01-04 03:13:00,39,145,Eletrônico,3,184
4515,2024-01-04 03:14:00,81,12,Alimento,6,93
4516,2024-01-04 03:15:00,43,160,Móvel,3,203
4517,2024-01-04 03:16:00,47,50,Eletrônico,4,97
4518,2024-01-04 03:17:00,63,76,Alimento,8,139
4519,2024-01-04 03:18:00,90,55,Brinquedo,5,145
4520,2024-01-04 03:19:00,62,119,Alimento,4,181
4521,2024-01-04 03:20:00,73,115,Alimento,6,188
4522,2024-01-04 03:21:00,73,65,Vestuário,9,138
4523,2024-01-04 03:22:00,110,18,Brinquedo,2,128
4524,2024-01-04 03:23:00,23,160,Brinquedo,2,183
4525,2024-01-04 03:24:00,62,30,Brinquedo,5,92
4526,2024-01-04 03:25:00,58,166,Alimento,1,224
4527,2024-01-04 03:26:00,41,167,Vestuário,2,208
4528,2024-01-04 03:27:00,47,31,Alimento,4,78
4529,2024-01-04 03:28:00,76,163,Brinquedo,3,239
4530,2024-01-04 03:29:00,95,14,Móvel,9,109
4531,2024-01-04 03:30:00,102,151,Eletrônico,1,253
4532,2024-01-04 03:31:00,48,124,Brinquedo,1,172
4533,2024-01-04 03:32:00,103,27,Vestuário,4,130
4534,2024-01-04 03:33:00,84,51,Móvel,6,135
4535,2024-01-04 03:34:00,15,109,Alimento,9,124
4536,2024-01-04 03:35:00,43,179,Móvel,7,222
4537,2024-01-04 03:36:00,53,139,Vestuário,9,192
4538,2024-01-04 03:37:00,86,160,Móvel,2,246
4539,2024-01-04 03:38:00,19,166,Móvel,4,185
4540,2024-01-04 03:39:00,25,11,Vestuário,4,36
4541,2024-01-04 03:40:00,102,53,Alimento,4,155
4542,2024-01-04 03:41:00,92,169,Móvel,9,261
4543,2024-01-04 03:42:00,21,27,Alimento,6,48
4544,2024-01-04 03:43:00,14,144,Brinquedo,4,158
4545,2024-01-04 03:44:00,61,163,Eletrônico,1,224
4546,2024-01-04 03:45:00,119,31,Eletrônico,9,150
4547,2024-01-04 03:46:00,108,76,Alimento,5,184
4548,2024-01-04 03:47:00,45,32,Alimento,1,77
4549,2024-01-04 03:48:00,85,147,Brinquedo,5,232
4550,2024-01-04 03:49:00,22,42,Eletrônico,8,64
4551,2024-01-04 03:50:00,110,114,Eletrônico,7,224
4552,2024-01-04 03:51:00,115,121,Brinquedo,3,236
4553,2024-01-04 03:52:00,39,142,Vestuário,7,181
4554,2024-01-04 03:53:00,92,22,Alimento,3,114
4555,2024-01-04 03:54:00,110,160,Vestuário,4,270
4556,2024-01-04 03:55:00,15,37,Alimento,5,52
4557,2024-01-04 03:56:00,36,77,Vestuário,7,113
4558,2024-01-04 03:57:00,21,67,Brinquedo,1,88
4559,2024-01-04 03:58:00,115,147,Alimento,2,262
4560,2024-01-04 03:59:00,35,120,Brinquedo,7,155
4561,2024-01-04 04:00:00,69,35,Vestuário,8,104
4562,2024-01-04 04:01:00,37,100,Alimento,1,137
4563,2024-01-04 04:02:00,53,49,Vestuário,9,102
4564,2024-01-04 04:03:00,115,54,Vestuário,5,169
4565,2024-01-04 04:04:00,107,81,Móvel,8,188
4566,2024-01-04 04:05:00,43,90,Brinquedo,3,133
4567,2024-01-04 04:06:00,90,11,Alimento,1,101
4568,2024-01-04 04:07:00,53,56,Móvel,3,109
4569,2024-01-04 04:08:00,35,112,Móvel,8,147
4570,2024-01-04 04:09:00,24,179,Móvel,6,203
4571,2024-01-04 04:10:00,26,167,Vestuário,7,193
4572,2024-01-04 04:11:00,37,170,Eletrônico,3,207
4573,2024-01-04 04:12:00,114,161,Brinquedo,7,275
4574,2024-01-04 04:13:00,51,58,Brinquedo,5,109
4575,2024-01-04 04:14:00,92,146,Brinquedo,9,238
4576,2024-01-04 04:15:00,116,30,Eletrônico,2,146
4577,2024-01-04 04:16:00,92,111,Eletrônico,6,203
4578,2024-01-04 04:17:00,43,114,Vestuário,5,157
4579,2024-01-04 04:18:00,61,129,Brinquedo,9,190
4580,2024-01-04 04:19:00,96,156,Móvel,4,252
4581,2024-01-04 04:20:00,47,42,Alimento,6,89
4582,2024-01-04 04:21:00,27,137,Brinquedo,4,164
4583,2024-01-04 04:22:00,104,35,Vestuário,3,139
4584,2024-01-04 04:23:00,13,47,Brinquedo,5,60
4585,2024-01-04 04:24:00,59,126,Móvel,9,185
4586,2024-01-04 04:25:00,94,42,Eletrônico,6,136
4587,2024-01-04 04:26:00,78,66,Vestuário,7,144
4588,2024-01-04 04:27:00,43,18,Brinquedo,4,61
4589,2024-01-04 04:28:00,51,171,Eletrônico,4,222
4590,2024-01-04 04:29:00,99,96,Brinquedo,2,195
4591,2024-01-04 04:30:00,59,144,Alimento,3,203
4592,2024-01-04 04:31:00,104,163,Eletrônico,7,267
4593,2024-01-04 04:32:00,82,104,Eletrônico,9,186
4594,2024-01-04 04:33:00,13,77,Eletrônico,3,90
4595,2024-01-04 04:34:00,113,175,Móvel,3,288
4596,2024-01-04 04:35:00,72,177,Brinquedo,2,249
4597,2024-01-04 04:36:00,109,162,Alimento,2,271
4598,2024-01-04 04:37:00,95,154,Alimento,7,249
4599,2024-01-04 04:38:00,90,102,Alimento,6,192
4600,2024-01-04 04:39:00,25,130,Alimento,5,155
4601,2024-01-04 04:40:00,62,118,Eletrônico,3,180
4602,2024-01-04 04:41:00,105,172,Alimento,7,277
4603,2024-01-04 04:42:00,11,84,Eletrônico,5,95
4604,2024-01-04 04:43:00,66,67,Eletrônico,2,133
4605,2024-01-04 04:44:00,11,43,Vestuário,6,54
4606,2024-01-04 04:45:00,40,116,Brinquedo,6,156
4607,2024-01-04 04:46:00,46,146,Eletrônico,6,192
4608,2024-01-04 04:47:00,29,27,Vestuário,9,56
4609,2024-01-04 04:48:00,50,111,Vestuário,6,161
4610,2024-01-04 04:49:00,92,51,Alimento,1,143
4611,2024-01-04 04:50:00,40,89,Eletrônico,6,129
4612,2024-01-04 04:51:00,77,41,Brinquedo,6,118
4613,2024-01-04 04:52:00,30,38,Alimento,1,68
4614,2024-01-04 04:53:00,110,159,Eletrônico,1,269
4615,2024-01-04 04:54:00,67,129,Alimento,8,196
4616,2024-01-04 04:55:00,63,158,Brinquedo,9,221
4617,2024-01-04 04:56:00,60,153,Brinquedo,4,213
4618,2024-01-04 04:57:00,48,130,Eletrônico,5,178
4619,2024-01-04 04:58:00,37,99,Brinquedo,3,136
4620,2024-01-04 04:59:00,91,150,Móvel,7,241
4621,2024-01-04 05:00:00,40,112,Móvel,1,152
4622,2024-01-04 05:01:00,107,57,Brinquedo,8,164
4623,2024-01-04 05:02:00,72,88,Brinquedo,1,160
4624,2024-01-04 05:03:00,50,167,Móvel,4,217
4625,2024-01-04 05:04:00,23,174,Brinquedo,1,197
4626,2024-01-04 05:05:00,37,166,Móvel,4,203
4627,2024-01-04 05:06:00,62,49,Eletrônico,7,111
4628,2024-01-04 05:07:00,103,150,Brinquedo,3,253
4629,2024-01-04 05:08:00,92,78,Brinquedo,6,170
4630,2024-01-04 05:09:00,74,173,Vestuário,4,247
4631,2024-01-04 05:10:00,63,95,Alimento,1,158
4632,2024-01-04 05:11:00,57,10,Vestuário,5,67
4633,2024-01-04 05:12:00,19,129,Eletrônico,3,148
4634,2024-01-04 05:13:00,66,94,Eletrônico,1,160
4635,2024-01-04 05:14:00,90,24,Vestuário,1,114
4636,2024-01-04 05:15:00,114,113,Eletrônico,3,227
4637,2024-01-04 05:16:00,90,73,Vestuário,8,163
4638,2024-01-04 05:17:00,116,141,Vestuário,2,257
4639,2024-01-04 05:18:00,50,35,Alimento,9,85
4640,2024-01-04 05:19:00,54,26,Móvel,5,80
4641,2024-01-04 05:20:00,60,99,Móvel,7,159
4642,2024-01-04 05:21:00,40,82,Alimento,5,122
4643,2024-01-04 05:22:00,25,70,Eletrônico,3,95
4644,2024-01-04 05:23:00,119,19,Eletrônico,1,138
4645,2024-01-04 05:24:00,86,74,Brinquedo,5,160
4646,2024-01-04 05:25:00,80,132,Vestuário,6,212
4647,2024-01-04 05:26:00,45,106,Alimento,4,151
4648,2024-01-04 05:27:00,92,53,Eletrônico,3,145
4649,2024-01-04 05:28:00,23,162,Eletrônico,5,185
4650,2024-01-04 05:29:00,119,20,Brinquedo,9,139
4651,2024-01-04 05:30:00,105,126,Móvel,4,231
4652,2024-01-04 05:31:00,40,106,Eletrônico,1,146
4653,2024-01-04 05:32:00,100,79,Móvel,1,179
4654,2024-01-04 05:33:00,74,175,Vestuário,6,249
4655,2024-01-04 05:34:00,110,177,Alimento,2,287
4656,2024-01-04 05:35:00,10,127,Móvel,9,137
4657,2024-01-04 05:36:00,21,35,Móvel,7,56
4658,2024-01-04 05:37:00,65,25,Móvel,1,90
4659,2024-01-04 05:38:00,17,125,Móvel,9,142
4660,2024-01-04 05:39:00,36,36,Brinquedo,7,72
4661,2024-01-04 05:40:00,67,86,Móvel,9,153
4662,2024-01-04 05:41:00,114,51,Alimento,6,165
4663,2024-01-04 05:42:00,34,139,Eletrônico,2,173
4664,2024-01-04 05:43:00,68,108,Brinquedo,2,176
4665,2024-01-04 05:44:00,75,135,Vestuário,4,210
4666,2024-01-04 05:45:00,18,14,Eletrônico,8,32
4667,2024-01-04 05:46:00,66,122,Móvel,5,188
4668,2024-01-04 05:47:00,57,100,Vestuário,9,157
4669,2024-01-04 05:48:00,84,148,Vestuário,2,232
4670,2024-01-04 05:49:00,84,94,Vestuário,2,178
4671,2024-01-04 05:50:00,75,161,Móvel,6,236
4672,2024-01-04 05:51:00,114,16,Alimento,2,130
4673,2024-01-04 05:52:00,17,139,Alimento,4,156
4674,2024-01-04 05:53:00,33,29,Brinquedo,8,62
4675,2024-01-04 05:54:00,87,104,Brinquedo,4,191
4676,2024-01-04 05:55:00,113,17,Móvel,8,130
4677,2024-01-04 05:56:00,54,57,Brinquedo,7,111
4678,2024-01-04 05:57:00,76,103,Alimento,1,179
4679,2024-01-04 05:58:00,28,92,Alimento,9,120
4680,2024-01-04 05:59:00,13,128,Vestuário,1,141
4681,2024-01-04 06:00:00,17,11,Vestuário,4,28
4682,2024-01-04 06:01:00,109,66,Móvel,9,175
4683,2024-01-04 06:02:00,107,90,Alimento,5,197
4684,2024-01-04 06:03:00,75,70,Brinquedo,8,145
4685,2024-01-04 06:04:00,93,83,Alimento,6,176
4686,2024-01-04 06:05:00,63,106,Móvel,1,169
4687,2024-01-04 06:06:00,51,79,Móvel,9,130
4688,2024-01-04 06:07:00,107,79,Vestuário,9,186
4689,2024-01-04 06:08:00,96,17,Alimento,1,113
4690,2024-01-04 06:09:00,28,163,Móvel,7,191
4691,2024-01-04 06:10:00,41,127,Móvel,4,168
4692,2024-01-04 06:11:00,18,44,Eletrônico,8,62
4693,2024-01-04 06:12:00,55,89,Eletrônico,5,144
4694,2024-01-04 06:13:00,106,87,Eletrônico,4,193
4695,2024-01-04 06:14:00,48,168,Eletrônico,4,216
4696,2024-01-04 06:15:00,58,143,Eletrônico,2,201
4697,2024-01-04 06:16:00,28,174,Brinquedo,4,202
4698,2024-01-04 06:17:00,84,86,Móvel,4,170
4699,2024-01-04 06:18:00,18,106,Móvel,6,124
4700,2024-01-04 06:19:00,18,62,Alimento,1,80
4701,2024-01-04 06:20:00,81,57,Vestuário,4,138
4702,2024-01-04 06:21:00,105,126,Eletrônico,9,231
4703,2024-01-04 06:22:00,64,116,Brinquedo,7,180
4704,2024-01-04 06:23:00,37,146,Vestuário,4,183
4705,2024-01-04 06:24:00,111,18,Eletrônico,2,129
4706,2024-01-04 06:25:00,57,70,Móvel,5,127
4707,2024-01-04 06:26:00,73,99,Brinquedo,1,172
4708,2024-01-04 06:27:00,78,152,Alimento,7,230
4709,2024-01-04 06:28:00,62,102,Móvel,8,164
4710,2024-01-04 06:29:00,95,58,Vestuário,8,153
4711,2024-01-04 06:30:00,62,25,Alimento,4,87
4712,2024-01-04 06:31:00,99,27,Eletrônico,8,126
4713,2024-01-04 06:32:00,103,21,Móvel,9,124
4714,2024-01-04 06:33:00,23,64,Alimento,4,87
4715,2024-01-04 06:34:00,99,112,Móvel,1,211
4716,2024-01-04 06:35:00,69,24,Alimento,8,93
4717,2024-01-04 06:36:00,42,29,Alimento,2,71
4718,2024-01-04 06:37:00,29,25,Móvel,2,54
4719,2024-01-04 06:38:00,54,179,Brinquedo,4,233
4720,2024-01-04 06:39:00,118,112,Móvel,9,230
4721,2024-01-04 06:40:00,84,145,Brinquedo,4,229
4722,2024-01-04 06:41:00,100,77,Móvel,5,177
4723,2024-01-04 06:42:00,50,32,Eletrônico,6,82
4724,2024-01-04 06:43:00,85,65,Brinquedo,3,150
4725,2024-01-04 06:44:00,81,171,Eletrônico,3,252
4726,2024-01-04 06:45:00,63,52,Vestuário,7,115
4727,2024-01-04 06:46:00,115,103,Alimento,4,218
4728,2024-01-04 06:47:00,86,45,Vestuário,4,131
4729,2024-01-04 06:48:00,13,96,Brinquedo,7,109
4730,2024-01-04 06:49:00,78,105,Vestuário,5,183
4731,2024-01-04 06:50:00,28,162,Alimento,3,190
4732,2024-01-04 06:51:00,110,55,Alimento,9,165
4733,2024-01-04 06:52:00,95,102,Brinquedo,3,197
4734,2024-01-04 06:53:00,24,152,Vestuário,1,176
4735,2024-01-04 06:54:00,68,174,Brinquedo,4,242
4736,2024-01-04 06:55:00,70,113,Vestuário,2,183
4737,2024-01-04 06:56:00,12,104,Móvel,5,116
4738,2024-01-04 06:57:00,86,86,Brinquedo,6,172
4739,2024-01-04 06:58:00,88,119,Vestuário,6,207
4740,2024-01-04 06:59:00,51,59,Eletrônico,9,110
4741,2024-01-04 07:00:00,63,124,Brinquedo,6,187
4742,2024-01-04 07:01:00,27,89,Eletrônico,9,116
4743,2024-01-04 07:02:00,51,96,Móvel,2,147
4744,2024-01-04 07:03:00,117,25,Eletrônico,8,142
4745,2024-01-04 07:04:00,17,133,Eletrônico,5,150
4746,2024-01-04 07:05:00,74,116,Alimento,6,190
4747,2024-01-04 07:06:00,105,48,Brinquedo,6,153
4748,2024-01-04 07:07:00,82,89,Móvel,7,171
4749,2024-01-04 07:08:00,116,34,Móvel,5,150
4750,2024-01-04 07:09:00,14,90,Alimento,1,104
4751,2024-01-04 07:10:00,38,68,Brinquedo,5,106
4752,2024-01-04 07:11:00,95,86,Alimento,9,181
4753,2024-01-04 07:12:00,90,141,Alimento,4,231
4754,2024-01-04 07:13:00,55,117,Brinquedo,1,172
4755,2024-01-04 07:14:00,67,140,Vestuário,5,207
4756,2024-01-04 07:15:00,69,154,Eletrônico,2,223
4757,2024-01-04 07:16:00,23,34,Alimento,7,57
4758,2024-01-04 07:17:00,85,72,Brinquedo,2,157
4759,2024-01-04 07:18:00,62,139,Alimento,1,201
4760,2024-01-04 07:19:00,36,135,Alimento,5,171
4761,2024-01-04 07:20:00,16,32,Móvel,6,48
4762,2024-01-04 07:21:00,75,35,Alimento,7,110
4763,2024-01-04 07:22:00,27,118,Brinquedo,1,145
4764,2024-01-04 07:23:00,114,171,Eletrônico,6,285
4765,2024-01-04 07:24:00,15,102,Móvel,5,117
4766,2024-01-04 07:25:00,10,140,Eletrônico,8,150
4767,2024-01-04 07:26:00,48,95,Brinquedo,8,143
4768,2024-01-04 07:27:00,77,113,Alimento,3,190
4769,2024-01-04 07:28:00,28,80,Brinquedo,3,108
4770,2024-01-04 07:29:00,31,64,Móvel,8,95
4771,2024-01-04 07:30:00,84,157,Móvel,7,241
4772,2024-01-04 07:31:00,90,176,Vestuário,5,266
4773,2024-01-04 07:32:00,58,23,Brinquedo,8,81
4774,2024-01-04 07:33:00,13,28,Eletrônico,1,41
4775,2024-01-04 07:34:00,65,120,Eletrônico,8,185
4776,2024-01-04 07:35:00,43,54,Brinquedo,7,97
4777,2024-01-04 07:36:00,98,137,Alimento,8,235
4778,2024-01-04 07:37:00,21,18,Alimento,9,39
4779,2024-01-04 07:38:00,106,33,Brinquedo,7,139
4780,2024-01-04 07:39:00,97,103,Brinquedo,5,200
4781,2024-01-04 07:40:00,39,121,Eletrônico,4,160
4782,2024-01-04 07:41:00,69,51,Eletrônico,1,120
4783,2024-01-04 07:42:00,28,171,Móvel,8,199
4784,2024-01-04 07:43:00,75,55,Eletrônico,9,130
4785,2024-01-04 07:44:00,53,173,Alimento,1,226
4786,2024-01-04 07:45:00,53,115,Eletrônico,4,168
4787,2024-01-04 07:46:00,50,48,Vestuário,7,98
4788,2024-01-04 07:47:00,39,175,Móvel,8,214
4789,2024-01-04 07:48:00,88,83,Alimento,8,171
4790,2024-01-04 07:49:00,115,164,Alimento,4,279
4791,2024-01-04 07:50:00,94,142,Vestuário,9,236
4792,2024-01-04 07:51:00,115,11,Móvel,1,126
4793,2024-01-04 07:52:00,93,37,Vestuário,1,130
4794,2024-01-04 07:53:00,28,79,Móvel,4,107
4795,2024-01-04 07:54:00,116,174,Eletrônico,3,290
4796,2024-01-04 07:55:00,116,34,Eletrônico,2,150
4797,2024-01-04 07:56:00,53,120,Vestuário,4,173
4798,2024-01-04 07:57:00,94,61,Alimento,7,155
4799,2024-01-04 07:58:00,65,30,Alimento,9,95
4800,2024-01-04 07:59:00,76,154,Vestuário,5,230
4801,2024-01-04 08:00:00,75,158,Alimento,1,233
4802,2024-01-04 08:01:00,24,46,Eletrônico,7,70
4803,2024-01-04 08:02:00,44,168,Brinquedo,4,212
4804,2024-01-04 08:03:00,89,39,Vestuário,3,128
4805,2024-01-04 08:04:00,57,134,Alimento,7,191
4806,2024-01-04 08:05:00,47,105,Brinquedo,1,152
4807,2024-01-04 08:06:00,53,85,Eletrônico,2,138
4808,2024-01-04 08:07:00,98,15,Móvel,7,113
4809,2024-01-04 08:08:00,15,136,Brinquedo,5,151
4810,2024-01-04 08:09:00,50,27,Vestuário,7,77
4811,2024-01-04 08:10:00,73,112,Móvel,6,185
4812,2024-01-04 08:11:00,80,49,Alimento,9,129
4813,2024-01-04 08:12:00,74,114,Vestuário,3,188
4814,2024-01-04 08:13:00,96,132,Alimento,5,228
4815,2024-01-04 08:14:00,25,11,Eletrônico,6,36
4816,2024-01-04 08:15:00,113,101,Brinquedo,6,214
4817,2024-01-04 08:16:00,111,28,Alimento,6,139
4818,2024-01-04 08:17:00,116,177,Vestuário,6,293
4819,2024-01-04 08:18:00,116,34,Brinquedo,4,150
4820,2024-01-04 08:19:00,31,14,Vestuário,5,45
4821,2024-01-04 08:20:00,58,27,Vestuário,6,85
4822,2024-01-04 08:21:00,88,17,Vestuário,8,105
4823,2024-01-04 08:22:00,61,44,Eletrônico,7,105
4824,2024-01-04 08:23:00,45,51,Eletrônico,4,96
4825,2024-01-04 08:24:00,65,32,Brinquedo,8,97
4826,2024-01-04 08:25:00,41,29,Eletrônico,7,70
4827,2024-01-04 08:26:00,98,176,Alimento,3,274
4828,2024-01-04 08:27:00,79,65,Vestuário,4,144
4829,2024-01-04 08:28:00,116,46,Eletrônico,5,162
4830,2024-01-04 08:29:00,90,105,Eletrônico,5,195
4831,2024-01-04 08:30:00,85,52,Eletrônico,2,137
4832,2024-01-04 08:31:00,46,157,Eletrônico,8,203
4833,2024-01-04 08:32:00,41,148,Brinquedo,2,189
4834,2024-01-04 08:33:00,15,32,Móvel,8,47
4835,2024-01-04 08:34:00,115,120,Móvel,1,235
4836,2024-01-04 08:35:00,47,124,Brinquedo,4,171
4837,2024-01-04 08:36:00,48,45,Móvel,7,93
4838,2024-01-04 08:37:00,72,74,Eletrônico,6,146
4839,2024-01-04 08:38:00,81,142,Vestuário,4,223
4840,2024-01-04 08:39:00,52,57,Vestuário,6,109
4841,2024-01-04 08:40:00,18,119,Móvel,1,137
4842,2024-01-04 08:41:00,112,129,Brinquedo,2,241
4843,2024-01-04 08:42:00,60,36,Vestuário,5,96
4844,2024-01-04 08:43:00,115,77,Brinquedo,5,192
4845,2024-01-04 08:44:00,82,67,Brinquedo,2,149
4846,2024-01-04 08:45:00,84,96,Eletrônico,1,180
4847,2024-01-04 08:46:00,62,65,Alimento,6,127
4848,2024-01-04 08:47:00,113,113,Alimento,3,226
4849,2024-01-04 08:48:00,25,130,Vestuário,5,155
4850,2024-01-04 08:49:00,115,53,Móvel,8,168
4851,2024-01-04 08:50:00,88,126,Móvel,8,214
4852,2024-01-04 08:51:00,77,169,Eletrônico,6,246
4853,2024-01-04 08:52:00,25,26,Alimento,3,51
4854,2024-01-04 08:53:00,74,91,Alimento,2,165
4855,2024-01-04 08:54:00,13,101,Vestuário,3,114
4856,2024-01-04 08:55:00,78,74,Móvel,7,152
4857,2024-01-04 08:56:00,39,154,Alimento,3,193
4858,2024-01-04 08:57:00,56,28,Móvel,9,84
4859,2024-01-04 08:58:00,108,74,Alimento,4,182
4860,2024-01-04 08:59:00,15,37,Brinquedo,7,52
4861,2024-01-04 09:00:00,45,47,Vestuário,5,92
4862,2024-01-04 09:01:00,56,66,Móvel,2,122
4863,2024-01-04 09:02:00,10,55,Eletrônico,1,65
4864,2024-01-04 09:03:00,78,146,Vestuário,2,224
4865,2024-01-04 09:04:00,116,149,Brinquedo,2,265
4866,2024-01-04 09:05:00,79,14,Eletrônico,9,93
4867,2024-01-04 09:06:00,10,20,Brinquedo,8,30
4868,2024-01-04 09:07:00,51,128,Brinquedo,3,179
4869,2024-01-04 09:08:00,110,102,Móvel,5,212
4870,2024-01-04 09:09:00,20,94,Alimento,5,114
4871,2024-01-04 09:10:00,74,99,Eletrônico,5,173
4872,2024-01-04 09:11:00,102,10,Móvel,8,112
4873,2024-01-04 09:12:00,15,38,Móvel,9,53
4874,2024-01-04 09:13:00,53,67,Brinquedo,3,120
4875,2024-01-04 09:14:00,107,82,Móvel,1,189
4876,2024-01-04 09:15:00,70,15,Eletrônico,5,85
4877,2024-01-04 09:16:00,78,116,Alimento,4,194
4878,2024-01-04 09:17:00,88,106,Alimento,8,194
4879,2024-01-04 09:18:00,21,119,Vestuário,6,140
4880,2024-01-04 09:19:00,40,78,Vestuário,6,118
4881,2024-01-04 09:20:00,83,41,Brinquedo,6,124
4882,2024-01-04 09:21:00,48,162,Brinquedo,2,210
4883,2024-01-04 09:22:00,42,128,Vestuário,3,170
4884,2024-01-04 09:23:00,24,95,Brinquedo,4,119
4885,2024-01-04 09:24:00,72,95,Eletrônico,6,167
4886,2024-01-04 09:25:00,70,137,Vestuário,5,207
4887,2024-01-04 09:26:00,110,30,Vestuário,4,140
4888,2024-01-04 09:27:00,21,80,Móvel,3,101
4889,2024-01-04 09:28:00,39,60,Brinquedo,7,99
4890,2024-01-04 09:29:00,17,30,Alimento,8,47
4891,2024-01-04 09:30:00,115,139,Alimento,7,254
4892,2024-01-04 09:31:00,14,82,Brinquedo,3,96
4893,2024-01-04 09:32:00,55,40,Vestuário,8,95
4894,2024-01-04 09:33:00,102,89,Brinquedo,7,191
4895,2024-01-04 09:34:00,39,100,Vestuário,7,139
4896,2024-01-04 09:35:00,55,97,Vestuário,7,152
4897,2024-01-04 09:36:00,34,161,Vestuário,8,195
4898,2024-01-04 09:37:00,67,45,Alimento,2,112
4899,2024-01-04 09:38:00,44,122,Eletrônico,9,166
4900,2024-01-04 09:39:00,71,72,Eletrônico,6,143
4901,2024-01-04 09:40:00,93,113,Brinquedo,1,206
4902,2024-01-04 09:41:00,60,29,Móvel,9,89
4903,2024-01-04 09:42:00,90,167,Eletrônico,7,257
4904,2024-01-04 09:43:00,83,178,Brinquedo,6,261
4905,2024-01-04 09:44:00,77,152,Eletrônico,2,229
4906,2024-01-04 09:45:00,32,162,Vestuário,7,194
4907,2024-01-04 09:46:00,40,84,Vestuário,2,124
4908,2024-01-04 09:47:00,119,174,Alimento,5,293
4909,2024-01-04 09:48:00,88,14,Eletrônico,7,102
4910,2024-01-04 09:49:00,57,112,Vestuário,9,169
4911,2024-01-04 09:50:00,31,111,Alimento,3,142
4912,2024-01-04 09:51:00,65,108,Vestuário,7,173
4913,2024-01-04 09:52:00,18,178,Alimento,4,196
4914,2024-01-04 09:53:00,38,152,Vestuário,2,190
4915,2024-01-04 09:54:00,82,172,Vestuário,2,254
4916,2024-01-04 09:55:00,101,62,Alimento,2,163
4917,2024-01-04 09:56:00,45,173,Eletrônico,1,218
4918,2024-01-04 09:57:00,49,123,Eletrônico,6,172
4919,2024-01-04 09:58:00,39,141,Alimento,1,180
4920,2024-01-04 09:59:00,24,14,Móvel,6,38
4921,2024-01-04 10:00:00,95,59,Vestuário,7,154
4922,2024-01-04 10:01:00,115,27,Eletrônico,6,142
4923,2024-01-04 10:02:00,117,167,Vestuário,4,284
4924,2024-01-04 10:03:00,72,22,Eletrônico,4,94
4925,2024-01-04 10:04:00,25,163,Brinquedo,6,188
4926,2024-01-04 10:05:00,47,15,Eletrônico,4,62
4927,2024-01-04 10:06:00,96,97,Eletrônico,3,193
4928,2024-01-04 10:07:00,67,68,Vestuário,6,135
4929,2024-01-04 10:08:00,102,99,Alimento,1,201
4930,2024-01-04 10:09:00,85,92,Brinquedo,1,177
4931,2024-01-04 10:10:00,114,39,Eletrônico,2,153
4932,2024-01-04 10:11:00,112,76,Vestuário,2,188
4933,2024-01-04 10:12:00,72,131,Eletrônico,4,203
4934,2024-01-04 10:13:00,82,171,Eletrônico,6,253
4935,2024-01-04 10:14:00,30,87,Eletrônico,6,117
4936,2024-01-04 10:15:00,56,61,Vestuário,1,117
4937,2024-01-04 10:16:00,17,46,Alimento,6,63
4938,2024-01-04 10:17:00,11,168,Brinquedo,1,179
4939,2024-01-04 10:18:00,11,146,Alimento,8,157
4940,2024-01-04 10:19:00,57,156,Vestuário,3,213
4941,2024-01-04 10:20:00,18,63,Eletrônico,3,81
4942,2024-01-04 10:21:00,65,91,Vestuário,9,156
4943,2024-01-04 10:22:00,115,140,Eletrônico,9,255
4944,2024-01-04 10:23:00,30,175,Móvel,7,205
4945,2024-01-04 10:24:00,18,143,Eletrônico,5,161
4946,2024-01-04 10:25:00,94,39,Alimento,4,133
4947,2024-01-04 10:26:00,105,40,Brinquedo,8,145
4948,2024-01-04 10:27:00,40,41,Brinquedo,4,81
4949,2024-01-04 10:28:00,18,109,Vestuário,5,127
4950,2024-01-04 10:29:00,101,52,Brinquedo,7,153
4951,2024-01-04 10:30:00,74,36,Alimento,3,110
4952,2024-01-04 10:31:00,37,29,Móvel,8,66
4953,2024-01-04 10:32:00,82,176,Brinquedo,2,258
4954,2024-01-04 10:33:00,40,97,Móvel,3,137
4955,2024-01-04 10:34:00,13,141,Vestuário,5,154
4956,2024-01-04 10:35:00,15,155,Móvel,2,170
4957,2024-01-04 10:36:00,43,31,Móvel,5,74
4958,2024-01-04 10:37:00,81,132,Brinquedo,9,213
4959,2024-01-04 10:38:00,91,73,Alimento,1,164
4960,2024-01-04 10:39:00,119,122,Móvel,3,241
4961,2024-01-04 10:40:00,73,151,Móvel,5,224
4962,2024-01-04 10:41:00,43,113,Eletrônico,2,156
4963,2024-01-04 10:42:00,48,104,Vestuário,2,152
4964,2024-01-04 10:43:00,31,146,Vestuário,1,177
4965,2024-01-04 10:44:00,18,12,Eletrônico,6,30
4966,2024-01-04 10:45:00,32,37,Alimento,7,69
4967,2024-01-04 10:46:00,15,85,Eletrônico,5,100
4968,2024-01-04 10:47:00,17,47,Vestuário,6,64
4969,2024-01-04 10:48:00,91,146,Vestuário,1,237
4970,2024-01-04 10:49:00,57,24,Eletrônico,2,81
4971,2024-01-04 10:50:00,107,97,Brinquedo,8,204
4972,2024-01-04 10:51:00,57,13,Móvel,1,70
4973,2024-01-04 10:52:00,34,175,Vestuário,5,209
4974,2024-01-04 10:53:00,24,161,Vestuário,4,185
4975,2024-01-04 10:54:00,104,119,Vestuário,3,223
4976,2024-01-04 10:55:00,64,126,Móvel,9,190
4977,2024-01-04 10:56:00,85,18,Eletrônico,4,103
4978,2024-01-04 10:57:00,47,52,Móvel,8,99
4979,2024-01-04 10:58:00,92,84,Brinquedo,2,176
4980,2024-01-04 10:59:00,90,139,Móvel,9,229
4981,2024-01-04 11:00:00,98,132,Alimento,8,230
4982,2024-01-04 11:01:00,40,123,Móvel,2,163
4983,2024-01-04 11:02:00,40,26,Móvel,6,66
4984,2024-01-04 11:03:00,22,88,Brinquedo,7,110
4985,2024-01-04 11:04:00,112,106,Vestuário,2,218
4986,2024-01-04 11:05:00,107,15,Alimento,2,122
4987,2024-01-04 11:06:00,119,106,Brinquedo,5,225
4988,2024-01-04 11:07:00,112,115,Móvel,6,227
4989,2024-01-04 11:08:00,99,19,Eletrônico,7,118
4990,2024-01-04 11:09:00,29,164,Eletrônico,7,193
4991,2024-01-04 11:10:00,70,86,Móvel,5,156
4992,2024-01-04 11:11:00,54,69,Móvel,9,123
4993,2024-01-04 11:12:00,47,37,Vestuário,5,84
4994,2024-01-04 11:13:00,54,13,Eletrônico,7,67
4995,2024-01-04 11:14:00,80,27,Brinquedo,2,107
4996,2024-01-04 11:15:00,81,111,Alimento,5,192
4997,2024-01-04 11:16:00,23,55,Alimento,2,78
4998,2024-01-04 11:17:00,30,18,Alimento,9,48
4999,2024-01-04 11:18:00,76,125,Móvel,1,201
5000,2024-01-04 11:19:00,14,159,Alimento,4,173
5001,2024-01-04 11:20:00,57,24,Brinquedo,3,81
5002,2024-01-04 11:21:00,19,86,Móvel,1,105
5003,2024-01-04 11:22:00,93,100,Móvel,3,193
5004,2024-01-04 11:23:00,109,96,Móvel,4,205
5005,2024-01-04 11:24:00,116,114,Alimento,1,230
5006,2024-01-04 11:25:00,80,140,Brinquedo,5,220
5007,2024-01-04 11:26:00,46,114,Móvel,6,160
5008,2024-01-04 11:27:00,21,123,Vestuário,3,144
5009,2024-01-04 11:28:00,79,96,Eletrônico,2,175
5010,2024-01-04 11:29:00,48,82,Móvel,2,130
5011,2024-01-04 11:30:00,44,41,Brinquedo,9,85
5012,2024-01-04 11:31:00,82,114,Vestuário,5,196
5013,2024-01-04 11:32:00,77,89,Alimento,2,166
5014,2024-01-04 11:33:00,52,49,Eletrônico,7,101
5015,2024-01-04 11:34:00,89,80,Móvel,4,169
5016,2024-01-04 11:35:00,52,144,Brinquedo,2,196
5017,2024-01-04 11:36:00,11,10,Brinquedo,6,21
5018,2024-01-04 11:37:00,94,158,Móvel,1,252
5019,2024-01-04 11:38:00,91,40,Brinquedo,4,131
5020,2024-01-04 11:39:00,78,53,Móvel,3,131
5021,2024-01-04 11:40:00,21,120,Móvel,6,141
5022,2024-01-04 11:41:00,52,63,Brinquedo,9,115
5023,2024-01-04 11:42:00,41,76,Brinquedo,4,117
5024,2024-01-04 11:43:00,42,96,Vestuário,4,138
5025,2024-01-04 11:44:00,35,116,Brinquedo,8,151
5026,2024-01-04 11:45:00,52,141,Brinquedo,2,193
5027,2024-01-04 11:46:00,49,160,Brinquedo,7,209
5028,2024-01-04 11:47:00,58,137,Alimento,8,195
5029,2024-01-04 11:48:00,41,154,Móvel,8,195
5030,2024-01-04 11:49:00,108,71,Móvel,5,179
5031,2024-01-04 11:50:00,32,166,Móvel,3,198
5032,2024-01-04 11:51:00,45,86,Eletrônico,8,131
5033,2024-01-04 11:52:00,100,99,Eletrônico,9,199
5034,2024-01-04 11:53:00,60,45,Eletrônico,2,105
5035,2024-01-04 11:54:00,108,36,Vestuário,2,144
5036,2024-01-04 11:55:00,11,83,Alimento,3,94
5037,2024-01-04 11:56:00,29,171,Móvel,1,200
5038,2024-01-04 11:57:00,46,139,Alimento,6,185
5039,2024-01-04 11:58:00,119,34,Eletrônico,3,153
5040,2024-01-04 11:59:00,103,73,Vestuário,9,176
5041,2024-01-04 12:00:00,19,32,Eletrônico,5,51
5042,2024-01-04 12:01:00,11,113,Alimento,6,124
5043,2024-01-04 12:02:00,34,22,Eletrônico,3,56
5044,2024-01-04 12:03:00,37,82,Vestuário,3,119
5045,2024-01-04 12:04:00,42,79,Eletrônico,5,121
5046,2024-01-04 12:05:00,117,73,Alimento,2,190
5047,2024-01-04 12:06:00,110,141,Móvel,7,251
5048,2024-01-04 12:07:00,87,26,Alimento,2,113
5049,2024-01-04 12:08:00,82,97,Brinquedo,5,179
5050,2024-01-04 12:09:00,24,121,Vestuário,5,145
5051,2024-01-04 12:10:00,54,34,Móvel,3,88
5052,2024-01-04 12:11:00,40,10,Móvel,4,50
5053,2024-01-04 12:12:00,86,49,Brinquedo,9,135
5054,2024-01-04 12:13:00,18,50,Móvel,7,68
5055,2024-01-04 12:14:00,24,112,Brinquedo,2,136
5056,2024-01-04 12:15:00,31,84,Alimento,9,115
5057,2024-01-04 12:16:00,65,70,Brinquedo,3,135
5058,2024-01-04 12:17:00,20,87,Eletrônico,8,107
5059,2024-01-04 12:18:00,91,148,Alimento,9,239
5060,2024-01-04 12:19:00,112,148,Alimento,8,260
5061,2024-01-04 12:20:00,33,104,Vestuário,7,137
5062,2024-01-04 12:21:00,76,18,Alimento,7,94
5063,2024-01-04 12:22:00,110,74,Alimento,1,184
5064,2024-01-04 12:23:00,111,108,Brinquedo,4,219
5065,2024-01-04 12:24:00,42,73,Móvel,6,115
5066,2024-01-04 12:25:00,44,108,Alimento,8,152
5067,2024-01-04 12:26:00,28,40,Eletrônico,7,68
5068,2024-01-04 12:27:00,88,42,Alimento,8,130
5069,2024-01-04 12:28:00,17,38,Móvel,6,55
5070,2024-01-04 12:29:00,67,89,Eletrônico,7,156
5071,2024-01-04 12:30:00,27,153,Brinquedo,1,180
5072,2024-01-04 12:31:00,73,25,Eletrônico,9,98
5073,2024-01-04 12:32:00,48,132,Eletrônico,8,180
5074,2024-01-04 12:33:00,51,152,Móvel,6,203
5075,2024-01-04 12:34:00,24,44,Vestuário,4,68
5076,2024-01-04 12:35:00,83,133,Móvel,4,216
5077,2024-01-04 12:36:00,80,96,Alimento,8,176
5078,2024-01-04 12:37:00,24,164,Vestuário,7,188
5079,2024-01-04 12:38:00,88,30,Brinquedo,2,118
5080,2024-01-04 12:39:00,36,126,Móvel,4,162
5081,2024-01-04 12:40:00,79,10,Brinquedo,4,89
5082,2024-01-04 12:41:00,13,90,Eletrônico,8,103
5083,2024-01-04 12:42:00,48,116,Móvel,6,164
5084,2024-01-04 12:43:00,78,170,Brinquedo,4,248
5085,2024-01-04 12:44:00,26,105,Móvel,6,131
5086,2024-01-04 12:45:00,61,165,Eletrônico,7,226
5087,2024-01-04 12:46:00,102,126,Eletrônico,6,228
5088,2024-01-04 12:47:00,85,132,Brinquedo,2,217
5089,2024-01-04 12:48:00,60,15,Vestuário,1,75
5090,2024-01-04 12:49:00,118,40,Eletrônico,1,158
5091,2024-01-04 12:50:00,102,58,Eletrônico,6,160
5092,2024-01-04 12:51:00,97,117,Móvel,9,214
5093,2024-01-04 12:52:00,55,138,Móvel,9,193
5094,2024-01-04 12:53:00,55,84,Eletrônico,8,139
5095,2024-01-04 12:54:00,50,57,Móvel,5,107
5096,2024-01-04 12:55:00,34,112,Vestuário,1,146
5097,2024-01-04 12:56:00,39,15,Móvel,7,54
5098,2024-01-04 12:57:00,52,152,Alimento,1,204
5099,2024-01-04 12:58:00,104,132,Vestuário,7,236
5100,2024-01-04 12:59:00,29,54,Alimento,1,83
5101,2024-01-04 13:00:00,43,171,Brinquedo,1,214
5102,2024-01-04 13:01:00,53,172,Alimento,9,225
5103,2024-01-04 13:02:00,110,149,Móvel,3,259
5104,2024-01-04 13:03:00,14,134,Eletrônico,3,148
5105,2024-01-04 13:04:00,118,70,Móvel,3,188
5106,2024-01-04 13:05:00,45,96,Eletrônico,5,141
5107,2024-01-04 13:06:00,32,140,Vestuário,1,172
5108,2024-01-04 13:07:00,98,47,Vestuário,4,145
5109,2024-01-04 13:08:00,29,177,Vestuário,5,206
5110,2024-01-04 13:09:00,20,133,Alimento,6,153
5111,2024-01-04 13:10:00,81,106,Móvel,4,187
5112,2024-01-04 13:11:00,60,100,Vestuário,7,160
5113,2024-01-04 13:12:00,86,10,Vestuário,5,96
5114,2024-01-04 13:13:00,34,101,Vestuário,7,135
5115,2024-01-04 13:14:00,101,170,Eletrônico,5,271
5116,2024-01-04 13:15:00,32,62,Eletrônico,2,94
5117,2024-01-04 13:16:00,112,82,Eletrônico,2,194
5118,2024-01-04 13:17:00,71,41,Móvel,2,112
5119,2024-01-04 13:18:00,44,121,Vestuário,8,165
5120,2024-01-04 13:19:00,102,100,Eletrônico,7,202
5121,2024-01-04 13:20:00,27,64,Vestuário,7,91
5122,2024-01-04 13:21:00,50,54,Vestuário,4,104
5123,2024-01-04 13:22:00,71,123,Móvel,4,194
5124,2024-01-04 13:23:00,82,134,Alimento,3,216
5125,2024-01-04 13:24:00,105,51,Alimento,5,156
5126,2024-01-04 13:25:00,117,61,Alimento,9,178
5127,2024-01-04 13:26:00,19,170,Eletrônico,2,189
5128,2024-01-04 13:27:00,91,13,Vestuário,2,104
5129,2024-01-04 13:28:00,36,74,Eletrônico,1,110
5130,2024-01-04 13:29:00,53,165,Móvel,6,218
5131,2024-01-04 13:30:00,24,176,Móvel,5,200
5132,2024-01-04 13:31:00,11,32,Alimento,1,43
5133,2024-01-04 13:32:00,23,70,Brinquedo,7,93
5134,2024-01-04 13:33:00,35,123,Vestuário,3,158
5135,2024-01-04 13:34:00,105,172,Brinquedo,7,277
5136,2024-01-04 13:35:00,18,59,Brinquedo,4,77
5137,2024-01-04 13:36:00,37,172,Móvel,1,209
5138,2024-01-04 13:37:00,94,97,Eletrônico,1,191
5139,2024-01-04 13:38:00,60,158,Móvel,8,218
5140,2024-01-04 13:39:00,40,77,Móvel,8,117
5141,2024-01-04 13:40:00,95,44,Alimento,2,139
5142,2024-01-04 13:41:00,90,115,Alimento,1,205
5143,2024-01-04 13:42:00,12,80,Móvel,2,92
5144,2024-01-04 13:43:00,38,63,Alimento,6,101
5145,2024-01-04 13:44:00,44,41,Vestuário,8,85
5146,2024-01-04 13:45:00,77,40,Brinquedo,9,117
5147,2024-01-04 13:46:00,92,83,Móvel,7,175
5148,2024-01-04 13:47:00,26,27,Eletrônico,7,53
5149,2024-01-04 13:48:00,31,155,Alimento,3,186
5150,2024-01-04 13:49:00,41,109,Brinquedo,4,150
5151,2024-01-04 13:50:00,68,19,Eletrônico,2,87
5152,2024-01-04 13:51:00,34,135,Alimento,6,169
5153,2024-01-04 13:52:00,60,151,Móvel,8,211
5154,2024-01-04 13:53:00,41,12,Eletrônico,8,53
5155,2024-01-04 13:54:00,82,112,Brinquedo,2,194
5156,2024-01-04 13:55:00,15,21,Eletrônico,7,36
5157,2024-01-04 13:56:00,95,92,Vestuário,2,187
5158,2024-01-04 13:57:00,53,110,Alimento,1,163
5159,2024-01-04 13:58:00,13,67,Brinquedo,9,80
5160,2024-01-04 13:59:00,33,177,Alimento,5,210
5161,2024-01-04 14:00:00,21,33,Móvel,5,54
5162,2024-01-04 14:01:00,89,140,Eletrônico,9,229
5163,2024-01-04 14:02:00,27,51,Brinquedo,4,78
5164,2024-01-04 14:03:00,58,90,Alimento,6,148
5165,2024-01-04 14:04:00,87,127,Móvel,5,214
5166,2024-01-04 14:05:00,50,29,Móvel,4,79
5167,2024-01-04 14:06:00,34,18,Alimento,5,52
5168,2024-01-04 14:07:00,13,176,Brinquedo,2,189
5169,2024-01-04 14:08:00,25,112,Alimento,7,137
5170,2024-01-04 14:09:00,40,60,Alimento,8,100
5171,2024-01-04 14:10:00,15,154,Brinquedo,5,169
5172,2024-01-04 14:11:00,70,96,Móvel,2,166
5173,2024-01-04 14:12:00,13,129,Móvel,5,142
5174,2024-01-04 14:13:00,53,85,Alimento,8,138
5175,2024-01-04 14:14:00,69,137,Eletrônico,2,206
5176,2024-01-04 14:15:00,97,176,Eletrônico,6,273
5177,2024-01-04 14:16:00,103,159,Móvel,7,262
5178,2024-01-04 14:17:00,113,39,Vestuário,1,152
5179,2024-01-04 14:18:00,94,168,Móvel,8,262
5180,2024-01-04 14:19:00,111,161,Eletrônico,6,272
5181,2024-01-04 14:20:00,53,168,Vestuário,3,221
5182,2024-01-04 14:21:00,10,31,Alimento,6,41
5183,2024-01-04 14:22:00,99,17,Alimento,1,116
5184,2024-01-04 14:23:00,100,98,Vestuário,1,198
5185,2024-01-04 14:24:00,63,83,Brinquedo,5,146
5186,2024-01-04 14:25:00,118,166,Eletrônico,4,284
5187,2024-01-04 14:26:00,53,95,Móvel,1,148
5188,2024-01-04 14:27:00,15,66,Móvel,5,81
5189,2024-01-04 14:28:00,99,170,Eletrônico,9,269
5190,2024-01-04 14:29:00,102,128,Brinquedo,5,230
5191,2024-01-04 14:30:00,114,120,Alimento,4,234
5192,2024-01-04 14:31:00,81,68,Alimento,2,149
5193,2024-01-04 14:32:00,58,157,Alimento,7,215
5194,2024-01-04 14:33:00,116,121,Eletrônico,5,237
5195,2024-01-04 14:34:00,75,92,Brinquedo,1,167
5196,2024-01-04 14:35:00,75,45,Alimento,3,120
5197,2024-01-04 14:36:00,50,13,Alimento,8,63
5198,2024-01-04 14:37:00,22,157,Alimento,3,179
5199,2024-01-04 14:38:00,28,127,Eletrônico,4,155
5200,2024-01-04 14:39:00,54,63,Alimento,2,117
5201,2024-01-04 14:40:00,65,145,Vestuário,7,210
5202,2024-01-04 14:41:00,63,28,Vestuário,7,91
5203,2024-01-04 14:42:00,41,178,Alimento,5,219
5204,2024-01-04 14:43:00,45,46,Brinquedo,4,91
5205,2024-01-04 14:44:00,21,148,Brinquedo,8,169
5206,2024-01-04 14:45:00,86,61,Vestuário,8,147
5207,2024-01-04 14:46:00,45,123,Eletrônico,9,168
5208,2024-01-04 14:47:00,81,157,Brinquedo,2,238
5209,2024-01-04 14:48:00,81,43,Eletrônico,7,124
5210,2024-01-04 14:49:00,33,131,Alimento,8,164
5211,2024-01-04 14:50:00,100,110,Vestuário,2,210
5212,2024-01-04 14:51:00,64,110,Brinquedo,7,174
5213,2024-01-04 14:52:00,47,69,Alimento,6,116
5214,2024-01-04 14:53:00,64,11,Eletrônico,5,75
5215,2024-01-04 14:54:00,67,54,Alimento,4,121
5216,2024-01-04 14:55:00,60,106,Eletrônico,8,166
5217,2024-01-04 14:56:00,67,124,Eletrônico,9,191
5218,2024-01-04 14:57:00,106,109,Móvel,8,215
5219,2024-01-04 14:58:00,22,48,Móvel,9,70
5220,2024-01-04 14:59:00,110,75,Brinquedo,6,185
5221,2024-01-04 15:00:00,25,73,Alimento,3,98
5222,2024-01-04 15:01:00,49,134,Vestuário,5,183
5223,2024-01-04 15:02:00,96,81,Brinquedo,1,177
5224,2024-01-04 15:03:00,61,170,Alimento,9,231
5225,2024-01-04 15:04:00,34,168,Brinquedo,3,202
5226,2024-01-04 15:05:00,86,30,Móvel,3,116
5227,2024-01-04 15:06:00,36,83,Móvel,1,119
5228,2024-01-04 15:07:00,114,40,Brinquedo,4,154
5229,2024-01-04 15:08:00,96,16,Móvel,8,112
5230,2024-01-04 15:09:00,48,166,Eletrônico,1,214
5231,2024-01-04 15:10:00,30,96,Alimento,4,126
5232,2024-01-04 15:11:00,37,72,Alimento,5,109
5233,2024-01-04 15:12:00,89,162,Alimento,2,251
5234,2024-01-04 15:13:00,33,142,Vestuário,3,175
5235,2024-01-04 15:14:00,34,63,Móvel,9,97
5236,2024-01-04 15:15:00,87,125,Alimento,8,212
5237,2024-01-04 15:16:00,94,56,Vestuário,4,150
5238,2024-01-04 15:17:00,30,98,Vestuário,8,128
5239,2024-01-04 15:18:00,35,101,Móvel,1,136
5240,2024-01-04 15:19:00,61,71,Eletrônico,1,132
5241,2024-01-04 15:20:00,72,104,Eletrônico,9,176
5242,2024-01-04 15:21:00,71,144,Vestuário,1,215
5243,2024-01-04 15:22:00,44,12,Brinquedo,5,56
5244,2024-01-04 15:23:00,26,24,Eletrônico,3,50
5245,2024-01-04 15:24:00,110,77,Eletrônico,3,187
5246,2024-01-04 15:25:00,86,32,Móvel,5,118
5247,2024-01-04 15:26:00,118,123,Alimento,5,241
5248,2024-01-04 15:27:00,33,103,Vestuário,2,136
5249,2024-01-04 15:28:00,68,139,Brinquedo,1,207
5250,2024-01-04 15:29:00,21,115,Eletrônico,8,136
5251,2024-01-04 15:30:00,17,55,Alimento,7,72
5252,2024-01-04 15:31:00,39,71,Alimento,8,110
5253,2024-01-04 15:32:00,95,155,Vestuário,6,250
5254,2024-01-04 15:33:00,41,81,Eletrônico,8,122
5255,2024-01-04 15:34:00,117,134,Brinquedo,4,251
5256,2024-01-04 15:35:00,92,58,Vestuário,7,150
5257,2024-01-04 15:36:00,117,34,Alimento,1,151
5258,2024-01-04 15:37:00,56,34,Móvel,9,90
5259,2024-01-04 15:38:00,75,32,Móvel,6,107
5260,2024-01-04 15:39:00,54,43,Eletrônico,1,97
5261,2024-01-04 15:40:00,99,28,Eletrônico,2,127
5262,2024-01-04 15:41:00,21,101,Móvel,1,122
5263,2024-01-04 15:42:00,107,67,Eletrônico,5,174
5264,2024-01-04 15:43:00,43,50,Eletrônico,4,93
5265,2024-01-04 15:44:00,57,148,Alimento,5,205
5266,2024-01-04 15:45:00,82,80,Móvel,5,162
5267,2024-01-04 15:46:00,80,161,Eletrônico,8,241
5268,2024-01-04 15:47:00,108,66,Vestuário,7,174
5269,2024-01-04 15:48:00,39,22,Alimento,9,61
5270,2024-01-04 15:49:00,55,44,Móvel,8,99
5271,2024-01-04 15:50:00,116,119,Brinquedo,5,235
5272,2024-01-04 15:51:00,88,177,Eletrônico,1,265
5273,2024-01-04 15:52:00,102,30,Brinquedo,4,132
5274,2024-01-04 15:53:00,70,135,Alimento,7,205
5275,2024-01-04 15:54:00,43,112,Eletrônico,2,155
5276,2024-01-04 15:55:00,26,148,Brinquedo,6,174
5277,2024-01-04 15:56:00,99,82,Alimento,4,181
5278,2024-01-04 15:57:00,48,177,Alimento,8,225
5279,2024-01-04 15:58:00,109,126,Vestuário,4,235
5280,2024-01-04 15:59:00,67,47,Alimento,5,114
5281,2024-01-04 16:00:00,63,50,Móvel,1,113
5282,2024-01-04 16:01:00,15,68,Móvel,9,83
5283,2024-01-04 16:02:00,99,87,Eletrônico,6,186
5284,2024-01-04 16:03:00,91,96,Vestuário,5,187
5285,2024-01-04 16:04:00,44,114,Móvel,9,158
5286,2024-01-04 16:05:00,30,146,Eletrônico,4,176
5287,2024-01-04 16:06:00,73,179,Vestuário,1,252
5288,2024-01-04 16:07:00,88,86,Alimento,1,174
5289,2024-01-04 16:08:00,80,156,Brinquedo,4,236
5290,2024-01-04 16:09:00,29,20,Brinquedo,1,49
5291,2024-01-04 16:10:00,81,146,Alimento,5,227
5292,2024-01-04 16:11:00,13,131,Eletrônico,2,144
5293,2024-01-04 16:12:00,90,166,Eletrônico,1,256
5294,2024-01-04 16:13:00,51,118,Brinquedo,5,169
5295,2024-01-04 16:14:00,17,101,Vestuário,2,118
5296,2024-01-04 16:15:00,10,53,Eletrônico,5,63
5297,2024-01-04 16:16:00,47,45,Alimento,8,92
5298,2024-01-04 16:17:00,39,166,Vestuário,9,205
5299,2024-01-04 16:18:00,91,166,Eletrônico,4,257
5300,2024-01-04 16:19:00,45,37,Móvel,8,82
5301,2024-01-04 16:20:00,20,53,Alimento,2,73
5302,2024-01-04 16:21:00,60,172,Eletrônico,3,232
5303,2024-01-04 16:22:00,84,163,Vestuário,1,247
5304,2024-01-04 16:23:00,54,103,Alimento,2,157
5305,2024-01-04 16:24:00,75,158,Alimento,9,233
5306,2024-01-04 16:25:00,76,26,Eletrônico,2,102
5307,2024-01-04 16:26:00,84,98,Brinquedo,4,182
5308,2024-01-04 16:27:00,91,135,Móvel,4,226
5309,2024-01-04 16:28:00,73,102,Móvel,5,175
5310,2024-01-04 16:29:00,101,83,Móvel,7,184
5311,2024-01-04 16:30:00,74,150,Eletrônico,4,224
5312,2024-01-04 16:31:00,51,77,Eletrônico,2,128
5313,2024-01-04 16:32:00,81,155,Brinquedo,3,236
5314,2024-01-04 16:33:00,83,120,Móvel,3,203
5315,2024-01-04 16:34:00,106,30,Brinquedo,1,136
5316,2024-01-04 16:35:00,52,135,Eletrônico,2,187
5317,2024-01-04 16:36:00,19,35,Alimento,7,54
5318,2024-01-04 16:37:00,78,115,Brinquedo,9,193
5319,2024-01-04 16:38:00,57,47,Móvel,5,104
5320,2024-01-04 16:39:00,49,16,Eletrônico,6,65
5321,2024-01-04 16:40:00,61,116,Eletrônico,1,177
5322,2024-01-04 16:41:00,87,62,Alimento,7,149
5323,2024-01-04 16:42:00,55,151,Móvel,1,206
5324,2024-01-04 16:43:00,113,163,Vestuário,5,276
5325,2024-01-04 16:44:00,64,121,Eletrônico,7,185
5326,2024-01-04 16:45:00,54,160,Eletrônico,8,214
5327,2024-01-04 16:46:00,27,72,Alimento,4,99
5328,2024-01-04 16:47:00,109,51,Eletrônico,3,160
5329,2024-01-04 16:48:00,35,17,Vestuário,2,52
5330,2024-01-04 16:49:00,19,126,Alimento,9,145
5331,2024-01-04 16:50:00,17,121,Móvel,2,138
5332,2024-01-04 16:51:00,105,123,Eletrônico,5,228
5333,2024-01-04 16:52:00,52,141,Alimento,8,193
5334,2024-01-04 16:53:00,109,117,Vestuário,2,226
5335,2024-01-04 16:54:00,119,102,Brinquedo,6,221
5336,2024-01-04 16:55:00,83,179,Alimento,3,262
5337,2024-01-04 16:56:00,65,150,Eletrônico,5,215
5338,2024-01-04 16:57:00,106,91,Vestuário,5,197
5339,2024-01-04 16:58:00,51,50,Brinquedo,3,101
5340,2024-01-04 16:59:00,118,139,Eletrônico,2,257
5341,2024-01-04 17:00:00,105,44,Vestuário,7,149
5342,2024-01-04 17:01:00,92,61,Brinquedo,2,153
5343,2024-01-04 17:02:00,66,104,Alimento,6,170
5344,2024-01-04 17:03:00,99,17,Móvel,2,116
5345,2024-01-04 17:04:00,23,42,Móvel,6,65
5346,2024-01-04 17:05:00,109,55,Brinquedo,3,164
5347,2024-01-04 17:06:00,54,13,Alimento,5,67
5348,2024-01-04 17:07:00,65,135,Alimento,3,200
5349,2024-01-04 17:08:00,115,166,Eletrônico,5,281
5350,2024-01-04 17:09:00,57,98,Eletrônico,8,155
5351,2024-01-04 17:10:00,119,154,Móvel,3,273
5352,2024-01-04 17:11:00,99,60,Eletrônico,3,159
5353,2024-01-04 17:12:00,88,161,Móvel,5,249
5354,2024-01-04 17:13:00,102,74,Vestuário,4,176
5355,2024-01-04 17:14:00,113,87,Alimento,2,200
5356,2024-01-04 17:15:00,83,37,Móvel,4,120
5357,2024-01-04 17:16:00,112,15,Eletrônico,8,127
5358,2024-01-04 17:17:00,54,47,Alimento,3,101
5359,2024-01-04 17:18:00,86,173,Brinquedo,1,259
5360,2024-01-04 17:19:00,58,83,Eletrônico,5,141
5361,2024-01-04 17:20:00,57,151,Móvel,2,208
5362,2024-01-04 17:21:00,95,42,Vestuário,5,137
5363,2024-01-04 17:22:00,46,61,Móvel,2,107
5364,2024-01-04 17:23:00,65,155,Alimento,2,220
5365,2024-01-04 17:24:00,80,86,Eletrônico,1,166
5366,2024-01-04 17:25:00,106,141,Alimento,7,247
5367,2024-01-04 17:26:00,96,64,Brinquedo,6,160
5368,2024-01-04 17:27:00,13,163,Alimento,8,176
5369,2024-01-04 17:28:00,95,103,Eletrônico,8,198
5370,2024-01-04 17:29:00,44,145,Alimento,4,189
5371,2024-01-04 17:30:00,64,150,Alimento,2,214
5372,2024-01-04 17:31:00,41,16,Eletrônico,9,57
5373,2024-01-04 17:32:00,90,75,Eletrônico,3,165
5374,2024-01-04 17:33:00,32,161,Alimento,8,193
5375,2024-01-04 17:34:00,64,143,Vestuário,2,207
5376,2024-01-04 17:35:00,67,162,Alimento,5,229
5377,2024-01-04 17:36:00,50,74,Brinquedo,2,124
5378,2024-01-04 17:37:00,93,122,Brinquedo,4,215
5379,2024-01-04 17:38:00,69,145,Móvel,7,214
5380,2024-01-04 17:39:00,76,167,Móvel,5,243
5381,2024-01-04 17:40:00,109,143,Eletrônico,8,252
5382,2024-01-04 17:41:00,93,48,Eletrônico,1,141
5383,2024-01-04 17:42:00,10,171,Alimento,3,181
5384,2024-01-04 17:43:00,111,152,Brinquedo,7,263
5385,2024-01-04 17:44:00,87,40,Eletrônico,6,127
5386,2024-01-04 17:45:00,32,57,Eletrônico,4,89
5387,2024-01-04 17:46:00,119,164,Móvel,8,283
5388,2024-01-04 17:47:00,89,159,Vestuário,1,248
5389,2024-01-04 17:48:00,39,164,Vestuário,9,203
5390,2024-01-04 17:49:00,48,14,Móvel,2,62
5391,2024-01-04 17:50:00,45,59,Brinquedo,8,104
5392,2024-01-04 17:51:00,40,96,Vestuário,6,136
5393,2024-01-04 17:52:00,59,122,Móvel,6,181
5394,2024-01-04 17:53:00,66,27,Vestuário,7,93
5395,2024-01-04 17:54:00,109,70,Vestuário,1,179
5396,2024-01-04 17:55:00,119,98,Eletrônico,2,217
5397,2024-01-04 17:56:00,104,156,Vestuário,2,260
5398,2024-01-04 17:57:00,89,47,Alimento,2,136
5399,2024-01-04 17:58:00,48,153,Vestuário,8,201
5400,2024-01-04 17:59:00,70,30,Alimento,9,100
5401,2024-01-04 18:00:00,71,33,Eletrônico,3,104
5402,2024-01-04 18:01:00,80,41,Alimento,4,121
5403,2024-01-04 18:02:00,21,60,Alimento,6,81
5404,2024-01-04 18:03:00,86,58,Móvel,4,144
5405,2024-01-04 18:04:00,96,70,Eletrônico,9,166
5406,2024-01-04 18:05:00,18,18,Vestuário,7,36
5407,2024-01-04 18:06:00,109,160,Brinquedo,2,269
5408,2024-01-04 18:07:00,16,36,Brinquedo,4,52
5409,2024-01-04 18:08:00,88,77,Eletrônico,9,165
5410,2024-01-04 18:09:00,70,95,Vestuário,2,165
5411,2024-01-04 18:10:00,50,89,Eletrônico,3,139
5412,2024-01-04 18:11:00,86,38,Eletrônico,6,124
5413,2024-01-04 18:12:00,52,132,Alimento,5,184
5414,2024-01-04 18:13:00,112,175,Eletrônico,9,287
5415,2024-01-04 18:14:00,69,92,Eletrônico,2,161
5416,2024-01-04 18:15:00,93,56,Alimento,2,149
5417,2024-01-04 18:16:00,104,15,Vestuário,5,119
5418,2024-01-04 18:17:00,91,103,Vestuário,5,194
5419,2024-01-04 18:18:00,13,43,Móvel,5,56
5420,2024-01-04 18:19:00,84,172,Brinquedo,6,256
5421,2024-01-04 18:20:00,84,75,Brinquedo,4,159
5422,2024-01-04 18:21:00,53,28,Eletrônico,6,81
5423,2024-01-04 18:22:00,64,54,Eletrônico,8,118
5424,2024-01-04 18:23:00,44,159,Brinquedo,8,203
5425,2024-01-04 18:24:00,68,44,Eletrônico,2,112
5426,2024-01-04 18:25:00,61,120,Alimento,7,181
5427,2024-01-04 18:26:00,117,48,Móvel,7,165
5428,2024-01-04 18:27:00,25,165,Móvel,4,190
5429,2024-01-04 18:28:00,76,102,Móvel,8,178
5430,2024-01-04 18:29:00,73,170,Brinquedo,2,243
5431,2024-01-04 18:30:00,23,143,Alimento,7,166
5432,2024-01-04 18:31:00,24,34,Alimento,6,58
5433,2024-01-04 18:32:00,50,136,Brinquedo,3,186
5434,2024-01-04 18:33:00,95,165,Móvel,8,260
5435,2024-01-04 18:34:00,88,123,Alimento,4,211
5436,2024-01-04 18:35:00,14,135,Alimento,5,149
5437,2024-01-04 18:36:00,52,97,Eletrônico,7,149
5438,2024-01-04 18:37:00,16,102,Vestuário,9,118
5439,2024-01-04 18:38:00,11,103,Móvel,3,114
5440,2024-01-04 18:39:00,64,35,Brinquedo,7,99
5441,2024-01-04 18:40:00,111,161,Eletrônico,7,272
5442,2024-01-04 18:41:00,110,147,Vestuário,8,257
5443,2024-01-04 18:42:00,33,168,Eletrônico,5,201
5444,2024-01-04 18:43:00,23,69,Eletrônico,6,92
5445,2024-01-04 18:44:00,75,176,Vestuário,5,251
5446,2024-01-04 18:45:00,22,159,Alimento,7,181
5447,2024-01-04 18:46:00,11,116,Móvel,8,127
5448,2024-01-04 18:47:00,33,97,Brinquedo,7,130
5449,2024-01-04 18:48:00,40,143,Alimento,7,183
5450,2024-01-04 18:49:00,69,161,Eletrônico,2,230
5451,2024-01-04 18:50:00,25,108,Brinquedo,6,133
5452,2024-01-04 18:51:00,75,29,Móvel,6,104
5453,2024-01-04 18:52:00,63,158,Vestuário,5,221
5454,2024-01-04 18:53:00,72,113,Móvel,4,185
5455,2024-01-04 18:54:00,47,155,Alimento,6,202
5456,2024-01-04 18:55:00,79,24,Eletrônico,3,103
5457,2024-01-04 18:56:00,13,135,Móvel,4,148
5458,2024-01-04 18:57:00,13,10,Móvel,1,23
5459,2024-01-04 18:58:00,64,32,Móvel,6,96
5460,2024-01-04 18:59:00,85,41,Eletrônico,8,126
5461,2024-01-04 19:00:00,41,177,Eletrônico,6,218
5462,2024-01-04 19:01:00,53,21,Vestuário,8,74
5463,2024-01-04 19:02:00,53,163,Brinquedo,4,216
5464,2024-01-04 19:03:00,55,129,Vestuário,8,184
5465,2024-01-04 19:04:00,51,136,Eletrônico,2,187
5466,2024-01-04 19:05:00,60,120,Vestuário,3,180
5467,2024-01-04 19:06:00,106,178,Brinquedo,9,284
5468,2024-01-04 19:07:00,20,12,Vestuário,5,32
5469,2024-01-04 19:08:00,45,64,Brinquedo,4,109
5470,2024-01-04 19:09:00,14,19,Alimento,7,33
5471,2024-01-04 19:10:00,76,78,Brinquedo,8,154
5472,2024-01-04 19:11:00,72,38,Brinquedo,4,110
5473,2024-01-04 19:12:00,32,61,Móvel,4,93
5474,2024-01-04 19:13:00,78,143,Alimento,2,221
5475,2024-01-04 19:14:00,22,32,Vestuário,7,54
5476,2024-01-04 19:15:00,105,156,Eletrônico,5,261
5477,2024-01-04 19:16:00,22,165,Móvel,3,187
5478,2024-01-04 19:17:00,107,46,Alimento,6,153
5479,2024-01-04 19:18:00,116,108,Móvel,7,224
5480,2024-01-04 19:19:00,29,21,Vestuário,8,50
5481,2024-01-04 19:20:00,15,140,Alimento,6,155
5482,2024-01-04 19:21:00,25,53,Alimento,1,78
5483,2024-01-04 19:22:00,97,99,Móvel,1,196
5484,2024-01-04 19:23:00,104,34,Vestuário,9,138
5485,2024-01-04 19:24:00,16,32,Brinquedo,1,48
5486,2024-01-04 19:25:00,19,105,Móvel,1,124
5487,2024-01-04 19:26:00,44,153,Móvel,3,197
5488,2024-01-04 19:27:00,18,41,Alimento,5,59
5489,2024-01-04 19:28:00,42,132,Vestuário,4,174
5490,2024-01-04 19:29:00,74,86,Alimento,1,160
5491,2024-01-04 19:30:00,103,102,Alimento,4,205
5492,2024-01-04 19:31:00,72,38,Brinquedo,9,110
5493,2024-01-04 19:32:00,47,67,Móvel,1,114
5494,2024-01-04 19:33:00,42,125,Eletrônico,4,167
5495,2024-01-04 19:34:00,21,119,Móvel,6,140
5496,2024-01-04 19:35:00,46,106,Alimento,1,152
5497,2024-01-04 19:36:00,96,101,Alimento,9,197
5498,2024-01-04 19:37:00,52,14,Vestuário,9,66
5499,2024-01-04 19:38:00,14,71,Vestuário,3,85
5500,2024-01-04 19:39:00,23,113,Eletrônico,6,136
5501,2024-01-04 19:40:00,100,115,Vestuário,2,215
5502,2024-01-04 19:41:00,10,112,Alimento,7,122
5503,2024-01-04 19:42:00,43,11,Vestuário,8,54
5504,2024-01-04 19:43:00,89,15,Móvel,9,104
5505,2024-01-04 19:44:00,96,174,Móvel,9,270
5506,2024-01-04 19:45:00,58,61,Vestuário,6,119
5507,2024-01-04 19:46:00,33,48,Vestuário,7,81
5508,2024-01-04 19:47:00,106,167,Móvel,5,273
5509,2024-01-04 19:48:00,107,64,Eletrônico,4,171
5510,2024-01-04 19:49:00,48,154,Alimento,3,202
5511,2024-01-04 19:50:00,111,138,Alimento,2,249
5512,2024-01-04 19:51:00,24,59,Móvel,5,83
5513,2024-01-04 19:52:00,76,116,Alimento,9,192
5514,2024-01-04 19:53:00,100,152,Eletrônico,3,252
5515,2024-01-04 19:54:00,51,177,Móvel,3,228
5516,2024-01-04 19:55:00,65,72,Brinquedo,3,137
5517,2024-01-04 19:56:00,55,17,Móvel,8,72
5518,2024-01-04 19:57:00,56,158,Eletrônico,7,214
5519,2024-01-04 19:58:00,111,54,Brinquedo,7,165
5520,2024-01-04 19:59:00,36,21,Móvel,3,57
5521,2024-01-04 20:00:00,45,160,Móvel,1,205
5522,2024-01-04 20:01:00,103,63,Eletrônico,6,166
5523,2024-01-04 20:02:00,47,137,Brinquedo,4,184
5524,2024-01-04 20:03:00,56,169,Alimento,8,225
5525,2024-01-04 20:04:00,92,112,Móvel,6,204
5526,2024-01-04 20:05:00,24,137,Brinquedo,2,161
5527,2024-01-04 20:06:00,52,77,Eletrônico,2,129
5528,2024-01-04 20:07:00,29,75,Eletrônico,1,104
5529,2024-01-04 20:08:00,84,18,Alimento,7,102
5530,2024-01-04 20:09:00,49,106,Eletrônico,4,155
5531,2024-01-04 20:10:00,83,39,Vestuário,5,122
5532,2024-01-04 20:11:00,28,21,Eletrônico,4,49
5533,2024-01-04 20:12:00,74,72,Eletrônico,9,146
5534,2024-01-04 20:13:00,73,150,Brinquedo,1,223
5535,2024-01-04 20:14:00,60,71,Alimento,3,131
5536,2024-01-04 20:15:00,48,70,Eletrônico,1,118
5537,2024-01-04 20:16:00,56,33,Alimento,9,89
5538,2024-01-04 20:17:00,34,18,Brinquedo,6,52
5539,2024-01-04 20:18:00,80,124,Eletrônico,8,204
5540,2024-01-04 20:19:00,91,64,Móvel,3,155
5541,2024-01-04 20:20:00,48,140,Alimento,4,188
5542,2024-01-04 20:21:00,96,138,Alimento,3,234
5543,2024-01-04 20:22:00,90,104,Móvel,4,194
5544,2024-01-04 20:23:00,73,38,Móvel,7,111
5545,2024-01-04 20:24:00,75,80,Móvel,7,155
5546,2024-01-04 20:25:00,93,68,Alimento,3,161
5547,2024-01-04 20:26:00,60,169,Eletrônico,6,229
5548,2024-01-04 20:27:00,59,85,Brinquedo,3,144
5549,2024-01-04 20:28:00,25,160,Brinquedo,7,185
5550,2024-01-04 20:29:00,110,176,Alimento,6,286
5551,2024-01-04 20:30:00,27,42,Vestuário,8,69
5552,2024-01-04 20:31:00,80,32,Vestuário,5,112
5553,2024-01-04 20:32:00,23,122,Eletrônico,7,145
5554,2024-01-04 20:33:00,12,169,Móvel,1,181
5555,2024-01-04 20:34:00,35,102,Eletrônico,1,137
5556,2024-01-04 20:35:00,63,20,Alimento,1,83
5557,2024-01-04 20:36:00,34,29,Alimento,6,63
5558,2024-01-04 20:37:00,29,135,Móvel,2,164
5559,2024-01-04 20:38:00,104,119,Vestuário,9,223
5560,2024-01-04 20:39:00,46,61,Móvel,5,107
5561,2024-01-04 20:40:00,95,50,Eletrônico,3,145
5562,2024-01-04 20:41:00,18,135,Alimento,3,153
5563,2024-01-04 20:42:00,73,154,Eletrônico,8,227
5564,2024-01-04 20:43:00,70,20,Eletrônico,7,90
5565,2024-01-04 20:44:00,40,53,Eletrônico,3,93
5566,2024-01-04 20:45:00,21,15,Móvel,9,36
5567,2024-01-04 20:46:00,35,135,Alimento,4,170
5568,2024-01-04 20:47:00,58,149,Móvel,4,207
5569,2024-01-04 20:48:00,55,112,Eletrônico,3,167
5570,2024-01-04 20:49:00,60,93,Móvel,8,153
5571,2024-01-04 20:50:00,71,72,Eletrônico,1,143
5572,2024-01-04 20:51:00,21,65,Alimento,3,86
5573,2024-01-04 20:52:00,22,140,Brinquedo,4,162
5574,2024-01-04 20:53:00,51,68,Brinquedo,3,119
5575,2024-01-04 20:54:00,98,178,Vestuário,4,276
5576,2024-01-04 20:55:00,26,63,Eletrônico,9,89
5577,2024-01-04 20:56:00,19,125,Alimento,7,144
5578,2024-01-04 20:57:00,108,32,Vestuário,8,140
5579,2024-01-04 20:58:00,67,169,Brinquedo,7,236
5580,2024-01-04 20:59:00,27,36,Vestuário,8,63
5581,2024-01-04 21:00:00,18,176,Brinquedo,9,194
5582,2024-01-04 21:01:00,44,19,Alimento,9,63
5583,2024-01-04 21:02:00,49,156,Brinquedo,1,205
5584,2024-01-04 21:03:00,31,77,Vestuário,2,108
5585,2024-01-04 21:04:00,67,74,Brinquedo,8,141
5586,2024-01-04 21:05:00,47,119,Vestuário,1,166
5587,2024-01-04 21:06:00,47,160,Vestuário,5,207
5588,2024-01-04 21:07:00,76,73,Eletrônico,3,149
5589,2024-01-04 21:08:00,83,175,Móvel,2,258
5590,2024-01-04 21:09:00,105,153,Vestuário,7,258
5591,2024-01-04 21:10:00,113,100,Eletrônico,4,213
5592,2024-01-04 21:11:00,41,132,Móvel,7,173
5593,2024-01-04 21:12:00,103,147,Brinquedo,2,250
5594,2024-01-04 21:13:00,63,20,Alimento,5,83
5595,2024-01-04 21:14:00,92,52,Eletrônico,5,144
5596,2024-01-04 21:15:00,95,136,Vestuário,3,231
5597,2024-01-04 21:16:00,38,138,Brinquedo,2,176
5598,2024-01-04 21:17:00,10,108,Brinquedo,3,118
5599,2024-01-04 21:18:00,84,75,Vestuário,4,159
5600,2024-01-04 21:19:00,89,106,Móvel,2,195
5601,2024-01-04 21:20:00,83,17,Brinquedo,4,100
5602,2024-01-04 21:21:00,101,77,Eletrônico,2,178
5603,2024-01-04 21:22:00,15,101,Eletrônico,6,116
5604,2024-01-04 21:23:00,14,48,Vestuário,1,62
5605,2024-01-04 21:24:00,86,145,Móvel,4,231
5606,2024-01-04 21:25:00,56,153,Eletrônico,7,209
5607,2024-01-04 21:26:00,105,41,Móvel,4,146
5608,2024-01-04 21:27:00,85,148,Vestuário,8,233
5609,2024-01-04 21:28:00,91,116,Alimento,4,207
5610,2024-01-04 21:29:00,68,174,Brinquedo,3,242
5611,2024-01-04 21:30:00,89,146,Brinquedo,7,235
5612,2024-01-04 21:31:00,90,74,Vestuário,8,164
5613,2024-01-04 21:32:00,119,13,Alimento,4,132
5614,2024-01-04 21:33:00,28,49,Eletrônico,9,77
5615,2024-01-04 21:34:00,10,129,Alimento,5,139
5616,2024-01-04 21:35:00,48,64,Vestuário,9,112
5617,2024-01-04 21:36:00,54,119,Alimento,6,173
5618,2024-01-04 21:37:00,55,116,Alimento,8,171
5619,2024-01-04 21:38:00,52,19,Brinquedo,7,71
5620,2024-01-04 21:39:00,63,62,Brinquedo,7,125
5621,2024-01-04 21:40:00,83,21,Eletrônico,7,104
5622,2024-01-04 21:41:00,89,168,Eletrônico,5,257
5623,2024-01-04 21:42:00,71,153,Vestuário,2,224
5624,2024-01-04 21:43:00,20,178,Alimento,1,198
5625,2024-01-04 21:44:00,35,118,Móvel,7,153
5626,2024-01-04 21:45:00,88,46,Vestuário,2,134
5627,2024-01-04 21:46:00,85,85,Eletrônico,2,170
5628,2024-01-04 21:47:00,102,96,Vestuário,3,198
5629,2024-01-04 21:48:00,80,106,Vestuário,7,186
5630,2024-01-04 21:49:00,13,41,Vestuário,3,54
5631,2024-01-04 21:50:00,43,135,Brinquedo,9,178
5632,2024-01-04 21:51:00,71,133,Vestuário,5,204
5633,2024-01-04 21:52:00,20,160,Vestuário,7,180
5634,2024-01-04 21:53:00,118,27,Alimento,9,145
5635,2024-01-04 21:54:00,95,153,Vestuário,1,248
5636,2024-01-04 21:55:00,89,144,Alimento,3,233
5637,2024-01-04 21:56:00,35,136,Móvel,5,171
5638,2024-01-04 21:57:00,55,148,Móvel,7,203
5639,2024-01-04 21:58:00,29,160,Móvel,2,189
5640,2024-01-04 21:59:00,31,54,Eletrônico,3,85
5641,2024-01-04 22:00:00,12,139,Vestuário,5,151
5642,2024-01-04 22:01:00,13,147,Alimento,7,160
5643,2024-01-04 22:02:00,112,121,Brinquedo,8,233
5644,2024-01-04 22:03:00,10,50,Alimento,3,60
5645,2024-01-04 22:04:00,31,46,Móvel,9,77
5646,2024-01-04 22:05:00,13,61,Alimento,2,74
5647,2024-01-04 22:06:00,114,143,Móvel,6,257
5648,2024-01-04 22:07:00,85,28,Móvel,7,113
5649,2024-01-04 22:08:00,30,169,Vestuário,7,199
5650,2024-01-04 22:09:00,42,176,Móvel,5,218
5651,2024-01-04 22:10:00,10,34,Alimento,3,44
5652,2024-01-04 22:11:00,80,36,Vestuário,5,116
5653,2024-01-04 22:12:00,63,51,Móvel,9,114
5654,2024-01-04 22:13:00,47,108,Vestuário,4,155
5655,2024-01-04 22:14:00,26,41,Móvel,2,67
5656,2024-01-04 22:15:00,97,57,Vestuário,5,154
5657,2024-01-04 22:16:00,19,18,Móvel,6,37
5658,2024-01-04 22:17:00,90,17,Alimento,6,107
5659,2024-01-04 22:18:00,29,147,Brinquedo,7,176
5660,2024-01-04 22:19:00,43,94,Alimento,8,137
5661,2024-01-04 22:20:00,30,51,Vestuário,3,81
5662,2024-01-04 22:21:00,59,30,Alimento,3,89
5663,2024-01-04 22:22:00,12,92,Móvel,6,104
5664,2024-01-04 22:23:00,58,31,Vestuário,9,89
5665,2024-01-04 22:24:00,60,69,Brinquedo,6,129
5666,2024-01-04 22:25:00,50,88,Brinquedo,6,138
5667,2024-01-04 22:26:00,91,87,Eletrônico,4,178
5668,2024-01-04 22:27:00,69,133,Vestuário,7,202
5669,2024-01-04 22:28:00,105,114,Móvel,3,219
5670,2024-01-04 22:29:00,23,124,Móvel,9,147
5671,2024-01-04 22:30:00,69,53,Brinquedo,1,122
5672,2024-01-04 22:31:00,73,107,Eletrônico,5,180
5673,2024-01-04 22:32:00,98,30,Vestuário,5,128
5674,2024-01-04 22:33:00,85,80,Eletrônico,8,165
5675,2024-01-04 22:34:00,109,157,Vestuário,4,266
5676,2024-01-04 22:35:00,64,81,Alimento,2,145
5677,2024-01-04 22:36:00,55,130,Alimento,7,185
5678,2024-01-04 22:37:00,21,18,Eletrônico,7,39
5679,2024-01-04 22:38:00,71,120,Eletrônico,6,191
5680,2024-01-04 22:39:00,55,22,Móvel,2,77
5681,2024-01-04 22:40:00,74,44,Vestuário,4,118
5682,2024-01-04 22:41:00,59,67,Vestuário,2,126
5683,2024-01-04 22:42:00,114,89,Alimento,9,203
5684,2024-01-04 22:43:00,33,62,Alimento,6,95
5685,2024-01-04 22:44:00,39,109,Brinquedo,2,148
5686,2024-01-04 22:45:00,112,154,Vestuário,1,266
5687,2024-01-04 22:46:00,118,70,Eletrônico,3,188
5688,2024-01-04 22:47:00,18,103,Alimento,8,121
5689,2024-01-04 22:48:00,89,79,Móvel,9,168
5690,2024-01-04 22:49:00,37,153,Móvel,1,190
5691,2024-01-04 22:50:00,56,148,Brinquedo,1,204
5692,2024-01-04 22:51:00,11,73,Eletrônico,4,84
5693,2024-01-04 22:52:00,73,78,Brinquedo,1,151
5694,2024-01-04 22:53:00,89,143,Alimento,9,232
5695,2024-01-04 22:54:00,19,50,Eletrônico,8,69
5696,2024-01-04 22:55:00,97,102,Alimento,7,199
5697,2024-01-04 22:56:00,56,83,Móvel,9,139
5698,2024-01-04 22:57:00,74,170,Vestuário,6,244
5699,2024-01-04 22:58:00,95,37,Alimento,6,132
5700,2024-01-04 22:59:00,11,104,Móvel,6,115
5701,2024-01-04 23:00:00,45,52,Brinquedo,7,97
5702,2024-01-04 23:01:00,83,19,Alimento,3,102
5703,2024-01-04 23:02:00,55,89,Móvel,1,144
5704,2024-01-04 23:03:00,25,167,Alimento,7,192
5705,2024-01-04 23:04:00,79,85,Brinquedo,7,164
5706,2024-01-04 23:05:00,26,165,Móvel,8,191
5707,2024-01-04 23:06:00,82,158,Eletrônico,3,240
5708,2024-01-04 23:07:00,96,13,Móvel,2,109
5709,2024-01-04 23:08:00,74,175,Móvel,2,249
5710,2024-01-04 23:09:00,46,170,Brinquedo,4,216
5711,2024-01-04 23:10:00,50,120,Móvel,1,170
5712,2024-01-04 23:11:00,40,29,Alimento,3,69
5713,2024-01-04 23:12:00,25,27,Alimento,6,52
5714,2024-01-04 23:13:00,81,135,Móvel,5,216
5715,2024-01-04 23:14:00,61,32,Brinquedo,4,93
5716,2024-01-04 23:15:00,117,172,Brinquedo,2,289
5717,2024-01-04 23:16:00,114,24,Eletrônico,6,138
5718,2024-01-04 23:17:00,37,120,Alimento,2,157
5719,2024-01-04 23:18:00,72,127,Brinquedo,5,199
5720,2024-01-04 23:19:00,46,132,Vestuário,1,178
5721,2024-01-04 23:20:00,85,25,Alimento,7,110
5722,2024-01-04 23:21:00,82,132,Móvel,2,214
5723,2024-01-04 23:22:00,100,125,Vestuário,4,225
5724,2024-01-04 23:23:00,115,21,Brinquedo,1,136
5725,2024-01-04 23:24:00,34,110,Eletrônico,7,144
5726,2024-01-04 23:25:00,12,63,Alimento,5,75
5727,2024-01-04 23:26:00,26,117,Vestuário,9,143
5728,2024-01-04 23:27:00,34,42,Eletrônico,9,76
5729,2024-01-04 23:28:00,32,149,Alimento,1,181
5730,2024-01-04 23:29:00,95,64,Eletrônico,6,159
5731,2024-01-04 23:30:00,47,109,Alimento,1,156
5732,2024-01-04 23:31:00,93,156,Eletrônico,1,249
5733,2024-01-04 23:32:00,109,16,Móvel,4,125
5734,2024-01-04 23:33:00,74,143,Móvel,9,217
5735,2024-01-04 23:34:00,116,46,Eletrônico,8,162
5736,2024-01-04 23:35:00,118,140,Alimento,6,258
5737,2024-01-04 23:36:00,67,32,Móvel,4,99
5738,2024-01-04 23:37:00,58,97,Vestuário,3,155
5739,2024-01-04 23:38:00,59,51,Móvel,6,110
5740,2024-01-04 23:39:00,21,92,Vestuário,1,113
5741,2024-01-04 23:40:00,72,70,Eletrônico,6,142
5742,2024-01-04 23:41:00,77,45,Eletrônico,3,122
5743,2024-01-04 23:42:00,32,39,Alimento,6,71
5744,2024-01-04 23:43:00,88,139,Alimento,6,227
5745,2024-01-04 23:44:00,27,145,Brinquedo,3,172
5746,2024-01-04 23:45:00,79,109,Vestuário,3,188
5747,2024-01-04 23:46:00,10,59,Eletrônico,6,69
5748,2024-01-04 23:47:00,77,56,Móvel,3,133
5749,2024-01-04 23:48:00,60,85,Vestuário,9,145
5750,2024-01-04 23:49:00,57,171,Brinquedo,2,228
5751,2024-01-04 23:50:00,70,68,Alimento,9,138
5752,2024-01-04 23:51:00,19,133,Vestuário,7,152
5753,2024-01-04 23:52:00,38,151,Móvel,2,189
5754,2024-01-04 23:53:00,35,108,Móvel,9,143
5755,2024-01-04 23:54:00,23,28,Móvel,1,51
5756,2024-01-04 23:55:00,53,118,Vestuário,6,171
5757,2024-01-04 23:56:00,93,149,Alimento,7,242
5758,2024-01-04 23:57:00,57,26,Vestuário,7,83
5759,2024-01-04 23:58:00,13,53,Eletrônico,8,66
5760,2024-01-04 23:59:00,113,165,Brinquedo,4,278
5761,2024-01-05 00:00:00,76,112,Brinquedo,5,188
5762,2024-01-05 00:01:00,94,63,Móvel,4,157
5763,2024-01-05 00:02:00,53,143,Alimento,7,196
5764,2024-01-05 00:03:00,61,56,Brinquedo,1,117
5765,2024-01-05 00:04:00,26,61,Alimento,1,87
5766,2024-01-05 00:05:00,17,37,Brinquedo,5,54
5767,2024-01-05 00:06:00,10,94,Brinquedo,9,104
5768,2024-01-05 00:07:00,48,38,Alimento,1,86
5769,2024-01-05 00:08:00,113,135,Brinquedo,7,248
5770,2024-01-05 00:09:00,87,113,Brinquedo,1,200
5771,2024-01-05 00:10:00,92,78,Eletrônico,9,170
5772,2024-01-05 00:11:00,45,100,Brinquedo,2,145
5773,2024-01-05 00:12:00,107,112,Eletrônico,7,219
5774,2024-01-05 00:13:00,19,32,Alimento,9,51
5775,2024-01-05 00:14:00,93,59,Móvel,5,152
5776,2024-01-05 00:15:00,47,60,Vestuário,2,107
5777,2024-01-05 00:16:00,46,102,Eletrônico,4,148
5778,2024-01-05 00:17:00,37,50,Alimento,1,87
5779,2024-01-05 00:18:00,83,155,Móvel,2,238
5780,2024-01-05 00:19:00,35,126,Alimento,5,161
5781,2024-01-05 00:20:00,12,147,Eletrônico,6,159
5782,2024-01-05 00:21:00,117,49,Móvel,1,166
5783,2024-01-05 00:22:00,42,26,Eletrônico,4,68
5784,2024-01-05 00:23:00,65,28,Alimento,7,93
5785,2024-01-05 00:24:00,109,32,Móvel,7,141
5786,2024-01-05 00:25:00,118,141,Móvel,2,259
5787,2024-01-05 00:26:00,50,111,Eletrônico,2,161
5788,2024-01-05 00:27:00,63,73,Vestuário,6,136
5789,2024-01-05 00:28:00,30,50,Móvel,9,80
5790,2024-01-05 00:29:00,91,62,Móvel,6,153
5791,2024-01-05 00:30:00,32,161,Alimento,4,193
5792,2024-01-05 00:31:00,42,160,Alimento,6,202
5793,2024-01-05 00:32:00,11,79,Brinquedo,1,90
5794,2024-01-05 00:33:00,85,173,Eletrônico,1,258
5795,2024-01-05 00:34:00,63,60,Móvel,9,123
5796,2024-01-05 00:35:00,30,166,Brinquedo,9,196
5797,2024-01-05 00:36:00,41,114,Eletrônico,8,155
5798,2024-01-05 00:37:00,53,24,Alimento,3,77
5799,2024-01-05 00:38:00,111,134,Eletrônico,7,245
5800,2024-01-05 00:39:00,78,60,Eletrônico,6,138
5801,2024-01-05 00:40:00,76,157,Móvel,7,233
5802,2024-01-05 00:41:00,97,142,Alimento,9,239
5803,2024-01-05 00:42:00,40,82,Vestuário,4,122
5804,2024-01-05 00:43:00,35,58,Eletrônico,1,93
5805,2024-01-05 00:44:00,12,138,Eletrônico,6,150
5806,2024-01-05 00:45:00,78,111,Eletrônico,7,189
5807,2024-01-05 00:46:00,105,76,Alimento,4,181
5808,2024-01-05 00:47:00,84,106,Vestuário,7,190
5809,2024-01-05 00:48:00,93,163,Eletrônico,4,256
5810,2024-01-05 00:49:00,94,111,Móvel,9,205
5811,2024-01-05 00:50:00,112,47,Móvel,1,159
5812,2024-01-05 00:51:00,26,74,Alimento,1,100
5813,2024-01-05 00:52:00,50,155,Vestuário,5,205
5814,2024-01-05 00:53:00,78,33,Eletrônico,6,111
5815,2024-01-05 00:54:00,96,82,Eletrônico,6,178
5816,2024-01-05 00:55:00,77,136,Vestuário,2,213
5817,2024-01-05 00:56:00,94,85,Eletrônico,8,179
5818,2024-01-05 00:57:00,48,177,Brinquedo,6,225
5819,2024-01-05 00:58:00,113,117,Vestuário,2,230
5820,2024-01-05 00:59:00,64,57,Brinquedo,2,121
5821,2024-01-05 01:00:00,107,144,Brinquedo,3,251
5822,2024-01-05 01:01:00,48,149,Eletrônico,3,197
5823,2024-01-05 01:02:00,69,23,Móvel,1,92
5824,2024-01-05 01:03:00,78,167,Brinquedo,5,245
5825,2024-01-05 01:04:00,115,159,Móvel,3,274
5826,2024-01-05 01:05:00,96,140,Móvel,5,236
5827,2024-01-05 01:06:00,30,91,Móvel,3,121
5828,2024-01-05 01:07:00,60,14,Alimento,7,74
5829,2024-01-05 01:08:00,100,125,Brinquedo,2,225
5830,2024-01-05 01:09:00,52,26,Alimento,8,78
5831,2024-01-05 01:10:00,69,121,Eletrônico,9,190
5832,2024-01-05 01:11:00,73,89,Vestuário,6,162
5833,2024-01-05 01:12:00,77,176,Eletrônico,7,253
5834,2024-01-05 01:13:00,50,88,Brinquedo,7,138
5835,2024-01-05 01:14:00,46,64,Alimento,5,110
5836,2024-01-05 01:15:00,59,73,Eletrônico,6,132
5837,2024-01-05 01:16:00,24,166,Brinquedo,7,190
5838,2024-01-05 01:17:00,89,166,Brinquedo,6,255
5839,2024-01-05 01:18:00,29,136,Vestuário,2,165
5840,2024-01-05 01:19:00,84,161,Eletrônico,7,245
5841,2024-01-05 01:20:00,25,101,Vestuário,4,126
5842,2024-01-05 01:21:00,45,130,Brinquedo,2,175
5843,2024-01-05 01:22:00,89,120,Alimento,9,209
5844,2024-01-05 01:23:00,105,155,Vestuário,3,260
5845,2024-01-05 01:24:00,87,177,Vestuário,9,264
5846,2024-01-05 01:25:00,77,138,Alimento,4,215
5847,2024-01-05 01:26:00,24,153,Brinquedo,9,177
5848,2024-01-05 01:27:00,43,158,Alimento,9,201
5849,2024-01-05 01:28:00,51,74,Alimento,6,125
5850,2024-01-05 01:29:00,108,31,Vestuário,5,139
5851,2024-01-05 01:30:00,79,61,Móvel,6,140
5852,2024-01-05 01:31:00,25,59,Eletrônico,6,84
5853,2024-01-05 01:32:00,97,20,Brinquedo,9,117
5854,2024-01-05 01:33:00,59,98,Vestuário,1,157
5855,2024-01-05 01:34:00,90,159,Eletrônico,9,249
5856,2024-01-05 01:35:00,47,34,Brinquedo,8,81
5857,2024-01-05 01:36:00,52,47,Vestuário,2,99
5858,2024-01-05 01:37:00,53,104,Brinquedo,3,157
5859,2024-01-05 01:38:00,43,46,Móvel,7,89
5860,2024-01-05 01:39:00,116,31,Móvel,3,147
5861,2024-01-05 01:40:00,102,26,Móvel,5,128
5862,2024-01-05 01:41:00,18,125,Alimento,9,143
5863,2024-01-05 01:42:00,34,123,Eletrônico,4,157
5864,2024-01-05 01:43:00,68,32,Vestuário,8,100
5865,2024-01-05 01:44:00,52,109,Vestuário,8,161
5866,2024-01-05 01:45:00,33,73,Alimento,9,106
5867,2024-01-05 01:46:00,46,43,Móvel,1,89
5868,2024-01-05 01:47:00,83,112,Alimento,9,195
5869,2024-01-05 01:48:00,47,131,Móvel,5,178
5870,2024-01-05 01:49:00,107,134,Eletrônico,2,241
5871,2024-01-05 01:50:00,20,104,Alimento,8,124
5872,2024-01-05 01:51:00,43,44,Brinquedo,5,87
5873,2024-01-05 01:52:00,81,169,Brinquedo,1,250
5874,2024-01-05 01:53:00,104,38,Alimento,2,142
5875,2024-01-05 01:54:00,34,35,Eletrônico,4,69
5876,2024-01-05 01:55:00,94,69,Vestuário,6,163
5877,2024-01-05 01:56:00,106,84,Móvel,2,190
5878,2024-01-05 01:57:00,54,128,Vestuário,4,182
5879,2024-01-05 01:58:00,73,128,Brinquedo,7,201
5880,2024-01-05 01:59:00,13,112,Vestuário,9,125
5881,2024-01-05 02:00:00,44,141,Brinquedo,7,185
5882,2024-01-05 02:01:00,65,73,Móvel,5,138
5883,2024-01-05 02:02:00,88,125,Alimento,9,213
5884,2024-01-05 02:03:00,13,74,Móvel,1,87
5885,2024-01-05 02:04:00,26,24,Brinquedo,7,50
5886,2024-01-05 02:05:00,11,124,Móvel,1,135
5887,2024-01-05 02:06:00,49,11,Alimento,2,60
5888,2024-01-05 02:07:00,114,10,Móvel,5,124
5889,2024-01-05 02:08:00,32,64,Vestuário,7,96
5890,2024-01-05 02:09:00,64,40,Vestuário,7,104
5891,2024-01-05 02:10:00,20,165,Alimento,5,185
5892,2024-01-05 02:11:00,77,18,Eletrônico,5,95
5893,2024-01-05 02:12:00,69,88,Vestuário,7,157
5894,2024-01-05 02:13:00,53,126,Alimento,7,179
5895,2024-01-05 02:14:00,29,33,Eletrônico,3,62
5896,2024-01-05 02:15:00,108,117,Alimento,8,225
5897,2024-01-05 02:16:00,66,56,Eletrônico,5,122
5898,2024-01-05 02:17:00,16,141,Vestuário,5,157
5899,2024-01-05 02:18:00,118,81,Eletrônico,5,199
5900,2024-01-05 02:19:00,31,21,Vestuário,7,52
5901,2024-01-05 02:20:00,17,145,Alimento,2,162
5902,2024-01-05 02:21:00,40,31,Alimento,7,71
5903,2024-01-05 02:22:00,21,168,Eletrônico,5,189
5904,2024-01-05 02:23:00,101,118,Alimento,4,219
5905,2024-01-05 02:24:00,88,34,Vestuário,4,122
5906,2024-01-05 02:25:00,19,76,Brinquedo,9,95
5907,2024-01-05 02:26:00,74,117,Móvel,3,191
5908,2024-01-05 02:27:00,20,178,Vestuário,7,198
5909,2024-01-05 02:28:00,111,127,Móvel,3,238
5910,2024-01-05 02:29:00,47,129,Vestuário,8,176
5911,2024-01-05 02:30:00,69,71,Móvel,9,140
5912,2024-01-05 02:31:00,116,99,Eletrônico,4,215
5913,2024-01-05 02:32:00,67,52,Móvel,4,119
5914,2024-01-05 02:33:00,89,123,Móvel,1,212
5915,2024-01-05 02:34:00,59,131,Eletrônico,1,190
5916,2024-01-05 02:35:00,74,39,Eletrônico,7,113
5917,2024-01-05 02:36:00,43,138,Brinquedo,1,181
5918,2024-01-05 02:37:00,52,178,Alimento,5,230
5919,2024-01-05 02:38:00,64,16,Vestuário,3,80
5920,2024-01-05 02:39:00,27,179,Brinquedo,2,206
5921,2024-01-05 02:40:00,53,110,Brinquedo,2,163
5922,2024-01-05 02:41:00,87,135,Brinquedo,4,222
5923,2024-01-05 02:42:00,64,179,Brinquedo,4,243
5924,2024-01-05 02:43:00,91,108,Vestuário,7,199
5925,2024-01-05 02:44:00,113,64,Vestuário,4,177
5926,2024-01-05 02:45:00,67,97,Brinquedo,7,164
5927,2024-01-05 02:46:00,21,33,Móvel,7,54
5928,2024-01-05 02:47:00,13,117,Vestuário,1,130
5929,2024-01-05 02:48:00,87,166,Vestuário,5,253
5930,2024-01-05 02:49:00,64,80,Eletrônico,9,144
5931,2024-01-05 02:50:00,84,46,Móvel,5,130
5932,2024-01-05 02:51:00,18,119,Brinquedo,8,137
5933,2024-01-05 02:52:00,61,73,Alimento,4,134
5934,2024-01-05 02:53:00,110,90,Vestuário,4,200
5935,2024-01-05 02:54:00,79,65,Alimento,5,144
5936,2024-01-05 02:55:00,63,118,Alimento,1,181
5937,2024-01-05 02:56:00,23,10,Alimento,4,33
5938,2024-01-05 02:57:00,16,84,Vestuário,4,100
5939,2024-01-05 02:58:00,32,39,Eletrônico,9,71
5940,2024-01-05 02:59:00,103,53,Móvel,5,156
5941,2024-01-05 03:00:00,49,38,Eletrônico,1,87
5942,2024-01-05 03:01:00,103,62,Alimento,8,165
5943,2024-01-05 03:02:00,102,82,Brinquedo,9,184
5944,2024-01-05 03:03:00,88,36,Alimento,6,124
5945,2024-01-05 03:04:00,49,151,Eletrônico,6,200
5946,2024-01-05 03:05:00,101,129,Vestuário,2,230
5947,2024-01-05 03:06:00,33,91,Alimento,4,124
5948,2024-01-05 03:07:00,63,10,Alimento,4,73
5949,2024-01-05 03:08:00,68,163,Vestuário,1,231
5950,2024-01-05 03:09:00,26,76,Móvel,4,102
5951,2024-01-05 03:10:00,22,129,Alimento,4,151
5952,2024-01-05 03:11:00,109,26,Brinquedo,8,135
5953,2024-01-05 03:12:00,42,172,Móvel,8,214
5954,2024-01-05 03:13:00,53,121,Vestuário,8,174
5955,2024-01-05 03:14:00,33,120,Eletrônico,6,153
5956,2024-01-05 03:15:00,26,42,Brinquedo,8,68
5957,2024-01-05 03:16:00,43,111,Alimento,8,154
5958,2024-01-05 03:17:00,116,57,Brinquedo,1,173
5959,2024-01-05 03:18:00,30,64,Vestuário,4,94
5960,2024-01-05 03:19:00,37,122,Vestuário,8,159
5961,2024-01-05 03:20:00,89,85,Vestuário,2,174
5962,2024-01-05 03:21:00,116,28,Brinquedo,8,144
5963,2024-01-05 03:22:00,21,70,Alimento,9,91
5964,2024-01-05 03:23:00,31,169,Vestuário,2,200
5965,2024-01-05 03:24:00,26,53,Alimento,2,79
5966,2024-01-05 03:25:00,61,134,Alimento,6,195
5967,2024-01-05 03:26:00,118,72,Alimento,9,190
5968,2024-01-05 03:27:00,115,160,Brinquedo,7,275
5969,2024-01-05 03:28:00,66,50,Alimento,4,116
5970,2024-01-05 03:29:00,93,64,Eletrônico,4,157
5971,2024-01-05 03:30:00,70,145,Móvel,3,215
5972,2024-01-05 03:31:00,54,97,Vestuário,2,151
5973,2024-01-05 03:32:00,56,63,Móvel,1,119
5974,2024-01-05 03:33:00,33,12,Vestuário,1,45
5975,2024-01-05 03:34:00,97,162,Alimento,8,259
5976,2024-01-05 03:35:00,52,50,Eletrônico,8,102
5977,2024-01-05 03:36:00,73,151,Alimento,8,224
5978,2024-01-05 03:37:00,19,165,Móvel,4,184
5979,2024-01-05 03:38:00,49,88,Alimento,4,137
5980,2024-01-05 03:39:00,84,129,Móvel,9,213
5981,2024-01-05 03:40:00,57,107,Alimento,6,164
5982,2024-01-05 03:41:00,100,28,Brinquedo,6,128
5983,2024-01-05 03:42:00,66,109,Brinquedo,1,175
5984,2024-01-05 03:43:00,50,57,Eletrônico,9,107
5985,2024-01-05 03:44:00,111,159,Móvel,4,270
5986,2024-01-05 03:45:00,68,88,Alimento,2,156
5987,2024-01-05 03:46:00,36,125,Vestuário,1,161
5988,2024-01-05 03:47:00,66,118,Brinquedo,7,184
5989,2024-01-05 03:48:00,105,139,Alimento,9,244
5990,2024-01-05 03:49:00,106,64,Móvel,9,170
5991,2024-01-05 03:50:00,114,124,Móvel,2,238
5992,2024-01-05 03:51:00,109,106,Móvel,7,215
5993,2024-01-05 03:52:00,15,81,Vestuário,4,96
5994,2024-01-05 03:53:00,115,142,Eletrônico,4,257
5995,2024-01-05 03:54:00,65,161,Alimento,9,226
5996,2024-01-05 03:55:00,97,26,Vestuário,5,123
5997,2024-01-05 03:56:00,99,46,Eletrônico,1,145
5998,2024-01-05 03:57:00,24,178,Móvel,2,202
5999,2024-01-05 03:58:00,42,113,Móvel,8,155
6000,2024-01-05 03:59:00,91,106,Vestuário,2,197
6001,2024-01-05 04:00:00,80,59,Móvel,1,139
6002,2024-01-05 04:01:00,103,103,Móvel,4,206
6003,2024-01-05 04:02:00,80,115,Móvel,8,195
6004,2024-01-05 04:03:00,40,93,Eletrônico,2,133
6005,2024-01-05 04:04:00,91,100,Brinquedo,9,191
6006,2024-01-05 04:05:00,115,96,Brinquedo,5,211
6007,2024-01-05 04:06:00,90,157,Alimento,7,247
6008,2024-01-05 04:07:00,46,90,Alimento,1,136
6009,2024-01-05 04:08:00,58,102,Alimento,3,160
6010,2024-01-05 04:09:00,14,102,Brinquedo,2,116
6011,2024-01-05 04:10:00,45,136,Eletrônico,8,181
6012,2024-01-05 04:11:00,40,66,Vestuário,7,106
6013,2024-01-05 04:12:00,39,23,Eletrônico,5,62
6014,2024-01-05 04:13:00,57,63,Brinquedo,1,120
6015,2024-01-05 04:14:00,78,20,Vestuário,8,98
6016,2024-01-05 04:15:00,18,10,Brinquedo,1,28
6017,2024-01-05 04:16:00,50,45,Brinquedo,2,95
6018,2024-01-05 04:17:00,95,28,Brinquedo,7,123
6019,2024-01-05 04:18:00,24,133,Eletrônico,6,157
6020,2024-01-05 04:19:00,30,75,Brinquedo,1,105
6021,2024-01-05 04:20:00,30,109,Alimento,7,139
6022,2024-01-05 04:21:00,94,85,Vestuário,6,179
6023,2024-01-05 04:22:00,11,99,Brinquedo,9,110
6024,2024-01-05 04:23:00,64,25,Móvel,6,89
6025,2024-01-05 04:24:00,37,85,Eletrônico,6,122
6026,2024-01-05 04:25:00,38,115,Brinquedo,5,153
6027,2024-01-05 04:26:00,27,65,Móvel,7,92
6028,2024-01-05 04:27:00,98,70,Eletrônico,4,168
6029,2024-01-05 04:28:00,48,62,Eletrônico,1,110
6030,2024-01-05 04:29:00,92,122,Alimento,3,214
6031,2024-01-05 04:30:00,109,120,Eletrônico,5,229
6032,2024-01-05 04:31:00,76,21,Eletrônico,8,97
6033,2024-01-05 04:32:00,86,163,Eletrônico,6,249
6034,2024-01-05 04:33:00,63,96,Alimento,4,159
6035,2024-01-05 04:34:00,92,64,Vestuário,1,156
6036,2024-01-05 04:35:00,64,68,Eletrônico,2,132
6037,2024-01-05 04:36:00,66,120,Móvel,2,186
6038,2024-01-05 04:37:00,99,71,Brinquedo,8,170
6039,2024-01-05 04:38:00,27,107,Móvel,9,134
6040,2024-01-05 04:39:00,37,128,Eletrônico,3,165
6041,2024-01-05 04:40:00,33,124,Vestuário,9,157
6042,2024-01-05 04:41:00,108,145,Alimento,1,253
6043,2024-01-05 04:42:00,18,18,Móvel,4,36
6044,2024-01-05 04:43:00,73,11,Alimento,5,84
6045,2024-01-05 04:44:00,92,75,Eletrônico,9,167
6046,2024-01-05 04:45:00,30,83,Brinquedo,3,113
6047,2024-01-05 04:46:00,80,10,Eletrônico,3,90
6048,2024-01-05 04:47:00,53,113,Brinquedo,8,166
6049,2024-01-05 04:48:00,83,32,Alimento,1,115
6050,2024-01-05 04:49:00,118,135,Móvel,2,253
6051,2024-01-05 04:50:00,50,151,Alimento,8,201
6052,2024-01-05 04:51:00,99,44,Eletrônico,2,143
6053,2024-01-05 04:52:00,35,20,Alimento,6,55
6054,2024-01-05 04:53:00,83,81,Móvel,5,164
6055,2024-01-05 04:54:00,102,174,Eletrônico,3,276
6056,2024-01-05 04:55:00,109,93,Alimento,4,202
6057,2024-01-05 04:56:00,59,140,Vestuário,5,199
6058,2024-01-05 04:57:00,62,147,Vestuário,8,209
6059,2024-01-05 04:58:00,46,87,Brinquedo,4,133
6060,2024-01-05 04:59:00,73,43,Eletrônico,6,116
6061,2024-01-05 05:00:00,42,59,Brinquedo,4,101
6062,2024-01-05 05:01:00,59,41,Brinquedo,7,100
6063,2024-01-05 05:02:00,73,29,Alimento,3,102
6064,2024-01-05 05:03:00,108,28,Brinquedo,5,136
6065,2024-01-05 05:04:00,36,53,Vestuário,9,89
6066,2024-01-05 05:05:00,96,19,Alimento,9,115
6067,2024-01-05 05:06:00,22,173,Brinquedo,3,195
6068,2024-01-05 05:07:00,50,92,Vestuário,6,142
6069,2024-01-05 05:08:00,102,105,Alimento,2,207
6070,2024-01-05 05:09:00,91,148,Alimento,4,239
6071,2024-01-05 05:10:00,64,177,Vestuário,4,241
6072,2024-01-05 05:11:00,93,23,Vestuário,1,116
6073,2024-01-05 05:12:00,40,151,Eletrônico,2,191
6074,2024-01-05 05:13:00,63,25,Vestuário,4,88
6075,2024-01-05 05:14:00,51,112,Móvel,2,163
6076,2024-01-05 05:15:00,11,26,Alimento,7,37
6077,2024-01-05 05:16:00,34,39,Móvel,7,73
6078,2024-01-05 05:17:00,49,161,Eletrônico,8,210
6079,2024-01-05 05:18:00,83,113,Alimento,6,196
6080,2024-01-05 05:19:00,31,96,Vestuário,2,127
6081,2024-01-05 05:20:00,96,65,Eletrônico,3,161
6082,2024-01-05 05:21:00,28,15,Brinquedo,8,43
6083,2024-01-05 05:22:00,106,125,Brinquedo,9,231
6084,2024-01-05 05:23:00,87,179,Brinquedo,3,266
6085,2024-01-05 05:24:00,89,97,Eletrônico,4,186
6086,2024-01-05 05:25:00,117,100,Eletrônico,5,217
6087,2024-01-05 05:26:00,48,100,Alimento,8,148
6088,2024-01-05 05:27:00,19,87,Vestuário,1,106
6089,2024-01-05 05:28:00,101,30,Eletrônico,6,131
6090,2024-01-05 05:29:00,89,82,Alimento,3,171
6091,2024-01-05 05:30:00,55,89,Brinquedo,3,144
6092,2024-01-05 05:31:00,34,105,Eletrônico,2,139
6093,2024-01-05 05:32:00,50,137,Eletrônico,9,187
6094,2024-01-05 05:33:00,82,173,Alimento,8,255
6095,2024-01-05 05:34:00,69,126,Brinquedo,9,195
6096,2024-01-05 05:35:00,24,83,Brinquedo,8,107
6097,2024-01-05 05:36:00,101,45,Eletrônico,7,146
6098,2024-01-05 05:37:00,26,118,Móvel,8,144
6099,2024-01-05 05:38:00,104,143,Alimento,8,247
6100,2024-01-05 05:39:00,24,159,Alimento,2,183
6101,2024-01-05 05:40:00,92,65,Eletrônico,4,157
6102,2024-01-05 05:41:00,70,83,Alimento,5,153
6103,2024-01-05 05:42:00,46,24,Vestuário,7,70
6104,2024-01-05 05:43:00,55,64,Móvel,1,119
6105,2024-01-05 05:44:00,112,114,Móvel,5,226
6106,2024-01-05 05:45:00,107,34,Brinquedo,1,141
6107,2024-01-05 05:46:00,70,149,Vestuário,1,219
6108,2024-01-05 05:47:00,76,89,Vestuário,6,165
6109,2024-01-05 05:48:00,80,113,Alimento,4,193
6110,2024-01-05 05:49:00,17,18,Eletrônico,5,35
6111,2024-01-05 05:50:00,75,28,Brinquedo,1,103
6112,2024-01-05 05:51:00,52,114,Vestuário,1,166
6113,2024-01-05 05:52:00,100,112,Brinquedo,9,212
6114,2024-01-05 05:53:00,81,63,Vestuário,5,144
6115,2024-01-05 05:54:00,58,76,Móvel,9,134
6116,2024-01-05 05:55:00,80,63,Vestuário,4,143
6117,2024-01-05 05:56:00,18,30,Móvel,2,48
6118,2024-01-05 05:57:00,99,19,Alimento,4,118
6119,2024-01-05 05:58:00,16,75,Brinquedo,1,91
6120,2024-01-05 05:59:00,55,133,Alimento,4,188
6121,2024-01-05 06:00:00,118,109,Móvel,7,227
6122,2024-01-05 06:01:00,108,41,Vestuário,7,149
6123,2024-01-05 06:02:00,84,30,Móvel,6,114
6124,2024-01-05 06:03:00,101,12,Brinquedo,8,113
6125,2024-01-05 06:04:00,74,104,Móvel,4,178
6126,2024-01-05 06:05:00,95,115,Brinquedo,1,210
6127,2024-01-05 06:06:00,54,118,Vestuário,9,172
6128,2024-01-05 06:07:00,38,19,Alimento,5,57
6129,2024-01-05 06:08:00,54,158,Móvel,4,212
6130,2024-01-05 06:09:00,52,150,Eletrônico,2,202
6131,2024-01-05 06:10:00,112,131,Móvel,8,243
6132,2024-01-05 06:11:00,116,13,Brinquedo,7,129
6133,2024-01-05 06:12:00,29,164,Vestuário,7,193
6134,2024-01-05 06:13:00,47,133,Brinquedo,8,180
6135,2024-01-05 06:14:00,58,25,Eletrônico,6,83
6136,2024-01-05 06:15:00,34,135,Brinquedo,1,169
6137,2024-01-05 06:16:00,67,143,Móvel,1,210
6138,2024-01-05 06:17:00,88,65,Eletrônico,1,153
6139,2024-01-05 06:18:00,118,10,Brinquedo,9,128
6140,2024-01-05 06:19:00,42,79,Vestuário,2,121
6141,2024-01-05 06:20:00,15,74,Eletrônico,3,89
6142,2024-01-05 06:21:00,34,47,Brinquedo,5,81
6143,2024-01-05 06:22:00,18,120,Móvel,8,138
6144,2024-01-05 06:23:00,100,104,Móvel,4,204
6145,2024-01-05 06:24:00,23,113,Alimento,2,136
6146,2024-01-05 06:25:00,33,139,Vestuário,8,172
6147,2024-01-05 06:26:00,116,67,Brinquedo,4,183
6148,2024-01-05 06:27:00,17,151,Eletrônico,2,168
6149,2024-01-05 06:28:00,89,154,Alimento,5,243
6150,2024-01-05 06:29:00,11,50,Vestuário,1,61
6151,2024-01-05 06:30:00,104,166,Brinquedo,2,270
6152,2024-01-05 06:31:00,73,75,Vestuário,9,148
6153,2024-01-05 06:32:00,108,32,Eletrônico,1,140
6154,2024-01-05 06:33:00,59,118,Vestuário,4,177
6155,2024-01-05 06:34:00,39,89,Brinquedo,8,128
6156,2024-01-05 06:35:00,43,82,Brinquedo,5,125
6157,2024-01-05 06:36:00,20,50,Móvel,6,70
6158,2024-01-05 06:37:00,58,119,Alimento,9,177
6159,2024-01-05 06:38:00,71,97,Brinquedo,3,168
6160,2024-01-05 06:39:00,41,153,Brinquedo,3,194
6161,2024-01-05 06:40:00,59,91,Vestuário,6,150
6162,2024-01-05 06:41:00,60,85,Eletrônico,2,145
6163,2024-01-05 06:42:00,70,172,Móvel,5,242
6164,2024-01-05 06:43:00,99,165,Brinquedo,4,264
6165,2024-01-05 06:44:00,46,146,Alimento,8,192
6166,2024-01-05 06:45:00,33,149,Vestuário,1,182
6167,2024-01-05 06:46:00,44,147,Alimento,2,191
6168,2024-01-05 06:47:00,61,98,Vestuário,2,159
6169,2024-01-05 06:48:00,49,98,Móvel,1,147
6170,2024-01-05 06:49:00,54,90,Brinquedo,3,144
6171,2024-01-05 06:50:00,26,140,Vestuário,7,166
6172,2024-01-05 06:51:00,105,29,Alimento,5,134
6173,2024-01-05 06:52:00,103,178,Alimento,6,281
6174,2024-01-05 06:53:00,72,128,Vestuário,2,200
6175,2024-01-05 06:54:00,45,164,Alimento,3,209
6176,2024-01-05 06:55:00,49,120,Eletrônico,2,169
6177,2024-01-05 06:56:00,30,125,Alimento,2,155
6178,2024-01-05 06:57:00,21,162,Alimento,3,183
6179,2024-01-05 06:58:00,82,150,Alimento,2,232
6180,2024-01-05 06:59:00,65,74,Alimento,1,139
6181,2024-01-05 07:00:00,77,167,Eletrônico,5,244
6182,2024-01-05 07:01:00,93,71,Eletrônico,9,164
6183,2024-01-05 07:02:00,64,10,Vestuário,7,74
6184,2024-01-05 07:03:00,37,97,Vestuário,1,134
6185,2024-01-05 07:04:00,85,91,Eletrônico,7,176
6186,2024-01-05 07:05:00,84,125,Alimento,7,209
6187,2024-01-05 07:06:00,47,24,Móvel,5,71
6188,2024-01-05 07:07:00,58,80,Brinquedo,6,138
6189,2024-01-05 07:08:00,47,61,Brinquedo,1,108
6190,2024-01-05 07:09:00,73,169,Alimento,3,242
6191,2024-01-05 07:10:00,36,160,Vestuário,8,196
6192,2024-01-05 07:11:00,84,120,Alimento,8,204
6193,2024-01-05 07:12:00,108,44,Móvel,1,152
6194,2024-01-05 07:13:00,25,157,Móvel,7,182
6195,2024-01-05 07:14:00,71,52,Vestuário,7,123
6196,2024-01-05 07:15:00,56,64,Brinquedo,1,120
6197,2024-01-05 07:16:00,94,144,Alimento,3,238
6198,2024-01-05 07:17:00,116,50,Vestuário,7,166
6199,2024-01-05 07:18:00,17,67,Eletrônico,9,84
6200,2024-01-05 07:19:00,112,77,Móvel,1,189
6201,2024-01-05 07:20:00,44,52,Vestuário,9,96
6202,2024-01-05 07:21:00,20,42,Alimento,1,62
6203,2024-01-05 07:22:00,33,173,Eletrônico,9,206
6204,2024-01-05 07:23:00,52,175,Brinquedo,9,227
6205,2024-01-05 07:24:00,21,161,Vestuário,5,182
6206,2024-01-05 07:25:00,50,100,Alimento,4,150
6207,2024-01-05 07:26:00,96,81,Brinquedo,7,177
6208,2024-01-05 07:27:00,28,119,Alimento,9,147
6209,2024-01-05 07:28:00,12,72,Móvel,8,84
6210,2024-01-05 07:29:00,13,28,Alimento,7,41
6211,2024-01-05 07:30:00,25,34,Alimento,2,59
6212,2024-01-05 07:31:00,53,51,Alimento,4,104
6213,2024-01-05 07:32:00,110,47,Alimento,1,157
6214,2024-01-05 07:33:00,54,10,Eletrônico,2,64
6215,2024-01-05 07:34:00,90,15,Brinquedo,7,105
6216,2024-01-05 07:35:00,24,126,Móvel,7,150
6217,2024-01-05 07:36:00,62,179,Móvel,5,241
6218,2024-01-05 07:37:00,59,60,Vestuário,8,119
6219,2024-01-05 07:38:00,64,40,Brinquedo,3,104
6220,2024-01-05 07:39:00,97,81,Vestuário,1,178
6221,2024-01-05 07:40:00,101,121,Brinquedo,5,222
6222,2024-01-05 07:41:00,75,20,Vestuário,6,95
6223,2024-01-05 07:42:00,87,105,Alimento,5,192
6224,2024-01-05 07:43:00,26,165,Móvel,6,191
6225,2024-01-05 07:44:00,84,32,Vestuário,1,116
6226,2024-01-05 07:45:00,60,117,Brinquedo,3,177
6227,2024-01-05 07:46:00,74,139,Alimento,7,213
6228,2024-01-05 07:47:00,56,32,Móvel,1,88
6229,2024-01-05 07:48:00,32,43,Móvel,7,75
6230,2024-01-05 07:49:00,90,31,Eletrônico,6,121
6231,2024-01-05 07:50:00,56,131,Móvel,3,187
6232,2024-01-05 07:51:00,54,37,Móvel,4,91
6233,2024-01-05 07:52:00,19,55,Vestuário,8,74
6234,2024-01-05 07:53:00,101,98,Brinquedo,2,199
6235,2024-01-05 07:54:00,109,98,Brinquedo,1,207
6236,2024-01-05 07:55:00,53,47,Vestuário,5,100
6237,2024-01-05 07:56:00,40,35,Alimento,4,75
6238,2024-01-05 07:57:00,112,46,Eletrônico,4,158
6239,2024-01-05 07:58:00,70,15,Móvel,2,85
6240,2024-01-05 07:59:00,39,178,Vestuário,5,217
6241,2024-01-05 08:00:00,76,128,Brinquedo,8,204
6242,2024-01-05 08:01:00,32,74,Eletrônico,5,106
6243,2024-01-05 08:02:00,103,37,Eletrônico,5,140
6244,2024-01-05 08:03:00,113,63,Eletrônico,4,176
6245,2024-01-05 08:04:00,28,109,Alimento,9,137
6246,2024-01-05 08:05:00,44,119,Móvel,2,163
6247,2024-01-05 08:06:00,39,51,Eletrônico,9,90
6248,2024-01-05 08:07:00,118,94,Eletrônico,6,212
6249,2024-01-05 08:08:00,16,99,Eletrônico,6,115
6250,2024-01-05 08:09:00,97,161,Brinquedo,4,258
6251,2024-01-05 08:10:00,19,98,Alimento,1,117
6252,2024-01-05 08:11:00,28,54,Vestuário,6,82
6253,2024-01-05 08:12:00,41,74,Brinquedo,8,115
6254,2024-01-05 08:13:00,64,59,Vestuário,5,123
6255,2024-01-05 08:14:00,17,77,Eletrônico,4,94
6256,2024-01-05 08:15:00,82,102,Vestuário,8,184
6257,2024-01-05 08:16:00,38,112,Brinquedo,8,150
6258,2024-01-05 08:17:00,69,10,Móvel,5,79
6259,2024-01-05 08:18:00,16,67,Eletrônico,7,83
6260,2024-01-05 08:19:00,69,45,Móvel,1,114
6261,2024-01-05 08:20:00,44,82,Brinquedo,5,126
6262,2024-01-05 08:21:00,102,70,Alimento,5,172
6263,2024-01-05 08:22:00,59,33,Vestuário,7,92
6264,2024-01-05 08:23:00,115,117,Eletrônico,9,232
6265,2024-01-05 08:24:00,98,171,Eletrônico,8,269
6266,2024-01-05 08:25:00,23,172,Brinquedo,3,195
6267,2024-01-05 08:26:00,34,114,Vestuário,3,148
6268,2024-01-05 08:27:00,98,157,Alimento,3,255
6269,2024-01-05 08:28:00,63,129,Eletrônico,6,192
6270,2024-01-05 08:29:00,81,129,Alimento,9,210
6271,2024-01-05 08:30:00,51,28,Vestuário,8,79
6272,2024-01-05 08:31:00,45,170,Brinquedo,5,215
6273,2024-01-05 08:32:00,109,115,Brinquedo,2,224
6274,2024-01-05 08:33:00,91,23,Alimento,2,114
6275,2024-01-05 08:34:00,40,43,Eletrônico,7,83
6276,2024-01-05 08:35:00,26,17,Alimento,3,43
6277,2024-01-05 08:36:00,20,153,Vestuário,5,173
6278,2024-01-05 08:37:00,86,43,Móvel,9,129
6279,2024-01-05 08:38:00,115,102,Móvel,9,217
6280,2024-01-05 08:39:00,74,161,Vestuário,9,235
6281,2024-01-05 08:40:00,76,126,Móvel,8,202
6282,2024-01-05 08:41:00,25,113,Móvel,2,138
6283,2024-01-05 08:42:00,78,89,Alimento,2,167
6284,2024-01-05 08:43:00,67,41,Vestuário,7,108
6285,2024-01-05 08:44:00,115,89,Vestuário,9,204
6286,2024-01-05 08:45:00,45,79,Móvel,1,124
6287,2024-01-05 08:46:00,45,150,Alimento,9,195
6288,2024-01-05 08:47:00,34,124,Alimento,2,158
6289,2024-01-05 08:48:00,51,68,Móvel,5,119
6290,2024-01-05 08:49:00,58,172,Móvel,4,230
6291,2024-01-05 08:50:00,61,78,Alimento,8,139
6292,2024-01-05 08:51:00,64,172,Alimento,6,236
6293,2024-01-05 08:52:00,32,119,Alimento,5,151
6294,2024-01-05 08:53:00,60,65,Brinquedo,7,125
6295,2024-01-05 08:54:00,82,130,Alimento,7,212
6296,2024-01-05 08:55:00,60,138,Brinquedo,8,198
6297,2024-01-05 08:56:00,85,107,Alimento,1,192
6298,2024-01-05 08:57:00,10,163,Brinquedo,5,173
6299,2024-01-05 08:58:00,33,88,Móvel,8,121
6300,2024-01-05 08:59:00,94,64,Brinquedo,2,158
6301,2024-01-05 09:00:00,23,122,Móvel,6,145
6302,2024-01-05 09:01:00,50,92,Alimento,9,142
6303,2024-01-05 09:02:00,74,143,Brinquedo,6,217
6304,2024-01-05 09:03:00,38,17,Móvel,8,55
6305,2024-01-05 09:04:00,111,21,Alimento,5,132
6306,2024-01-05 09:05:00,113,17,Vestuário,1,130
6307,2024-01-05 09:06:00,99,53,Alimento,9,152
6308,2024-01-05 09:07:00,70,83,Vestuário,8,153
6309,2024-01-05 09:08:00,25,98,Móvel,7,123
6310,2024-01-05 09:09:00,83,96,Brinquedo,4,179
6311,2024-01-05 09:10:00,41,149,Vestuário,5,190
6312,2024-01-05 09:11:00,36,166,Móvel,4,202
6313,2024-01-05 09:12:00,12,156,Eletrônico,2,168
6314,2024-01-05 09:13:00,112,172,Brinquedo,8,284
6315,2024-01-05 09:14:00,69,148,Alimento,6,217
6316,2024-01-05 09:15:00,88,132,Eletrônico,4,220
6317,2024-01-05 09:16:00,49,69,Alimento,8,118
6318,2024-01-05 09:17:00,59,174,Eletrônico,2,233
6319,2024-01-05 09:18:00,73,125,Brinquedo,9,198
6320,2024-01-05 09:19:00,41,73,Eletrônico,1,114
6321,2024-01-05 09:20:00,52,153,Alimento,6,205
6322,2024-01-05 09:21:00,22,55,Eletrônico,3,77
6323,2024-01-05 09:22:00,102,167,Móvel,8,269
6324,2024-01-05 09:23:00,108,55,Móvel,1,163
6325,2024-01-05 09:24:00,30,153,Brinquedo,5,183
6326,2024-01-05 09:25:00,105,131,Móvel,2,236
6327,2024-01-05 09:26:00,80,146,Eletrônico,9,226
6328,2024-01-05 09:27:00,42,61,Alimento,8,103
6329,2024-01-05 09:28:00,24,148,Brinquedo,5,172
6330,2024-01-05 09:29:00,13,60,Vestuário,3,73
6331,2024-01-05 09:30:00,47,50,Móvel,8,97
6332,2024-01-05 09:31:00,76,84,Eletrônico,1,160
6333,2024-01-05 09:32:00,112,76,Brinquedo,5,188
6334,2024-01-05 09:33:00,41,45,Móvel,7,86
6335,2024-01-05 09:34:00,38,136,Alimento,7,174
6336,2024-01-05 09:35:00,102,99,Móvel,1,201
6337,2024-01-05 09:36:00,89,42,Móvel,4,131
6338,2024-01-05 09:37:00,24,17,Móvel,3,41
6339,2024-01-05 09:38:00,39,129,Eletrônico,6,168
6340,2024-01-05 09:39:00,91,15,Brinquedo,2,106
6341,2024-01-05 09:40:00,64,169,Alimento,6,233
6342,2024-01-05 09:41:00,13,93,Vestuário,2,106
6343,2024-01-05 09:42:00,119,99,Eletrônico,4,218
6344,2024-01-05 09:43:00,81,135,Eletrônico,1,216
6345,2024-01-05 09:44:00,55,102,Móvel,4,157
6346,2024-01-05 09:45:00,103,111,Brinquedo,3,214
6347,2024-01-05 09:46:00,103,30,Vestuário,6,133
6348,2024-01-05 09:47:00,20,56,Alimento,7,76
6349,2024-01-05 09:48:00,80,105,Móvel,3,185
6350,2024-01-05 09:49:00,41,58,Brinquedo,2,99
6351,2024-01-05 09:50:00,54,23,Brinquedo,6,77
6352,2024-01-05 09:51:00,95,87,Brinquedo,2,182
6353,2024-01-05 09:52:00,91,45,Alimento,7,136
6354,2024-01-05 09:53:00,10,108,Móvel,9,118
6355,2024-01-05 09:54:00,36,75,Vestuário,7,111
6356,2024-01-05 09:55:00,78,57,Vestuário,4,135
6357,2024-01-05 09:56:00,103,16,Brinquedo,6,119
6358,2024-01-05 09:57:00,90,36,Eletrônico,3,126
6359,2024-01-05 09:58:00,10,55,Móvel,1,65
6360,2024-01-05 09:59:00,13,88,Vestuário,6,101
6361,2024-01-05 10:00:00,71,80,Alimento,6,151
6362,2024-01-05 10:01:00,36,34,Vestuário,4,70
6363,2024-01-05 10:02:00,89,113,Alimento,2,202
6364,2024-01-05 10:03:00,13,74,Alimento,2,87
6365,2024-01-05 10:04:00,101,83,Brinquedo,3,184
6366,2024-01-05 10:05:00,91,82,Brinquedo,7,173
6367,2024-01-05 10:06:00,10,138,Eletrônico,5,148
6368,2024-01-05 10:07:00,16,19,Eletrônico,8,35
6369,2024-01-05 10:08:00,53,102,Vestuário,4,155
6370,2024-01-05 10:09:00,94,90,Móvel,8,184
6371,2024-01-05 10:10:00,62,33,Móvel,4,95
6372,2024-01-05 10:11:00,30,140,Vestuário,6,170
6373,2024-01-05 10:12:00,57,61,Vestuário,5,118
6374,2024-01-05 10:13:00,10,100,Móvel,2,110
6375,2024-01-05 10:14:00,17,83,Brinquedo,7,100
6376,2024-01-05 10:15:00,89,149,Vestuário,4,238
6377,2024-01-05 10:16:00,33,138,Brinquedo,9,171
6378,2024-01-05 10:17:00,90,49,Móvel,9,139
6379,2024-01-05 10:18:00,15,100,Móvel,7,115
6380,2024-01-05 10:19:00,41,84,Móvel,8,125
6381,2024-01-05 10:20:00,58,27,Móvel,6,85
6382,2024-01-05 10:21:00,67,131,Alimento,6,198
6383,2024-01-05 10:22:00,47,27,Alimento,9,74
6384,2024-01-05 10:23:00,41,118,Brinquedo,7,159
6385,2024-01-05 10:24:00,76,132,Brinquedo,3,208
6386,2024-01-05 10:25:00,92,110,Eletrônico,2,202
6387,2024-01-05 10:26:00,24,111,Móvel,1,135
6388,2024-01-05 10:27:00,19,87,Brinquedo,3,106
6389,2024-01-05 10:28:00,54,48,Brinquedo,4,102
6390,2024-01-05 10:29:00,33,27,Alimento,1,60
6391,2024-01-05 10:30:00,79,29,Móvel,5,108
6392,2024-01-05 10:31:00,43,80,Alimento,6,123
6393,2024-01-05 10:32:00,79,144,Vestuário,8,223
6394,2024-01-05 10:33:00,118,62,Alimento,1,180
6395,2024-01-05 10:34:00,39,83,Brinquedo,7,122
6396,2024-01-05 10:35:00,81,128,Móvel,8,209
6397,2024-01-05 10:36:00,24,134,Alimento,8,158
6398,2024-01-05 10:37:00,16,52,Brinquedo,8,68
6399,2024-01-05 10:38:00,115,148,Brinquedo,7,263
6400,2024-01-05 10:39:00,22,139,Eletrônico,5,161
6401,2024-01-05 10:40:00,50,100,Brinquedo,3,150
6402,2024-01-05 10:41:00,92,47,Vestuário,2,139
6403,2024-01-05 10:42:00,23,82,Brinquedo,7,105
6404,2024-01-05 10:43:00,43,167,Vestuário,4,210
6405,2024-01-05 10:44:00,29,108,Móvel,9,137
6406,2024-01-05 10:45:00,36,43,Móvel,1,79
6407,2024-01-05 10:46:00,112,96,Alimento,9,208
6408,2024-01-05 10:47:00,48,55,Alimento,9,103
6409,2024-01-05 10:48:00,64,170,Alimento,8,234
6410,2024-01-05 10:49:00,114,100,Alimento,5,214
6411,2024-01-05 10:50:00,17,156,Móvel,6,173
6412,2024-01-05 10:51:00,39,136,Vestuário,3,175
6413,2024-01-05 10:52:00,78,53,Móvel,5,131
6414,2024-01-05 10:53:00,21,162,Móvel,4,183
6415,2024-01-05 10:54:00,94,98,Eletrônico,7,192
6416,2024-01-05 10:55:00,107,95,Brinquedo,6,202
6417,2024-01-05 10:56:00,17,98,Vestuário,4,115
6418,2024-01-05 10:57:00,77,50,Móvel,3,127
6419,2024-01-05 10:58:00,95,135,Eletrônico,1,230
6420,2024-01-05 10:59:00,62,122,Alimento,5,184
6421,2024-01-05 11:00:00,111,140,Móvel,6,251
6422,2024-01-05 11:01:00,15,16,Vestuário,3,31
6423,2024-01-05 11:02:00,117,97,Alimento,2,214
6424,2024-01-05 11:03:00,93,170,Móvel,1,263
6425,2024-01-05 11:04:00,108,40,Brinquedo,9,148
6426,2024-01-05 11:05:00,114,111,Alimento,8,225
6427,2024-01-05 11:06:00,49,89,Alimento,7,138
6428,2024-01-05 11:07:00,25,109,Alimento,5,134
6429,2024-01-05 11:08:00,45,56,Móvel,2,101
6430,2024-01-05 11:09:00,106,98,Alimento,4,204
6431,2024-01-05 11:10:00,111,67,Brinquedo,1,178
6432,2024-01-05 11:11:00,42,92,Alimento,3,134
6433,2024-01-05 11:12:00,89,127,Brinquedo,9,216
6434,2024-01-05 11:13:00,118,136,Móvel,5,254
6435,2024-01-05 11:14:00,24,135,Vestuário,7,159
6436,2024-01-05 11:15:00,18,50,Alimento,8,68
6437,2024-01-05 11:16:00,23,99,Móvel,2,122
6438,2024-01-05 11:17:00,100,64,Eletrônico,5,164
6439,2024-01-05 11:18:00,47,32,Eletrônico,2,79
6440,2024-01-05 11:19:00,96,151,Vestuário,2,247
6441,2024-01-05 11:20:00,88,131,Eletrônico,5,219
6442,2024-01-05 11:21:00,16,53,Vestuário,6,69
6443,2024-01-05 11:22:00,73,106,Alimento,8,179
6444,2024-01-05 11:23:00,32,42,Alimento,7,74
6445,2024-01-05 11:24:00,74,63,Vestuário,8,137
6446,2024-01-05 11:25:00,109,140,Vestuário,9,249
6447,2024-01-05 11:26:00,41,48,Móvel,4,89
6448,2024-01-05 11:27:00,46,11,Vestuário,8,57
6449,2024-01-05 11:28:00,42,101,Vestuário,3,143
6450,2024-01-05 11:29:00,119,13,Vestuário,1,132
6451,2024-01-05 11:30:00,117,116,Eletrônico,2,233
6452,2024-01-05 11:31:00,115,97,Vestuário,1,212
6453,2024-01-05 11:32:00,101,127,Alimento,6,228
6454,2024-01-05 11:33:00,47,131,Móvel,6,178
6455,2024-01-05 11:34:00,11,146,Alimento,3,157
6456,2024-01-05 11:35:00,45,71,Alimento,6,116
6457,2024-01-05 11:36:00,83,91,Móvel,2,174
6458,2024-01-05 11:37:00,23,79,Vestuário,2,102
6459,2024-01-05 11:38:00,65,14,Alimento,6,79
6460,2024-01-05 11:39:00,95,66,Eletrônico,9,161
6461,2024-01-05 11:40:00,64,81,Vestuário,8,145
6462,2024-01-05 11:41:00,48,95,Vestuário,7,143
6463,2024-01-05 11:42:00,46,122,Alimento,6,168
6464,2024-01-05 11:43:00,33,133,Vestuário,4,166
6465,2024-01-05 11:44:00,66,164,Móvel,2,230
6466,2024-01-05 11:45:00,18,86,Alimento,8,104
6467,2024-01-05 11:46:00,119,156,Móvel,3,275
6468,2024-01-05 11:47:00,100,132,Brinquedo,5,232
6469,2024-01-05 11:48:00,38,91,Vestuário,7,129
6470,2024-01-05 11:49:00,70,66,Vestuário,6,136
6471,2024-01-05 11:50:00,93,141,Vestuário,6,234
6472,2024-01-05 11:51:00,110,143,Eletrônico,8,253
6473,2024-01-05 11:52:00,93,69,Móvel,7,162
6474,2024-01-05 11:53:00,110,171,Brinquedo,3,281
6475,2024-01-05 11:54:00,68,37,Vestuário,9,105
6476,2024-01-05 11:55:00,93,172,Vestuário,4,265
6477,2024-01-05 11:56:00,86,104,Brinquedo,6,190
6478,2024-01-05 11:57:00,79,171,Brinquedo,6,250
6479,2024-01-05 11:58:00,35,72,Móvel,5,107
6480,2024-01-05 11:59:00,41,36,Vestuário,7,77
6481,2024-01-05 12:00:00,24,45,Brinquedo,8,69
6482,2024-01-05 12:01:00,92,146,Eletrônico,5,238
6483,2024-01-05 12:02:00,63,140,Móvel,5,203
6484,2024-01-05 12:03:00,45,168,Alimento,2,213
6485,2024-01-05 12:04:00,91,78,Brinquedo,9,169
6486,2024-01-05 12:05:00,104,99,Vestuário,1,203
6487,2024-01-05 12:06:00,64,144,Alimento,9,208
6488,2024-01-05 12:07:00,58,147,Eletrônico,2,205
6489,2024-01-05 12:08:00,82,149,Móvel,5,231
6490,2024-01-05 12:09:00,98,11,Eletrônico,8,109
6491,2024-01-05 12:10:00,16,147,Eletrônico,8,163
6492,2024-01-05 12:11:00,55,112,Alimento,8,167
6493,2024-01-05 12:12:00,107,11,Móvel,2,118
6494,2024-01-05 12:13:00,118,129,Vestuário,3,247
6495,2024-01-05 12:14:00,36,129,Brinquedo,2,165
6496,2024-01-05 12:15:00,73,17,Vestuário,9,90
6497,2024-01-05 12:16:00,119,85,Brinquedo,5,204
6498,2024-01-05 12:17:00,63,87,Móvel,7,150
6499,2024-01-05 12:18:00,95,126,Alimento,4,221
6500,2024-01-05 12:19:00,31,126,Brinquedo,8,157
6501,2024-01-05 12:20:00,117,87,Brinquedo,9,204
6502,2024-01-05 12:21:00,40,44,Vestuário,3,84
6503,2024-01-05 12:22:00,57,155,Vestuário,6,212
6504,2024-01-05 12:23:00,30,19,Brinquedo,9,49
6505,2024-01-05 12:24:00,14,179,Brinquedo,3,193
6506,2024-01-05 12:25:00,29,156,Eletrônico,5,185
6507,2024-01-05 12:26:00,102,148,Eletrônico,3,250
6508,2024-01-05 12:27:00,18,86,Alimento,5,104
6509,2024-01-05 12:28:00,88,107,Brinquedo,8,195
6510,2024-01-05 12:29:00,87,50,Brinquedo,4,137
6511,2024-01-05 12:30:00,36,123,Móvel,7,159
6512,2024-01-05 12:31:00,108,144,Eletrônico,7,252
6513,2024-01-05 12:32:00,17,168,Móvel,2,185
6514,2024-01-05 12:33:00,103,108,Brinquedo,5,211
6515,2024-01-05 12:34:00,52,112,Brinquedo,2,164
6516,2024-01-05 12:35:00,12,140,Brinquedo,5,152
6517,2024-01-05 12:36:00,12,167,Eletrônico,6,179
6518,2024-01-05 12:37:00,96,106,Eletrônico,5,202
6519,2024-01-05 12:38:00,68,102,Eletrônico,8,170
6520,2024-01-05 12:39:00,32,43,Vestuário,3,75
6521,2024-01-05 12:40:00,56,102,Alimento,9,158
6522,2024-01-05 12:41:00,104,59,Alimento,2,163
6523,2024-01-05 12:42:00,70,63,Vestuário,7,133
6524,2024-01-05 12:43:00,40,102,Vestuário,2,142
6525,2024-01-05 12:44:00,115,106,Brinquedo,5,221
6526,2024-01-05 12:45:00,25,87,Móvel,1,112
6527,2024-01-05 12:46:00,10,24,Brinquedo,9,34
6528,2024-01-05 12:47:00,73,29,Alimento,7,102
6529,2024-01-05 12:48:00,24,156,Eletrônico,4,180
6530,2024-01-05 12:49:00,92,12,Alimento,2,104
6531,2024-01-05 12:50:00,68,95,Brinquedo,4,163
6532,2024-01-05 12:51:00,74,59,Vestuário,1,133
6533,2024-01-05 12:52:00,49,44,Eletrônico,8,93
6534,2024-01-05 12:53:00,63,130,Vestuário,6,193
6535,2024-01-05 12:54:00,18,127,Brinquedo,6,145
6536,2024-01-05 12:55:00,56,116,Alimento,7,172
6537,2024-01-05 12:56:00,94,86,Brinquedo,7,180
6538,2024-01-05 12:57:00,45,135,Eletrônico,3,180
6539,2024-01-05 12:58:00,54,153,Vestuário,3,207
6540,2024-01-05 12:59:00,117,27,Vestuário,5,144
6541,2024-01-05 13:00:00,106,167,Vestuário,2,273
6542,2024-01-05 13:01:00,52,151,Brinquedo,5,203
6543,2024-01-05 13:02:00,14,96,Móvel,4,110
6544,2024-01-05 13:03:00,118,19,Vestuário,1,137
6545,2024-01-05 13:04:00,19,52,Vestuário,2,71
6546,2024-01-05 13:05:00,25,139,Eletrônico,6,164
6547,2024-01-05 13:06:00,48,13,Eletrônico,1,61
6548,2024-01-05 13:07:00,40,150,Alimento,6,190
6549,2024-01-05 13:08:00,55,129,Móvel,9,184
6550,2024-01-05 13:09:00,61,172,Brinquedo,8,233
6551,2024-01-05 13:10:00,92,49,Eletrônico,4,141
6552,2024-01-05 13:11:00,43,127,Vestuário,9,170
6553,2024-01-05 13:12:00,110,28,Alimento,5,138
6554,2024-01-05 13:13:00,77,35,Brinquedo,9,112
6555,2024-01-05 13:14:00,101,107,Vestuário,8,208
6556,2024-01-05 13:15:00,17,16,Móvel,4,33
6557,2024-01-05 13:16:00,38,133,Alimento,9,171
6558,2024-01-05 13:17:00,47,111,Eletrônico,2,158
6559,2024-01-05 13:18:00,27,135,Brinquedo,8,162
6560,2024-01-05 13:19:00,76,45,Eletrônico,4,121
6561,2024-01-05 13:20:00,89,167,Móvel,2,256
6562,2024-01-05 13:21:00,81,23,Eletrônico,5,104
6563,2024-01-05 13:22:00,45,133,Alimento,1,178
6564,2024-01-05 13:23:00,32,127,Móvel,4,159
6565,2024-01-05 13:24:00,17,11,Vestuário,8,28
6566,2024-01-05 13:25:00,115,84,Alimento,4,199
6567,2024-01-05 13:26:00,118,11,Alimento,5,129
6568,2024-01-05 13:27:00,35,24,Vestuário,6,59
6569,2024-01-05 13:28:00,84,90,Vestuário,1,174
6570,2024-01-05 13:29:00,45,144,Móvel,7,189
6571,2024-01-05 13:30:00,31,133,Alimento,7,164
6572,2024-01-05 13:31:00,117,98,Eletrônico,1,215
6573,2024-01-05 13:32:00,63,32,Alimento,8,95
6574,2024-01-05 13:33:00,50,64,Eletrônico,8,114
6575,2024-01-05 13:34:00,16,27,Brinquedo,1,43
6576,2024-01-05 13:35:00,80,89,Móvel,1,169
6577,2024-01-05 13:36:00,105,161,Brinquedo,5,266
6578,2024-01-05 13:37:00,98,32,Vestuário,7,130
6579,2024-01-05 13:38:00,96,16,Eletrônico,6,112
6580,2024-01-05 13:39:00,22,139,Brinquedo,9,161
6581,2024-01-05 13:40:00,16,119,Vestuário,9,135
6582,2024-01-05 13:41:00,69,53,Vestuário,6,122
6583,2024-01-05 13:42:00,57,36,Móvel,4,93
6584,2024-01-05 13:43:00,43,146,Vestuário,1,189
6585,2024-01-05 13:44:00,85,110,Vestuário,9,195
6586,2024-01-05 13:45:00,83,17,Móvel,7,100
6587,2024-01-05 13:46:00,74,135,Brinquedo,8,209
6588,2024-01-05 13:47:00,80,32,Eletrônico,9,112
6589,2024-01-05 13:48:00,107,86,Móvel,3,193
6590,2024-01-05 13:49:00,80,151,Móvel,9,231
6591,2024-01-05 13:50:00,91,39,Eletrônico,6,130
6592,2024-01-05 13:51:00,116,152,Eletrônico,7,268
6593,2024-01-05 13:52:00,75,156,Brinquedo,9,231
6594,2024-01-05 13:53:00,52,98,Eletrônico,8,150
6595,2024-01-05 13:54:00,55,161,Vestuário,5,216
6596,2024-01-05 13:55:00,70,146,Vestuário,4,216
6597,2024-01-05 13:56:00,15,170,Vestuário,1,185
6598,2024-01-05 13:57:00,11,42,Alimento,5,53
6599,2024-01-05 13:58:00,84,76,Alimento,6,160
6600,2024-01-05 13:59:00,70,48,Alimento,6,118
6601,2024-01-05 14:00:00,76,158,Móvel,9,234
6602,2024-01-05 14:01:00,55,25,Eletrônico,9,80
6603,2024-01-05 14:02:00,17,91,Móvel,4,108
6604,2024-01-05 14:03:00,29,54,Alimento,3,83
6605,2024-01-05 14:04:00,28,153,Alimento,5,181
6606,2024-01-05 14:05:00,104,66,Vestuário,9,170
6607,2024-01-05 14:06:00,23,157,Vestuário,8,180
6608,2024-01-05 14:07:00,97,84,Eletrônico,1,181
6609,2024-01-05 14:08:00,45,149,Alimento,2,194
6610,2024-01-05 14:09:00,101,166,Brinquedo,1,267
6611,2024-01-05 14:10:00,69,128,Eletrônico,1,197
6612,2024-01-05 14:11:00,10,176,Alimento,3,186
6613,2024-01-05 14:12:00,49,162,Vestuário,9,211
6614,2024-01-05 14:13:00,26,161,Alimento,9,187
6615,2024-01-05 14:14:00,29,66,Móvel,3,95
6616,2024-01-05 14:15:00,20,164,Brinquedo,8,184
6617,2024-01-05 14:16:00,22,41,Eletrônico,5,63
6618,2024-01-05 14:17:00,63,51,Brinquedo,2,114
6619,2024-01-05 14:18:00,81,176,Eletrônico,6,257
6620,2024-01-05 14:19:00,54,52,Vestuário,9,106
6621,2024-01-05 14:20:00,75,13,Alimento,7,88
6622,2024-01-05 14:21:00,45,51,Vestuário,5,96
6623,2024-01-05 14:22:00,44,105,Brinquedo,1,149
6624,2024-01-05 14:23:00,106,143,Brinquedo,6,249
6625,2024-01-05 14:24:00,11,57,Eletrônico,7,68
6626,2024-01-05 14:25:00,34,129,Brinquedo,4,163
6627,2024-01-05 14:26:00,87,136,Alimento,8,223
6628,2024-01-05 14:27:00,118,169,Brinquedo,2,287
6629,2024-01-05 14:28:00,114,83,Eletrônico,5,197
6630,2024-01-05 14:29:00,37,64,Móvel,3,101
6631,2024-01-05 14:30:00,114,14,Vestuário,2,128
6632,2024-01-05 14:31:00,112,133,Eletrônico,8,245
6633,2024-01-05 14:32:00,40,30,Móvel,6,70
6634,2024-01-05 14:33:00,36,143,Brinquedo,9,179
6635,2024-01-05 14:34:00,93,54,Alimento,7,147
6636,2024-01-05 14:35:00,46,42,Brinquedo,7,88
6637,2024-01-05 14:36:00,108,78,Alimento,7,186
6638,2024-01-05 14:37:00,36,123,Móvel,4,159
6639,2024-01-05 14:38:00,40,45,Brinquedo,4,85
6640,2024-01-05 14:39:00,38,54,Vestuário,6,92
6641,2024-01-05 14:40:00,44,125,Móvel,9,169
6642,2024-01-05 14:41:00,50,149,Brinquedo,1,199
6643,2024-01-05 14:42:00,58,57,Brinquedo,8,115
6644,2024-01-05 14:43:00,36,151,Alimento,8,187
6645,2024-01-05 14:44:00,40,74,Vestuário,4,114
6646,2024-01-05 14:45:00,62,166,Móvel,8,228
6647,2024-01-05 14:46:00,103,133,Alimento,8,236
6648,2024-01-05 14:47:00,63,107,Eletrônico,6,170
6649,2024-01-05 14:48:00,16,74,Móvel,9,90
6650,2024-01-05 14:49:00,35,143,Vestuário,2,178
6651,2024-01-05 14:50:00,117,156,Alimento,4,273
6652,2024-01-05 14:51:00,64,59,Brinquedo,2,123
6653,2024-01-05 14:52:00,109,58,Móvel,8,167
6654,2024-01-05 14:53:00,47,95,Móvel,3,142
6655,2024-01-05 14:54:00,33,177,Alimento,9,210
6656,2024-01-05 14:55:00,118,47,Alimento,9,165
6657,2024-01-05 14:56:00,101,12,Alimento,9,113
6658,2024-01-05 14:57:00,71,109,Eletrônico,5,180
6659,2024-01-05 14:58:00,39,76,Alimento,6,115
6660,2024-01-05 14:59:00,68,123,Vestuário,2,191
6661,2024-01-05 15:00:00,32,83,Móvel,7,115
6662,2024-01-05 15:01:00,41,77,Alimento,5,118
6663,2024-01-05 15:02:00,84,168,Eletrônico,7,252
6664,2024-01-05 15:03:00,81,103,Brinquedo,4,184
6665,2024-01-05 15:04:00,113,66,Brinquedo,5,179
6666,2024-01-05 15:05:00,77,131,Vestuário,5,208
6667,2024-01-05 15:06:00,98,43,Alimento,8,141
6668,2024-01-05 15:07:00,91,99,Móvel,1,190
6669,2024-01-05 15:08:00,75,78,Brinquedo,6,153
6670,2024-01-05 15:09:00,94,60,Brinquedo,4,154
6671,2024-01-05 15:10:00,107,19,Eletrônico,6,126
6672,2024-01-05 15:11:00,79,19,Brinquedo,8,98
6673,2024-01-05 15:12:00,71,64,Alimento,8,135
6674,2024-01-05 15:13:00,60,158,Brinquedo,2,218
6675,2024-01-05 15:14:00,114,23,Eletrônico,3,137
6676,2024-01-05 15:15:00,42,140,Alimento,5,182
6677,2024-01-05 15:16:00,28,28,Alimento,2,56
6678,2024-01-05 15:17:00,73,133,Eletrônico,6,206
6679,2024-01-05 15:18:00,69,167,Eletrônico,1,236
6680,2024-01-05 15:19:00,118,21,Vestuário,1,139
6681,2024-01-05 15:20:00,53,163,Alimento,4,216
6682,2024-01-05 15:21:00,22,62,Alimento,7,84
6683,2024-01-05 15:22:00,36,178,Móvel,4,214
6684,2024-01-05 15:23:00,48,86,Vestuário,5,134
6685,2024-01-05 15:24:00,103,152,Brinquedo,3,255
6686,2024-01-05 15:25:00,68,135,Alimento,2,203
6687,2024-01-05 15:26:00,25,140,Eletrônico,2,165
6688,2024-01-05 15:27:00,100,120,Brinquedo,2,220
6689,2024-01-05 15:28:00,39,144,Móvel,4,183
6690,2024-01-05 15:29:00,78,169,Eletrônico,6,247
6691,2024-01-05 15:30:00,41,107,Brinquedo,6,148
6692,2024-01-05 15:31:00,104,20,Eletrônico,9,124
6693,2024-01-05 15:32:00,112,87,Brinquedo,8,199
6694,2024-01-05 15:33:00,12,80,Vestuário,7,92
6695,2024-01-05 15:34:00,39,173,Alimento,2,212
6696,2024-01-05 15:35:00,52,74,Vestuário,7,126
6697,2024-01-05 15:36:00,114,19,Vestuário,6,133
6698,2024-01-05 15:37:00,23,176,Móvel,5,199
6699,2024-01-05 15:38:00,64,171,Móvel,8,235
6700,2024-01-05 15:39:00,56,109,Alimento,3,165
6701,2024-01-05 15:40:00,11,76,Eletrônico,7,87
6702,2024-01-05 15:41:00,117,92,Alimento,2,209
6703,2024-01-05 15:42:00,13,109,Vestuário,9,122
6704,2024-01-05 15:43:00,49,88,Eletrônico,1,137
6705,2024-01-05 15:44:00,47,151,Brinquedo,4,198
6706,2024-01-05 15:45:00,91,87,Vestuário,5,178
6707,2024-01-05 15:46:00,64,50,Eletrônico,2,114
6708,2024-01-05 15:47:00,71,23,Móvel,4,94
6709,2024-01-05 15:48:00,31,129,Vestuário,7,160
6710,2024-01-05 15:49:00,30,67,Brinquedo,3,97
6711,2024-01-05 15:50:00,89,64,Alimento,6,153
6712,2024-01-05 15:51:00,69,59,Móvel,9,128
6713,2024-01-05 15:52:00,99,76,Alimento,8,175
6714,2024-01-05 15:53:00,38,134,Brinquedo,3,172
6715,2024-01-05 15:54:00,57,128,Móvel,4,185
6716,2024-01-05 15:55:00,18,15,Brinquedo,5,33
6717,2024-01-05 15:56:00,52,61,Eletrônico,7,113
6718,2024-01-05 15:57:00,27,49,Alimento,6,76
6719,2024-01-05 15:58:00,109,153,Móvel,6,262
6720,2024-01-05 15:59:00,74,28,Vestuário,1,102
6721,2024-01-05 16:00:00,109,36,Alimento,5,145
6722,2024-01-05 16:01:00,88,15,Alimento,7,103
6723,2024-01-05 16:02:00,53,141,Alimento,3,194
6724,2024-01-05 16:03:00,104,35,Vestuário,6,139
6725,2024-01-05 16:04:00,60,116,Eletrônico,8,176
6726,2024-01-05 16:05:00,78,151,Vestuário,4,229
6727,2024-01-05 16:06:00,61,71,Brinquedo,9,132
6728,2024-01-05 16:07:00,29,152,Brinquedo,1,181
6729,2024-01-05 16:08:00,11,166,Vestuário,6,177
6730,2024-01-05 16:09:00,64,28,Alimento,2,92
6731,2024-01-05 16:10:00,46,104,Vestuário,6,150
6732,2024-01-05 16:11:00,56,146,Alimento,5,202
6733,2024-01-05 16:12:00,69,24,Móvel,8,93
6734,2024-01-05 16:13:00,42,29,Brinquedo,3,71
6735,2024-01-05 16:14:00,107,179,Vestuário,3,286
6736,2024-01-05 16:15:00,34,100,Eletrônico,5,134
6737,2024-01-05 16:16:00,11,97,Vestuário,7,108
6738,2024-01-05 16:17:00,72,74,Eletrônico,6,146
6739,2024-01-05 16:18:00,49,94,Vestuário,2,143
6740,2024-01-05 16:19:00,49,79,Vestuário,3,128
6741,2024-01-05 16:20:00,80,109,Eletrônico,9,189
6742,2024-01-05 16:21:00,96,33,Vestuário,2,129
6743,2024-01-05 16:22:00,31,16,Brinquedo,9,47
6744,2024-01-05 16:23:00,113,85,Eletrônico,9,198
6745,2024-01-05 16:24:00,87,51,Eletrônico,2,138
6746,2024-01-05 16:25:00,80,98,Brinquedo,3,178
6747,2024-01-05 16:26:00,91,55,Alimento,5,146
6748,2024-01-05 16:27:00,24,16,Móvel,5,40
6749,2024-01-05 16:28:00,113,36,Alimento,2,149
6750,2024-01-05 16:29:00,48,79,Eletrônico,7,127
6751,2024-01-05 16:30:00,72,127,Eletrônico,6,199
6752,2024-01-05 16:31:00,76,142,Alimento,7,218
6753,2024-01-05 16:32:00,78,175,Vestuário,9,253
6754,2024-01-05 16:33:00,26,118,Brinquedo,6,144
6755,2024-01-05 16:34:00,12,109,Alimento,5,121
6756,2024-01-05 16:35:00,84,83,Móvel,7,167
6757,2024-01-05 16:36:00,55,117,Eletrônico,6,172
6758,2024-01-05 16:37:00,28,34,Brinquedo,8,62
6759,2024-01-05 16:38:00,54,115,Brinquedo,9,169
6760,2024-01-05 16:39:00,11,56,Móvel,2,67
6761,2024-01-05 16:40:00,63,83,Móvel,7,146
6762,2024-01-05 16:41:00,51,72,Alimento,6,123
6763,2024-01-05 16:42:00,53,172,Alimento,1,225
6764,2024-01-05 16:43:00,49,25,Eletrônico,2,74
6765,2024-01-05 16:44:00,66,161,Móvel,5,227
6766,2024-01-05 16:45:00,116,144,Eletrônico,5,260
6767,2024-01-05 16:46:00,30,152,Alimento,3,182
6768,2024-01-05 16:47:00,56,11,Alimento,2,67
6769,2024-01-05 16:48:00,79,159,Eletrônico,7,238
6770,2024-01-05 16:49:00,65,69,Brinquedo,9,134
6771,2024-01-05 16:50:00,102,167,Vestuário,2,269
6772,2024-01-05 16:51:00,62,178,Eletrônico,9,240
6773,2024-01-05 16:52:00,16,94,Vestuário,2,110
6774,2024-01-05 16:53:00,57,142,Brinquedo,7,199
6775,2024-01-05 16:54:00,99,13,Móvel,8,112
6776,2024-01-05 16:55:00,21,118,Eletrônico,7,139
6777,2024-01-05 16:56:00,118,43,Vestuário,6,161
6778,2024-01-05 16:57:00,31,37,Eletrônico,6,68
6779,2024-01-05 16:58:00,30,126,Eletrônico,9,156
6780,2024-01-05 16:59:00,33,178,Móvel,9,211
6781,2024-01-05 17:00:00,25,104,Móvel,8,129
6782,2024-01-05 17:01:00,70,56,Vestuário,9,126
6783,2024-01-05 17:02:00,58,156,Eletrônico,2,214
6784,2024-01-05 17:03:00,26,151,Alimento,5,177
6785,2024-01-05 17:04:00,74,145,Eletrônico,6,219
6786,2024-01-05 17:05:00,105,71,Móvel,1,176
6787,2024-01-05 17:06:00,19,119,Vestuário,1,138
6788,2024-01-05 17:07:00,71,47,Alimento,5,118
6789,2024-01-05 17:08:00,53,80,Alimento,1,133
6790,2024-01-05 17:09:00,24,75,Vestuário,5,99
6791,2024-01-05 17:10:00,107,131,Alimento,7,238
6792,2024-01-05 17:11:00,30,65,Eletrônico,5,95
6793,2024-01-05 17:12:00,94,39,Alimento,3,133
6794,2024-01-05 17:13:00,92,36,Alimento,3,128
6795,2024-01-05 17:14:00,41,105,Brinquedo,1,146
6796,2024-01-05 17:15:00,51,95,Móvel,9,146
6797,2024-01-05 17:16:00,79,25,Brinquedo,5,104
6798,2024-01-05 17:17:00,54,53,Móvel,9,107
6799,2024-01-05 17:18:00,22,156,Brinquedo,3,178
6800,2024-01-05 17:19:00,76,35,Vestuário,3,111
6801,2024-01-05 17:20:00,60,172,Vestuário,5,232
6802,2024-01-05 17:21:00,85,54,Brinquedo,5,139
6803,2024-01-05 17:22:00,104,110,Móvel,6,214
6804,2024-01-05 17:23:00,57,14,Móvel,9,71
6805,2024-01-05 17:24:00,72,34,Vestuário,4,106
6806,2024-01-05 17:25:00,90,94,Vestuário,3,184
6807,2024-01-05 17:26:00,65,134,Móvel,3,199
6808,2024-01-05 17:27:00,83,11,Vestuário,3,94
6809,2024-01-05 17:28:00,113,109,Vestuário,5,222
6810,2024-01-05 17:29:00,74,176,Eletrônico,6,250
6811,2024-01-05 17:30:00,53,74,Móvel,8,127
6812,2024-01-05 17:31:00,51,24,Móvel,6,75
6813,2024-01-05 17:32:00,33,145,Brinquedo,4,178
6814,2024-01-05 17:33:00,54,82,Alimento,3,136
6815,2024-01-05 17:34:00,85,124,Alimento,8,209
6816,2024-01-05 17:35:00,44,135,Alimento,6,179
6817,2024-01-05 17:36:00,34,34,Brinquedo,6,68
6818,2024-01-05 17:37:00,82,126,Móvel,4,208
6819,2024-01-05 17:38:00,112,17,Brinquedo,9,129
6820,2024-01-05 17:39:00,93,42,Móvel,3,135
6821,2024-01-05 17:40:00,104,79,Alimento,2,183
6822,2024-01-05 17:41:00,100,101,Alimento,1,201
6823,2024-01-05 17:42:00,96,119,Móvel,1,215
6824,2024-01-05 17:43:00,66,65,Eletrônico,6,131
6825,2024-01-05 17:44:00,15,97,Brinquedo,7,112
6826,2024-01-05 17:45:00,47,149,Eletrônico,8,196
6827,2024-01-05 17:46:00,99,157,Vestuário,4,256
6828,2024-01-05 17:47:00,49,49,Eletrônico,4,98
6829,2024-01-05 17:48:00,50,85,Alimento,1,135
6830,2024-01-05 17:49:00,26,80,Móvel,7,106
6831,2024-01-05 17:50:00,116,143,Vestuário,4,259
6832,2024-01-05 17:51:00,93,148,Brinquedo,5,241
6833,2024-01-05 17:52:00,67,169,Alimento,7,236
6834,2024-01-05 17:53:00,82,161,Alimento,2,243
6835,2024-01-05 17:54:00,13,106,Brinquedo,3,119
6836,2024-01-05 17:55:00,103,27,Vestuário,2,130
6837,2024-01-05 17:56:00,97,117,Alimento,6,214
6838,2024-01-05 17:57:00,39,119,Brinquedo,5,158
6839,2024-01-05 17:58:00,102,49,Brinquedo,3,151
6840,2024-01-05 17:59:00,53,150,Eletrônico,6,203
6841,2024-01-05 18:00:00,73,154,Alimento,6,227
6842,2024-01-05 18:01:00,17,60,Alimento,2,77
6843,2024-01-05 18:02:00,73,87,Móvel,3,160
6844,2024-01-05 18:03:00,12,178,Móvel,4,190
6845,2024-01-05 18:04:00,68,139,Alimento,9,207
6846,2024-01-05 18:05:00,95,11,Móvel,6,106
6847,2024-01-05 18:06:00,29,95,Eletrônico,5,124
6848,2024-01-05 18:07:00,72,107,Vestuário,3,179
6849,2024-01-05 18:08:00,56,89,Brinquedo,3,145
6850,2024-01-05 18:09:00,108,68,Móvel,9,176
6851,2024-01-05 18:10:00,87,172,Brinquedo,9,259
6852,2024-01-05 18:11:00,37,47,Brinquedo,5,84
6853,2024-01-05 18:12:00,40,116,Móvel,8,156
6854,2024-01-05 18:13:00,66,104,Vestuário,4,170
6855,2024-01-05 18:14:00,16,13,Brinquedo,4,29
6856,2024-01-05 18:15:00,59,110,Alimento,5,169
6857,2024-01-05 18:16:00,84,143,Vestuário,7,227
6858,2024-01-05 18:17:00,48,133,Vestuário,2,181
6859,2024-01-05 18:18:00,80,21,Vestuário,1,101
6860,2024-01-05 18:19:00,57,63,Alimento,3,120
6861,2024-01-05 18:20:00,113,138,Eletrônico,8,251
6862,2024-01-05 18:21:00,68,53,Alimento,4,121
6863,2024-01-05 18:22:00,58,141,Alimento,3,199
6864,2024-01-05 18:23:00,38,151,Brinquedo,8,189
6865,2024-01-05 18:24:00,54,127,Brinquedo,8,181
6866,2024-01-05 18:25:00,39,142,Móvel,2,181
6867,2024-01-05 18:26:00,36,11,Alimento,3,47
6868,2024-01-05 18:27:00,12,143,Móvel,8,155
6869,2024-01-05 18:28:00,58,177,Brinquedo,6,235
6870,2024-01-05 18:29:00,44,164,Eletrônico,5,208
6871,2024-01-05 18:30:00,92,158,Alimento,6,250
6872,2024-01-05 18:31:00,93,145,Eletrônico,1,238
6873,2024-01-05 18:32:00,73,71,Brinquedo,8,144
6874,2024-01-05 18:33:00,105,26,Brinquedo,4,131
6875,2024-01-05 18:34:00,33,35,Eletrônico,2,68
6876,2024-01-05 18:35:00,105,95,Vestuário,3,200
6877,2024-01-05 18:36:00,111,137,Eletrônico,6,248
6878,2024-01-05 18:37:00,60,124,Eletrônico,9,184
6879,2024-01-05 18:38:00,77,31,Móvel,2,108
6880,2024-01-05 18:39:00,46,130,Alimento,9,176
6881,2024-01-05 18:40:00,14,134,Brinquedo,2,148
6882,2024-01-05 18:41:00,33,122,Eletrônico,6,155
6883,2024-01-05 18:42:00,72,135,Vestuário,2,207
6884,2024-01-05 18:43:00,47,64,Vestuário,2,111
6885,2024-01-05 18:44:00,15,90,Eletrônico,6,105
6886,2024-01-05 18:45:00,23,87,Alimento,1,110
6887,2024-01-05 18:46:00,109,152,Alimento,9,261
6888,2024-01-05 18:47:00,26,30,Alimento,6,56
6889,2024-01-05 18:48:00,42,130,Alimento,2,172
6890,2024-01-05 18:49:00,78,161,Móvel,4,239
6891,2024-01-05 18:50:00,66,179,Eletrônico,1,245
6892,2024-01-05 18:51:00,45,124,Alimento,5,169
6893,2024-01-05 18:52:00,114,25,Móvel,8,139
6894,2024-01-05 18:53:00,45,33,Eletrônico,7,78
6895,2024-01-05 18:54:00,54,47,Vestuário,9,101
6896,2024-01-05 18:55:00,74,21,Vestuário,4,95
6897,2024-01-05 18:56:00,43,28,Móvel,1,71
6898,2024-01-05 18:57:00,71,150,Vestuário,2,221
6899,2024-01-05 18:58:00,78,145,Vestuário,5,223
6900,2024-01-05 18:59:00,15,96,Alimento,5,111
6901,2024-01-05 19:00:00,62,91,Vestuário,7,153
6902,2024-01-05 19:01:00,102,152,Alimento,1,254
6903,2024-01-05 19:02:00,14,61,Vestuário,1,75
6904,2024-01-05 19:03:00,58,164,Brinquedo,6,222
6905,2024-01-05 19:04:00,74,66,Alimento,7,140
6906,2024-01-05 19:05:00,100,64,Vestuário,4,164
6907,2024-01-05 19:06:00,43,78,Brinquedo,9,121
6908,2024-01-05 19:07:00,45,146,Móvel,2,191
6909,2024-01-05 19:08:00,75,176,Vestuário,8,251
6910,2024-01-05 19:09:00,87,156,Alimento,2,243
6911,2024-01-05 19:10:00,55,79,Alimento,2,134
6912,2024-01-05 19:11:00,37,67,Móvel,9,104
6913,2024-01-05 19:12:00,79,135,Eletrônico,2,214
6914,2024-01-05 19:13:00,37,91,Eletrônico,9,128
6915,2024-01-05 19:14:00,85,70,Móvel,8,155
6916,2024-01-05 19:15:00,43,19,Brinquedo,3,62
6917,2024-01-05 19:16:00,41,88,Brinquedo,2,129
6918,2024-01-05 19:17:00,105,139,Brinquedo,8,244
6919,2024-01-05 19:18:00,38,62,Móvel,9,100
6920,2024-01-05 19:19:00,105,49,Móvel,5,154
6921,2024-01-05 19:20:00,82,18,Eletrônico,3,100
6922,2024-01-05 19:21:00,46,119,Vestuário,2,165
6923,2024-01-05 19:22:00,37,94,Eletrônico,5,131
6924,2024-01-05 19:23:00,72,110,Alimento,8,182
6925,2024-01-05 19:24:00,112,154,Vestuário,9,266
6926,2024-01-05 19:25:00,95,34,Alimento,6,129
6927,2024-01-05 19:26:00,97,142,Eletrônico,8,239
6928,2024-01-05 19:27:00,113,165,Móvel,7,278
6929,2024-01-05 19:28:00,85,37,Vestuário,4,122
6930,2024-01-05 19:29:00,30,34,Móvel,6,64
6931,2024-01-05 19:30:00,51,15,Eletrônico,5,66
6932,2024-01-05 19:31:00,97,90,Móvel,7,187
6933,2024-01-05 19:32:00,78,160,Vestuário,7,238
6934,2024-01-05 19:33:00,99,70,Móvel,5,169
6935,2024-01-05 19:34:00,42,55,Vestuário,2,97
6936,2024-01-05 19:35:00,76,103,Móvel,4,179
6937,2024-01-05 19:36:00,116,28,Brinquedo,1,144
6938,2024-01-05 19:37:00,25,165,Brinquedo,8,190
6939,2024-01-05 19:38:00,70,79,Alimento,2,149
6940,2024-01-05 19:39:00,30,51,Eletrônico,4,81
6941,2024-01-05 19:40:00,119,85,Brinquedo,9,204
6942,2024-01-05 19:41:00,31,82,Móvel,1,113
6943,2024-01-05 19:42:00,102,23,Eletrônico,3,125
6944,2024-01-05 19:43:00,22,154,Brinquedo,1,176
6945,2024-01-05 19:44:00,15,41,Brinquedo,5,56
6946,2024-01-05 19:45:00,40,155,Móvel,7,195
6947,2024-01-05 19:46:00,100,48,Vestuário,5,148
6948,2024-01-05 19:47:00,119,35,Alimento,7,154
6949,2024-01-05 19:48:00,96,92,Móvel,9,188
6950,2024-01-05 19:49:00,49,141,Eletrônico,5,190
6951,2024-01-05 19:50:00,80,177,Alimento,6,257
6952,2024-01-05 19:51:00,102,115,Brinquedo,4,217
6953,2024-01-05 19:52:00,55,160,Eletrônico,5,215
6954,2024-01-05 19:53:00,42,72,Vestuário,1,114
6955,2024-01-05 19:54:00,88,179,Vestuário,7,267
6956,2024-01-05 19:55:00,34,14,Brinquedo,7,48
6957,2024-01-05 19:56:00,83,119,Alimento,4,202
6958,2024-01-05 19:57:00,100,15,Móvel,9,115
6959,2024-01-05 19:58:00,107,97,Vestuário,6,204
6960,2024-01-05 19:59:00,38,163,Móvel,2,201
6961,2024-01-05 20:00:00,45,166,Eletrônico,8,211
6962,2024-01-05 20:01:00,102,36,Alimento,1,138
6963,2024-01-05 20:02:00,78,43,Brinquedo,3,121
6964,2024-01-05 20:03:00,85,77,Vestuário,7,162
6965,2024-01-05 20:04:00,59,131,Vestuário,8,190
6966,2024-01-05 20:05:00,115,131,Vestuário,4,246
6967,2024-01-05 20:06:00,104,169,Eletrônico,3,273
6968,2024-01-05 20:07:00,23,125,Vestuário,9,148
6969,2024-01-05 20:08:00,45,155,Brinquedo,2,200
6970,2024-01-05 20:09:00,77,138,Eletrônico,3,215
6971,2024-01-05 20:10:00,65,137,Vestuário,8,202
6972,2024-01-05 20:11:00,99,42,Brinquedo,1,141
6973,2024-01-05 20:12:00,85,75,Móvel,9,160
6974,2024-01-05 20:13:00,39,159,Alimento,4,198
6975,2024-01-05 20:14:00,115,89,Brinquedo,1,204
6976,2024-01-05 20:15:00,53,87,Eletrônico,8,140
6977,2024-01-05 20:16:00,40,121,Alimento,5,161
6978,2024-01-05 20:17:00,32,48,Eletrônico,3,80
6979,2024-01-05 20:18:00,115,44,Brinquedo,3,159
6980,2024-01-05 20:19:00,47,154,Alimento,5,201
6981,2024-01-05 20:20:00,77,25,Alimento,4,102
6982,2024-01-05 20:21:00,83,173,Brinquedo,3,256
6983,2024-01-05 20:22:00,16,126,Móvel,8,142
6984,2024-01-05 20:23:00,82,101,Móvel,3,183
6985,2024-01-05 20:24:00,11,84,Eletrônico,1,95
6986,2024-01-05 20:25:00,71,150,Brinquedo,5,221
6987,2024-01-05 20:26:00,100,104,Vestuário,8,204
6988,2024-01-05 20:27:00,55,36,Eletrônico,7,91
6989,2024-01-05 20:28:00,106,72,Brinquedo,2,178
6990,2024-01-05 20:29:00,30,108,Móvel,3,138
6991,2024-01-05 20:30:00,87,76,Vestuário,7,163
6992,2024-01-05 20:31:00,109,139,Alimento,3,248
6993,2024-01-05 20:32:00,104,118,Brinquedo,2,222
6994,2024-01-05 20:33:00,48,174,Alimento,9,222
6995,2024-01-05 20:34:00,116,72,Brinquedo,3,188
6996,2024-01-05 20:35:00,93,140,Móvel,3,233
6997,2024-01-05 20:36:00,109,22,Eletrônico,9,131
6998,2024-01-05 20:37:00,114,17,Alimento,4,131
6999,2024-01-05 20:38:00,44,40,Alimento,7,84
7000,2024-01-05 20:39:00,119,115,Brinquedo,4,234
7001,2024-01-05 20:40:00,114,70,Brinquedo,2,184
7002,2024-01-05 20:41:00,101,81,Vestuário,3,182
7003,2024-01-05 20:42:00,24,171,Vestuário,6,195
7004,2024-01-05 20:43:00,40,172,Eletrônico,5,212
7005,2024-01-05 20:44:00,100,61,Brinquedo,3,161
7006,2024-01-05 20:45:00,99,72,Brinquedo,9,171
7007,2024-01-05 20:46:00,114,123,Brinquedo,4,237
7008,2024-01-05 20:47:00,118,131,Alimento,2,249
7009,2024-01-05 20:48:00,59,152,Alimento,8,211
7010,2024-01-05 20:49:00,61,154,Vestuário,7,215
7011,2024-01-05 20:50:00,35,107,Alimento,3,142
7012,2024-01-05 20:51:00,65,149,Móvel,2,214
7013,2024-01-05 20:52:00,21,67,Brinquedo,1,88
7014,2024-01-05 20:53:00,17,63,Eletrônico,1,80
7015,2024-01-05 20:54:00,11,175,Vestuário,5,186
7016,2024-01-05 20:55:00,86,52,Móvel,1,138
7017,2024-01-05 20:56:00,19,83,Brinquedo,9,102
7018,2024-01-05 20:57:00,23,151,Vestuário,8,174
7019,2024-01-05 20:58:00,21,149,Vestuário,1,170
7020,2024-01-05 20:59:00,38,28,Alimento,6,66
7021,2024-01-05 21:00:00,74,89,Alimento,6,163
7022,2024-01-05 21:01:00,63,15,Alimento,3,78
7023,2024-01-05 21:02:00,55,37,Brinquedo,4,92
7024,2024-01-05 21:03:00,109,38,Alimento,1,147
7025,2024-01-05 21:04:00,12,88,Eletrônico,5,100
7026,2024-01-05 21:05:00,16,93,Vestuário,8,109
7027,2024-01-05 21:06:00,56,99,Vestuário,3,155
7028,2024-01-05 21:07:00,66,131,Alimento,7,197
7029,2024-01-05 21:08:00,78,179,Vestuário,3,257
7030,2024-01-05 21:09:00,26,40,Vestuário,5,66
7031,2024-01-05 21:10:00,116,125,Eletrônico,5,241
7032,2024-01-05 21:11:00,77,126,Eletrônico,3,203
7033,2024-01-05 21:12:00,57,11,Móvel,5,68
7034,2024-01-05 21:13:00,84,168,Eletrônico,4,252
7035,2024-01-05 21:14:00,61,142,Alimento,4,203
7036,2024-01-05 21:15:00,57,139,Brinquedo,5,196
7037,2024-01-05 21:16:00,112,24,Vestuário,7,136
7038,2024-01-05 21:17:00,41,33,Brinquedo,4,74
7039,2024-01-05 21:18:00,54,56,Alimento,4,110
7040,2024-01-05 21:19:00,23,171,Eletrônico,1,194
7041,2024-01-05 21:20:00,47,110,Eletrônico,4,157
7042,2024-01-05 21:21:00,59,99,Móvel,9,158
7043,2024-01-05 21:22:00,61,106,Eletrônico,1,167
7044,2024-01-05 21:23:00,58,78,Eletrônico,6,136
7045,2024-01-05 21:24:00,104,17,Vestuário,5,121
7046,2024-01-05 21:25:00,19,128,Móvel,6,147
7047,2024-01-05 21:26:00,50,53,Vestuário,6,103
7048,2024-01-05 21:27:00,22,109,Brinquedo,8,131
7049,2024-01-05 21:28:00,24,16,Eletrônico,9,40
7050,2024-01-05 21:29:00,12,130,Brinquedo,4,142
7051,2024-01-05 21:30:00,13,33,Eletrônico,6,46
7052,2024-01-05 21:31:00,98,42,Vestuário,8,140
7053,2024-01-05 21:32:00,33,34,Eletrônico,7,67
7054,2024-01-05 21:33:00,82,94,Vestuário,1,176
7055,2024-01-05 21:34:00,32,37,Brinquedo,1,69
7056,2024-01-05 21:35:00,39,81,Vestuário,9,120
7057,2024-01-05 21:36:00,25,142,Móvel,4,167
7058,2024-01-05 21:37:00,18,161,Móvel,3,179
7059,2024-01-05 21:38:00,19,172,Móvel,6,191
7060,2024-01-05 21:39:00,60,175,Eletrônico,6,235
7061,2024-01-05 21:40:00,44,115,Brinquedo,2,159
7062,2024-01-05 21:41:00,112,142,Vestuário,2,254
7063,2024-01-05 21:42:00,77,119,Eletrônico,2,196
7064,2024-01-05 21:43:00,72,47,Brinquedo,6,119
7065,2024-01-05 21:44:00,42,108,Brinquedo,9,150
7066,2024-01-05 21:45:00,51,20,Eletrônico,9,71
7067,2024-01-05 21:46:00,45,94,Brinquedo,4,139
7068,2024-01-05 21:47:00,31,57,Eletrônico,4,88
7069,2024-01-05 21:48:00,35,162,Móvel,4,197
7070,2024-01-05 21:49:00,61,170,Alimento,3,231
7071,2024-01-05 21:50:00,34,54,Vestuário,6,88
7072,2024-01-05 21:51:00,110,99,Móvel,2,209
7073,2024-01-05 21:52:00,95,24,Alimento,8,119
7074,2024-01-05 21:53:00,49,177,Móvel,2,226
7075,2024-01-05 21:54:00,104,95,Eletrônico,6,199
7076,2024-01-05 21:55:00,62,13,Vestuário,9,75
7077,2024-01-05 21:56:00,68,114,Alimento,1,182
7078,2024-01-05 21:57:00,36,72,Eletrônico,3,108
7079,2024-01-05 21:58:00,85,163,Eletrônico,9,248
7080,2024-01-05 21:59:00,84,23,Brinquedo,3,107
7081,2024-01-05 22:00:00,65,81,Vestuário,3,146
7082,2024-01-05 22:01:00,74,60,Alimento,4,134
7083,2024-01-05 22:02:00,55,165,Alimento,9,220
7084,2024-01-05 22:03:00,28,147,Vestuário,9,175
7085,2024-01-05 22:04:00,33,162,Móvel,2,195
7086,2024-01-05 22:05:00,75,141,Alimento,9,216
7087,2024-01-05 22:06:00,21,118,Móvel,3,139
7088,2024-01-05 22:07:00,117,20,Alimento,9,137
7089,2024-01-05 22:08:00,74,174,Brinquedo,3,248
7090,2024-01-05 22:09:00,85,135,Eletrônico,9,220
7091,2024-01-05 22:10:00,35,61,Eletrônico,5,96
7092,2024-01-05 22:11:00,28,71,Alimento,8,99
7093,2024-01-05 22:12:00,103,147,Móvel,3,250
7094,2024-01-05 22:13:00,85,92,Vestuário,3,177
7095,2024-01-05 22:14:00,47,70,Eletrônico,7,117
7096,2024-01-05 22:15:00,75,57,Alimento,4,132
7097,2024-01-05 22:16:00,31,19,Vestuário,7,50
7098,2024-01-05 22:17:00,10,158,Brinquedo,9,168
7099,2024-01-05 22:18:00,115,75,Alimento,7,190
7100,2024-01-05 22:19:00,38,123,Brinquedo,7,161
7101,2024-01-05 22:20:00,69,106,Vestuário,3,175
7102,2024-01-05 22:21:00,52,57,Vestuário,5,109
7103,2024-01-05 22:22:00,18,178,Móvel,9,196
7104,2024-01-05 22:23:00,63,158,Móvel,2,221
7105,2024-01-05 22:24:00,38,147,Vestuário,4,185
7106,2024-01-05 22:25:00,45,20,Brinquedo,8,65
7107,2024-01-05 22:26:00,35,70,Eletrônico,8,105
7108,2024-01-05 22:27:00,15,24,Brinquedo,4,39
7109,2024-01-05 22:28:00,28,63,Móvel,6,91
7110,2024-01-05 22:29:00,17,55,Alimento,1,72
7111,2024-01-05 22:30:00,31,93,Móvel,7,124
7112,2024-01-05 22:31:00,53,95,Alimento,7,148
7113,2024-01-05 22:32:00,34,11,Alimento,4,45
7114,2024-01-05 22:33:00,116,52,Móvel,9,168
7115,2024-01-05 22:34:00,42,16,Móvel,3,58
7116,2024-01-05 22:35:00,39,119,Móvel,4,158
7117,2024-01-05 22:36:00,59,166,Alimento,8,225
7118,2024-01-05 22:37:00,54,66,Alimento,7,120
7119,2024-01-05 22:38:00,37,56,Eletrônico,4,93
7120,2024-01-05 22:39:00,29,118,Móvel,2,147
7121,2024-01-05 22:40:00,21,64,Alimento,1,85
7122,2024-01-05 22:41:00,89,110,Brinquedo,9,199
7123,2024-01-05 22:42:00,85,160,Brinquedo,8,245
7124,2024-01-05 22:43:00,36,87,Brinquedo,7,123
7125,2024-01-05 22:44:00,111,63,Brinquedo,4,174
7126,2024-01-05 22:45:00,102,130,Vestuário,2,232
7127,2024-01-05 22:46:00,11,113,Eletrônico,4,124
7128,2024-01-05 22:47:00,103,98,Vestuário,2,201
7129,2024-01-05 22:48:00,52,159,Alimento,7,211
7130,2024-01-05 22:49:00,54,76,Móvel,4,130
7131,2024-01-05 22:50:00,111,127,Eletrônico,8,238
7132,2024-01-05 22:51:00,116,122,Móvel,8,238
7133,2024-01-05 22:52:00,87,133,Brinquedo,7,220
7134,2024-01-05 22:53:00,58,96,Eletrônico,7,154
7135,2024-01-05 22:54:00,97,78,Brinquedo,5,175
7136,2024-01-05 22:55:00,33,131,Vestuário,7,164
7137,2024-01-05 22:56:00,73,44,Vestuário,2,117
7138,2024-01-05 22:57:00,35,51,Alimento,2,86
7139,2024-01-05 22:58:00,64,40,Móvel,7,104
7140,2024-01-05 22:59:00,35,11,Brinquedo,5,46
7141,2024-01-05 23:00:00,42,101,Brinquedo,4,143
7142,2024-01-05 23:01:00,74,176,Móvel,7,250
7143,2024-01-05 23:02:00,60,27,Vestuário,4,87
7144,2024-01-05 23:03:00,78,37,Brinquedo,5,115
7145,2024-01-05 23:04:00,119,34,Móvel,7,153
7146,2024-01-05 23:05:00,86,29,Vestuário,4,115
7147,2024-01-05 23:06:00,54,156,Móvel,1,210
7148,2024-01-05 23:07:00,53,136,Móvel,9,189
7149,2024-01-05 23:08:00,71,118,Móvel,1,189
7150,2024-01-05 23:09:00,21,99,Brinquedo,3,120
7151,2024-01-05 23:10:00,69,108,Eletrônico,6,177
7152,2024-01-05 23:11:00,77,164,Alimento,1,241
7153,2024-01-05 23:12:00,52,11,Brinquedo,7,63
7154,2024-01-05 23:13:00,111,65,Brinquedo,9,176
7155,2024-01-05 23:14:00,21,97,Móvel,9,118
7156,2024-01-05 23:15:00,89,47,Vestuário,7,136
7157,2024-01-05 23:16:00,37,139,Vestuário,3,176
7158,2024-01-05 23:17:00,104,14,Vestuário,3,118
7159,2024-01-05 23:18:00,88,46,Brinquedo,7,134
7160,2024-01-05 23:19:00,11,106,Móvel,4,117
7161,2024-01-05 23:20:00,80,97,Eletrônico,4,177
7162,2024-01-05 23:21:00,41,12,Móvel,1,53
7163,2024-01-05 23:22:00,61,41,Brinquedo,7,102
7164,2024-01-05 23:23:00,65,126,Móvel,7,191
7165,2024-01-05 23:24:00,117,112,Vestuário,4,229
7166,2024-01-05 23:25:00,76,45,Alimento,8,121
7167,2024-01-05 23:26:00,54,24,Vestuário,5,78
7168,2024-01-05 23:27:00,115,166,Alimento,6,281
7169,2024-01-05 23:28:00,47,31,Móvel,9,78
7170,2024-01-05 23:29:00,89,83,Vestuário,8,172
7171,2024-01-05 23:30:00,37,133,Vestuário,1,170
7172,2024-01-05 23:31:00,66,79,Vestuário,3,145
7173,2024-01-05 23:32:00,12,75,Vestuário,8,87
7174,2024-01-05 23:33:00,43,80,Vestuário,7,123
7175,2024-01-05 23:34:00,93,58,Alimento,1,151
7176,2024-01-05 23:35:00,51,55,Eletrônico,3,106
7177,2024-01-05 23:36:00,100,10,Brinquedo,8,110
7178,2024-01-05 23:37:00,87,151,Vestuário,3,238
7179,2024-01-05 23:38:00,70,44,Brinquedo,5,114
7180,2024-01-05 23:39:00,18,54,Vestuário,8,72
7181,2024-01-05 23:40:00,99,93,Eletrônico,7,192
7182,2024-01-05 23:41:00,108,165,Eletrônico,2,273
7183,2024-01-05 23:42:00,49,44,Brinquedo,2,93
7184,2024-01-05 23:43:00,99,91,Brinquedo,2,190
7185,2024-01-05 23:44:00,58,73,Vestuário,6,131
7186,2024-01-05 23:45:00,94,117,Alimento,4,211
7187,2024-01-05 23:46:00,97,124,Alimento,2,221
7188,2024-01-05 23:47:00,112,36,Vestuário,6,148
7189,2024-01-05 23:48:00,112,91,Móvel,4,203
7190,2024-01-05 23:49:00,90,36,Móvel,4,126
7191,2024-01-05 23:50:00,49,106,Móvel,9,155
7192,2024-01-05 23:51:00,86,45,Vestuário,8,131
7193,2024-01-05 23:52:00,106,137,Eletrônico,5,243
7194,2024-01-05 23:53:00,101,161,Vestuário,7,262
7195,2024-01-05 23:54:00,25,82,Móvel,4,107
7196,2024-01-05 23:55:00,112,30,Eletrônico,7,142
7197,2024-01-05 23:56:00,78,30,Brinquedo,2,108
7198,2024-01-05 23:57:00,20,69,Brinquedo,7,89
7199,2024-01-05 23:58:00,59,161,Vestuário,8,220
7200,2024-01-05 23:59:00,108,17,Vestuário,1,125
7201,2024-01-06 00:00:00,60,66,Alimento,8,126
7202,2024-01-06 00:01:00,83,86,Móvel,2,169
7203,2024-01-06 00:02:00,87,131,Eletrônico,2,218
7204,2024-01-06 00:03:00,107,144,Vestuário,8,251
7205,2024-01-06 00:04:00,101,97,Eletrônico,4,198
7206,2024-01-06 00:05:00,46,106,Móvel,7,152
7207,2024-01-06 00:06:00,89,73,Eletrônico,8,162
7208,2024-01-06 00:07:00,22,75,Vestuário,7,97
7209,2024-01-06 00:08:00,51,172,Brinquedo,9,223
7210,2024-01-06 00:09:00,10,89,Eletrônico,2,99
7211,2024-01-06 00:10:00,115,166,Vestuário,3,281
7212,2024-01-06 00:11:00,86,115,Alimento,1,201
7213,2024-01-06 00:12:00,115,105,Alimento,4,220
7214,2024-01-06 00:13:00,25,135,Móvel,8,160
7215,2024-01-06 00:14:00,72,162,Móvel,7,234
7216,2024-01-06 00:15:00,61,97,Móvel,3,158
7217,2024-01-06 00:16:00,103,78,Brinquedo,4,181
7218,2024-01-06 00:17:00,90,34,Alimento,3,124
7219,2024-01-06 00:18:00,69,121,Móvel,5,190
7220,2024-01-06 00:19:00,24,133,Móvel,6,157
7221,2024-01-06 00:20:00,19,113,Eletrônico,1,132
7222,2024-01-06 00:21:00,51,160,Eletrônico,2,211
7223,2024-01-06 00:22:00,41,66,Móvel,3,107
7224,2024-01-06 00:23:00,64,147,Brinquedo,1,211
7225,2024-01-06 00:24:00,10,116,Eletrônico,4,126
7226,2024-01-06 00:25:00,114,55,Eletrônico,4,169
7227,2024-01-06 00:26:00,70,31,Brinquedo,1,101
7228,2024-01-06 00:27:00,80,86,Alimento,1,166
7229,2024-01-06 00:28:00,46,12,Alimento,6,58
7230,2024-01-06 00:29:00,82,20,Alimento,7,102
7231,2024-01-06 00:30:00,26,71,Vestuário,2,97
7232,2024-01-06 00:31:00,31,160,Vestuário,5,191
7233,2024-01-06 00:32:00,31,161,Vestuário,3,192
7234,2024-01-06 00:33:00,41,36,Eletrônico,1,77
7235,2024-01-06 00:34:00,19,90,Eletrônico,5,109
7236,2024-01-06 00:35:00,78,150,Móvel,3,228
7237,2024-01-06 00:36:00,70,45,Brinquedo,9,115
7238,2024-01-06 00:37:00,38,33,Vestuário,7,71
7239,2024-01-06 00:38:00,96,127,Brinquedo,6,223
7240,2024-01-06 00:39:00,21,139,Eletrônico,2,160
7241,2024-01-06 00:40:00,88,19,Eletrônico,5,107
7242,2024-01-06 00:41:00,67,65,Móvel,7,132
7243,2024-01-06 00:42:00,49,85,Móvel,9,134
7244,2024-01-06 00:43:00,40,20,Móvel,9,60
7245,2024-01-06 00:44:00,55,105,Eletrônico,2,160
7246,2024-01-06 00:45:00,42,77,Vestuário,5,119
7247,2024-01-06 00:46:00,34,59,Móvel,3,93
7248,2024-01-06 00:47:00,82,131,Brinquedo,7,213
7249,2024-01-06 00:48:00,82,42,Vestuário,1,124
7250,2024-01-06 00:49:00,119,149,Eletrônico,2,268
7251,2024-01-06 00:50:00,88,135,Móvel,9,223
7252,2024-01-06 00:51:00,26,91,Brinquedo,9,117
7253,2024-01-06 00:52:00,21,18,Brinquedo,9,39
7254,2024-01-06 00:53:00,74,29,Alimento,2,103
7255,2024-01-06 00:54:00,23,135,Alimento,8,158
7256,2024-01-06 00:55:00,81,133,Eletrônico,1,214
7257,2024-01-06 00:56:00,108,154,Móvel,2,262
7258,2024-01-06 00:57:00,110,71,Eletrônico,3,181
7259,2024-01-06 00:58:00,99,55,Vestuário,7,154
7260,2024-01-06 00:59:00,57,112,Eletrônico,2,169
7261,2024-01-06 01:00:00,23,24,Alimento,7,47
7262,2024-01-06 01:01:00,113,47,Móvel,4,160
7263,2024-01-06 01:02:00,111,145,Brinquedo,1,256
7264,2024-01-06 01:03:00,20,83,Móvel,5,103
7265,2024-01-06 01:04:00,92,113,Móvel,4,205
7266,2024-01-06 01:05:00,14,148,Alimento,5,162
7267,2024-01-06 01:06:00,32,28,Eletrônico,6,60
7268,2024-01-06 01:07:00,29,33,Brinquedo,2,62
7269,2024-01-06 01:08:00,106,126,Alimento,7,232
7270,2024-01-06 01:09:00,36,20,Eletrônico,4,56
7271,2024-01-06 01:10:00,92,46,Eletrônico,9,138
7272,2024-01-06 01:11:00,26,178,Móvel,4,204
7273,2024-01-06 01:12:00,101,73,Eletrônico,5,174
7274,2024-01-06 01:13:00,83,65,Alimento,3,148
7275,2024-01-06 01:14:00,25,71,Móvel,9,96
7276,2024-01-06 01:15:00,84,142,Vestuário,9,226
7277,2024-01-06 01:16:00,53,34,Vestuário,1,87
7278,2024-01-06 01:17:00,43,46,Vestuário,7,89
7279,2024-01-06 01:18:00,113,51,Móvel,4,164
7280,2024-01-06 01:19:00,83,25,Eletrônico,3,108
7281,2024-01-06 01:20:00,93,14,Móvel,8,107
7282,2024-01-06 01:21:00,35,122,Alimento,3,157
7283,2024-01-06 01:22:00,12,153,Alimento,5,165
7284,2024-01-06 01:23:00,97,25,Móvel,6,122
7285,2024-01-06 01:24:00,54,154,Brinquedo,4,208
7286,2024-01-06 01:25:00,110,28,Alimento,3,138
7287,2024-01-06 01:26:00,22,94,Móvel,9,116
7288,2024-01-06 01:27:00,74,39,Eletrônico,1,113
7289,2024-01-06 01:28:00,99,69,Vestuário,5,168
7290,2024-01-06 01:29:00,14,167,Brinquedo,1,181
7291,2024-01-06 01:30:00,71,49,Brinquedo,5,120
7292,2024-01-06 01:31:00,15,78,Vestuário,1,93
7293,2024-01-06 01:32:00,43,85,Móvel,4,128
7294,2024-01-06 01:33:00,82,23,Brinquedo,8,105
7295,2024-01-06 01:34:00,16,26,Eletrônico,4,42
7296,2024-01-06 01:35:00,86,104,Eletrônico,2,190
7297,2024-01-06 01:36:00,97,40,Eletrônico,5,137
7298,2024-01-06 01:37:00,57,163,Eletrônico,6,220
7299,2024-01-06 01:38:00,54,152,Eletrônico,2,206
7300,2024-01-06 01:39:00,15,125,Móvel,6,140
7301,2024-01-06 01:40:00,50,96,Vestuário,7,146
7302,2024-01-06 01:41:00,67,159,Vestuário,3,226
7303,2024-01-06 01:42:00,76,33,Móvel,8,109
7304,2024-01-06 01:43:00,108,78,Móvel,5,186
7305,2024-01-06 01:44:00,57,17,Brinquedo,5,74
7306,2024-01-06 01:45:00,20,133,Brinquedo,9,153
7307,2024-01-06 01:46:00,57,19,Móvel,5,76
7308,2024-01-06 01:47:00,30,41,Vestuário,6,71
7309,2024-01-06 01:48:00,23,120,Alimento,9,143
7310,2024-01-06 01:49:00,27,142,Móvel,8,169
7311,2024-01-06 01:50:00,60,16,Eletrônico,1,76
7312,2024-01-06 01:51:00,58,21,Móvel,8,79
7313,2024-01-06 01:52:00,115,56,Brinquedo,1,171
7314,2024-01-06 01:53:00,114,151,Alimento,2,265
7315,2024-01-06 01:54:00,107,137,Brinquedo,4,244
7316,2024-01-06 01:55:00,108,86,Móvel,8,194
7317,2024-01-06 01:56:00,84,41,Vestuário,2,125
7318,2024-01-06 01:57:00,16,94,Vestuário,8,110
7319,2024-01-06 01:58:00,37,160,Vestuário,7,197
7320,2024-01-06 01:59:00,106,39,Alimento,5,145
7321,2024-01-06 02:00:00,64,52,Brinquedo,4,116
7322,2024-01-06 02:01:00,87,39,Móvel,5,126
7323,2024-01-06 02:02:00,53,103,Eletrônico,2,156
7324,2024-01-06 02:03:00,37,71,Vestuário,5,108
7325,2024-01-06 02:04:00,69,169,Brinquedo,2,238
7326,2024-01-06 02:05:00,84,34,Vestuário,5,118
7327,2024-01-06 02:06:00,54,121,Eletrônico,9,175
7328,2024-01-06 02:07:00,34,151,Vestuário,6,185
7329,2024-01-06 02:08:00,48,134,Móvel,7,182
7330,2024-01-06 02:09:00,104,93,Brinquedo,7,197
7331,2024-01-06 02:10:00,105,117,Eletrônico,5,222
7332,2024-01-06 02:11:00,49,139,Móvel,2,188
7333,2024-01-06 02:12:00,119,111,Móvel,7,230
7334,2024-01-06 02:13:00,68,150,Eletrônico,7,218
7335,2024-01-06 02:14:00,30,175,Vestuário,2,205
7336,2024-01-06 02:15:00,24,158,Brinquedo,6,182
7337,2024-01-06 02:16:00,23,158,Eletrônico,5,181
7338,2024-01-06 02:17:00,66,83,Brinquedo,3,149
7339,2024-01-06 02:18:00,98,130,Móvel,2,228
7340,2024-01-06 02:19:00,28,18,Eletrônico,7,46
7341,2024-01-06 02:20:00,22,28,Móvel,1,50
7342,2024-01-06 02:21:00,29,131,Móvel,3,160
7343,2024-01-06 02:22:00,113,134,Vestuário,6,247
7344,2024-01-06 02:23:00,118,54,Alimento,9,172
7345,2024-01-06 02:24:00,78,42,Eletrônico,8,120
7346,2024-01-06 02:25:00,100,134,Móvel,8,234
7347,2024-01-06 02:26:00,20,174,Vestuário,8,194
7348,2024-01-06 02:27:00,101,96,Vestuário,3,197
7349,2024-01-06 02:28:00,113,114,Alimento,8,227
7350,2024-01-06 02:29:00,13,178,Móvel,6,191
7351,2024-01-06 02:30:00,29,179,Móvel,5,208
7352,2024-01-06 02:31:00,44,118,Alimento,8,162
7353,2024-01-06 02:32:00,75,168,Vestuário,3,243
7354,2024-01-06 02:33:00,40,48,Brinquedo,7,88
7355,2024-01-06 02:34:00,26,43,Alimento,9,69
7356,2024-01-06 02:35:00,73,101,Alimento,9,174
7357,2024-01-06 02:36:00,83,111,Brinquedo,8,194
7358,2024-01-06 02:37:00,23,156,Vestuário,3,179
7359,2024-01-06 02:38:00,61,165,Vestuário,3,226
7360,2024-01-06 02:39:00,22,123,Alimento,3,145
7361,2024-01-06 02:40:00,46,133,Alimento,7,179
7362,2024-01-06 02:41:00,16,95,Alimento,8,111
7363,2024-01-06 02:42:00,117,109,Brinquedo,2,226
7364,2024-01-06 02:43:00,119,110,Eletrônico,8,229
7365,2024-01-06 02:44:00,14,142,Vestuário,8,156
7366,2024-01-06 02:45:00,65,159,Alimento,3,224
7367,2024-01-06 02:46:00,28,145,Vestuário,3,173
7368,2024-01-06 02:47:00,68,93,Vestuário,4,161
7369,2024-01-06 02:48:00,52,140,Brinquedo,5,192
7370,2024-01-06 02:49:00,26,154,Vestuário,3,180
7371,2024-01-06 02:50:00,16,135,Eletrônico,2,151
7372,2024-01-06 02:51:00,114,141,Eletrônico,8,255
7373,2024-01-06 02:52:00,13,68,Eletrônico,4,81
7374,2024-01-06 02:53:00,80,131,Móvel,7,211
7375,2024-01-06 02:54:00,63,110,Vestuário,4,173
7376,2024-01-06 02:55:00,61,43,Alimento,1,104
7377,2024-01-06 02:56:00,115,16,Alimento,7,131
7378,2024-01-06 02:57:00,94,118,Eletrônico,1,212
7379,2024-01-06 02:58:00,10,35,Brinquedo,5,45
7380,2024-01-06 02:59:00,18,104,Móvel,3,122
7381,2024-01-06 03:00:00,18,112,Alimento,6,130
7382,2024-01-06 03:01:00,101,125,Alimento,4,226
7383,2024-01-06 03:02:00,25,98,Alimento,8,123
7384,2024-01-06 03:03:00,44,19,Móvel,6,63
7385,2024-01-06 03:04:00,90,12,Brinquedo,6,102
7386,2024-01-06 03:05:00,105,144,Brinquedo,8,249
7387,2024-01-06 03:06:00,27,151,Brinquedo,4,178
7388,2024-01-06 03:07:00,21,76,Brinquedo,3,97
7389,2024-01-06 03:08:00,20,139,Vestuário,8,159
7390,2024-01-06 03:09:00,72,15,Vestuário,2,87
7391,2024-01-06 03:10:00,30,146,Brinquedo,8,176
7392,2024-01-06 03:11:00,91,36,Eletrônico,6,127
7393,2024-01-06 03:12:00,17,122,Alimento,9,139
7394,2024-01-06 03:13:00,16,139,Móvel,1,155
7395,2024-01-06 03:14:00,97,64,Brinquedo,2,161
7396,2024-01-06 03:15:00,57,120,Alimento,9,177
7397,2024-01-06 03:16:00,68,44,Brinquedo,3,112
7398,2024-01-06 03:17:00,33,126,Brinquedo,5,159
7399,2024-01-06 03:18:00,90,75,Brinquedo,6,165
7400,2024-01-06 03:19:00,22,84,Móvel,3,106
7401,2024-01-06 03:20:00,17,111,Móvel,9,128
7402,2024-01-06 03:21:00,81,44,Vestuário,1,125
7403,2024-01-06 03:22:00,107,115,Brinquedo,1,222
7404,2024-01-06 03:23:00,105,71,Móvel,6,176
7405,2024-01-06 03:24:00,114,26,Móvel,5,140
7406,2024-01-06 03:25:00,50,93,Móvel,2,143
7407,2024-01-06 03:26:00,11,46,Alimento,8,57
7408,2024-01-06 03:27:00,103,110,Vestuário,7,213
7409,2024-01-06 03:28:00,57,60,Móvel,4,117
7410,2024-01-06 03:29:00,104,117,Alimento,6,221
7411,2024-01-06 03:30:00,74,163,Alimento,2,237
7412,2024-01-06 03:31:00,35,93,Alimento,8,128
7413,2024-01-06 03:32:00,12,43,Brinquedo,4,55
7414,2024-01-06 03:33:00,115,74,Alimento,7,189
7415,2024-01-06 03:34:00,102,24,Brinquedo,3,126
7416,2024-01-06 03:35:00,117,42,Brinquedo,5,159
7417,2024-01-06 03:36:00,43,37,Móvel,6,80
7418,2024-01-06 03:37:00,82,139,Eletrônico,4,221
7419,2024-01-06 03:38:00,57,127,Vestuário,6,184
7420,2024-01-06 03:39:00,86,63,Móvel,3,149
7421,2024-01-06 03:40:00,92,48,Vestuário,6,140
7422,2024-01-06 03:41:00,14,143,Vestuário,1,157
7423,2024-01-06 03:42:00,24,51,Alimento,3,75
7424,2024-01-06 03:43:00,92,110,Eletrônico,5,202
7425,2024-01-06 03:44:00,15,47,Vestuário,2,62
7426,2024-01-06 03:45:00,22,36,Alimento,2,58
7427,2024-01-06 03:46:00,55,136,Eletrônico,6,191
7428,2024-01-06 03:47:00,115,174,Vestuário,8,289
7429,2024-01-06 03:48:00,107,116,Brinquedo,3,223
7430,2024-01-06 03:49:00,51,43,Alimento,4,94
7431,2024-01-06 03:50:00,21,15,Vestuário,1,36
7432,2024-01-06 03:51:00,18,95,Móvel,2,113
7433,2024-01-06 03:52:00,96,24,Eletrônico,7,120
7434,2024-01-06 03:53:00,34,105,Alimento,9,139
7435,2024-01-06 03:54:00,95,177,Eletrônico,9,272
7436,2024-01-06 03:55:00,46,152,Eletrônico,6,198
7437,2024-01-06 03:56:00,50,85,Brinquedo,2,135
7438,2024-01-06 03:57:00,72,117,Móvel,5,189
7439,2024-01-06 03:58:00,65,14,Alimento,4,79
7440,2024-01-06 03:59:00,94,15,Alimento,8,109
7441,2024-01-06 04:00:00,33,86,Brinquedo,3,119
7442,2024-01-06 04:01:00,41,119,Móvel,6,160
7443,2024-01-06 04:02:00,16,52,Móvel,8,68
7444,2024-01-06 04:03:00,23,154,Vestuário,1,177
7445,2024-01-06 04:04:00,16,36,Móvel,3,52
7446,2024-01-06 04:05:00,105,78,Vestuário,2,183
7447,2024-01-06 04:06:00,91,71,Eletrônico,7,162
7448,2024-01-06 04:07:00,49,43,Eletrônico,8,92
7449,2024-01-06 04:08:00,20,69,Eletrônico,5,89
7450,2024-01-06 04:09:00,82,155,Alimento,1,237
7451,2024-01-06 04:10:00,45,93,Brinquedo,4,138
7452,2024-01-06 04:11:00,39,20,Móvel,5,59
7453,2024-01-06 04:12:00,25,56,Vestuário,9,81
7454,2024-01-06 04:13:00,112,73,Brinquedo,2,185
7455,2024-01-06 04:14:00,102,83,Móvel,7,185
7456,2024-01-06 04:15:00,104,165,Alimento,9,269
7457,2024-01-06 04:16:00,73,84,Móvel,3,157
7458,2024-01-06 04:17:00,66,150,Eletrônico,7,216
7459,2024-01-06 04:18:00,113,67,Vestuário,4,180
7460,2024-01-06 04:19:00,119,56,Vestuário,7,175
7461,2024-01-06 04:20:00,106,62,Vestuário,4,168
7462,2024-01-06 04:21:00,71,57,Eletrônico,5,128
7463,2024-01-06 04:22:00,87,27,Eletrônico,7,114
7464,2024-01-06 04:23:00,43,170,Vestuário,8,213
7465,2024-01-06 04:24:00,54,111,Alimento,2,165
7466,2024-01-06 04:25:00,90,110,Alimento,7,200
7467,2024-01-06 04:26:00,92,13,Alimento,8,105
7468,2024-01-06 04:27:00,116,66,Brinquedo,1,182
7469,2024-01-06 04:28:00,21,101,Brinquedo,1,122
7470,2024-01-06 04:29:00,15,156,Vestuário,7,171
7471,2024-01-06 04:30:00,29,60,Brinquedo,6,89
7472,2024-01-06 04:31:00,94,35,Móvel,5,129
7473,2024-01-06 04:32:00,34,65,Brinquedo,8,99
7474,2024-01-06 04:33:00,75,27,Brinquedo,8,102
7475,2024-01-06 04:34:00,96,130,Vestuário,6,226
7476,2024-01-06 04:35:00,89,141,Vestuário,9,230
7477,2024-01-06 04:36:00,75,176,Eletrônico,3,251
7478,2024-01-06 04:37:00,110,98,Brinquedo,8,208
7479,2024-01-06 04:38:00,16,26,Vestuário,1,42
7480,2024-01-06 04:39:00,114,161,Eletrônico,5,275
7481,2024-01-06 04:40:00,32,13,Alimento,5,45
7482,2024-01-06 04:41:00,105,111,Vestuário,2,216
7483,2024-01-06 04:42:00,27,20,Vestuário,8,47
7484,2024-01-06 04:43:00,56,27,Vestuário,6,83
7485,2024-01-06 04:44:00,105,143,Brinquedo,6,248
7486,2024-01-06 04:45:00,48,159,Brinquedo,6,207
7487,2024-01-06 04:46:00,118,59,Alimento,8,177
7488,2024-01-06 04:47:00,93,72,Móvel,9,165
7489,2024-01-06 04:48:00,39,63,Brinquedo,6,102
7490,2024-01-06 04:49:00,85,137,Móvel,1,222
7491,2024-01-06 04:50:00,69,136,Vestuário,3,205
7492,2024-01-06 04:51:00,80,64,Brinquedo,4,144
7493,2024-01-06 04:52:00,34,79,Vestuário,4,113
7494,2024-01-06 04:53:00,50,177,Móvel,3,227
7495,2024-01-06 04:54:00,51,60,Móvel,3,111
7496,2024-01-06 04:55:00,78,66,Móvel,3,144
7497,2024-01-06 04:56:00,20,57,Eletrônico,8,77
7498,2024-01-06 04:57:00,82,137,Móvel,6,219
7499,2024-01-06 04:58:00,18,53,Brinquedo,7,71
7500,2024-01-06 04:59:00,60,147,Móvel,3,207
7501,2024-01-06 05:00:00,76,98,Vestuário,9,174
7502,2024-01-06 05:01:00,47,21,Vestuário,1,68
7503,2024-01-06 05:02:00,89,161,Brinquedo,3,250
7504,2024-01-06 05:03:00,105,161,Alimento,8,266
7505,2024-01-06 05:04:00,92,69,Móvel,3,161
7506,2024-01-06 05:05:00,29,13,Alimento,5,42
7507,2024-01-06 05:06:00,85,100,Brinquedo,1,185
7508,2024-01-06 05:07:00,87,157,Alimento,9,244
7509,2024-01-06 05:08:00,108,30,Eletrônico,5,138
7510,2024-01-06 05:09:00,114,23,Alimento,9,137
7511,2024-01-06 05:10:00,66,152,Móvel,2,218
7512,2024-01-06 05:11:00,89,147,Eletrônico,7,236
7513,2024-01-06 05:12:00,46,114,Vestuário,1,160
7514,2024-01-06 05:13:00,19,154,Eletrônico,5,173
7515,2024-01-06 05:14:00,19,155,Brinquedo,5,174
7516,2024-01-06 05:15:00,109,113,Vestuário,9,222
7517,2024-01-06 05:16:00,58,129,Brinquedo,1,187
7518,2024-01-06 05:17:00,40,55,Alimento,5,95
7519,2024-01-06 05:18:00,100,53,Móvel,8,153
7520,2024-01-06 05:19:00,98,171,Alimento,8,269
7521,2024-01-06 05:20:00,82,11,Alimento,8,93
7522,2024-01-06 05:21:00,79,166,Brinquedo,1,245
7523,2024-01-06 05:22:00,91,79,Vestuário,6,170
7524,2024-01-06 05:23:00,62,123,Brinquedo,3,185
7525,2024-01-06 05:24:00,60,112,Vestuário,1,172
7526,2024-01-06 05:25:00,26,39,Móvel,5,65
7527,2024-01-06 05:26:00,26,95,Alimento,6,121
7528,2024-01-06 05:27:00,13,64,Alimento,2,77
7529,2024-01-06 05:28:00,47,129,Brinquedo,5,176
7530,2024-01-06 05:29:00,29,10,Brinquedo,1,39
7531,2024-01-06 05:30:00,15,163,Alimento,7,178
7532,2024-01-06 05:31:00,22,122,Vestuário,7,144
7533,2024-01-06 05:32:00,113,63,Vestuário,3,176
7534,2024-01-06 05:33:00,55,21,Brinquedo,5,76
7535,2024-01-06 05:34:00,15,23,Eletrônico,1,38
7536,2024-01-06 05:35:00,16,120,Brinquedo,8,136
7537,2024-01-06 05:36:00,39,147,Móvel,2,186
7538,2024-01-06 05:37:00,15,83,Eletrônico,8,98
7539,2024-01-06 05:38:00,35,17,Brinquedo,8,52
7540,2024-01-06 05:39:00,46,76,Vestuário,1,122
7541,2024-01-06 05:40:00,77,59,Brinquedo,2,136
7542,2024-01-06 05:41:00,78,161,Móvel,5,239
7543,2024-01-06 05:42:00,56,36,Vestuário,2,92
7544,2024-01-06 05:43:00,108,129,Brinquedo,5,237
7545,2024-01-06 05:44:00,42,77,Brinquedo,3,119
7546,2024-01-06 05:45:00,32,52,Móvel,9,84
7547,2024-01-06 05:46:00,114,89,Eletrônico,9,203
7548,2024-01-06 05:47:00,19,122,Vestuário,5,141
7549,2024-01-06 05:48:00,49,13,Brinquedo,7,62
7550,2024-01-06 05:49:00,89,27,Brinquedo,7,116
7551,2024-01-06 05:50:00,68,69,Vestuário,2,137
7552,2024-01-06 05:51:00,107,85,Vestuário,1,192
7553,2024-01-06 05:52:00,66,81,Vestuário,4,147
7554,2024-01-06 05:53:00,33,98,Vestuário,4,131
7555,2024-01-06 05:54:00,22,113,Eletrônico,2,135
7556,2024-01-06 05:55:00,107,43,Brinquedo,7,150
7557,2024-01-06 05:56:00,47,147,Eletrônico,2,194
7558,2024-01-06 05:57:00,69,11,Eletrônico,2,80
7559,2024-01-06 05:58:00,42,53,Móvel,8,95
7560,2024-01-06 05:59:00,42,121,Móvel,6,163
7561,2024-01-06 06:00:00,110,154,Eletrônico,1,264
7562,2024-01-06 06:01:00,67,20,Móvel,7,87
7563,2024-01-06 06:02:00,75,157,Eletrônico,7,232
7564,2024-01-06 06:03:00,22,85,Móvel,5,107
7565,2024-01-06 06:04:00,37,19,Móvel,1,56
7566,2024-01-06 06:05:00,38,87,Alimento,7,125
7567,2024-01-06 06:06:00,80,38,Móvel,1,118
7568,2024-01-06 06:07:00,24,23,Brinquedo,9,47
7569,2024-01-06 06:08:00,35,130,Vestuário,2,165
7570,2024-01-06 06:09:00,35,18,Vestuário,3,53
7571,2024-01-06 06:10:00,110,24,Alimento,8,134
7572,2024-01-06 06:11:00,23,22,Vestuário,9,45
7573,2024-01-06 06:12:00,70,105,Brinquedo,4,175
7574,2024-01-06 06:13:00,19,45,Eletrônico,9,64
7575,2024-01-06 06:14:00,24,101,Alimento,4,125
7576,2024-01-06 06:15:00,68,94,Eletrônico,9,162
7577,2024-01-06 06:16:00,37,99,Móvel,6,136
7578,2024-01-06 06:17:00,29,73,Vestuário,7,102
7579,2024-01-06 06:18:00,48,159,Brinquedo,9,207
7580,2024-01-06 06:19:00,38,73,Alimento,6,111
7581,2024-01-06 06:20:00,111,73,Móvel,3,184
7582,2024-01-06 06:21:00,111,56,Alimento,5,167
7583,2024-01-06 06:22:00,107,131,Vestuário,5,238
7584,2024-01-06 06:23:00,39,166,Alimento,9,205
7585,2024-01-06 06:24:00,92,153,Móvel,2,245
7586,2024-01-06 06:25:00,96,20,Vestuário,1,116
7587,2024-01-06 06:26:00,41,13,Vestuário,3,54
7588,2024-01-06 06:27:00,16,46,Alimento,1,62
7589,2024-01-06 06:28:00,56,59,Móvel,8,115
7590,2024-01-06 06:29:00,57,42,Alimento,1,99
7591,2024-01-06 06:30:00,10,13,Brinquedo,4,23
7592,2024-01-06 06:31:00,45,150,Vestuário,3,195
7593,2024-01-06 06:32:00,36,14,Vestuário,2,50
7594,2024-01-06 06:33:00,35,26,Eletrônico,8,61
7595,2024-01-06 06:34:00,107,91,Alimento,1,198
7596,2024-01-06 06:35:00,70,140,Brinquedo,7,210
7597,2024-01-06 06:36:00,70,58,Vestuário,1,128
7598,2024-01-06 06:37:00,35,29,Eletrônico,2,64
7599,2024-01-06 06:38:00,99,13,Eletrônico,6,112
7600,2024-01-06 06:39:00,87,62,Vestuário,2,149
7601,2024-01-06 06:40:00,49,117,Eletrônico,8,166
7602,2024-01-06 06:41:00,96,86,Vestuário,3,182
7603,2024-01-06 06:42:00,66,150,Brinquedo,5,216
7604,2024-01-06 06:43:00,39,110,Eletrônico,3,149
7605,2024-01-06 06:44:00,103,150,Brinquedo,7,253
7606,2024-01-06 06:45:00,42,144,Vestuário,7,186
7607,2024-01-06 06:46:00,92,35,Brinquedo,1,127
7608,2024-01-06 06:47:00,102,22,Eletrônico,6,124
7609,2024-01-06 06:48:00,42,74,Eletrônico,2,116
7610,2024-01-06 06:49:00,24,114,Móvel,2,138
7611,2024-01-06 06:50:00,107,126,Vestuário,4,233
7612,2024-01-06 06:51:00,89,34,Brinquedo,7,123
7613,2024-01-06 06:52:00,95,58,Eletrônico,5,153
7614,2024-01-06 06:53:00,63,89,Eletrônico,8,152
7615,2024-01-06 06:54:00,75,20,Brinquedo,1,95
7616,2024-01-06 06:55:00,27,10,Móvel,5,37
7617,2024-01-06 06:56:00,50,30,Alimento,9,80
7618,2024-01-06 06:57:00,43,89,Eletrônico,8,132
7619,2024-01-06 06:58:00,66,132,Móvel,3,198
7620,2024-01-06 06:59:00,107,53,Vestuário,2,160
7621,2024-01-06 07:00:00,64,111,Móvel,4,175
7622,2024-01-06 07:01:00,104,147,Vestuário,1,251
7623,2024-01-06 07:02:00,42,92,Alimento,8,134
7624,2024-01-06 07:03:00,106,112,Brinquedo,1,218
7625,2024-01-06 07:04:00,84,99,Móvel,2,183
7626,2024-01-06 07:05:00,13,50,Vestuário,2,63
7627,2024-01-06 07:06:00,21,145,Vestuário,4,166
7628,2024-01-06 07:07:00,13,106,Eletrônico,9,119
7629,2024-01-06 07:08:00,24,116,Alimento,1,140
7630,2024-01-06 07:09:00,99,82,Vestuário,1,181
7631,2024-01-06 07:10:00,82,27,Eletrônico,1,109
7632,2024-01-06 07:11:00,28,101,Eletrônico,6,129
7633,2024-01-06 07:12:00,88,145,Eletrônico,9,233
7634,2024-01-06 07:13:00,63,47,Brinquedo,4,110
7635,2024-01-06 07:14:00,79,139,Brinquedo,3,218
7636,2024-01-06 07:15:00,69,62,Alimento,1,131
7637,2024-01-06 07:16:00,102,64,Brinquedo,5,166
7638,2024-01-06 07:17:00,112,34,Brinquedo,7,146
7639,2024-01-06 07:18:00,95,53,Alimento,7,148
7640,2024-01-06 07:19:00,52,107,Eletrônico,2,159
7641,2024-01-06 07:20:00,61,148,Alimento,9,209
7642,2024-01-06 07:21:00,112,118,Brinquedo,1,230
7643,2024-01-06 07:22:00,44,13,Eletrônico,4,57
7644,2024-01-06 07:23:00,88,89,Alimento,7,177
7645,2024-01-06 07:24:00,99,37,Brinquedo,4,136
7646,2024-01-06 07:25:00,46,18,Móvel,4,64
7647,2024-01-06 07:26:00,97,74,Vestuário,4,171
7648,2024-01-06 07:27:00,22,160,Alimento,5,182
7649,2024-01-06 07:28:00,81,56,Brinquedo,2,137
7650,2024-01-06 07:29:00,14,72,Móvel,1,86
7651,2024-01-06 07:30:00,92,149,Eletrônico,8,241
7652,2024-01-06 07:31:00,34,26,Eletrônico,1,60
7653,2024-01-06 07:32:00,96,46,Brinquedo,8,142
7654,2024-01-06 07:33:00,71,59,Alimento,2,130
7655,2024-01-06 07:34:00,35,31,Eletrônico,8,66
7656,2024-01-06 07:35:00,95,55,Móvel,8,150
7657,2024-01-06 07:36:00,22,87,Eletrônico,6,109
7658,2024-01-06 07:37:00,77,84,Brinquedo,5,161
7659,2024-01-06 07:38:00,94,42,Brinquedo,2,136
7660,2024-01-06 07:39:00,52,95,Vestuário,1,147
7661,2024-01-06 07:40:00,79,51,Vestuário,5,130
7662,2024-01-06 07:41:00,52,135,Eletrônico,8,187
7663,2024-01-06 07:42:00,86,139,Móvel,9,225
7664,2024-01-06 07:43:00,68,54,Alimento,5,122
7665,2024-01-06 07:44:00,98,85,Brinquedo,2,183
7666,2024-01-06 07:45:00,16,66,Alimento,3,82
7667,2024-01-06 07:46:00,19,137,Eletrônico,5,156
7668,2024-01-06 07:47:00,94,81,Alimento,8,175
7669,2024-01-06 07:48:00,27,176,Móvel,1,203
7670,2024-01-06 07:49:00,90,107,Alimento,2,197
7671,2024-01-06 07:50:00,30,139,Móvel,3,169
7672,2024-01-06 07:51:00,19,101,Brinquedo,2,120
7673,2024-01-06 07:52:00,113,85,Alimento,7,198
7674,2024-01-06 07:53:00,66,83,Eletrônico,8,149
7675,2024-01-06 07:54:00,26,162,Vestuário,4,188
7676,2024-01-06 07:55:00,115,115,Vestuário,8,230
7677,2024-01-06 07:56:00,95,56,Móvel,1,151
7678,2024-01-06 07:57:00,67,109,Vestuário,5,176
7679,2024-01-06 07:58:00,68,72,Eletrônico,6,140
7680,2024-01-06 07:59:00,15,77,Vestuário,3,92
7681,2024-01-06 08:00:00,68,176,Eletrônico,6,244
7682,2024-01-06 08:01:00,15,95,Eletrônico,3,110
7683,2024-01-06 08:02:00,119,57,Eletrônico,7,176
7684,2024-01-06 08:03:00,69,144,Vestuário,1,213
7685,2024-01-06 08:04:00,102,103,Móvel,4,205
7686,2024-01-06 08:05:00,38,173,Brinquedo,4,211
7687,2024-01-06 08:06:00,59,30,Móvel,8,89
7688,2024-01-06 08:07:00,36,21,Móvel,2,57
7689,2024-01-06 08:08:00,114,44,Brinquedo,2,158
7690,2024-01-06 08:09:00,55,153,Móvel,7,208
7691,2024-01-06 08:10:00,16,171,Vestuário,3,187
7692,2024-01-06 08:11:00,52,120,Vestuário,5,172
7693,2024-01-06 08:12:00,55,139,Alimento,1,194
7694,2024-01-06 08:13:00,48,139,Eletrônico,7,187
7695,2024-01-06 08:14:00,24,144,Brinquedo,7,168
7696,2024-01-06 08:15:00,86,26,Eletrônico,5,112
7697,2024-01-06 08:16:00,51,54,Alimento,7,105
7698,2024-01-06 08:17:00,70,75,Brinquedo,9,145
7699,2024-01-06 08:18:00,33,127,Eletrônico,3,160
7700,2024-01-06 08:19:00,111,118,Alimento,7,229
7701,2024-01-06 08:20:00,94,160,Vestuário,7,254
7702,2024-01-06 08:21:00,14,57,Móvel,1,71
7703,2024-01-06 08:22:00,65,75,Alimento,9,140
7704,2024-01-06 08:23:00,23,11,Eletrônico,3,34
7705,2024-01-06 08:24:00,29,155,Móvel,2,184
7706,2024-01-06 08:25:00,34,156,Eletrônico,5,190
7707,2024-01-06 08:26:00,83,44,Móvel,6,127
7708,2024-01-06 08:27:00,23,97,Alimento,9,120
7709,2024-01-06 08:28:00,85,60,Móvel,4,145
7710,2024-01-06 08:29:00,104,69,Eletrônico,8,173
7711,2024-01-06 08:30:00,59,178,Alimento,6,237
7712,2024-01-06 08:31:00,73,77,Alimento,4,150
7713,2024-01-06 08:32:00,47,110,Alimento,7,157
7714,2024-01-06 08:33:00,61,33,Vestuário,9,94
7715,2024-01-06 08:34:00,115,143,Eletrônico,4,258
7716,2024-01-06 08:35:00,57,132,Alimento,1,189
7717,2024-01-06 08:36:00,86,144,Móvel,1,230
7718,2024-01-06 08:37:00,91,52,Brinquedo,3,143
7719,2024-01-06 08:38:00,100,97,Vestuário,2,197
7720,2024-01-06 08:39:00,36,153,Brinquedo,7,189
7721,2024-01-06 08:40:00,43,12,Brinquedo,2,55
7722,2024-01-06 08:41:00,44,21,Alimento,4,65
7723,2024-01-06 08:42:00,11,79,Vestuário,5,90
7724,2024-01-06 08:43:00,58,71,Brinquedo,2,129
7725,2024-01-06 08:44:00,98,44,Eletrônico,5,142
7726,2024-01-06 08:45:00,105,82,Alimento,5,187
7727,2024-01-06 08:46:00,99,50,Eletrônico,6,149
7728,2024-01-06 08:47:00,11,129,Eletrônico,7,140
7729,2024-01-06 08:48:00,74,145,Alimento,9,219
7730,2024-01-06 08:49:00,95,55,Vestuário,5,150
7731,2024-01-06 08:50:00,59,100,Móvel,5,159
7732,2024-01-06 08:51:00,98,100,Vestuário,7,198
7733,2024-01-06 08:52:00,12,132,Móvel,1,144
7734,2024-01-06 08:53:00,87,127,Brinquedo,8,214
7735,2024-01-06 08:54:00,24,49,Móvel,3,73
7736,2024-01-06 08:55:00,80,141,Móvel,5,221
7737,2024-01-06 08:56:00,87,84,Eletrônico,8,171
7738,2024-01-06 08:57:00,59,93,Brinquedo,1,152
7739,2024-01-06 08:58:00,78,31,Brinquedo,5,109
7740,2024-01-06 08:59:00,62,46,Alimento,8,108
7741,2024-01-06 09:00:00,107,41,Alimento,9,148
7742,2024-01-06 09:01:00,116,152,Móvel,2,268
7743,2024-01-06 09:02:00,80,134,Alimento,4,214
7744,2024-01-06 09:03:00,60,124,Brinquedo,3,184
7745,2024-01-06 09:04:00,22,105,Brinquedo,5,127
7746,2024-01-06 09:05:00,11,160,Eletrônico,9,171
7747,2024-01-06 09:06:00,57,168,Eletrônico,6,225
7748,2024-01-06 09:07:00,50,174,Vestuário,4,224
7749,2024-01-06 09:08:00,99,154,Brinquedo,2,253
7750,2024-01-06 09:09:00,46,104,Vestuário,8,150
7751,2024-01-06 09:10:00,34,144,Móvel,7,178
7752,2024-01-06 09:11:00,54,41,Alimento,4,95
7753,2024-01-06 09:12:00,113,169,Móvel,1,282
7754,2024-01-06 09:13:00,34,154,Eletrônico,8,188
7755,2024-01-06 09:14:00,56,179,Móvel,3,235
7756,2024-01-06 09:15:00,32,166,Alimento,6,198
7757,2024-01-06 09:16:00,118,99,Vestuário,5,217
7758,2024-01-06 09:17:00,51,140,Brinquedo,4,191
7759,2024-01-06 09:18:00,99,63,Eletrônico,9,162
7760,2024-01-06 09:19:00,90,127,Alimento,1,217
7761,2024-01-06 09:20:00,78,137,Eletrônico,4,215
7762,2024-01-06 09:21:00,109,142,Vestuário,4,251
7763,2024-01-06 09:22:00,10,98,Alimento,6,108
7764,2024-01-06 09:23:00,74,177,Móvel,9,251
7765,2024-01-06 09:24:00,89,22,Eletrônico,3,111
7766,2024-01-06 09:25:00,28,40,Eletrônico,5,68
7767,2024-01-06 09:26:00,20,127,Alimento,4,147
7768,2024-01-06 09:27:00,111,114,Vestuário,3,225
7769,2024-01-06 09:28:00,48,33,Vestuário,3,81
7770,2024-01-06 09:29:00,47,10,Eletrônico,5,57
7771,2024-01-06 09:30:00,16,94,Móvel,9,110
7772,2024-01-06 09:31:00,75,86,Alimento,8,161
7773,2024-01-06 09:32:00,92,150,Eletrônico,1,242
7774,2024-01-06 09:33:00,51,67,Brinquedo,2,118
7775,2024-01-06 09:34:00,112,54,Móvel,3,166
7776,2024-01-06 09:35:00,61,124,Vestuário,5,185
7777,2024-01-06 09:36:00,76,106,Móvel,2,182
7778,2024-01-06 09:37:00,20,43,Brinquedo,5,63
7779,2024-01-06 09:38:00,65,152,Alimento,3,217
7780,2024-01-06 09:39:00,10,100,Móvel,8,110
7781,2024-01-06 09:40:00,86,155,Eletrônico,8,241
7782,2024-01-06 09:41:00,31,134,Vestuário,2,165
7783,2024-01-06 09:42:00,24,52,Alimento,2,76
7784,2024-01-06 09:43:00,108,141,Brinquedo,7,249
7785,2024-01-06 09:44:00,91,137,Brinquedo,1,228
7786,2024-01-06 09:45:00,64,141,Móvel,8,205
7787,2024-01-06 09:46:00,77,37,Brinquedo,1,114
7788,2024-01-06 09:47:00,53,141,Brinquedo,6,194
7789,2024-01-06 09:48:00,36,91,Alimento,2,127
7790,2024-01-06 09:49:00,37,75,Móvel,9,112
7791,2024-01-06 09:50:00,61,133,Vestuário,1,194
7792,2024-01-06 09:51:00,67,63,Eletrônico,5,130
7793,2024-01-06 09:52:00,90,139,Alimento,2,229
7794,2024-01-06 09:53:00,117,83,Brinquedo,7,200
7795,2024-01-06 09:54:00,38,70,Eletrônico,1,108
7796,2024-01-06 09:55:00,57,137,Vestuário,9,194
7797,2024-01-06 09:56:00,111,115,Eletrônico,4,226
7798,2024-01-06 09:57:00,102,169,Vestuário,5,271
7799,2024-01-06 09:58:00,34,98,Eletrônico,4,132
7800,2024-01-06 09:59:00,60,121,Eletrônico,3,181
7801,2024-01-06 10:00:00,102,140,Brinquedo,1,242
7802,2024-01-06 10:01:00,59,152,Móvel,8,211
7803,2024-01-06 10:02:00,41,155,Móvel,9,196
7804,2024-01-06 10:03:00,88,92,Vestuário,8,180
7805,2024-01-06 10:04:00,45,134,Alimento,7,179
7806,2024-01-06 10:05:00,43,47,Eletrônico,6,90
7807,2024-01-06 10:06:00,80,39,Vestuário,9,119
7808,2024-01-06 10:07:00,114,96,Vestuário,1,210
7809,2024-01-06 10:08:00,57,168,Móvel,9,225
7810,2024-01-06 10:09:00,107,88,Brinquedo,3,195
7811,2024-01-06 10:10:00,106,96,Alimento,3,202
7812,2024-01-06 10:11:00,97,37,Móvel,9,134
7813,2024-01-06 10:12:00,75,123,Vestuário,2,198
7814,2024-01-06 10:13:00,79,123,Brinquedo,1,202
7815,2024-01-06 10:14:00,112,145,Vestuário,7,257
7816,2024-01-06 10:15:00,44,162,Móvel,4,206
7817,2024-01-06 10:16:00,57,78,Móvel,1,135
7818,2024-01-06 10:17:00,31,107,Alimento,1,138
7819,2024-01-06 10:18:00,35,166,Eletrônico,9,201
7820,2024-01-06 10:19:00,40,161,Alimento,5,201
7821,2024-01-06 10:20:00,88,159,Alimento,3,247
7822,2024-01-06 10:21:00,51,132,Eletrônico,2,183
7823,2024-01-06 10:22:00,15,48,Eletrônico,8,63
7824,2024-01-06 10:23:00,84,86,Móvel,1,170
7825,2024-01-06 10:24:00,72,163,Eletrônico,8,235
7826,2024-01-06 10:25:00,112,45,Alimento,6,157
7827,2024-01-06 10:26:00,73,31,Móvel,7,104
7828,2024-01-06 10:27:00,17,27,Alimento,8,44
7829,2024-01-06 10:28:00,44,168,Vestuário,7,212
7830,2024-01-06 10:29:00,69,115,Alimento,7,184
7831,2024-01-06 10:30:00,118,177,Alimento,1,295
7832,2024-01-06 10:31:00,119,123,Alimento,9,242
7833,2024-01-06 10:32:00,60,61,Alimento,1,121
7834,2024-01-06 10:33:00,80,145,Móvel,9,225
7835,2024-01-06 10:34:00,42,165,Brinquedo,8,207
7836,2024-01-06 10:35:00,70,44,Móvel,3,114
7837,2024-01-06 10:36:00,118,179,Brinquedo,2,297
7838,2024-01-06 10:37:00,77,47,Brinquedo,4,124
7839,2024-01-06 10:38:00,67,30,Eletrônico,4,97
7840,2024-01-06 10:39:00,52,117,Brinquedo,8,169
7841,2024-01-06 10:40:00,60,115,Vestuário,2,175
7842,2024-01-06 10:41:00,87,53,Móvel,7,140
7843,2024-01-06 10:42:00,119,128,Alimento,1,247
7844,2024-01-06 10:43:00,85,62,Brinquedo,1,147
7845,2024-01-06 10:44:00,72,10,Móvel,8,82
7846,2024-01-06 10:45:00,105,73,Alimento,9,178
7847,2024-01-06 10:46:00,114,36,Móvel,6,150
7848,2024-01-06 10:47:00,80,84,Brinquedo,9,164
7849,2024-01-06 10:48:00,107,116,Alimento,1,223
7850,2024-01-06 10:49:00,19,80,Vestuário,5,99
7851,2024-01-06 10:50:00,68,45,Brinquedo,8,113
7852,2024-01-06 10:51:00,116,80,Brinquedo,7,196
7853,2024-01-06 10:52:00,39,72,Brinquedo,4,111
7854,2024-01-06 10:53:00,67,76,Brinquedo,4,143
7855,2024-01-06 10:54:00,50,117,Móvel,8,167
7856,2024-01-06 10:55:00,113,54,Brinquedo,7,167
7857,2024-01-06 10:56:00,47,178,Vestuário,4,225
7858,2024-01-06 10:57:00,51,88,Brinquedo,8,139
7859,2024-01-06 10:58:00,67,87,Vestuário,9,154
7860,2024-01-06 10:59:00,23,58,Alimento,5,81
7861,2024-01-06 11:00:00,32,11,Vestuário,6,43
7862,2024-01-06 11:01:00,42,109,Vestuário,8,151
7863,2024-01-06 11:02:00,65,150,Alimento,3,215
7864,2024-01-06 11:03:00,60,155,Móvel,8,215
7865,2024-01-06 11:04:00,27,126,Móvel,3,153
7866,2024-01-06 11:05:00,43,170,Eletrônico,9,213
7867,2024-01-06 11:06:00,42,95,Vestuário,4,137
7868,2024-01-06 11:07:00,42,129,Eletrônico,9,171
7869,2024-01-06 11:08:00,100,37,Alimento,8,137
7870,2024-01-06 11:09:00,20,132,Alimento,4,152
7871,2024-01-06 11:10:00,108,99,Vestuário,9,207
7872,2024-01-06 11:11:00,51,27,Móvel,1,78
7873,2024-01-06 11:12:00,91,63,Eletrônico,4,154
7874,2024-01-06 11:13:00,74,66,Eletrônico,4,140
7875,2024-01-06 11:14:00,56,95,Móvel,7,151
7876,2024-01-06 11:15:00,64,68,Eletrônico,4,132
7877,2024-01-06 11:16:00,28,17,Brinquedo,8,45
7878,2024-01-06 11:17:00,19,100,Eletrônico,8,119
7879,2024-01-06 11:18:00,51,38,Vestuário,1,89
7880,2024-01-06 11:19:00,109,149,Móvel,4,258
7881,2024-01-06 11:20:00,47,35,Eletrônico,6,82
7882,2024-01-06 11:21:00,10,125,Móvel,6,135
7883,2024-01-06 11:22:00,43,159,Eletrônico,4,202
7884,2024-01-06 11:23:00,116,152,Alimento,3,268
7885,2024-01-06 11:24:00,22,96,Alimento,4,118
7886,2024-01-06 11:25:00,67,21,Móvel,5,88
7887,2024-01-06 11:26:00,62,53,Vestuário,5,115
7888,2024-01-06 11:27:00,55,131,Eletrônico,3,186
7889,2024-01-06 11:28:00,16,173,Alimento,5,189
7890,2024-01-06 11:29:00,40,161,Eletrônico,1,201
7891,2024-01-06 11:30:00,102,133,Móvel,9,235
7892,2024-01-06 11:31:00,23,136,Brinquedo,9,159
7893,2024-01-06 11:32:00,34,162,Eletrônico,4,196
7894,2024-01-06 11:33:00,31,47,Vestuário,4,78
7895,2024-01-06 11:34:00,55,108,Móvel,3,163
7896,2024-01-06 11:35:00,68,110,Brinquedo,9,178
7897,2024-01-06 11:36:00,82,29,Brinquedo,9,111
7898,2024-01-06 11:37:00,67,122,Brinquedo,5,189
7899,2024-01-06 11:38:00,75,79,Móvel,9,154
7900,2024-01-06 11:39:00,11,137,Brinquedo,2,148
7901,2024-01-06 11:40:00,111,75,Vestuário,7,186
7902,2024-01-06 11:41:00,115,134,Brinquedo,6,249
7903,2024-01-06 11:42:00,28,68,Eletrônico,7,96
7904,2024-01-06 11:43:00,25,125,Móvel,8,150
7905,2024-01-06 11:44:00,14,158,Móvel,1,172
7906,2024-01-06 11:45:00,38,50,Eletrônico,6,88
7907,2024-01-06 11:46:00,82,96,Brinquedo,5,178
7908,2024-01-06 11:47:00,95,169,Eletrônico,4,264
7909,2024-01-06 11:48:00,19,121,Vestuário,3,140
7910,2024-01-06 11:49:00,21,54,Eletrônico,8,75
7911,2024-01-06 11:50:00,100,99,Vestuário,3,199
7912,2024-01-06 11:51:00,83,51,Brinquedo,8,134
7913,2024-01-06 11:52:00,115,37,Brinquedo,9,152
7914,2024-01-06 11:53:00,67,121,Móvel,1,188
7915,2024-01-06 11:54:00,107,90,Eletrônico,5,197
7916,2024-01-06 11:55:00,31,40,Vestuário,7,71
7917,2024-01-06 11:56:00,15,31,Alimento,8,46
7918,2024-01-06 11:57:00,28,166,Móvel,3,194
7919,2024-01-06 11:58:00,94,152,Eletrônico,4,246
7920,2024-01-06 11:59:00,56,110,Vestuário,4,166
7921,2024-01-06 12:00:00,19,150,Móvel,1,169
7922,2024-01-06 12:01:00,41,101,Vestuário,8,142
7923,2024-01-06 12:02:00,115,128,Alimento,9,243
7924,2024-01-06 12:03:00,11,104,Vestuário,3,115
7925,2024-01-06 12:04:00,117,118,Móvel,1,235
7926,2024-01-06 12:05:00,43,118,Móvel,7,161
7927,2024-01-06 12:06:00,32,122,Eletrônico,4,154
7928,2024-01-06 12:07:00,65,83,Alimento,3,148
7929,2024-01-06 12:08:00,119,57,Alimento,7,176
7930,2024-01-06 12:09:00,68,72,Móvel,9,140
7931,2024-01-06 12:10:00,47,115,Brinquedo,4,162
7932,2024-01-06 12:11:00,89,102,Alimento,1,191
7933,2024-01-06 12:12:00,10,28,Alimento,1,38
7934,2024-01-06 12:13:00,51,86,Alimento,6,137
7935,2024-01-06 12:14:00,40,117,Alimento,9,157
7936,2024-01-06 12:15:00,107,146,Alimento,5,253
7937,2024-01-06 12:16:00,89,167,Vestuário,3,256
7938,2024-01-06 12:17:00,16,122,Móvel,4,138
7939,2024-01-06 12:18:00,100,51,Vestuário,2,151
7940,2024-01-06 12:19:00,114,104,Móvel,7,218
7941,2024-01-06 12:20:00,16,37,Alimento,8,53
7942,2024-01-06 12:21:00,113,31,Vestuário,8,144
7943,2024-01-06 12:22:00,49,80,Brinquedo,5,129
7944,2024-01-06 12:23:00,105,111,Móvel,9,216
7945,2024-01-06 12:24:00,118,77,Móvel,7,195
7946,2024-01-06 12:25:00,56,145,Alimento,3,201
7947,2024-01-06 12:26:00,59,132,Móvel,2,191
7948,2024-01-06 12:27:00,21,85,Alimento,1,106
7949,2024-01-06 12:28:00,36,143,Vestuário,2,179
7950,2024-01-06 12:29:00,98,156,Brinquedo,3,254
7951,2024-01-06 12:30:00,30,99,Brinquedo,7,129
7952,2024-01-06 12:31:00,70,153,Móvel,7,223
7953,2024-01-06 12:32:00,105,174,Eletrônico,1,279
7954,2024-01-06 12:33:00,96,20,Alimento,7,116
7955,2024-01-06 12:34:00,49,106,Eletrônico,1,155
7956,2024-01-06 12:35:00,95,31,Brinquedo,8,126
7957,2024-01-06 12:36:00,82,133,Alimento,7,215
7958,2024-01-06 12:37:00,42,57,Brinquedo,3,99
7959,2024-01-06 12:38:00,11,94,Vestuário,7,105
7960,2024-01-06 12:39:00,20,129,Móvel,4,149
7961,2024-01-06 12:40:00,12,60,Alimento,4,72
7962,2024-01-06 12:41:00,24,151,Vestuário,6,175
7963,2024-01-06 12:42:00,93,106,Eletrônico,8,199
7964,2024-01-06 12:43:00,12,18,Eletrônico,5,30
7965,2024-01-06 12:44:00,101,51,Alimento,7,152
7966,2024-01-06 12:45:00,49,41,Vestuário,3,90
7967,2024-01-06 12:46:00,95,163,Móvel,5,258
7968,2024-01-06 12:47:00,32,103,Vestuário,9,135
7969,2024-01-06 12:48:00,43,13,Brinquedo,2,56
7970,2024-01-06 12:49:00,44,38,Alimento,4,82
7971,2024-01-06 12:50:00,20,170,Vestuário,3,190
7972,2024-01-06 12:51:00,61,20,Eletrônico,4,81
7973,2024-01-06 12:52:00,32,52,Brinquedo,7,84
7974,2024-01-06 12:53:00,18,40,Eletrônico,2,58
7975,2024-01-06 12:54:00,83,153,Móvel,4,236
7976,2024-01-06 12:55:00,85,179,Alimento,3,264
7977,2024-01-06 12:56:00,15,135,Vestuário,3,150
7978,2024-01-06 12:57:00,98,171,Alimento,1,269
7979,2024-01-06 12:58:00,90,87,Brinquedo,9,177
7980,2024-01-06 12:59:00,44,101,Brinquedo,6,145
7981,2024-01-06 13:00:00,22,14,Móvel,2,36
7982,2024-01-06 13:01:00,109,88,Móvel,9,197
7983,2024-01-06 13:02:00,69,72,Alimento,2,141
7984,2024-01-06 13:03:00,13,32,Móvel,8,45
7985,2024-01-06 13:04:00,66,13,Móvel,6,79
7986,2024-01-06 13:05:00,27,82,Eletrônico,3,109
7987,2024-01-06 13:06:00,54,95,Brinquedo,4,149
7988,2024-01-06 13:07:00,68,153,Alimento,4,221
7989,2024-01-06 13:08:00,84,68,Eletrônico,9,152
7990,2024-01-06 13:09:00,18,119,Brinquedo,8,137
7991,2024-01-06 13:10:00,104,38,Eletrônico,5,142
7992,2024-01-06 13:11:00,44,10,Vestuário,7,54
7993,2024-01-06 13:12:00,92,137,Vestuário,5,229
7994,2024-01-06 13:13:00,101,140,Móvel,4,241
7995,2024-01-06 13:14:00,23,136,Alimento,6,159
7996,2024-01-06 13:15:00,79,142,Alimento,1,221
7997,2024-01-06 13:16:00,31,78,Móvel,3,109
7998,2024-01-06 13:17:00,51,123,Vestuário,9,174
7999,2024-01-06 13:18:00,51,119,Vestuário,4,170
8000,2024-01-06 13:19:00,84,19,Vestuário,4,103
8001,2024-01-06 13:20:00,16,173,Brinquedo,2,189
8002,2024-01-06 13:21:00,79,14,Eletrônico,4,93
8003,2024-01-06 13:22:00,59,117,Eletrônico,8,176
8004,2024-01-06 13:23:00,82,62,Eletrônico,1,144
8005,2024-01-06 13:24:00,34,160,Alimento,3,194
8006,2024-01-06 13:25:00,19,163,Brinquedo,3,182
8007,2024-01-06 13:26:00,59,17,Alimento,7,76
8008,2024-01-06 13:27:00,48,91,Brinquedo,8,139
8009,2024-01-06 13:28:00,79,28,Vestuário,6,107
8010,2024-01-06 13:29:00,52,130,Eletrônico,5,182
8011,2024-01-06 13:30:00,45,117,Móvel,9,162
8012,2024-01-06 13:31:00,115,37,Vestuário,8,152
8013,2024-01-06 13:32:00,119,137,Eletrônico,8,256
8014,2024-01-06 13:33:00,11,166,Alimento,3,177
8015,2024-01-06 13:34:00,57,143,Eletrônico,4,200
8016,2024-01-06 13:35:00,36,161,Vestuário,9,197
8017,2024-01-06 13:36:00,13,151,Brinquedo,2,164
8018,2024-01-06 13:37:00,10,77,Eletrônico,7,87
8019,2024-01-06 13:38:00,17,107,Móvel,2,124
8020,2024-01-06 13:39:00,24,111,Vestuário,5,135
8021,2024-01-06 13:40:00,37,85,Vestuário,3,122
8022,2024-01-06 13:41:00,100,173,Móvel,6,273
8023,2024-01-06 13:42:00,98,38,Alimento,3,136
8024,2024-01-06 13:43:00,79,13,Eletrônico,4,92
8025,2024-01-06 13:44:00,85,100,Alimento,6,185
8026,2024-01-06 13:45:00,62,86,Vestuário,6,148
8027,2024-01-06 13:46:00,92,78,Móvel,9,170
8028,2024-01-06 13:47:00,42,141,Eletrônico,6,183
8029,2024-01-06 13:48:00,23,128,Vestuário,7,151
8030,2024-01-06 13:49:00,74,94,Vestuário,2,168
8031,2024-01-06 13:50:00,114,164,Vestuário,2,278
8032,2024-01-06 13:51:00,92,126,Vestuário,8,218
8033,2024-01-06 13:52:00,14,126,Eletrônico,3,140
8034,2024-01-06 13:53:00,28,94,Alimento,9,122
8035,2024-01-06 13:54:00,63,29,Móvel,3,92
8036,2024-01-06 13:55:00,36,43,Eletrônico,7,79
8037,2024-01-06 13:56:00,83,74,Móvel,6,157
8038,2024-01-06 13:57:00,96,124,Vestuário,1,220
8039,2024-01-06 13:58:00,84,97,Eletrônico,2,181
8040,2024-01-06 13:59:00,60,164,Eletrônico,7,224
8041,2024-01-06 14:00:00,38,86,Móvel,6,124
8042,2024-01-06 14:01:00,64,135,Brinquedo,5,199
8043,2024-01-06 14:02:00,79,13,Móvel,8,92
8044,2024-01-06 14:03:00,16,60,Alimento,2,76
8045,2024-01-06 14:04:00,25,69,Eletrônico,6,94
8046,2024-01-06 14:05:00,94,66,Alimento,1,160
8047,2024-01-06 14:06:00,55,54,Alimento,4,109
8048,2024-01-06 14:07:00,59,100,Eletrônico,4,159
8049,2024-01-06 14:08:00,58,71,Vestuário,5,129
8050,2024-01-06 14:09:00,19,78,Alimento,7,97
8051,2024-01-06 14:10:00,112,175,Móvel,6,287
8052,2024-01-06 14:11:00,113,40,Vestuário,3,153
8053,2024-01-06 14:12:00,38,55,Móvel,1,93
8054,2024-01-06 14:13:00,65,156,Alimento,5,221
8055,2024-01-06 14:14:00,109,148,Vestuário,3,257
8056,2024-01-06 14:15:00,43,162,Móvel,5,205
8057,2024-01-06 14:16:00,33,112,Móvel,2,145
8058,2024-01-06 14:17:00,19,121,Vestuário,5,140
8059,2024-01-06 14:18:00,30,66,Vestuário,1,96
8060,2024-01-06 14:19:00,69,60,Vestuário,3,129
8061,2024-01-06 14:20:00,20,82,Brinquedo,6,102
8062,2024-01-06 14:21:00,36,20,Eletrônico,4,56
8063,2024-01-06 14:22:00,37,40,Móvel,3,77
8064,2024-01-06 14:23:00,84,171,Alimento,4,255
8065,2024-01-06 14:24:00,30,76,Eletrônico,8,106
8066,2024-01-06 14:25:00,28,157,Vestuário,8,185
8067,2024-01-06 14:26:00,117,162,Brinquedo,3,279
8068,2024-01-06 14:27:00,43,15,Brinquedo,3,58
8069,2024-01-06 14:28:00,118,69,Brinquedo,5,187
8070,2024-01-06 14:29:00,27,43,Móvel,5,70
8071,2024-01-06 14:30:00,67,29,Vestuário,5,96
8072,2024-01-06 14:31:00,59,39,Eletrônico,1,98
8073,2024-01-06 14:32:00,21,141,Móvel,6,162
8074,2024-01-06 14:33:00,16,156,Alimento,2,172
8075,2024-01-06 14:34:00,66,21,Móvel,5,87
8076,2024-01-06 14:35:00,80,70,Alimento,1,150
8077,2024-01-06 14:36:00,74,23,Vestuário,2,97
8078,2024-01-06 14:37:00,81,172,Eletrônico,4,253
8079,2024-01-06 14:38:00,90,88,Brinquedo,2,178
8080,2024-01-06 14:39:00,23,128,Vestuário,7,151
8081,2024-01-06 14:40:00,87,58,Móvel,2,145
8082,2024-01-06 14:41:00,16,131,Vestuário,1,147
8083,2024-01-06 14:42:00,37,61,Móvel,5,98
8084,2024-01-06 14:43:00,42,84,Eletrônico,5,126
8085,2024-01-06 14:44:00,44,42,Vestuário,9,86
8086,2024-01-06 14:45:00,61,165,Vestuário,8,226
8087,2024-01-06 14:46:00,93,143,Móvel,4,236
8088,2024-01-06 14:47:00,66,96,Brinquedo,4,162
8089,2024-01-06 14:48:00,91,55,Eletrônico,2,146
8090,2024-01-06 14:49:00,72,46,Móvel,8,118
8091,2024-01-06 14:50:00,106,147,Alimento,8,253
8092,2024-01-06 14:51:00,64,88,Vestuário,6,152
8093,2024-01-06 14:52:00,71,150,Brinquedo,2,221
8094,2024-01-06 14:53:00,75,179,Vestuário,7,254
8095,2024-01-06 14:54:00,56,22,Móvel,6,78
8096,2024-01-06 14:55:00,112,68,Móvel,5,180
8097,2024-01-06 14:56:00,49,166,Eletrônico,7,215
8098,2024-01-06 14:57:00,69,91,Brinquedo,5,160
8099,2024-01-06 14:58:00,18,67,Alimento,5,85
8100,2024-01-06 14:59:00,100,90,Móvel,6,190
8101,2024-01-06 15:00:00,69,151,Eletrônico,4,220
8102,2024-01-06 15:01:00,102,118,Vestuário,4,220
8103,2024-01-06 15:02:00,103,116,Vestuário,5,219
8104,2024-01-06 15:03:00,53,158,Brinquedo,8,211
8105,2024-01-06 15:04:00,107,141,Brinquedo,4,248
8106,2024-01-06 15:05:00,57,117,Alimento,7,174
8107,2024-01-06 15:06:00,13,18,Eletrônico,3,31
8108,2024-01-06 15:07:00,98,25,Brinquedo,6,123
8109,2024-01-06 15:08:00,76,161,Eletrônico,2,237
8110,2024-01-06 15:09:00,116,103,Eletrônico,5,219
8111,2024-01-06 15:10:00,66,35,Brinquedo,8,101
8112,2024-01-06 15:11:00,94,166,Vestuário,1,260
8113,2024-01-06 15:12:00,72,65,Brinquedo,3,137
8114,2024-01-06 15:13:00,92,104,Eletrônico,9,196
8115,2024-01-06 15:14:00,49,71,Vestuário,6,120
8116,2024-01-06 15:15:00,46,87,Alimento,5,133
8117,2024-01-06 15:16:00,108,96,Vestuário,4,204
8118,2024-01-06 15:17:00,62,123,Eletrônico,2,185
8119,2024-01-06 15:18:00,108,154,Móvel,3,262
8120,2024-01-06 15:19:00,30,18,Alimento,9,48
8121,2024-01-06 15:20:00,49,80,Móvel,7,129
8122,2024-01-06 15:21:00,94,174,Móvel,3,268
8123,2024-01-06 15:22:00,17,135,Eletrônico,5,152
8124,2024-01-06 15:23:00,104,33,Brinquedo,9,137
8125,2024-01-06 15:24:00,102,146,Vestuário,9,248
8126,2024-01-06 15:25:00,21,104,Brinquedo,9,125
8127,2024-01-06 15:26:00,31,97,Móvel,6,128
8128,2024-01-06 15:27:00,106,112,Móvel,8,218
8129,2024-01-06 15:28:00,69,27,Eletrônico,7,96
8130,2024-01-06 15:29:00,25,16,Vestuário,2,41
8131,2024-01-06 15:30:00,29,84,Brinquedo,9,113
8132,2024-01-06 15:31:00,63,103,Móvel,8,166
8133,2024-01-06 15:32:00,53,19,Móvel,2,72
8134,2024-01-06 15:33:00,48,173,Móvel,6,221
8135,2024-01-06 15:34:00,10,160,Brinquedo,8,170
8136,2024-01-06 15:35:00,11,98,Brinquedo,6,109
8137,2024-01-06 15:36:00,14,122,Alimento,9,136
8138,2024-01-06 15:37:00,22,51,Móvel,6,73
8139,2024-01-06 15:38:00,74,136,Eletrônico,3,210
8140,2024-01-06 15:39:00,89,87,Eletrônico,3,176
8141,2024-01-06 15:40:00,34,61,Alimento,4,95
8142,2024-01-06 15:41:00,19,86,Eletrônico,6,105
8143,2024-01-06 15:42:00,70,32,Vestuário,8,102
8144,2024-01-06 15:43:00,66,169,Móvel,1,235
8145,2024-01-06 15:44:00,101,132,Vestuário,2,233
8146,2024-01-06 15:45:00,63,174,Móvel,7,237
8147,2024-01-06 15:46:00,26,82,Vestuário,9,108
8148,2024-01-06 15:47:00,35,84,Brinquedo,2,119
8149,2024-01-06 15:48:00,79,79,Eletrônico,6,158
8150,2024-01-06 15:49:00,14,114,Eletrônico,9,128
8151,2024-01-06 15:50:00,48,84,Vestuário,9,132
8152,2024-01-06 15:51:00,39,134,Móvel,5,173
8153,2024-01-06 15:52:00,58,72,Móvel,2,130
8154,2024-01-06 15:53:00,92,16,Brinquedo,5,108
8155,2024-01-06 15:54:00,110,75,Brinquedo,2,185
8156,2024-01-06 15:55:00,49,12,Alimento,4,61
8157,2024-01-06 15:56:00,88,154,Móvel,3,242
8158,2024-01-06 15:57:00,12,50,Alimento,9,62
8159,2024-01-06 15:58:00,82,132,Brinquedo,5,214
8160,2024-01-06 15:59:00,70,102,Móvel,6,172
8161,2024-01-06 16:00:00,100,106,Vestuário,8,206
8162,2024-01-06 16:01:00,110,83,Brinquedo,8,193
8163,2024-01-06 16:02:00,38,57,Vestuário,5,95
8164,2024-01-06 16:03:00,47,56,Brinquedo,7,103
8165,2024-01-06 16:04:00,118,144,Brinquedo,8,262
8166,2024-01-06 16:05:00,40,76,Móvel,2,116
8167,2024-01-06 16:06:00,51,17,Alimento,6,68
8168,2024-01-06 16:07:00,12,137,Eletrônico,6,149
8169,2024-01-06 16:08:00,67,139,Eletrônico,7,206
8170,2024-01-06 16:09:00,32,165,Alimento,4,197
8171,2024-01-06 16:10:00,108,28,Alimento,9,136
8172,2024-01-06 16:11:00,60,93,Alimento,3,153
8173,2024-01-06 16:12:00,87,26,Vestuário,2,113
8174,2024-01-06 16:13:00,25,33,Móvel,9,58
8175,2024-01-06 16:14:00,56,122,Alimento,8,178
8176,2024-01-06 16:15:00,80,18,Vestuário,4,98
8177,2024-01-06 16:16:00,53,174,Móvel,1,227
8178,2024-01-06 16:17:00,84,27,Eletrônico,5,111
8179,2024-01-06 16:18:00,104,53,Eletrônico,4,157
8180,2024-01-06 16:19:00,71,93,Brinquedo,3,164
8181,2024-01-06 16:20:00,49,71,Alimento,1,120
8182,2024-01-06 16:21:00,42,156,Brinquedo,5,198
8183,2024-01-06 16:22:00,66,131,Móvel,1,197
8184,2024-01-06 16:23:00,30,27,Móvel,7,57
8185,2024-01-06 16:24:00,40,73,Alimento,4,113
8186,2024-01-06 16:25:00,111,65,Brinquedo,5,176
8187,2024-01-06 16:26:00,33,149,Alimento,4,182
8188,2024-01-06 16:27:00,108,164,Vestuário,2,272
8189,2024-01-06 16:28:00,42,28,Eletrônico,5,70
8190,2024-01-06 16:29:00,11,16,Eletrônico,3,27
8191,2024-01-06 16:30:00,102,41,Móvel,7,143
8192,2024-01-06 16:31:00,82,74,Eletrônico,8,156
8193,2024-01-06 16:32:00,48,28,Eletrônico,1,76
8194,2024-01-06 16:33:00,65,38,Eletrônico,2,103
8195,2024-01-06 16:34:00,49,100,Alimento,3,149
8196,2024-01-06 16:35:00,75,60,Alimento,2,135
8197,2024-01-06 16:36:00,16,114,Móvel,6,130
8198,2024-01-06 16:37:00,110,114,Móvel,1,224
8199,2024-01-06 16:38:00,118,178,Brinquedo,7,296
8200,2024-01-06 16:39:00,55,98,Móvel,8,153
8201,2024-01-06 16:40:00,107,13,Alimento,4,120
8202,2024-01-06 16:41:00,92,115,Brinquedo,6,207
8203,2024-01-06 16:42:00,112,107,Móvel,2,219
8204,2024-01-06 16:43:00,33,159,Eletrônico,8,192
8205,2024-01-06 16:44:00,67,59,Vestuário,9,126
8206,2024-01-06 16:45:00,34,93,Brinquedo,8,127
8207,2024-01-06 16:46:00,65,178,Móvel,2,243
8208,2024-01-06 16:47:00,16,165,Eletrônico,6,181
8209,2024-01-06 16:48:00,28,20,Móvel,8,48
8210,2024-01-06 16:49:00,29,13,Brinquedo,7,42
8211,2024-01-06 16:50:00,14,55,Móvel,5,69
8212,2024-01-06 16:51:00,102,41,Alimento,6,143
8213,2024-01-06 16:52:00,24,105,Móvel,7,129
8214,2024-01-06 16:53:00,18,151,Móvel,4,169
8215,2024-01-06 16:54:00,38,101,Vestuário,6,139
8216,2024-01-06 16:55:00,21,42,Alimento,8,63
8217,2024-01-06 16:56:00,79,160,Móvel,3,239
8218,2024-01-06 16:57:00,35,89,Eletrônico,7,124
8219,2024-01-06 16:58:00,72,29,Eletrônico,8,101
8220,2024-01-06 16:59:00,79,68,Brinquedo,3,147
8221,2024-01-06 17:00:00,65,158,Eletrônico,4,223
8222,2024-01-06 17:01:00,59,170,Móvel,4,229
8223,2024-01-06 17:02:00,75,151,Brinquedo,8,226
8224,2024-01-06 17:03:00,93,110,Vestuário,5,203
8225,2024-01-06 17:04:00,115,113,Vestuário,3,228
8226,2024-01-06 17:05:00,65,97,Móvel,5,162
8227,2024-01-06 17:06:00,87,22,Vestuário,7,109
8228,2024-01-06 17:07:00,83,50,Alimento,1,133
8229,2024-01-06 17:08:00,112,54,Eletrônico,3,166
8230,2024-01-06 17:09:00,52,86,Eletrônico,2,138
8231,2024-01-06 17:10:00,11,80,Brinquedo,6,91
8232,2024-01-06 17:11:00,11,166,Vestuário,6,177
8233,2024-01-06 17:12:00,52,151,Alimento,7,203
8234,2024-01-06 17:13:00,115,112,Eletrônico,8,227
8235,2024-01-06 17:14:00,75,52,Eletrônico,8,127
8236,2024-01-06 17:15:00,109,176,Eletrônico,9,285
8237,2024-01-06 17:16:00,27,94,Alimento,2,121
8238,2024-01-06 17:17:00,108,71,Alimento,4,179
8239,2024-01-06 17:18:00,32,91,Móvel,8,123
8240,2024-01-06 17:19:00,50,148,Móvel,6,198
8241,2024-01-06 17:20:00,26,126,Eletrônico,8,152
8242,2024-01-06 17:21:00,55,51,Brinquedo,1,106
8243,2024-01-06 17:22:00,18,160,Eletrônico,1,178
8244,2024-01-06 17:23:00,26,126,Móvel,3,152
8245,2024-01-06 17:24:00,40,63,Móvel,9,103
8246,2024-01-06 17:25:00,112,152,Alimento,7,264
8247,2024-01-06 17:26:00,40,109,Brinquedo,6,149
8248,2024-01-06 17:27:00,92,169,Móvel,7,261
8249,2024-01-06 17:28:00,13,79,Móvel,1,92
8250,2024-01-06 17:29:00,46,60,Eletrônico,2,106
8251,2024-01-06 17:30:00,10,30,Móvel,4,40
8252,2024-01-06 17:31:00,107,46,Brinquedo,4,153
8253,2024-01-06 17:32:00,102,60,Móvel,4,162
8254,2024-01-06 17:33:00,69,164,Móvel,6,233
8255,2024-01-06 17:34:00,29,37,Vestuário,4,66
8256,2024-01-06 17:35:00,71,42,Brinquedo,6,113
8257,2024-01-06 17:36:00,96,142,Eletrônico,2,238
8258,2024-01-06 17:37:00,31,72,Alimento,6,103
8259,2024-01-06 17:38:00,90,156,Vestuário,7,246
8260,2024-01-06 17:39:00,20,137,Alimento,7,157
8261,2024-01-06 17:40:00,16,88,Vestuário,1,104
8262,2024-01-06 17:41:00,14,20,Móvel,9,34
8263,2024-01-06 17:42:00,28,132,Móvel,9,160
8264,2024-01-06 17:43:00,67,92,Vestuário,3,159
8265,2024-01-06 17:44:00,11,70,Vestuário,3,81
8266,2024-01-06 17:45:00,74,14,Eletrônico,9,88
8267,2024-01-06 17:46:00,10,127,Brinquedo,5,137
8268,2024-01-06 17:47:00,67,144,Brinquedo,2,211
8269,2024-01-06 17:48:00,11,118,Alimento,6,129
8270,2024-01-06 17:49:00,30,168,Vestuário,2,198
8271,2024-01-06 17:50:00,47,50,Eletrônico,6,97
8272,2024-01-06 17:51:00,41,103,Alimento,9,144
8273,2024-01-06 17:52:00,16,19,Móvel,3,35
8274,2024-01-06 17:53:00,41,110,Móvel,2,151
8275,2024-01-06 17:54:00,114,76,Vestuário,6,190
8276,2024-01-06 17:55:00,81,25,Eletrônico,3,106
8277,2024-01-06 17:56:00,62,99,Móvel,5,161
8278,2024-01-06 17:57:00,11,147,Alimento,4,158
8279,2024-01-06 17:58:00,59,108,Alimento,5,167
8280,2024-01-06 17:59:00,41,125,Vestuário,2,166
8281,2024-01-06 18:00:00,112,139,Alimento,8,251
8282,2024-01-06 18:01:00,85,106,Móvel,7,191
8283,2024-01-06 18:02:00,72,45,Brinquedo,3,117
8284,2024-01-06 18:03:00,57,32,Vestuário,2,89
8285,2024-01-06 18:04:00,93,148,Móvel,5,241
8286,2024-01-06 18:05:00,112,170,Brinquedo,4,282
8287,2024-01-06 18:06:00,31,148,Alimento,3,179
8288,2024-01-06 18:07:00,12,105,Alimento,7,117
8289,2024-01-06 18:08:00,21,121,Brinquedo,2,142
8290,2024-01-06 18:09:00,30,159,Eletrônico,1,189
8291,2024-01-06 18:10:00,12,91,Eletrônico,2,103
8292,2024-01-06 18:11:00,89,128,Alimento,8,217
8293,2024-01-06 18:12:00,103,42,Móvel,6,145
8294,2024-01-06 18:13:00,39,155,Brinquedo,1,194
8295,2024-01-06 18:14:00,53,44,Brinquedo,9,97
8296,2024-01-06 18:15:00,11,61,Alimento,8,72
8297,2024-01-06 18:16:00,94,128,Vestuário,5,222
8298,2024-01-06 18:17:00,15,140,Brinquedo,2,155
8299,2024-01-06 18:18:00,84,59,Vestuário,5,143
8300,2024-01-06 18:19:00,58,81,Alimento,1,139
8301,2024-01-06 18:20:00,39,141,Móvel,4,180
8302,2024-01-06 18:21:00,53,126,Eletrônico,4,179
8303,2024-01-06 18:22:00,111,112,Eletrônico,4,223
8304,2024-01-06 18:23:00,84,15,Alimento,3,99
8305,2024-01-06 18:24:00,89,163,Alimento,6,252
8306,2024-01-06 18:25:00,116,116,Alimento,7,232
8307,2024-01-06 18:26:00,115,50,Eletrônico,4,165
8308,2024-01-06 18:27:00,91,101,Brinquedo,6,192
8309,2024-01-06 18:28:00,70,43,Móvel,3,113
8310,2024-01-06 18:29:00,74,171,Brinquedo,9,245
8311,2024-01-06 18:30:00,107,63,Eletrônico,9,170
8312,2024-01-06 18:31:00,78,84,Eletrônico,5,162
8313,2024-01-06 18:32:00,37,146,Alimento,9,183
8314,2024-01-06 18:33:00,96,76,Vestuário,5,172
8315,2024-01-06 18:34:00,20,126,Alimento,9,146
8316,2024-01-06 18:35:00,77,134,Alimento,9,211
8317,2024-01-06 18:36:00,52,166,Eletrônico,2,218
8318,2024-01-06 18:37:00,39,57,Brinquedo,7,96
8319,2024-01-06 18:38:00,64,73,Móvel,6,137
8320,2024-01-06 18:39:00,80,14,Alimento,7,94
8321,2024-01-06 18:40:00,71,167,Eletrônico,6,238
8322,2024-01-06 18:41:00,107,114,Vestuário,9,221
8323,2024-01-06 18:42:00,23,76,Brinquedo,8,99
8324,2024-01-06 18:43:00,39,92,Móvel,5,131
8325,2024-01-06 18:44:00,18,103,Móvel,2,121
8326,2024-01-06 18:45:00,63,158,Vestuário,9,221
8327,2024-01-06 18:46:00,100,172,Móvel,3,272
8328,2024-01-06 18:47:00,88,107,Vestuário,7,195
8329,2024-01-06 18:48:00,36,163,Brinquedo,8,199
8330,2024-01-06 18:49:00,25,75,Brinquedo,5,100
8331,2024-01-06 18:50:00,19,103,Vestuário,9,122
8332,2024-01-06 18:51:00,86,63,Brinquedo,8,149
8333,2024-01-06 18:52:00,95,70,Eletrônico,1,165
8334,2024-01-06 18:53:00,76,56,Brinquedo,2,132
8335,2024-01-06 18:54:00,31,141,Eletrônico,7,172
8336,2024-01-06 18:55:00,16,104,Vestuário,1,120
8337,2024-01-06 18:56:00,77,157,Alimento,1,234
8338,2024-01-06 18:57:00,22,99,Vestuário,9,121
8339,2024-01-06 18:58:00,13,48,Eletrônico,5,61
8340,2024-01-06 18:59:00,82,32,Brinquedo,1,114
8341,2024-01-06 19:00:00,73,120,Eletrônico,7,193
8342,2024-01-06 19:01:00,117,165,Alimento,9,282
8343,2024-01-06 19:02:00,85,67,Brinquedo,7,152
8344,2024-01-06 19:03:00,117,169,Móvel,1,286
8345,2024-01-06 19:04:00,65,71,Eletrônico,2,136
8346,2024-01-06 19:05:00,88,116,Vestuário,6,204
8347,2024-01-06 19:06:00,41,106,Vestuário,6,147
8348,2024-01-06 19:07:00,53,38,Eletrônico,7,91
8349,2024-01-06 19:08:00,33,94,Brinquedo,2,127
8350,2024-01-06 19:09:00,29,72,Móvel,5,101
8351,2024-01-06 19:10:00,18,36,Brinquedo,7,54
8352,2024-01-06 19:11:00,36,101,Eletrônico,2,137
8353,2024-01-06 19:12:00,92,121,Alimento,4,213
8354,2024-01-06 19:13:00,85,31,Alimento,6,116
8355,2024-01-06 19:14:00,65,114,Brinquedo,2,179
8356,2024-01-06 19:15:00,95,140,Eletrônico,4,235
8357,2024-01-06 19:16:00,10,77,Alimento,9,87
8358,2024-01-06 19:17:00,111,140,Eletrônico,6,251
8359,2024-01-06 19:18:00,68,167,Móvel,4,235
8360,2024-01-06 19:19:00,110,92,Alimento,9,202
8361,2024-01-06 19:20:00,106,94,Eletrônico,2,200
8362,2024-01-06 19:21:00,54,10,Vestuário,7,64
8363,2024-01-06 19:22:00,73,77,Móvel,4,150
8364,2024-01-06 19:23:00,24,134,Brinquedo,4,158
8365,2024-01-06 19:24:00,13,85,Móvel,7,98
8366,2024-01-06 19:25:00,46,124,Eletrônico,8,170
8367,2024-01-06 19:26:00,77,102,Vestuário,6,179
8368,2024-01-06 19:27:00,54,159,Eletrônico,2,213
8369,2024-01-06 19:28:00,30,171,Eletrônico,1,201
8370,2024-01-06 19:29:00,117,97,Móvel,3,214
8371,2024-01-06 19:30:00,15,74,Móvel,2,89
8372,2024-01-06 19:31:00,87,162,Alimento,4,249
8373,2024-01-06 19:32:00,28,69,Móvel,9,97
8374,2024-01-06 19:33:00,15,33,Móvel,5,48
8375,2024-01-06 19:34:00,57,40,Móvel,8,97
8376,2024-01-06 19:35:00,88,16,Alimento,3,104
8377,2024-01-06 19:36:00,116,146,Móvel,8,262
8378,2024-01-06 19:37:00,59,17,Eletrônico,8,76
8379,2024-01-06 19:38:00,111,99,Alimento,2,210
8380,2024-01-06 19:39:00,37,50,Alimento,1,87
8381,2024-01-06 19:40:00,113,53,Brinquedo,9,166
8382,2024-01-06 19:41:00,24,79,Vestuário,1,103
8383,2024-01-06 19:42:00,80,120,Eletrônico,6,200
8384,2024-01-06 19:43:00,67,76,Eletrônico,5,143
8385,2024-01-06 19:44:00,65,124,Brinquedo,7,189
8386,2024-01-06 19:45:00,50,50,Vestuário,6,100
8387,2024-01-06 19:46:00,29,153,Móvel,7,182
8388,2024-01-06 19:47:00,16,150,Vestuário,5,166
8389,2024-01-06 19:48:00,29,48,Móvel,1,77
8390,2024-01-06 19:49:00,115,47,Eletrônico,2,162
8391,2024-01-06 19:50:00,22,11,Alimento,7,33
8392,2024-01-06 19:51:00,29,28,Alimento,8,57
8393,2024-01-06 19:52:00,64,50,Alimento,2,114
8394,2024-01-06 19:53:00,47,152,Móvel,8,199
8395,2024-01-06 19:54:00,103,53,Eletrônico,7,156
8396,2024-01-06 19:55:00,106,95,Alimento,9,201
8397,2024-01-06 19:56:00,31,66,Móvel,4,97
8398,2024-01-06 19:57:00,66,120,Alimento,3,186
8399,2024-01-06 19:58:00,89,154,Eletrônico,7,243
8400,2024-01-06 19:59:00,14,43,Eletrônico,8,57
8401,2024-01-06 20:00:00,36,33,Vestuário,5,69
8402,2024-01-06 20:01:00,51,142,Brinquedo,2,193
8403,2024-01-06 20:02:00,47,20,Móvel,7,67
8404,2024-01-06 20:03:00,49,57,Eletrônico,7,106
8405,2024-01-06 20:04:00,112,88,Brinquedo,3,200
8406,2024-01-06 20:05:00,42,130,Vestuário,8,172
8407,2024-01-06 20:06:00,23,161,Vestuário,7,184
8408,2024-01-06 20:07:00,110,27,Móvel,6,137
8409,2024-01-06 20:08:00,30,134,Eletrônico,7,164
8410,2024-01-06 20:09:00,111,129,Móvel,4,240
8411,2024-01-06 20:10:00,89,134,Móvel,9,223
8412,2024-01-06 20:11:00,114,170,Brinquedo,8,284
8413,2024-01-06 20:12:00,40,65,Eletrônico,1,105
8414,2024-01-06 20:13:00,100,70,Brinquedo,3,170
8415,2024-01-06 20:14:00,91,58,Móvel,2,149
8416,2024-01-06 20:15:00,102,175,Eletrônico,7,277
8417,2024-01-06 20:16:00,105,51,Móvel,8,156
8418,2024-01-06 20:17:00,64,134,Alimento,8,198
8419,2024-01-06 20:18:00,104,126,Vestuário,5,230
8420,2024-01-06 20:19:00,64,76,Eletrônico,7,140
8421,2024-01-06 20:20:00,78,163,Brinquedo,1,241
8422,2024-01-06 20:21:00,73,47,Eletrônico,7,120
8423,2024-01-06 20:22:00,17,160,Móvel,4,177
8424,2024-01-06 20:23:00,90,40,Eletrônico,9,130
8425,2024-01-06 20:24:00,44,12,Alimento,6,56
8426,2024-01-06 20:25:00,71,167,Móvel,7,238
8427,2024-01-06 20:26:00,85,18,Alimento,8,103
8428,2024-01-06 20:27:00,104,132,Vestuário,1,236
8429,2024-01-06 20:28:00,10,124,Vestuário,5,134
8430,2024-01-06 20:29:00,116,117,Brinquedo,6,233
8431,2024-01-06 20:30:00,16,90,Eletrônico,1,106
8432,2024-01-06 20:31:00,33,130,Alimento,3,163
8433,2024-01-06 20:32:00,96,140,Móvel,4,236
8434,2024-01-06 20:33:00,10,104,Vestuário,7,114
8435,2024-01-06 20:34:00,76,111,Eletrônico,7,187
8436,2024-01-06 20:35:00,119,69,Móvel,8,188
8437,2024-01-06 20:36:00,83,97,Eletrônico,1,180
8438,2024-01-06 20:37:00,70,64,Vestuário,7,134
8439,2024-01-06 20:38:00,57,23,Eletrônico,3,80
8440,2024-01-06 20:39:00,75,149,Vestuário,9,224
8441,2024-01-06 20:40:00,79,111,Alimento,9,190
8442,2024-01-06 20:41:00,52,169,Alimento,8,221
8443,2024-01-06 20:42:00,117,74,Brinquedo,9,191
8444,2024-01-06 20:43:00,73,45,Móvel,2,118
8445,2024-01-06 20:44:00,75,69,Eletrônico,2,144
8446,2024-01-06 20:45:00,15,152,Móvel,4,167
8447,2024-01-06 20:46:00,104,47,Alimento,3,151
8448,2024-01-06 20:47:00,19,106,Vestuário,2,125
8449,2024-01-06 20:48:00,88,23,Eletrônico,1,111
8450,2024-01-06 20:49:00,119,28,Alimento,8,147
8451,2024-01-06 20:50:00,15,100,Móvel,3,115
8452,2024-01-06 20:51:00,88,140,Vestuário,5,228
8453,2024-01-06 20:52:00,59,46,Brinquedo,8,105
8454,2024-01-06 20:53:00,98,71,Eletrônico,2,169
8455,2024-01-06 20:54:00,90,140,Eletrônico,4,230
8456,2024-01-06 20:55:00,33,115,Eletrônico,5,148
8457,2024-01-06 20:56:00,99,131,Eletrônico,5,230
8458,2024-01-06 20:57:00,55,102,Vestuário,5,157
8459,2024-01-06 20:58:00,75,110,Eletrônico,4,185
8460,2024-01-06 20:59:00,107,105,Móvel,7,212
8461,2024-01-06 21:00:00,102,92,Eletrônico,3,194
8462,2024-01-06 21:01:00,105,139,Móvel,9,244
8463,2024-01-06 21:02:00,53,15,Brinquedo,4,68
8464,2024-01-06 21:03:00,47,163,Vestuário,1,210
8465,2024-01-06 21:04:00,43,61,Móvel,9,104
8466,2024-01-06 21:05:00,40,92,Brinquedo,1,132
8467,2024-01-06 21:06:00,115,54,Móvel,1,169
8468,2024-01-06 21:07:00,52,128,Alimento,6,180
8469,2024-01-06 21:08:00,93,178,Alimento,8,271
8470,2024-01-06 21:09:00,113,78,Móvel,7,191
8471,2024-01-06 21:10:00,27,138,Alimento,2,165
8472,2024-01-06 21:11:00,115,99,Eletrônico,5,214
8473,2024-01-06 21:12:00,55,45,Alimento,4,100
8474,2024-01-06 21:13:00,83,55,Alimento,7,138
8475,2024-01-06 21:14:00,47,20,Vestuário,3,67
8476,2024-01-06 21:15:00,52,147,Brinquedo,9,199
8477,2024-01-06 21:16:00,45,40,Móvel,5,85
8478,2024-01-06 21:17:00,114,162,Móvel,1,276
8479,2024-01-06 21:18:00,86,21,Eletrônico,1,107
8480,2024-01-06 21:19:00,21,111,Vestuário,4,132
8481,2024-01-06 21:20:00,17,121,Eletrônico,8,138
8482,2024-01-06 21:21:00,28,27,Alimento,2,55
8483,2024-01-06 21:22:00,72,162,Móvel,7,234
8484,2024-01-06 21:23:00,28,108,Alimento,1,136
8485,2024-01-06 21:24:00,47,112,Brinquedo,9,159
8486,2024-01-06 21:25:00,51,173,Eletrônico,5,224
8487,2024-01-06 21:26:00,54,137,Brinquedo,4,191
8488,2024-01-06 21:27:00,23,166,Móvel,3,189
8489,2024-01-06 21:28:00,30,96,Brinquedo,5,126
8490,2024-01-06 21:29:00,31,114,Eletrônico,6,145
8491,2024-01-06 21:30:00,46,10,Eletrônico,4,56
8492,2024-01-06 21:31:00,102,123,Eletrônico,2,225
8493,2024-01-06 21:32:00,14,78,Vestuário,8,92
8494,2024-01-06 21:33:00,52,62,Alimento,8,114
8495,2024-01-06 21:34:00,19,169,Vestuário,1,188
8496,2024-01-06 21:35:00,71,21,Eletrônico,1,92
8497,2024-01-06 21:36:00,73,171,Alimento,7,244
8498,2024-01-06 21:37:00,17,120,Móvel,5,137
8499,2024-01-06 21:38:00,106,147,Eletrônico,3,253
8500,2024-01-06 21:39:00,118,75,Móvel,9,193
8501,2024-01-06 21:40:00,33,124,Vestuário,3,157
8502,2024-01-06 21:41:00,14,153,Vestuário,9,167
8503,2024-01-06 21:42:00,15,71,Móvel,9,86
8504,2024-01-06 21:43:00,10,132,Móvel,4,142
8505,2024-01-06 21:44:00,78,40,Móvel,8,118
8506,2024-01-06 21:45:00,116,13,Eletrônico,7,129
8507,2024-01-06 21:46:00,98,16,Alimento,5,114
8508,2024-01-06 21:47:00,87,162,Móvel,8,249
8509,2024-01-06 21:48:00,15,85,Eletrônico,3,100
8510,2024-01-06 21:49:00,60,53,Vestuário,5,113
8511,2024-01-06 21:50:00,73,87,Eletrônico,1,160
8512,2024-01-06 21:51:00,71,117,Alimento,8,188
8513,2024-01-06 21:52:00,60,162,Alimento,5,222
8514,2024-01-06 21:53:00,30,131,Alimento,9,161
8515,2024-01-06 21:54:00,16,179,Brinquedo,9,195
8516,2024-01-06 21:55:00,112,105,Brinquedo,8,217
8517,2024-01-06 21:56:00,97,58,Alimento,7,155
8518,2024-01-06 21:57:00,102,164,Alimento,9,266
8519,2024-01-06 21:58:00,11,132,Móvel,1,143
8520,2024-01-06 21:59:00,115,173,Vestuário,3,288
8521,2024-01-06 22:00:00,16,151,Vestuário,8,167
8522,2024-01-06 22:01:00,69,117,Eletrônico,4,186
8523,2024-01-06 22:02:00,97,29,Brinquedo,4,126
8524,2024-01-06 22:03:00,16,119,Móvel,1,135
8525,2024-01-06 22:04:00,71,83,Eletrônico,1,154
8526,2024-01-06 22:05:00,24,90,Alimento,4,114
8527,2024-01-06 22:06:00,33,63,Alimento,7,96
8528,2024-01-06 22:07:00,41,110,Eletrônico,6,151
8529,2024-01-06 22:08:00,87,83,Eletrônico,9,170
8530,2024-01-06 22:09:00,84,42,Brinquedo,4,126
8531,2024-01-06 22:10:00,81,73,Brinquedo,5,154
8532,2024-01-06 22:11:00,72,91,Eletrônico,1,163
8533,2024-01-06 22:12:00,114,75,Alimento,4,189
8534,2024-01-06 22:13:00,48,48,Eletrônico,8,96
8535,2024-01-06 22:14:00,40,68,Eletrônico,7,108
8536,2024-01-06 22:15:00,51,148,Vestuário,1,199
8537,2024-01-06 22:16:00,71,52,Brinquedo,1,123
8538,2024-01-06 22:17:00,15,10,Eletrônico,4,25
8539,2024-01-06 22:18:00,115,105,Eletrônico,8,220
8540,2024-01-06 22:19:00,28,146,Vestuário,7,174
8541,2024-01-06 22:20:00,96,130,Brinquedo,6,226
8542,2024-01-06 22:21:00,79,39,Móvel,7,118
8543,2024-01-06 22:22:00,76,132,Móvel,8,208
8544,2024-01-06 22:23:00,101,88,Vestuário,6,189
8545,2024-01-06 22:24:00,111,133,Alimento,7,244
8546,2024-01-06 22:25:00,57,70,Alimento,1,127
8547,2024-01-06 22:26:00,75,81,Vestuário,8,156
8548,2024-01-06 22:27:00,22,148,Móvel,8,170
8549,2024-01-06 22:28:00,67,71,Alimento,1,138
8550,2024-01-06 22:29:00,82,125,Vestuário,9,207
8551,2024-01-06 22:30:00,12,69,Brinquedo,6,81
8552,2024-01-06 22:31:00,89,110,Vestuário,2,199
8553,2024-01-06 22:32:00,83,135,Brinquedo,7,218
8554,2024-01-06 22:33:00,89,152,Móvel,4,241
8555,2024-01-06 22:34:00,106,145,Vestuário,5,251
8556,2024-01-06 22:35:00,56,146,Eletrônico,3,202
8557,2024-01-06 22:36:00,85,124,Alimento,3,209
8558,2024-01-06 22:37:00,93,96,Brinquedo,1,189
8559,2024-01-06 22:38:00,99,27,Eletrônico,2,126
8560,2024-01-06 22:39:00,23,176,Vestuário,4,199
8561,2024-01-06 22:40:00,31,88,Vestuário,1,119
8562,2024-01-06 22:41:00,48,18,Eletrônico,3,66
8563,2024-01-06 22:42:00,97,98,Eletrônico,6,195
8564,2024-01-06 22:43:00,67,38,Vestuário,4,105
8565,2024-01-06 22:44:00,24,20,Móvel,8,44
8566,2024-01-06 22:45:00,64,10,Eletrônico,8,74
8567,2024-01-06 22:46:00,114,124,Móvel,6,238
8568,2024-01-06 22:47:00,100,43,Brinquedo,3,143
8569,2024-01-06 22:48:00,71,122,Brinquedo,8,193
8570,2024-01-06 22:49:00,81,79,Vestuário,2,160
8571,2024-01-06 22:50:00,86,168,Vestuário,7,254
8572,2024-01-06 22:51:00,94,159,Móvel,9,253
8573,2024-01-06 22:52:00,89,47,Móvel,7,136
8574,2024-01-06 22:53:00,20,83,Eletrônico,1,103
8575,2024-01-06 22:54:00,18,168,Móvel,5,186
8576,2024-01-06 22:55:00,89,164,Móvel,3,253
8577,2024-01-06 22:56:00,96,87,Alimento,2,183
8578,2024-01-06 22:57:00,63,56,Móvel,5,119
8579,2024-01-06 22:58:00,78,20,Móvel,2,98
8580,2024-01-06 22:59:00,103,113,Brinquedo,6,216
8581,2024-01-06 23:00:00,102,142,Eletrônico,3,244
8582,2024-01-06 23:01:00,34,162,Vestuário,5,196
8583,2024-01-06 23:02:00,49,109,Alimento,7,158
8584,2024-01-06 23:03:00,87,133,Brinquedo,6,220
8585,2024-01-06 23:04:00,104,128,Vestuário,7,232
8586,2024-01-06 23:05:00,14,52,Brinquedo,8,66
8587,2024-01-06 23:06:00,12,104,Eletrônico,1,116
8588,2024-01-06 23:07:00,35,16,Alimento,5,51
8589,2024-01-06 23:08:00,22,72,Alimento,4,94
8590,2024-01-06 23:09:00,72,16,Eletrônico,2,88
8591,2024-01-06 23:10:00,84,89,Alimento,5,173
8592,2024-01-06 23:11:00,28,170,Vestuário,5,198
8593,2024-01-06 23:12:00,101,155,Vestuário,6,256
8594,2024-01-06 23:13:00,88,55,Vestuário,6,143
8595,2024-01-06 23:14:00,55,156,Móvel,3,211
8596,2024-01-06 23:15:00,66,75,Vestuário,8,141
8597,2024-01-06 23:16:00,64,113,Móvel,4,177
8598,2024-01-06 23:17:00,89,127,Móvel,5,216
8599,2024-01-06 23:18:00,22,95,Vestuário,8,117
8600,2024-01-06 23:19:00,74,162,Brinquedo,8,236
8601,2024-01-06 23:20:00,116,159,Móvel,7,275
8602,2024-01-06 23:21:00,49,104,Móvel,9,153
8603,2024-01-06 23:22:00,112,21,Eletrônico,7,133
8604,2024-01-06 23:23:00,54,39,Alimento,8,93
8605,2024-01-06 23:24:00,86,116,Móvel,8,202
8606,2024-01-06 23:25:00,29,143,Brinquedo,4,172
8607,2024-01-06 23:26:00,37,12,Móvel,1,49
8608,2024-01-06 23:27:00,41,93,Brinquedo,4,134
8609,2024-01-06 23:28:00,60,52,Brinquedo,2,112
8610,2024-01-06 23:29:00,51,37,Brinquedo,2,88
8611,2024-01-06 23:30:00,81,84,Brinquedo,5,165
8612,2024-01-06 23:31:00,81,123,Brinquedo,3,204
8613,2024-01-06 23:32:00,17,176,Brinquedo,1,193
8614,2024-01-06 23:33:00,115,64,Vestuário,5,179
8615,2024-01-06 23:34:00,92,175,Alimento,5,267
8616,2024-01-06 23:35:00,23,150,Vestuário,8,173
8617,2024-01-06 23:36:00,20,71,Vestuário,3,91
8618,2024-01-06 23:37:00,112,79,Eletrônico,5,191
8619,2024-01-06 23:38:00,65,95,Móvel,1,160
8620,2024-01-06 23:39:00,39,100,Vestuário,5,139
8621,2024-01-06 23:40:00,54,25,Brinquedo,3,79
8622,2024-01-06 23:41:00,23,169,Alimento,7,192
8623,2024-01-06 23:42:00,83,99,Vestuário,1,182
8624,2024-01-06 23:43:00,30,126,Alimento,7,156
8625,2024-01-06 23:44:00,25,54,Alimento,9,79
8626,2024-01-06 23:45:00,18,80,Móvel,1,98
8627,2024-01-06 23:46:00,60,156,Móvel,3,216
8628,2024-01-06 23:47:00,67,120,Eletrônico,6,187
8629,2024-01-06 23:48:00,13,136,Eletrônico,8,149
8630,2024-01-06 23:49:00,42,152,Eletrônico,9,194
8631,2024-01-06 23:50:00,91,116,Alimento,4,207
8632,2024-01-06 23:51:00,47,38,Alimento,2,85
8633,2024-01-06 23:52:00,97,112,Alimento,4,209
8634,2024-01-06 23:53:00,23,123,Vestuário,4,146
8635,2024-01-06 23:54:00,32,67,Brinquedo,5,99
8636,2024-01-06 23:55:00,81,51,Brinquedo,3,132
8637,2024-01-06 23:56:00,80,140,Móvel,1,220
8638,2024-01-06 23:57:00,80,157,Vestuário,4,237
8639,2024-01-06 23:58:00,87,69,Alimento,3,156
8640,2024-01-06 23:59:00,46,130,Vestuário,9,176
8641,2024-01-07 00:00:00,33,165,Vestuário,9,198
8642,2024-01-07 00:01:00,101,122,Brinquedo,7,223
8643,2024-01-07 00:02:00,48,100,Brinquedo,7,148
8644,2024-01-07 00:03:00,42,86,Alimento,7,128
8645,2024-01-07 00:04:00,24,44,Brinquedo,5,68
8646,2024-01-07 00:05:00,20,68,Vestuário,4,88
8647,2024-01-07 00:06:00,56,100,Brinquedo,2,156
8648,2024-01-07 00:07:00,30,166,Móvel,6,196
8649,2024-01-07 00:08:00,36,126,Brinquedo,3,162
8650,2024-01-07 00:09:00,80,97,Móvel,6,177
8651,2024-01-07 00:10:00,95,145,Vestuário,5,240
8652,2024-01-07 00:11:00,11,130,Eletrônico,2,141
8653,2024-01-07 00:12:00,65,176,Alimento,8,241
8654,2024-01-07 00:13:00,30,170,Alimento,2,200
8655,2024-01-07 00:14:00,67,109,Vestuário,1,176
8656,2024-01-07 00:15:00,118,55,Brinquedo,2,173
8657,2024-01-07 00:16:00,113,141,Vestuário,8,254
8658,2024-01-07 00:17:00,32,124,Móvel,7,156
8659,2024-01-07 00:18:00,51,90,Alimento,7,141
8660,2024-01-07 00:19:00,109,20,Brinquedo,5,129
8661,2024-01-07 00:20:00,34,152,Alimento,8,186
8662,2024-01-07 00:21:00,34,57,Alimento,4,91
8663,2024-01-07 00:22:00,106,112,Móvel,5,218
8664,2024-01-07 00:23:00,74,153,Móvel,8,227
8665,2024-01-07 00:24:00,65,14,Eletrônico,8,79
8666,2024-01-07 00:25:00,46,89,Alimento,9,135
8667,2024-01-07 00:26:00,91,89,Vestuário,7,180
8668,2024-01-07 00:27:00,113,116,Eletrônico,5,229
8669,2024-01-07 00:28:00,50,58,Alimento,9,108
8670,2024-01-07 00:29:00,47,132,Brinquedo,2,179
8671,2024-01-07 00:30:00,17,153,Eletrônico,6,170
8672,2024-01-07 00:31:00,88,169,Móvel,8,257
8673,2024-01-07 00:32:00,118,56,Vestuário,7,174
8674,2024-01-07 00:33:00,91,140,Móvel,1,231
8675,2024-01-07 00:34:00,27,46,Vestuário,6,73
8676,2024-01-07 00:35:00,10,161,Brinquedo,6,171
8677,2024-01-07 00:36:00,83,63,Vestuário,7,146
8678,2024-01-07 00:37:00,79,33,Brinquedo,8,112
8679,2024-01-07 00:38:00,64,142,Alimento,8,206
8680,2024-01-07 00:39:00,29,113,Móvel,3,142
8681,2024-01-07 00:40:00,39,35,Alimento,6,74
8682,2024-01-07 00:41:00,79,84,Vestuário,2,163
8683,2024-01-07 00:42:00,39,171,Vestuário,5,210
8684,2024-01-07 00:43:00,35,21,Alimento,2,56
8685,2024-01-07 00:44:00,106,159,Brinquedo,8,265
8686,2024-01-07 00:45:00,100,178,Brinquedo,9,278
8687,2024-01-07 00:46:00,86,80,Eletrônico,7,166
8688,2024-01-07 00:47:00,117,121,Móvel,3,238
8689,2024-01-07 00:48:00,99,80,Eletrônico,6,179
8690,2024-01-07 00:49:00,77,29,Eletrônico,9,106
8691,2024-01-07 00:50:00,52,65,Móvel,6,117
8692,2024-01-07 00:51:00,43,56,Móvel,1,99
8693,2024-01-07 00:52:00,12,63,Eletrônico,6,75
8694,2024-01-07 00:53:00,34,139,Móvel,1,173
8695,2024-01-07 00:54:00,68,101,Móvel,5,169
8696,2024-01-07 00:55:00,20,102,Eletrônico,7,122
8697,2024-01-07 00:56:00,64,18,Alimento,3,82
8698,2024-01-07 00:57:00,98,168,Brinquedo,3,266
8699,2024-01-07 00:58:00,92,100,Alimento,6,192
8700,2024-01-07 00:59:00,81,115,Móvel,6,196
8701,2024-01-07 01:00:00,40,167,Vestuário,6,207
8702,2024-01-07 01:01:00,48,46,Vestuário,9,94
8703,2024-01-07 01:02:00,81,27,Brinquedo,9,108
8704,2024-01-07 01:03:00,75,154,Brinquedo,6,229
8705,2024-01-07 01:04:00,101,33,Alimento,9,134
8706,2024-01-07 01:05:00,117,10,Eletrônico,9,127
8707,2024-01-07 01:06:00,18,150,Brinquedo,4,168
8708,2024-01-07 01:07:00,11,111,Móvel,2,122
8709,2024-01-07 01:08:00,42,62,Alimento,5,104
8710,2024-01-07 01:09:00,28,135,Vestuário,8,163
8711,2024-01-07 01:10:00,27,59,Eletrônico,9,86
8712,2024-01-07 01:11:00,80,155,Eletrônico,2,235
8713,2024-01-07 01:12:00,44,91,Eletrônico,4,135
8714,2024-01-07 01:13:00,14,66,Eletrônico,8,80
8715,2024-01-07 01:14:00,119,43,Brinquedo,3,162
8716,2024-01-07 01:15:00,24,106,Móvel,1,130
8717,2024-01-07 01:16:00,42,166,Brinquedo,1,208
8718,2024-01-07 01:17:00,74,10,Vestuário,4,84
8719,2024-01-07 01:18:00,63,22,Eletrônico,7,85
8720,2024-01-07 01:19:00,27,178,Brinquedo,2,205
8721,2024-01-07 01:20:00,20,28,Brinquedo,3,48
8722,2024-01-07 01:21:00,52,179,Alimento,2,231
8723,2024-01-07 01:22:00,114,123,Brinquedo,1,237
8724,2024-01-07 01:23:00,50,93,Vestuário,7,143
8725,2024-01-07 01:24:00,63,142,Brinquedo,9,205
8726,2024-01-07 01:25:00,102,144,Alimento,9,246
8727,2024-01-07 01:26:00,25,88,Vestuário,2,113
8728,2024-01-07 01:27:00,107,77,Brinquedo,4,184
8729,2024-01-07 01:28:00,113,26,Móvel,6,139
8730,2024-01-07 01:29:00,73,141,Eletrônico,3,214
8731,2024-01-07 01:30:00,50,111,Brinquedo,9,161
8732,2024-01-07 01:31:00,80,87,Brinquedo,6,167
8733,2024-01-07 01:32:00,97,84,Eletrônico,7,181
8734,2024-01-07 01:33:00,33,129,Móvel,6,162
8735,2024-01-07 01:34:00,81,175,Brinquedo,8,256
8736,2024-01-07 01:35:00,27,91,Brinquedo,4,118
8737,2024-01-07 01:36:00,117,90,Brinquedo,1,207
8738,2024-01-07 01:37:00,13,110,Móvel,9,123
8739,2024-01-07 01:38:00,34,44,Vestuário,5,78
8740,2024-01-07 01:39:00,55,140,Eletrônico,6,195
8741,2024-01-07 01:40:00,84,58,Vestuário,9,142
8742,2024-01-07 01:41:00,100,117,Vestuário,8,217
8743,2024-01-07 01:42:00,104,100,Vestuário,7,204
8744,2024-01-07 01:43:00,43,68,Alimento,8,111
8745,2024-01-07 01:44:00,113,165,Alimento,2,278
8746,2024-01-07 01:45:00,15,146,Alimento,7,161
8747,2024-01-07 01:46:00,115,153,Alimento,7,268
8748,2024-01-07 01:47:00,10,99,Eletrônico,4,109
8749,2024-01-07 01:48:00,11,65,Alimento,5,76
8750,2024-01-07 01:49:00,34,138,Móvel,3,172
8751,2024-01-07 01:50:00,77,97,Alimento,3,174
8752,2024-01-07 01:51:00,83,85,Alimento,4,168
8753,2024-01-07 01:52:00,98,141,Móvel,7,239
8754,2024-01-07 01:53:00,41,20,Brinquedo,2,61
8755,2024-01-07 01:54:00,78,133,Brinquedo,5,211
8756,2024-01-07 01:55:00,117,105,Móvel,8,222
8757,2024-01-07 01:56:00,32,18,Móvel,7,50
8758,2024-01-07 01:57:00,55,23,Brinquedo,7,78
8759,2024-01-07 01:58:00,79,27,Eletrônico,1,106
8760,2024-01-07 01:59:00,81,178,Alimento,1,259
8761,2024-01-07 02:00:00,101,155,Móvel,2,256
8762,2024-01-07 02:01:00,83,96,Brinquedo,5,179
8763,2024-01-07 02:02:00,82,157,Brinquedo,8,239
8764,2024-01-07 02:03:00,101,78,Brinquedo,8,179
8765,2024-01-07 02:04:00,115,113,Brinquedo,9,228
8766,2024-01-07 02:05:00,85,48,Vestuário,1,133
8767,2024-01-07 02:06:00,97,33,Alimento,5,130
8768,2024-01-07 02:07:00,15,177,Alimento,7,192
8769,2024-01-07 02:08:00,65,96,Móvel,2,161
8770,2024-01-07 02:09:00,96,135,Alimento,5,231
8771,2024-01-07 02:10:00,109,29,Eletrônico,6,138
8772,2024-01-07 02:11:00,31,21,Alimento,7,52
8773,2024-01-07 02:12:00,68,101,Brinquedo,4,169
8774,2024-01-07 02:13:00,88,102,Vestuário,4,190
8775,2024-01-07 02:14:00,65,109,Alimento,8,174
8776,2024-01-07 02:15:00,56,66,Eletrônico,9,122
8777,2024-01-07 02:16:00,32,125,Móvel,2,157
8778,2024-01-07 02:17:00,106,94,Alimento,9,200
8779,2024-01-07 02:18:00,24,69,Vestuário,9,93
8780,2024-01-07 02:19:00,89,159,Móvel,3,248
8781,2024-01-07 02:20:00,95,121,Vestuário,9,216
8782,2024-01-07 02:21:00,28,49,Vestuário,4,77
8783,2024-01-07 02:22:00,46,69,Móvel,5,115
8784,2024-01-07 02:23:00,113,146,Alimento,2,259
8785,2024-01-07 02:24:00,105,41,Eletrônico,6,146
8786,2024-01-07 02:25:00,119,19,Alimento,3,138
8787,2024-01-07 02:26:00,36,42,Móvel,9,78
8788,2024-01-07 02:27:00,76,20,Eletrônico,7,96
8789,2024-01-07 02:28:00,25,91,Brinquedo,2,116
8790,2024-01-07 02:29:00,41,107,Eletrônico,2,148
8791,2024-01-07 02:30:00,26,21,Brinquedo,2,47
8792,2024-01-07 02:31:00,30,13,Brinquedo,5,43
8793,2024-01-07 02:32:00,105,132,Brinquedo,6,237
8794,2024-01-07 02:33:00,64,115,Móvel,2,179
8795,2024-01-07 02:34:00,20,129,Alimento,4,149
8796,2024-01-07 02:35:00,45,33,Móvel,4,78
8797,2024-01-07 02:36:00,83,60,Brinquedo,8,143
8798,2024-01-07 02:37:00,77,10,Vestuário,1,87
8799,2024-01-07 02:38:00,72,161,Alimento,6,233
8800,2024-01-07 02:39:00,88,55,Eletrônico,5,143
8801,2024-01-07 02:40:00,28,39,Alimento,8,67
8802,2024-01-07 02:41:00,110,13,Eletrônico,4,123
8803,2024-01-07 02:42:00,96,117,Eletrônico,3,213
8804,2024-01-07 02:43:00,60,84,Brinquedo,2,144
8805,2024-01-07 02:44:00,10,125,Brinquedo,3,135
8806,2024-01-07 02:45:00,46,21,Alimento,3,67
8807,2024-01-07 02:46:00,75,130,Alimento,2,205
8808,2024-01-07 02:47:00,27,172,Móvel,5,199
8809,2024-01-07 02:48:00,10,28,Móvel,4,38
8810,2024-01-07 02:49:00,113,115,Vestuário,2,228
8811,2024-01-07 02:50:00,40,69,Móvel,3,109
8812,2024-01-07 02:51:00,43,34,Alimento,8,77
8813,2024-01-07 02:52:00,47,153,Eletrônico,9,200
8814,2024-01-07 02:53:00,78,20,Brinquedo,9,98
8815,2024-01-07 02:54:00,81,110,Vestuário,4,191
8816,2024-01-07 02:55:00,87,156,Alimento,4,243
8817,2024-01-07 02:56:00,112,69,Vestuário,8,181
8818,2024-01-07 02:57:00,23,62,Vestuário,9,85
8819,2024-01-07 02:58:00,30,115,Eletrônico,4,145
8820,2024-01-07 02:59:00,96,164,Eletrônico,7,260
8821,2024-01-07 03:00:00,60,172,Brinquedo,6,232
8822,2024-01-07 03:01:00,21,89,Brinquedo,4,110
8823,2024-01-07 03:02:00,86,158,Móvel,7,244
8824,2024-01-07 03:03:00,58,98,Alimento,6,156
8825,2024-01-07 03:04:00,22,22,Móvel,1,44
8826,2024-01-07 03:05:00,72,20,Móvel,8,92
8827,2024-01-07 03:06:00,18,160,Vestuário,6,178
8828,2024-01-07 03:07:00,47,155,Móvel,2,202
8829,2024-01-07 03:08:00,111,26,Móvel,8,137
8830,2024-01-07 03:09:00,88,13,Vestuário,7,101
8831,2024-01-07 03:10:00,89,156,Eletrônico,8,245
8832,2024-01-07 03:11:00,112,174,Brinquedo,6,286
8833,2024-01-07 03:12:00,108,57,Brinquedo,7,165
8834,2024-01-07 03:13:00,93,93,Vestuário,5,186
8835,2024-01-07 03:14:00,47,138,Brinquedo,8,185
8836,2024-01-07 03:15:00,18,98,Brinquedo,1,116
8837,2024-01-07 03:16:00,18,126,Eletrônico,7,144
8838,2024-01-07 03:17:00,41,25,Eletrônico,8,66
8839,2024-01-07 03:18:00,71,31,Móvel,2,102
8840,2024-01-07 03:19:00,87,137,Alimento,1,224
8841,2024-01-07 03:20:00,23,161,Alimento,6,184
8842,2024-01-07 03:21:00,76,25,Móvel,8,101
8843,2024-01-07 03:22:00,113,74,Brinquedo,3,187
8844,2024-01-07 03:23:00,93,100,Brinquedo,2,193
8845,2024-01-07 03:24:00,29,37,Eletrônico,1,66
8846,2024-01-07 03:25:00,88,129,Móvel,4,217
8847,2024-01-07 03:26:00,64,116,Brinquedo,7,180
8848,2024-01-07 03:27:00,51,106,Eletrônico,1,157
8849,2024-01-07 03:28:00,44,28,Brinquedo,5,72
8850,2024-01-07 03:29:00,43,87,Alimento,1,130
8851,2024-01-07 03:30:00,90,123,Móvel,8,213
8852,2024-01-07 03:31:00,107,37,Vestuário,9,144
8853,2024-01-07 03:32:00,70,108,Alimento,8,178
8854,2024-01-07 03:33:00,114,100,Eletrônico,6,214
8855,2024-01-07 03:34:00,85,141,Eletrônico,7,226
8856,2024-01-07 03:35:00,19,138,Brinquedo,4,157
8857,2024-01-07 03:36:00,37,159,Vestuário,9,196
8858,2024-01-07 03:37:00,115,111,Brinquedo,2,226
8859,2024-01-07 03:38:00,116,29,Móvel,8,145
8860,2024-01-07 03:39:00,54,153,Vestuário,7,207
8861,2024-01-07 03:40:00,62,97,Vestuário,7,159
8862,2024-01-07 03:41:00,117,107,Móvel,6,224
8863,2024-01-07 03:42:00,43,19,Brinquedo,5,62
8864,2024-01-07 03:43:00,90,179,Móvel,8,269
8865,2024-01-07 03:44:00,30,62,Vestuário,3,92
8866,2024-01-07 03:45:00,64,50,Alimento,1,114
8867,2024-01-07 03:46:00,88,76,Vestuário,8,164
8868,2024-01-07 03:47:00,64,124,Vestuário,9,188
8869,2024-01-07 03:48:00,99,110,Móvel,8,209
8870,2024-01-07 03:49:00,26,11,Eletrônico,1,37
8871,2024-01-07 03:50:00,113,59,Móvel,8,172
8872,2024-01-07 03:51:00,47,135,Móvel,2,182
8873,2024-01-07 03:52:00,69,73,Móvel,4,142
8874,2024-01-07 03:53:00,37,156,Vestuário,5,193
8875,2024-01-07 03:54:00,24,140,Alimento,5,164
8876,2024-01-07 03:55:00,56,14,Móvel,5,70
8877,2024-01-07 03:56:00,80,18,Vestuário,6,98
8878,2024-01-07 03:57:00,116,174,Alimento,4,290
8879,2024-01-07 03:58:00,107,166,Alimento,4,273
8880,2024-01-07 03:59:00,85,77,Brinquedo,6,162
8881,2024-01-07 04:00:00,53,60,Móvel,7,113
8882,2024-01-07 04:01:00,55,137,Brinquedo,1,192
8883,2024-01-07 04:02:00,113,153,Alimento,3,266
8884,2024-01-07 04:03:00,59,39,Alimento,6,98
8885,2024-01-07 04:04:00,48,37,Vestuário,9,85
8886,2024-01-07 04:05:00,53,126,Eletrônico,4,179
8887,2024-01-07 04:06:00,83,51,Móvel,1,134
8888,2024-01-07 04:07:00,56,112,Eletrônico,5,168
8889,2024-01-07 04:08:00,107,142,Eletrônico,5,249
8890,2024-01-07 04:09:00,25,153,Vestuário,4,178
8891,2024-01-07 04:10:00,21,28,Vestuário,6,49
8892,2024-01-07 04:11:00,115,168,Alimento,1,283
8893,2024-01-07 04:12:00,116,35,Móvel,6,151
8894,2024-01-07 04:13:00,41,57,Brinquedo,7,98
8895,2024-01-07 04:14:00,25,153,Eletrônico,6,178
8896,2024-01-07 04:15:00,51,113,Móvel,1,164
8897,2024-01-07 04:16:00,40,54,Eletrônico,7,94
8898,2024-01-07 04:17:00,13,134,Móvel,8,147
8899,2024-01-07 04:18:00,89,127,Brinquedo,7,216
8900,2024-01-07 04:19:00,52,163,Eletrônico,9,215
8901,2024-01-07 04:20:00,38,114,Eletrônico,4,152
8902,2024-01-07 04:21:00,54,92,Móvel,9,146
8903,2024-01-07 04:22:00,49,55,Móvel,2,104
8904,2024-01-07 04:23:00,103,116,Eletrônico,5,219
8905,2024-01-07 04:24:00,76,85,Alimento,3,161
8906,2024-01-07 04:25:00,11,19,Alimento,7,30
8907,2024-01-07 04:26:00,40,167,Eletrônico,5,207
8908,2024-01-07 04:27:00,94,70,Brinquedo,2,164
8909,2024-01-07 04:28:00,27,118,Eletrônico,4,145
8910,2024-01-07 04:29:00,35,23,Vestuário,2,58
8911,2024-01-07 04:30:00,15,99,Vestuário,3,114
8912,2024-01-07 04:31:00,106,136,Vestuário,9,242
8913,2024-01-07 04:32:00,30,97,Eletrônico,2,127
8914,2024-01-07 04:33:00,115,12,Alimento,3,127
8915,2024-01-07 04:34:00,10,134,Móvel,1,144
8916,2024-01-07 04:35:00,26,69,Alimento,3,95
8917,2024-01-07 04:36:00,72,52,Móvel,8,124
8918,2024-01-07 04:37:00,81,85,Vestuário,4,166
8919,2024-01-07 04:38:00,108,20,Vestuário,2,128
8920,2024-01-07 04:39:00,76,137,Alimento,7,213
8921,2024-01-07 04:40:00,58,155,Eletrônico,3,213
8922,2024-01-07 04:41:00,68,18,Vestuário,1,86
8923,2024-01-07 04:42:00,83,28,Vestuário,5,111
8924,2024-01-07 04:43:00,16,20,Eletrônico,9,36
8925,2024-01-07 04:44:00,41,86,Alimento,8,127
8926,2024-01-07 04:45:00,79,35,Eletrônico,4,114
8927,2024-01-07 04:46:00,119,74,Vestuário,3,193
8928,2024-01-07 04:47:00,65,153,Vestuário,9,218
8929,2024-01-07 04:48:00,100,89,Móvel,1,189
8930,2024-01-07 04:49:00,110,72,Alimento,7,182
8931,2024-01-07 04:50:00,114,143,Brinquedo,7,257
8932,2024-01-07 04:51:00,103,147,Vestuário,4,250
8933,2024-01-07 04:52:00,54,176,Brinquedo,4,230
8934,2024-01-07 04:53:00,88,102,Brinquedo,2,190
8935,2024-01-07 04:54:00,89,179,Brinquedo,3,268
8936,2024-01-07 04:55:00,21,67,Vestuário,6,88
8937,2024-01-07 04:56:00,73,23,Vestuário,4,96
8938,2024-01-07 04:57:00,15,68,Brinquedo,1,83
8939,2024-01-07 04:58:00,21,21,Vestuário,3,42
8940,2024-01-07 04:59:00,14,149,Eletrônico,5,163
8941,2024-01-07 05:00:00,54,139,Vestuário,3,193
8942,2024-01-07 05:01:00,59,115,Vestuário,5,174
8943,2024-01-07 05:02:00,99,145,Brinquedo,2,244
8944,2024-01-07 05:03:00,104,40,Alimento,6,144
8945,2024-01-07 05:04:00,96,122,Vestuário,5,218
8946,2024-01-07 05:05:00,112,48,Vestuário,8,160
8947,2024-01-07 05:06:00,73,74,Alimento,5,147
8948,2024-01-07 05:07:00,77,66,Móvel,5,143
8949,2024-01-07 05:08:00,108,20,Vestuário,8,128
8950,2024-01-07 05:09:00,88,62,Móvel,6,150
8951,2024-01-07 05:10:00,20,17,Brinquedo,6,37
8952,2024-01-07 05:11:00,58,151,Vestuário,3,209
8953,2024-01-07 05:12:00,101,151,Brinquedo,4,252
8954,2024-01-07 05:13:00,72,107,Brinquedo,5,179
8955,2024-01-07 05:14:00,45,142,Brinquedo,9,187
8956,2024-01-07 05:15:00,117,121,Móvel,8,238
8957,2024-01-07 05:16:00,114,156,Alimento,9,270
8958,2024-01-07 05:17:00,97,69,Alimento,5,166
8959,2024-01-07 05:18:00,57,34,Vestuário,6,91
8960,2024-01-07 05:19:00,34,173,Eletrônico,6,207
8961,2024-01-07 05:20:00,44,78,Vestuário,8,122
8962,2024-01-07 05:21:00,117,144,Eletrônico,7,261
8963,2024-01-07 05:22:00,81,136,Brinquedo,7,217
8964,2024-01-07 05:23:00,53,89,Vestuário,1,142
8965,2024-01-07 05:24:00,86,72,Vestuário,2,158
8966,2024-01-07 05:25:00,14,88,Brinquedo,4,102
8967,2024-01-07 05:26:00,65,98,Vestuário,2,163
8968,2024-01-07 05:27:00,43,45,Móvel,4,88
8969,2024-01-07 05:28:00,39,30,Eletrônico,3,69
8970,2024-01-07 05:29:00,39,166,Eletrônico,5,205
8971,2024-01-07 05:30:00,24,46,Alimento,5,70
8972,2024-01-07 05:31:00,114,164,Eletrônico,9,278
8973,2024-01-07 05:32:00,68,157,Alimento,4,225
8974,2024-01-07 05:33:00,77,121,Eletrônico,6,198
8975,2024-01-07 05:34:00,35,141,Brinquedo,6,176
8976,2024-01-07 05:35:00,73,172,Alimento,1,245
8977,2024-01-07 05:36:00,116,121,Vestuário,2,237
8978,2024-01-07 05:37:00,118,126,Eletrônico,8,244
8979,2024-01-07 05:38:00,119,20,Alimento,7,139
8980,2024-01-07 05:39:00,53,129,Brinquedo,6,182
8981,2024-01-07 05:40:00,18,148,Alimento,9,166
8982,2024-01-07 05:41:00,82,28,Brinquedo,1,110
8983,2024-01-07 05:42:00,58,162,Alimento,7,220
8984,2024-01-07 05:43:00,35,13,Vestuário,7,48
8985,2024-01-07 05:44:00,98,55,Eletrônico,4,153
8986,2024-01-07 05:45:00,82,147,Alimento,6,229
8987,2024-01-07 05:46:00,35,104,Móvel,6,139
8988,2024-01-07 05:47:00,29,44,Móvel,9,73
8989,2024-01-07 05:48:00,68,79,Móvel,6,147
8990,2024-01-07 05:49:00,30,82,Móvel,2,112
8991,2024-01-07 05:50:00,54,147,Eletrônico,5,201
8992,2024-01-07 05:51:00,57,132,Móvel,9,189
8993,2024-01-07 05:52:00,69,32,Alimento,7,101
8994,2024-01-07 05:53:00,38,143,Alimento,9,181
8995,2024-01-07 05:54:00,116,60,Eletrônico,5,176
8996,2024-01-07 05:55:00,68,114,Alimento,6,182
8997,2024-01-07 05:56:00,68,64,Alimento,8,132
8998,2024-01-07 05:57:00,36,114,Brinquedo,9,150
8999,2024-01-07 05:58:00,35,97,Eletrônico,7,132
9000,2024-01-07 05:59:00,66,87,Alimento,1,153
9001,2024-01-07 06:00:00,22,55,Eletrônico,3,77
9002,2024-01-07 06:01:00,105,167,Eletrônico,8,272
9003,2024-01-07 06:02:00,69,131,Vestuário,7,200
9004,2024-01-07 06:03:00,89,171,Brinquedo,3,260
9005,2024-01-07 06:04:00,18,100,Alimento,5,118
9006,2024-01-07 06:05:00,70,44,Alimento,5,114
9007,2024-01-07 06:06:00,40,179,Eletrônico,2,219
9008,2024-01-07 06:07:00,44,39,Brinquedo,7,83
9009,2024-01-07 06:08:00,81,43,Vestuário,3,124
9010,2024-01-07 06:09:00,67,142,Móvel,7,209
9011,2024-01-07 06:10:00,96,79,Eletrônico,5,175
9012,2024-01-07 06:11:00,119,146,Brinquedo,4,265
9013,2024-01-07 06:12:00,74,176,Móvel,3,250
9014,2024-01-07 06:13:00,12,142,Brinquedo,2,154
9015,2024-01-07 06:14:00,29,179,Vestuário,9,208
9016,2024-01-07 06:15:00,83,10,Eletrônico,4,93
9017,2024-01-07 06:16:00,50,114,Eletrônico,3,164
9018,2024-01-07 06:17:00,15,47,Móvel,3,62
9019,2024-01-07 06:18:00,50,116,Alimento,2,166
9020,2024-01-07 06:19:00,43,122,Eletrônico,6,165
9021,2024-01-07 06:20:00,18,121,Brinquedo,5,139
9022,2024-01-07 06:21:00,79,15,Brinquedo,3,94
9023,2024-01-07 06:22:00,52,33,Alimento,6,85
9024,2024-01-07 06:23:00,87,119,Alimento,4,206
9025,2024-01-07 06:24:00,41,60,Vestuário,1,101
9026,2024-01-07 06:25:00,101,156,Alimento,1,257
9027,2024-01-07 06:26:00,28,141,Móvel,4,169
9028,2024-01-07 06:27:00,78,39,Móvel,6,117
9029,2024-01-07 06:28:00,95,52,Eletrônico,3,147
9030,2024-01-07 06:29:00,101,63,Brinquedo,9,164
9031,2024-01-07 06:30:00,32,86,Eletrônico,3,118
9032,2024-01-07 06:31:00,74,25,Brinquedo,5,99
9033,2024-01-07 06:32:00,53,81,Eletrônico,1,134
9034,2024-01-07 06:33:00,11,143,Móvel,5,154
9035,2024-01-07 06:34:00,105,110,Alimento,4,215
9036,2024-01-07 06:35:00,100,72,Eletrônico,1,172
9037,2024-01-07 06:36:00,71,150,Eletrônico,9,221
9038,2024-01-07 06:37:00,99,135,Eletrônico,8,234
9039,2024-01-07 06:38:00,25,46,Brinquedo,5,71
9040,2024-01-07 06:39:00,116,33,Brinquedo,2,149
9041,2024-01-07 06:40:00,39,177,Eletrônico,5,216
9042,2024-01-07 06:41:00,77,174,Alimento,5,251
9043,2024-01-07 06:42:00,91,171,Vestuário,8,262
9044,2024-01-07 06:43:00,18,158,Eletrônico,9,176
9045,2024-01-07 06:44:00,19,126,Brinquedo,2,145
9046,2024-01-07 06:45:00,109,12,Brinquedo,4,121
9047,2024-01-07 06:46:00,26,65,Móvel,7,91
9048,2024-01-07 06:47:00,73,51,Eletrônico,8,124
9049,2024-01-07 06:48:00,71,72,Móvel,8,143
9050,2024-01-07 06:49:00,99,45,Brinquedo,8,144
9051,2024-01-07 06:50:00,51,38,Alimento,4,89
9052,2024-01-07 06:51:00,12,27,Vestuário,7,39
9053,2024-01-07 06:52:00,46,107,Vestuário,6,153
9054,2024-01-07 06:53:00,112,14,Eletrônico,2,126
9055,2024-01-07 06:54:00,55,36,Vestuário,8,91
9056,2024-01-07 06:55:00,31,40,Eletrônico,9,71
9057,2024-01-07 06:56:00,24,146,Eletrônico,7,170
9058,2024-01-07 06:57:00,24,69,Alimento,5,93
9059,2024-01-07 06:58:00,21,86,Brinquedo,3,107
9060,2024-01-07 06:59:00,97,36,Vestuário,8,133
9061,2024-01-07 07:00:00,11,44,Eletrônico,8,55
9062,2024-01-07 07:01:00,111,141,Brinquedo,2,252
9063,2024-01-07 07:02:00,22,19,Vestuário,3,41
9064,2024-01-07 07:03:00,81,82,Vestuário,4,163
9065,2024-01-07 07:04:00,95,33,Alimento,9,128
9066,2024-01-07 07:05:00,13,123,Móvel,2,136
9067,2024-01-07 07:06:00,10,173,Móvel,7,183
9068,2024-01-07 07:07:00,70,22,Eletrônico,8,92
9069,2024-01-07 07:08:00,115,94,Móvel,7,209
9070,2024-01-07 07:09:00,63,43,Eletrônico,7,106
9071,2024-01-07 07:10:00,94,96,Móvel,1,190
9072,2024-01-07 07:11:00,49,88,Móvel,8,137
9073,2024-01-07 07:12:00,59,93,Móvel,2,152
9074,2024-01-07 07:13:00,77,29,Vestuário,3,106
9075,2024-01-07 07:14:00,22,25,Alimento,3,47
9076,2024-01-07 07:15:00,67,162,Vestuário,8,229
9077,2024-01-07 07:16:00,43,82,Alimento,7,125
9078,2024-01-07 07:17:00,103,77,Eletrônico,7,180
9079,2024-01-07 07:18:00,76,172,Móvel,7,248
9080,2024-01-07 07:19:00,27,169,Brinquedo,1,196
9081,2024-01-07 07:20:00,100,142,Brinquedo,7,242
9082,2024-01-07 07:21:00,16,157,Móvel,2,173
9083,2024-01-07 07:22:00,41,60,Alimento,8,101
9084,2024-01-07 07:23:00,92,21,Vestuário,4,113
9085,2024-01-07 07:24:00,49,62,Brinquedo,1,111
9086,2024-01-07 07:25:00,117,176,Brinquedo,6,293
9087,2024-01-07 07:26:00,119,148,Brinquedo,2,267
9088,2024-01-07 07:27:00,61,136,Eletrônico,3,197
9089,2024-01-07 07:28:00,20,130,Alimento,7,150
9090,2024-01-07 07:29:00,35,90,Brinquedo,9,125
9091,2024-01-07 07:30:00,40,13,Vestuário,9,53
9092,2024-01-07 07:31:00,74,119,Vestuário,4,193
9093,2024-01-07 07:32:00,113,16,Eletrônico,4,129
9094,2024-01-07 07:33:00,112,94,Alimento,1,206
9095,2024-01-07 07:34:00,42,110,Vestuário,8,152
9096,2024-01-07 07:35:00,114,58,Eletrônico,6,172
9097,2024-01-07 07:36:00,22,19,Móvel,7,41
9098,2024-01-07 07:37:00,54,103,Vestuário,1,157
9099,2024-01-07 07:38:00,68,90,Eletrônico,3,158
9100,2024-01-07 07:39:00,110,11,Móvel,9,121
9101,2024-01-07 07:40:00,27,25,Móvel,8,52
9102,2024-01-07 07:41:00,77,86,Móvel,3,163
9103,2024-01-07 07:42:00,45,128,Brinquedo,7,173
9104,2024-01-07 07:43:00,33,105,Vestuário,2,138
9105,2024-01-07 07:44:00,88,126,Vestuário,8,214
9106,2024-01-07 07:45:00,94,38,Eletrônico,9,132
9107,2024-01-07 07:46:00,21,28,Brinquedo,2,49
9108,2024-01-07 07:47:00,84,90,Móvel,1,174
9109,2024-01-07 07:48:00,52,65,Móvel,9,117
9110,2024-01-07 07:49:00,118,47,Eletrônico,7,165
9111,2024-01-07 07:50:00,105,20,Móvel,9,125
9112,2024-01-07 07:51:00,68,103,Brinquedo,6,171
9113,2024-01-07 07:52:00,13,17,Alimento,7,30
9114,2024-01-07 07:53:00,97,47,Vestuário,1,144
9115,2024-01-07 07:54:00,70,91,Brinquedo,5,161
9116,2024-01-07 07:55:00,32,177,Eletrônico,2,209
9117,2024-01-07 07:56:00,32,98,Vestuário,9,130
9118,2024-01-07 07:57:00,107,57,Vestuário,6,164
9119,2024-01-07 07:58:00,73,84,Eletrônico,9,157
9120,2024-01-07 07:59:00,75,15,Móvel,9,90
9121,2024-01-07 08:00:00,50,158,Alimento,2,208
9122,2024-01-07 08:01:00,73,103,Vestuário,3,176
9123,2024-01-07 08:02:00,104,176,Vestuário,1,280
9124,2024-01-07 08:03:00,99,14,Eletrônico,8,113
9125,2024-01-07 08:04:00,65,27,Alimento,8,92
9126,2024-01-07 08:05:00,40,144,Alimento,7,184
9127,2024-01-07 08:06:00,36,44,Eletrônico,3,80
9128,2024-01-07 08:07:00,16,48,Móvel,1,64
9129,2024-01-07 08:08:00,44,73,Móvel,2,117
9130,2024-01-07 08:09:00,29,70,Vestuário,4,99
9131,2024-01-07 08:10:00,90,83,Alimento,6,173
9132,2024-01-07 08:11:00,82,22,Brinquedo,3,104
9133,2024-01-07 08:12:00,59,59,Alimento,5,118
9134,2024-01-07 08:13:00,100,37,Alimento,6,137
9135,2024-01-07 08:14:00,64,142,Alimento,7,206
9136,2024-01-07 08:15:00,17,38,Eletrônico,7,55
9137,2024-01-07 08:16:00,17,107,Eletrônico,1,124
9138,2024-01-07 08:17:00,47,127,Eletrônico,8,174
9139,2024-01-07 08:18:00,105,167,Alimento,8,272
9140,2024-01-07 08:19:00,29,72,Móvel,4,101
9141,2024-01-07 08:20:00,12,162,Alimento,7,174
9142,2024-01-07 08:21:00,43,92,Eletrônico,4,135
9143,2024-01-07 08:22:00,36,75,Móvel,6,111
9144,2024-01-07 08:23:00,80,28,Alimento,2,108
9145,2024-01-07 08:24:00,64,69,Eletrônico,9,133
9146,2024-01-07 08:25:00,61,117,Alimento,1,178
9147,2024-01-07 08:26:00,61,179,Móvel,3,240
9148,2024-01-07 08:27:00,90,70,Móvel,8,160
9149,2024-01-07 08:28:00,18,156,Eletrônico,5,174
9150,2024-01-07 08:29:00,15,69,Móvel,6,84
9151,2024-01-07 08:30:00,108,66,Vestuário,8,174
9152,2024-01-07 08:31:00,80,116,Eletrônico,9,196
9153,2024-01-07 08:32:00,70,175,Alimento,3,245
9154,2024-01-07 08:33:00,89,103,Móvel,9,192
9155,2024-01-07 08:34:00,118,21,Brinquedo,9,139
9156,2024-01-07 08:35:00,12,31,Eletrônico,3,43
9157,2024-01-07 08:36:00,109,160,Móvel,9,269
9158,2024-01-07 08:37:00,33,85,Eletrônico,3,118
9159,2024-01-07 08:38:00,108,114,Vestuário,4,222
9160,2024-01-07 08:39:00,110,138,Móvel,5,248
9161,2024-01-07 08:40:00,71,30,Brinquedo,6,101
9162,2024-01-07 08:41:00,28,50,Móvel,2,78
9163,2024-01-07 08:42:00,66,81,Brinquedo,2,147
9164,2024-01-07 08:43:00,101,25,Eletrônico,7,126
9165,2024-01-07 08:44:00,36,13,Alimento,2,49
9166,2024-01-07 08:45:00,86,159,Móvel,5,245
9167,2024-01-07 08:46:00,99,66,Brinquedo,4,165
9168,2024-01-07 08:47:00,101,137,Brinquedo,3,238
9169,2024-01-07 08:48:00,41,66,Vestuário,1,107
9170,2024-01-07 08:49:00,96,78,Eletrônico,8,174
9171,2024-01-07 08:50:00,84,23,Móvel,4,107
9172,2024-01-07 08:51:00,77,77,Eletrônico,2,154
9173,2024-01-07 08:52:00,113,57,Alimento,9,170
9174,2024-01-07 08:53:00,21,55,Alimento,9,76
9175,2024-01-07 08:54:00,57,116,Brinquedo,1,173
9176,2024-01-07 08:55:00,41,15,Vestuário,9,56
9177,2024-01-07 08:56:00,84,110,Brinquedo,3,194
9178,2024-01-07 08:57:00,44,70,Móvel,8,114
9179,2024-01-07 08:58:00,82,153,Eletrônico,3,235
9180,2024-01-07 08:59:00,77,30,Móvel,7,107
9181,2024-01-07 09:00:00,97,57,Alimento,9,154
9182,2024-01-07 09:01:00,67,175,Vestuário,5,242
9183,2024-01-07 09:02:00,52,169,Brinquedo,4,221
9184,2024-01-07 09:03:00,107,53,Eletrônico,3,160
9185,2024-01-07 09:04:00,88,136,Alimento,3,224
9186,2024-01-07 09:05:00,113,114,Eletrônico,9,227
9187,2024-01-07 09:06:00,32,166,Alimento,2,198
9188,2024-01-07 09:07:00,57,124,Alimento,1,181
9189,2024-01-07 09:08:00,37,102,Brinquedo,1,139
9190,2024-01-07 09:09:00,62,45,Móvel,3,107
9191,2024-01-07 09:10:00,33,169,Eletrônico,3,202
9192,2024-01-07 09:11:00,57,71,Vestuário,2,128
9193,2024-01-07 09:12:00,74,90,Alimento,8,164
9194,2024-01-07 09:13:00,93,44,Alimento,8,137
9195,2024-01-07 09:14:00,49,150,Alimento,2,199
9196,2024-01-07 09:15:00,43,118,Vestuário,5,161
9197,2024-01-07 09:16:00,55,15,Móvel,7,70
9198,2024-01-07 09:17:00,39,161,Alimento,7,200
9199,2024-01-07 09:18:00,115,139,Eletrônico,4,254
9200,2024-01-07 09:19:00,89,140,Alimento,9,229
9201,2024-01-07 09:20:00,43,40,Eletrônico,3,83
9202,2024-01-07 09:21:00,70,26,Vestuário,8,96
9203,2024-01-07 09:22:00,50,179,Alimento,7,229
9204,2024-01-07 09:23:00,99,106,Vestuário,7,205
9205,2024-01-07 09:24:00,57,150,Eletrônico,9,207
9206,2024-01-07 09:25:00,78,137,Brinquedo,2,215
9207,2024-01-07 09:26:00,67,23,Vestuário,5,90
9208,2024-01-07 09:27:00,40,36,Vestuário,8,76
9209,2024-01-07 09:28:00,61,175,Vestuário,6,236
9210,2024-01-07 09:29:00,89,104,Móvel,5,193
9211,2024-01-07 09:30:00,39,175,Móvel,3,214
9212,2024-01-07 09:31:00,86,43,Eletrônico,7,129
9213,2024-01-07 09:32:00,47,110,Eletrônico,4,157
9214,2024-01-07 09:33:00,37,67,Brinquedo,4,104
9215,2024-01-07 09:34:00,107,20,Alimento,8,127
9216,2024-01-07 09:35:00,80,169,Vestuário,5,249
9217,2024-01-07 09:36:00,91,142,Alimento,6,233
9218,2024-01-07 09:37:00,57,27,Vestuário,5,84
9219,2024-01-07 09:38:00,94,111,Vestuário,3,205
9220,2024-01-07 09:39:00,38,19,Alimento,7,57
9221,2024-01-07 09:40:00,113,157,Alimento,1,270
9222,2024-01-07 09:41:00,70,67,Alimento,4,137
9223,2024-01-07 09:42:00,62,160,Vestuário,1,222
9224,2024-01-07 09:43:00,16,97,Eletrônico,4,113
9225,2024-01-07 09:44:00,53,56,Móvel,2,109
9226,2024-01-07 09:45:00,41,132,Brinquedo,9,173
9227,2024-01-07 09:46:00,10,171,Eletrônico,1,181
9228,2024-01-07 09:47:00,94,15,Móvel,4,109
9229,2024-01-07 09:48:00,56,39,Brinquedo,1,95
9230,2024-01-07 09:49:00,112,81,Vestuário,6,193
9231,2024-01-07 09:50:00,61,122,Vestuário,1,183
9232,2024-01-07 09:51:00,107,29,Móvel,8,136
9233,2024-01-07 09:52:00,18,131,Móvel,8,149
9234,2024-01-07 09:53:00,82,67,Vestuário,6,149
9235,2024-01-07 09:54:00,46,120,Eletrônico,2,166
9236,2024-01-07 09:55:00,41,154,Alimento,1,195
9237,2024-01-07 09:56:00,119,120,Vestuário,7,239
9238,2024-01-07 09:57:00,36,38,Eletrônico,8,74
9239,2024-01-07 09:58:00,59,165,Brinquedo,2,224
9240,2024-01-07 09:59:00,52,178,Eletrônico,8,230
9241,2024-01-07 10:00:00,69,68,Móvel,1,137
9242,2024-01-07 10:01:00,82,82,Eletrônico,9,164
9243,2024-01-07 10:02:00,16,44,Vestuário,9,60
9244,2024-01-07 10:03:00,23,63,Brinquedo,3,86
9245,2024-01-07 10:04:00,35,47,Móvel,2,82
9246,2024-01-07 10:05:00,54,101,Alimento,4,155
9247,2024-01-07 10:06:00,59,83,Brinquedo,7,142
9248,2024-01-07 10:07:00,94,90,Vestuário,8,184
9249,2024-01-07 10:08:00,100,170,Vestuário,6,270
9250,2024-01-07 10:09:00,117,60,Eletrônico,1,177
9251,2024-01-07 10:10:00,13,103,Móvel,1,116
9252,2024-01-07 10:11:00,118,54,Eletrônico,5,172
9253,2024-01-07 10:12:00,71,80,Eletrônico,9,151
9254,2024-01-07 10:13:00,94,21,Brinquedo,1,115
9255,2024-01-07 10:14:00,101,23,Eletrônico,2,124
9256,2024-01-07 10:15:00,37,84,Alimento,6,121
9257,2024-01-07 10:16:00,116,55,Brinquedo,2,171
9258,2024-01-07 10:17:00,62,65,Vestuário,9,127
9259,2024-01-07 10:18:00,66,18,Brinquedo,6,84
9260,2024-01-07 10:19:00,80,98,Móvel,8,178
9261,2024-01-07 10:20:00,80,21,Vestuário,4,101
9262,2024-01-07 10:21:00,32,93,Eletrônico,9,125
9263,2024-01-07 10:22:00,29,131,Vestuário,2,160
9264,2024-01-07 10:23:00,28,43,Móvel,2,71
9265,2024-01-07 10:24:00,37,80,Alimento,2,117
9266,2024-01-07 10:25:00,19,160,Eletrônico,7,179
9267,2024-01-07 10:26:00,117,78,Eletrônico,5,195
9268,2024-01-07 10:27:00,114,89,Vestuário,2,203
9269,2024-01-07 10:28:00,24,157,Eletrônico,5,181
9270,2024-01-07 10:29:00,59,178,Brinquedo,3,237
9271,2024-01-07 10:30:00,28,167,Eletrônico,7,195
9272,2024-01-07 10:31:00,119,22,Móvel,8,141
9273,2024-01-07 10:32:00,75,117,Vestuário,6,192
9274,2024-01-07 10:33:00,99,131,Móvel,9,230
9275,2024-01-07 10:34:00,28,79,Vestuário,6,107
9276,2024-01-07 10:35:00,104,145,Móvel,3,249
9277,2024-01-07 10:36:00,30,17,Móvel,1,47
9278,2024-01-07 10:37:00,26,10,Vestuário,7,36
9279,2024-01-07 10:38:00,49,67,Brinquedo,3,116
9280,2024-01-07 10:39:00,51,106,Móvel,1,157
9281,2024-01-07 10:40:00,114,12,Brinquedo,4,126
9282,2024-01-07 10:41:00,64,156,Brinquedo,6,220
9283,2024-01-07 10:42:00,19,145,Eletrônico,3,164
9284,2024-01-07 10:43:00,42,140,Alimento,4,182
9285,2024-01-07 10:44:00,22,111,Brinquedo,5,133
9286,2024-01-07 10:45:00,107,145,Eletrônico,4,252
9287,2024-01-07 10:46:00,114,156,Vestuário,2,270
9288,2024-01-07 10:47:00,51,96,Brinquedo,3,147
9289,2024-01-07 10:48:00,61,158,Eletrônico,1,219
9290,2024-01-07 10:49:00,22,75,Alimento,2,97
9291,2024-01-07 10:50:00,71,37,Eletrônico,6,108
9292,2024-01-07 10:51:00,96,100,Alimento,9,196
9293,2024-01-07 10:52:00,91,140,Eletrônico,2,231
9294,2024-01-07 10:53:00,22,75,Alimento,3,97
9295,2024-01-07 10:54:00,14,90,Alimento,4,104
9296,2024-01-07 10:55:00,59,93,Eletrônico,8,152
9297,2024-01-07 10:56:00,22,10,Alimento,7,32
9298,2024-01-07 10:57:00,74,74,Eletrônico,9,148
9299,2024-01-07 10:58:00,72,165,Vestuário,2,237
9300,2024-01-07 10:59:00,51,166,Móvel,7,217
9301,2024-01-07 11:00:00,97,49,Brinquedo,2,146
9302,2024-01-07 11:01:00,101,161,Alimento,2,262
9303,2024-01-07 11:02:00,68,173,Alimento,2,241
9304,2024-01-07 11:03:00,63,52,Alimento,5,115
9305,2024-01-07 11:04:00,81,29,Alimento,1,110
9306,2024-01-07 11:05:00,66,68,Móvel,3,134
9307,2024-01-07 11:06:00,79,84,Alimento,1,163
9308,2024-01-07 11:07:00,73,71,Eletrônico,2,144
9309,2024-01-07 11:08:00,77,29,Eletrônico,7,106
9310,2024-01-07 11:09:00,75,175,Vestuário,1,250
9311,2024-01-07 11:10:00,53,133,Eletrônico,9,186
9312,2024-01-07 11:11:00,16,119,Eletrônico,9,135
9313,2024-01-07 11:12:00,20,117,Alimento,3,137
9314,2024-01-07 11:13:00,16,134,Eletrônico,5,150
9315,2024-01-07 11:14:00,72,41,Vestuário,5,113
9316,2024-01-07 11:15:00,97,103,Alimento,4,200
9317,2024-01-07 11:16:00,60,159,Eletrônico,8,219
9318,2024-01-07 11:17:00,118,85,Eletrônico,7,203
9319,2024-01-07 11:18:00,83,132,Móvel,6,215
9320,2024-01-07 11:19:00,99,168,Vestuário,7,267
9321,2024-01-07 11:20:00,34,127,Eletrônico,5,161
9322,2024-01-07 11:21:00,104,28,Vestuário,9,132
9323,2024-01-07 11:22:00,93,31,Alimento,4,124
9324,2024-01-07 11:23:00,11,16,Vestuário,1,27
9325,2024-01-07 11:24:00,81,98,Eletrônico,3,179
9326,2024-01-07 11:25:00,74,71,Móvel,7,145
9327,2024-01-07 11:26:00,51,99,Brinquedo,2,150
9328,2024-01-07 11:27:00,100,140,Eletrônico,4,240
9329,2024-01-07 11:28:00,28,178,Vestuário,8,206
9330,2024-01-07 11:29:00,52,156,Brinquedo,4,208
9331,2024-01-07 11:30:00,87,106,Móvel,5,193
9332,2024-01-07 11:31:00,75,164,Brinquedo,4,239
9333,2024-01-07 11:32:00,26,111,Vestuário,1,137
9334,2024-01-07 11:33:00,106,117,Brinquedo,1,223
9335,2024-01-07 11:34:00,61,161,Alimento,6,222
9336,2024-01-07 11:35:00,81,82,Móvel,9,163
9337,2024-01-07 11:36:00,62,15,Móvel,4,77
9338,2024-01-07 11:37:00,119,106,Vestuário,3,225
9339,2024-01-07 11:38:00,42,114,Móvel,2,156
9340,2024-01-07 11:39:00,106,11,Alimento,2,117
9341,2024-01-07 11:40:00,77,78,Brinquedo,3,155
9342,2024-01-07 11:41:00,97,20,Eletrônico,6,117
9343,2024-01-07 11:42:00,10,107,Eletrônico,4,117
9344,2024-01-07 11:43:00,65,94,Brinquedo,1,159
9345,2024-01-07 11:44:00,64,104,Móvel,8,168
9346,2024-01-07 11:45:00,118,61,Eletrônico,3,179
9347,2024-01-07 11:46:00,46,178,Móvel,5,224
9348,2024-01-07 11:47:00,16,151,Vestuário,7,167
9349,2024-01-07 11:48:00,22,98,Móvel,2,120
9350,2024-01-07 11:49:00,12,88,Eletrônico,9,100
9351,2024-01-07 11:50:00,85,171,Vestuário,8,256
9352,2024-01-07 11:51:00,90,147,Alimento,5,237
9353,2024-01-07 11:52:00,95,29,Vestuário,4,124
9354,2024-01-07 11:53:00,94,39,Eletrônico,6,133
9355,2024-01-07 11:54:00,85,28,Alimento,1,113
9356,2024-01-07 11:55:00,19,14,Brinquedo,1,33
9357,2024-01-07 11:56:00,46,176,Alimento,9,222
9358,2024-01-07 11:57:00,73,153,Brinquedo,1,226
9359,2024-01-07 11:58:00,99,98,Móvel,2,197
9360,2024-01-07 11:59:00,10,134,Brinquedo,4,144
9361,2024-01-07 12:00:00,114,13,Alimento,7,127
9362,2024-01-07 12:01:00,62,42,Brinquedo,6,104
9363,2024-01-07 12:02:00,69,47,Móvel,6,116
9364,2024-01-07 12:03:00,18,36,Móvel,7,54
9365,2024-01-07 12:04:00,28,123,Brinquedo,9,151
9366,2024-01-07 12:05:00,76,135,Vestuário,6,211
9367,2024-01-07 12:06:00,102,11,Brinquedo,2,113
9368,2024-01-07 12:07:00,42,173,Vestuário,9,215
9369,2024-01-07 12:08:00,43,127,Brinquedo,1,170
9370,2024-01-07 12:09:00,40,138,Brinquedo,8,178
9371,2024-01-07 12:10:00,80,75,Eletrônico,3,155
9372,2024-01-07 12:11:00,116,112,Eletrônico,7,228
9373,2024-01-07 12:12:00,70,158,Vestuário,2,228
9374,2024-01-07 12:13:00,42,104,Alimento,1,146
9375,2024-01-07 12:14:00,48,119,Alimento,4,167
9376,2024-01-07 12:15:00,11,157,Vestuário,5,168
9377,2024-01-07 12:16:00,65,32,Vestuário,2,97
9378,2024-01-07 12:17:00,69,55,Eletrônico,8,124
9379,2024-01-07 12:18:00,33,143,Vestuário,9,176
9380,2024-01-07 12:19:00,73,36,Eletrônico,8,109
9381,2024-01-07 12:20:00,43,42,Alimento,7,85
9382,2024-01-07 12:21:00,111,86,Brinquedo,4,197
9383,2024-01-07 12:22:00,58,60,Alimento,8,118
9384,2024-01-07 12:23:00,61,139,Brinquedo,2,200
9385,2024-01-07 12:24:00,118,61,Vestuário,5,179
9386,2024-01-07 12:25:00,25,119,Eletrônico,8,144
9387,2024-01-07 12:26:00,36,146,Eletrônico,2,182
9388,2024-01-07 12:27:00,33,103,Brinquedo,7,136
9389,2024-01-07 12:28:00,113,42,Vestuário,8,155
9390,2024-01-07 12:29:00,83,60,Alimento,7,143
9391,2024-01-07 12:30:00,101,63,Eletrônico,3,164
9392,2024-01-07 12:31:00,47,83,Alimento,8,130
9393,2024-01-07 12:32:00,60,42,Eletrônico,6,102
9394,2024-01-07 12:33:00,95,60,Alimento,9,155
9395,2024-01-07 12:34:00,57,80,Alimento,1,137
9396,2024-01-07 12:35:00,116,29,Vestuário,8,145
9397,2024-01-07 12:36:00,71,24,Móvel,9,95
9398,2024-01-07 12:37:00,12,68,Vestuário,5,80
9399,2024-01-07 12:38:00,25,165,Eletrônico,6,190
9400,2024-01-07 12:39:00,100,33,Alimento,9,133
9401,2024-01-07 12:40:00,39,10,Móvel,8,49
9402,2024-01-07 12:41:00,104,35,Móvel,2,139
9403,2024-01-07 12:42:00,78,164,Móvel,9,242
9404,2024-01-07 12:43:00,98,44,Eletrônico,4,142
9405,2024-01-07 12:44:00,81,124,Brinquedo,2,205
9406,2024-01-07 12:45:00,81,57,Eletrônico,8,138
9407,2024-01-07 12:46:00,36,170,Alimento,1,206
9408,2024-01-07 12:47:00,80,115,Alimento,6,195
9409,2024-01-07 12:48:00,87,148,Eletrônico,5,235
9410,2024-01-07 12:49:00,27,136,Eletrônico,8,163
9411,2024-01-07 12:50:00,101,36,Eletrônico,7,137
9412,2024-01-07 12:51:00,17,173,Móvel,2,190
9413,2024-01-07 12:52:00,110,149,Alimento,7,259
9414,2024-01-07 12:53:00,56,122,Móvel,2,178
9415,2024-01-07 12:54:00,99,140,Brinquedo,2,239
9416,2024-01-07 12:55:00,91,121,Móvel,6,212
9417,2024-01-07 12:56:00,72,17,Brinquedo,7,89
9418,2024-01-07 12:57:00,115,46,Vestuário,5,161
9419,2024-01-07 12:58:00,84,179,Móvel,1,263
9420,2024-01-07 12:59:00,11,50,Eletrônico,8,61
9421,2024-01-07 13:00:00,62,143,Vestuário,8,205
9422,2024-01-07 13:01:00,17,25,Brinquedo,8,42
9423,2024-01-07 13:02:00,100,88,Alimento,9,188
9424,2024-01-07 13:03:00,22,50,Eletrônico,1,72
9425,2024-01-07 13:04:00,93,126,Móvel,1,219
9426,2024-01-07 13:05:00,58,148,Móvel,5,206
9427,2024-01-07 13:06:00,11,73,Móvel,2,84
9428,2024-01-07 13:07:00,82,87,Móvel,1,169
9429,2024-01-07 13:08:00,86,46,Móvel,7,132
9430,2024-01-07 13:09:00,17,97,Alimento,6,114
9431,2024-01-07 13:10:00,26,143,Eletrônico,2,169
9432,2024-01-07 13:11:00,70,14,Brinquedo,1,84
9433,2024-01-07 13:12:00,44,33,Móvel,7,77
9434,2024-01-07 13:13:00,103,134,Eletrônico,5,237
9435,2024-01-07 13:14:00,114,88,Vestuário,7,202
9436,2024-01-07 13:15:00,57,142,Eletrônico,3,199
9437,2024-01-07 13:16:00,56,134,Brinquedo,6,190
9438,2024-01-07 13:17:00,50,93,Móvel,5,143
9439,2024-01-07 13:18:00,72,38,Alimento,3,110
9440,2024-01-07 13:19:00,37,101,Brinquedo,3,138
9441,2024-01-07 13:20:00,67,78,Móvel,9,145
9442,2024-01-07 13:21:00,99,29,Brinquedo,2,128
9443,2024-01-07 13:22:00,102,81,Vestuário,3,183
9444,2024-01-07 13:23:00,40,129,Móvel,7,169
9445,2024-01-07 13:24:00,114,95,Brinquedo,1,209
9446,2024-01-07 13:25:00,117,173,Brinquedo,8,290
9447,2024-01-07 13:26:00,38,90,Móvel,5,128
9448,2024-01-07 13:27:00,91,47,Alimento,5,138
9449,2024-01-07 13:28:00,40,72,Alimento,7,112
9450,2024-01-07 13:29:00,99,74,Vestuário,4,173
9451,2024-01-07 13:30:00,15,139,Vestuário,9,154
9452,2024-01-07 13:31:00,31,69,Eletrônico,3,100
9453,2024-01-07 13:32:00,48,47,Vestuário,7,95
9454,2024-01-07 13:33:00,39,173,Brinquedo,5,212
9455,2024-01-07 13:34:00,84,51,Alimento,8,135
9456,2024-01-07 13:35:00,99,38,Móvel,7,137
9457,2024-01-07 13:36:00,87,20,Móvel,2,107
9458,2024-01-07 13:37:00,79,60,Móvel,4,139
9459,2024-01-07 13:38:00,67,114,Eletrônico,9,181
9460,2024-01-07 13:39:00,30,24,Brinquedo,6,54
9461,2024-01-07 13:40:00,87,82,Móvel,5,169
9462,2024-01-07 13:41:00,82,127,Alimento,6,209
9463,2024-01-07 13:42:00,110,97,Móvel,4,207
9464,2024-01-07 13:43:00,28,101,Móvel,2,129
9465,2024-01-07 13:44:00,14,75,Alimento,1,89
9466,2024-01-07 13:45:00,76,83,Alimento,4,159
9467,2024-01-07 13:46:00,29,83,Eletrônico,2,112
9468,2024-01-07 13:47:00,14,73,Vestuário,7,87
9469,2024-01-07 13:48:00,52,163,Vestuário,5,215
9470,2024-01-07 13:49:00,115,93,Móvel,8,208
9471,2024-01-07 13:50:00,43,92,Alimento,7,135
9472,2024-01-07 13:51:00,80,29,Eletrônico,8,109
9473,2024-01-07 13:52:00,20,60,Vestuário,2,80
9474,2024-01-07 13:53:00,75,136,Móvel,2,211
9475,2024-01-07 13:54:00,99,15,Móvel,3,114
9476,2024-01-07 13:55:00,90,152,Móvel,2,242
9477,2024-01-07 13:56:00,37,175,Alimento,2,212
9478,2024-01-07 13:57:00,109,53,Eletrônico,6,162
9479,2024-01-07 13:58:00,45,35,Vestuário,2,80
9480,2024-01-07 13:59:00,105,16,Alimento,3,121
9481,2024-01-07 14:00:00,37,150,Vestuário,4,187
9482,2024-01-07 14:01:00,105,37,Alimento,5,142
9483,2024-01-07 14:02:00,85,100,Vestuário,8,185
9484,2024-01-07 14:03:00,55,96,Brinquedo,1,151
9485,2024-01-07 14:04:00,21,26,Alimento,2,47
9486,2024-01-07 14:05:00,90,131,Eletrônico,4,221
9487,2024-01-07 14:06:00,88,97,Eletrônico,5,185
9488,2024-01-07 14:07:00,62,148,Alimento,5,210
9489,2024-01-07 14:08:00,30,49,Alimento,6,79
9490,2024-01-07 14:09:00,14,64,Eletrônico,7,78
9491,2024-01-07 14:10:00,88,121,Alimento,2,209
9492,2024-01-07 14:11:00,21,131,Brinquedo,7,152
9493,2024-01-07 14:12:00,103,85,Brinquedo,3,188
9494,2024-01-07 14:13:00,84,53,Brinquedo,6,137
9495,2024-01-07 14:14:00,68,137,Alimento,1,205
9496,2024-01-07 14:15:00,46,79,Móvel,7,125
9497,2024-01-07 14:16:00,22,67,Móvel,5,89
9498,2024-01-07 14:17:00,75,25,Alimento,2,100
9499,2024-01-07 14:18:00,99,135,Brinquedo,2,234
9500,2024-01-07 14:19:00,60,72,Eletrônico,3,132
9501,2024-01-07 14:20:00,15,137,Móvel,6,152
9502,2024-01-07 14:21:00,32,118,Eletrônico,6,150
9503,2024-01-07 14:22:00,107,118,Brinquedo,9,225
9504,2024-01-07 14:23:00,83,156,Brinquedo,3,239
9505,2024-01-07 14:24:00,73,160,Eletrônico,6,233
9506,2024-01-07 14:25:00,71,14,Vestuário,9,85
9507,2024-01-07 14:26:00,60,10,Alimento,8,70
9508,2024-01-07 14:27:00,118,34,Brinquedo,6,152
9509,2024-01-07 14:28:00,85,132,Eletrônico,1,217
9510,2024-01-07 14:29:00,41,116,Vestuário,7,157
9511,2024-01-07 14:30:00,19,97,Vestuário,4,116
9512,2024-01-07 14:31:00,83,81,Brinquedo,3,164
9513,2024-01-07 14:32:00,110,56,Vestuário,4,166
9514,2024-01-07 14:33:00,52,10,Vestuário,7,62
9515,2024-01-07 14:34:00,20,118,Alimento,9,138
9516,2024-01-07 14:35:00,69,107,Brinquedo,3,176
9517,2024-01-07 14:36:00,45,154,Móvel,8,199
9518,2024-01-07 14:37:00,85,167,Vestuário,1,252
9519,2024-01-07 14:38:00,31,124,Vestuário,1,155
9520,2024-01-07 14:39:00,81,75,Móvel,4,156
9521,2024-01-07 14:40:00,64,87,Alimento,4,151
9522,2024-01-07 14:41:00,118,167,Móvel,7,285
9523,2024-01-07 14:42:00,57,93,Eletrônico,9,150
9524,2024-01-07 14:43:00,17,40,Brinquedo,5,57
9525,2024-01-07 14:44:00,54,86,Brinquedo,1,140
9526,2024-01-07 14:45:00,33,17,Eletrônico,4,50
9527,2024-01-07 14:46:00,11,144,Móvel,6,155
9528,2024-01-07 14:47:00,81,168,Alimento,2,249
9529,2024-01-07 14:48:00,32,121,Alimento,7,153
9530,2024-01-07 14:49:00,42,51,Vestuário,2,93
9531,2024-01-07 14:50:00,44,171,Brinquedo,8,215
9532,2024-01-07 14:51:00,18,90,Móvel,7,108
9533,2024-01-07 14:52:00,61,31,Brinquedo,2,92
9534,2024-01-07 14:53:00,106,108,Brinquedo,1,214
9535,2024-01-07 14:54:00,14,99,Alimento,7,113
9536,2024-01-07 14:55:00,34,95,Brinquedo,9,129
9537,2024-01-07 14:56:00,96,129,Alimento,3,225
9538,2024-01-07 14:57:00,118,70,Móvel,7,188
9539,2024-01-07 14:58:00,113,159,Vestuário,8,272
9540,2024-01-07 14:59:00,87,37,Vestuário,3,124
9541,2024-01-07 15:00:00,33,159,Vestuário,5,192
9542,2024-01-07 15:01:00,17,96,Eletrônico,8,113
9543,2024-01-07 15:02:00,89,87,Brinquedo,5,176
9544,2024-01-07 15:03:00,10,93,Eletrônico,6,103
9545,2024-01-07 15:04:00,75,21,Alimento,1,96
9546,2024-01-07 15:05:00,71,40,Alimento,4,111
9547,2024-01-07 15:06:00,34,161,Brinquedo,3,195
9548,2024-01-07 15:07:00,63,179,Alimento,5,242
9549,2024-01-07 15:08:00,99,11,Eletrônico,2,110
9550,2024-01-07 15:09:00,37,18,Vestuário,4,55
9551,2024-01-07 15:10:00,55,100,Brinquedo,6,155
9552,2024-01-07 15:11:00,46,176,Vestuário,8,222
9553,2024-01-07 15:12:00,55,158,Alimento,6,213
9554,2024-01-07 15:13:00,115,140,Vestuário,3,255
9555,2024-01-07 15:14:00,59,165,Vestuário,1,224
9556,2024-01-07 15:15:00,116,129,Eletrônico,2,245
9557,2024-01-07 15:16:00,81,18,Brinquedo,2,99
9558,2024-01-07 15:17:00,57,61,Móvel,5,118
9559,2024-01-07 15:18:00,70,101,Eletrônico,9,171
9560,2024-01-07 15:19:00,59,103,Brinquedo,7,162
9561,2024-01-07 15:20:00,15,25,Móvel,2,40
9562,2024-01-07 15:21:00,45,85,Eletrônico,5,130
9563,2024-01-07 15:22:00,83,105,Brinquedo,7,188
9564,2024-01-07 15:23:00,46,176,Brinquedo,9,222
9565,2024-01-07 15:24:00,52,91,Vestuário,7,143
9566,2024-01-07 15:25:00,87,39,Brinquedo,6,126
9567,2024-01-07 15:26:00,58,82,Brinquedo,4,140
9568,2024-01-07 15:27:00,74,61,Vestuário,7,135
9569,2024-01-07 15:28:00,73,57,Vestuário,6,130
9570,2024-01-07 15:29:00,82,34,Móvel,5,116
9571,2024-01-07 15:30:00,78,164,Eletrônico,9,242
9572,2024-01-07 15:31:00,57,145,Móvel,1,202
9573,2024-01-07 15:32:00,10,139,Móvel,5,149
9574,2024-01-07 15:33:00,51,109,Eletrônico,8,160
9575,2024-01-07 15:34:00,33,98,Brinquedo,5,131
9576,2024-01-07 15:35:00,29,158,Alimento,5,187
9577,2024-01-07 15:36:00,87,66,Móvel,9,153
9578,2024-01-07 15:37:00,11,149,Vestuário,3,160
9579,2024-01-07 15:38:00,103,63,Brinquedo,7,166
9580,2024-01-07 15:39:00,114,83,Vestuário,7,197
9581,2024-01-07 15:40:00,36,110,Eletrônico,5,146
9582,2024-01-07 15:41:00,60,169,Móvel,1,229
9583,2024-01-07 15:42:00,99,115,Móvel,2,214
9584,2024-01-07 15:43:00,110,113,Brinquedo,1,223
9585,2024-01-07 15:44:00,37,35,Alimento,3,72
9586,2024-01-07 15:45:00,13,12,Alimento,2,25
9587,2024-01-07 15:46:00,98,177,Alimento,6,275
9588,2024-01-07 15:47:00,32,45,Móvel,2,77
9589,2024-01-07 15:48:00,40,155,Móvel,7,195
9590,2024-01-07 15:49:00,11,63,Vestuário,7,74
9591,2024-01-07 15:50:00,111,80,Eletrônico,6,191
9592,2024-01-07 15:51:00,78,55,Alimento,9,133
9593,2024-01-07 15:52:00,12,154,Brinquedo,1,166
9594,2024-01-07 15:53:00,108,145,Eletrônico,8,253
9595,2024-01-07 15:54:00,88,54,Eletrônico,4,142
9596,2024-01-07 15:55:00,67,165,Brinquedo,7,232
9597,2024-01-07 15:56:00,23,44,Brinquedo,2,67
9598,2024-01-07 15:57:00,15,163,Alimento,6,178
9599,2024-01-07 15:58:00,110,73,Alimento,5,183
9600,2024-01-07 15:59:00,114,57,Eletrônico,7,171
9601,2024-01-07 16:00:00,67,125,Móvel,9,192
9602,2024-01-07 16:01:00,35,89,Vestuário,8,124
9603,2024-01-07 16:02:00,46,83,Brinquedo,3,129
9604,2024-01-07 16:03:00,75,112,Móvel,6,187
9605,2024-01-07 16:04:00,81,37,Móvel,9,118
9606,2024-01-07 16:05:00,78,47,Alimento,2,125
9607,2024-01-07 16:06:00,38,159,Eletrônico,5,197
9608,2024-01-07 16:07:00,39,63,Móvel,8,102
9609,2024-01-07 16:08:00,98,12,Móvel,5,110
9610,2024-01-07 16:09:00,70,31,Vestuário,6,101
9611,2024-01-07 16:10:00,24,151,Eletrônico,3,175
9612,2024-01-07 16:11:00,109,177,Móvel,5,286
9613,2024-01-07 16:12:00,69,48,Eletrônico,9,117
9614,2024-01-07 16:13:00,59,20,Eletrônico,9,79
9615,2024-01-07 16:14:00,31,135,Alimento,9,166
9616,2024-01-07 16:15:00,65,10,Brinquedo,4,75
9617,2024-01-07 16:16:00,92,10,Alimento,9,102
9618,2024-01-07 16:17:00,12,125,Eletrônico,2,137
9619,2024-01-07 16:18:00,98,102,Vestuário,6,200
9620,2024-01-07 16:19:00,96,156,Brinquedo,5,252
9621,2024-01-07 16:20:00,119,136,Brinquedo,9,255
9622,2024-01-07 16:21:00,46,102,Alimento,6,148
9623,2024-01-07 16:22:00,102,137,Brinquedo,7,239
9624,2024-01-07 16:23:00,84,58,Brinquedo,4,142
9625,2024-01-07 16:24:00,15,42,Brinquedo,7,57
9626,2024-01-07 16:25:00,52,115,Eletrônico,1,167
9627,2024-01-07 16:26:00,59,153,Eletrônico,5,212
9628,2024-01-07 16:27:00,22,85,Vestuário,9,107
9629,2024-01-07 16:28:00,56,14,Brinquedo,8,70
9630,2024-01-07 16:29:00,37,87,Alimento,3,124
9631,2024-01-07 16:30:00,104,108,Eletrônico,9,212
9632,2024-01-07 16:31:00,59,160,Alimento,6,219
9633,2024-01-07 16:32:00,40,142,Móvel,3,182
9634,2024-01-07 16:33:00,38,38,Alimento,6,76
9635,2024-01-07 16:34:00,26,137,Eletrônico,8,163
9636,2024-01-07 16:35:00,75,17,Alimento,2,92
9637,2024-01-07 16:36:00,54,94,Eletrônico,7,148
9638,2024-01-07 16:37:00,89,69,Alimento,7,158
9639,2024-01-07 16:38:00,21,20,Vestuário,5,41
9640,2024-01-07 16:39:00,119,127,Brinquedo,8,246
9641,2024-01-07 16:40:00,97,129,Eletrônico,3,226
9642,2024-01-07 16:41:00,16,18,Brinquedo,2,34
9643,2024-01-07 16:42:00,35,60,Móvel,6,95
9644,2024-01-07 16:43:00,78,127,Brinquedo,1,205
9645,2024-01-07 16:44:00,91,19,Alimento,5,110
9646,2024-01-07 16:45:00,115,30,Brinquedo,2,145
9647,2024-01-07 16:46:00,35,76,Vestuário,1,111
9648,2024-01-07 16:47:00,118,68,Vestuário,8,186
9649,2024-01-07 16:48:00,48,14,Alimento,1,62
9650,2024-01-07 16:49:00,111,54,Vestuário,2,165
9651,2024-01-07 16:50:00,78,122,Alimento,3,200
9652,2024-01-07 16:51:00,80,173,Móvel,2,253
9653,2024-01-07 16:52:00,45,20,Eletrônico,2,65
9654,2024-01-07 16:53:00,107,12,Brinquedo,2,119
9655,2024-01-07 16:54:00,112,35,Eletrônico,8,147
9656,2024-01-07 16:55:00,70,11,Brinquedo,4,81
9657,2024-01-07 16:56:00,83,122,Móvel,3,205
9658,2024-01-07 16:57:00,115,29,Móvel,2,144
9659,2024-01-07 16:58:00,87,10,Eletrônico,7,97
9660,2024-01-07 16:59:00,69,172,Brinquedo,1,241
9661,2024-01-07 17:00:00,95,98,Vestuário,8,193
9662,2024-01-07 17:01:00,109,56,Alimento,3,165
9663,2024-01-07 17:02:00,11,145,Brinquedo,2,156
9664,2024-01-07 17:03:00,65,130,Alimento,6,195
9665,2024-01-07 17:04:00,32,127,Vestuário,2,159
9666,2024-01-07 17:05:00,50,40,Brinquedo,9,90
9667,2024-01-07 17:06:00,88,170,Brinquedo,9,258
9668,2024-01-07 17:07:00,101,105,Vestuário,6,206
9669,2024-01-07 17:08:00,35,11,Eletrônico,3,46
9670,2024-01-07 17:09:00,81,133,Vestuário,8,214
9671,2024-01-07 17:10:00,42,81,Eletrônico,5,123
9672,2024-01-07 17:11:00,36,160,Eletrônico,6,196
9673,2024-01-07 17:12:00,72,46,Eletrônico,5,118
9674,2024-01-07 17:13:00,42,124,Vestuário,4,166
9675,2024-01-07 17:14:00,49,133,Vestuário,5,182
9676,2024-01-07 17:15:00,33,154,Vestuário,3,187
9677,2024-01-07 17:16:00,96,127,Móvel,8,223
9678,2024-01-07 17:17:00,113,143,Alimento,3,256
9679,2024-01-07 17:18:00,93,116,Móvel,7,209
9680,2024-01-07 17:19:00,104,152,Alimento,4,256
9681,2024-01-07 17:20:00,61,71,Eletrônico,5,132
9682,2024-01-07 17:21:00,110,28,Eletrônico,5,138
9683,2024-01-07 17:22:00,20,48,Vestuário,7,68
9684,2024-01-07 17:23:00,11,119,Móvel,7,130
9685,2024-01-07 17:24:00,119,43,Eletrônico,2,162
9686,2024-01-07 17:25:00,16,55,Eletrônico,5,71
9687,2024-01-07 17:26:00,72,21,Móvel,6,93
9688,2024-01-07 17:27:00,44,152,Móvel,5,196
9689,2024-01-07 17:28:00,103,161,Eletrônico,8,264
9690,2024-01-07 17:29:00,95,26,Eletrônico,6,121
9691,2024-01-07 17:30:00,39,50,Eletrônico,2,89
9692,2024-01-07 17:31:00,110,41,Vestuário,9,151
9693,2024-01-07 17:32:00,103,148,Eletrônico,7,251
9694,2024-01-07 17:33:00,100,161,Alimento,1,261
9695,2024-01-07 17:34:00,12,130,Móvel,9,142
9696,2024-01-07 17:35:00,114,115,Vestuário,4,229
9697,2024-01-07 17:36:00,101,58,Vestuário,4,159
9698,2024-01-07 17:37:00,28,67,Brinquedo,5,95
9699,2024-01-07 17:38:00,77,89,Brinquedo,1,166
9700,2024-01-07 17:39:00,10,124,Eletrônico,7,134
9701,2024-01-07 17:40:00,21,126,Alimento,9,147
9702,2024-01-07 17:41:00,107,36,Brinquedo,6,143
9703,2024-01-07 17:42:00,81,72,Brinquedo,7,153
9704,2024-01-07 17:43:00,105,135,Eletrônico,9,240
9705,2024-01-07 17:44:00,94,93,Vestuário,4,187
9706,2024-01-07 17:45:00,42,131,Móvel,7,173
9707,2024-01-07 17:46:00,67,44,Alimento,2,111
9708,2024-01-07 17:47:00,101,116,Alimento,8,217
9709,2024-01-07 17:48:00,87,76,Móvel,1,163
9710,2024-01-07 17:49:00,24,88,Alimento,4,112
9711,2024-01-07 17:50:00,85,87,Brinquedo,3,172
9712,2024-01-07 17:51:00,58,82,Alimento,3,140
9713,2024-01-07 17:52:00,64,111,Brinquedo,1,175
9714,2024-01-07 17:53:00,44,69,Móvel,3,113
9715,2024-01-07 17:54:00,80,108,Eletrônico,5,188
9716,2024-01-07 17:55:00,28,97,Eletrônico,2,125
9717,2024-01-07 17:56:00,20,92,Vestuário,9,112
9718,2024-01-07 17:57:00,98,166,Móvel,9,264
9719,2024-01-07 17:58:00,42,126,Brinquedo,7,168
9720,2024-01-07 17:59:00,21,120,Brinquedo,3,141
9721,2024-01-07 18:00:00,49,105,Brinquedo,4,154
9722,2024-01-07 18:01:00,84,30,Eletrônico,4,114
9723,2024-01-07 18:02:00,76,93,Alimento,7,169
9724,2024-01-07 18:03:00,112,23,Vestuário,7,135
9725,2024-01-07 18:04:00,36,177,Brinquedo,6,213
9726,2024-01-07 18:05:00,90,23,Móvel,8,113
9727,2024-01-07 18:06:00,70,57,Vestuário,2,127
9728,2024-01-07 18:07:00,65,140,Brinquedo,7,205
9729,2024-01-07 18:08:00,15,16,Brinquedo,6,31
9730,2024-01-07 18:09:00,91,45,Vestuário,3,136
9731,2024-01-07 18:10:00,24,102,Eletrônico,4,126
9732,2024-01-07 18:11:00,46,175,Móvel,3,221
9733,2024-01-07 18:12:00,62,96,Alimento,1,158
9734,2024-01-07 18:13:00,33,107,Móvel,4,140
9735,2024-01-07 18:14:00,109,21,Brinquedo,4,130
9736,2024-01-07 18:15:00,56,148,Alimento,8,204
9737,2024-01-07 18:16:00,110,113,Brinquedo,9,223
9738,2024-01-07 18:17:00,37,54,Eletrônico,4,91
9739,2024-01-07 18:18:00,72,133,Brinquedo,8,205
9740,2024-01-07 18:19:00,43,140,Alimento,4,183
9741,2024-01-07 18:20:00,30,151,Brinquedo,4,181
9742,2024-01-07 18:21:00,51,91,Eletrônico,4,142
9743,2024-01-07 18:22:00,17,95,Móvel,8,112
9744,2024-01-07 18:23:00,113,15,Vestuário,5,128
9745,2024-01-07 18:24:00,39,107,Brinquedo,1,146
9746,2024-01-07 18:25:00,64,25,Eletrônico,2,89
9747,2024-01-07 18:26:00,47,94,Móvel,3,141
9748,2024-01-07 18:27:00,37,31,Vestuário,3,68
9749,2024-01-07 18:28:00,47,146,Brinquedo,3,193
9750,2024-01-07 18:29:00,79,127,Brinquedo,6,206
9751,2024-01-07 18:30:00,62,97,Alimento,3,159
9752,2024-01-07 18:31:00,80,58,Móvel,3,138
9753,2024-01-07 18:32:00,58,136,Vestuário,1,194
9754,2024-01-07 18:33:00,82,26,Alimento,8,108
9755,2024-01-07 18:34:00,80,24,Alimento,4,104
9756,2024-01-07 18:35:00,93,52,Brinquedo,3,145
9757,2024-01-07 18:36:00,51,99,Vestuário,8,150
9758,2024-01-07 18:37:00,35,138,Eletrônico,1,173
9759,2024-01-07 18:38:00,90,43,Vestuário,5,133
9760,2024-01-07 18:39:00,56,94,Eletrônico,5,150
9761,2024-01-07 18:40:00,11,44,Alimento,3,55
9762,2024-01-07 18:41:00,59,178,Vestuário,3,237
9763,2024-01-07 18:42:00,67,170,Eletrônico,1,237
9764,2024-01-07 18:43:00,52,78,Eletrônico,6,130
9765,2024-01-07 18:44:00,75,82,Vestuário,4,157
9766,2024-01-07 18:45:00,118,156,Eletrônico,6,274
9767,2024-01-07 18:46:00,55,136,Eletrônico,7,191
9768,2024-01-07 18:47:00,57,160,Vestuário,9,217
9769,2024-01-07 18:48:00,46,84,Brinquedo,7,130
9770,2024-01-07 18:49:00,106,72,Móvel,8,178
9771,2024-01-07 18:50:00,115,106,Brinquedo,1,221
9772,2024-01-07 18:51:00,34,118,Móvel,7,152
9773,2024-01-07 18:52:00,68,122,Móvel,7,190
9774,2024-01-07 18:53:00,60,58,Alimento,5,118
9775,2024-01-07 18:54:00,100,162,Eletrônico,4,262
9776,2024-01-07 18:55:00,39,145,Vestuário,9,184
9777,2024-01-07 18:56:00,104,14,Alimento,6,118
9778,2024-01-07 18:57:00,115,177,Brinquedo,8,292
9779,2024-01-07 18:58:00,102,61,Móvel,3,163
9780,2024-01-07 18:59:00,96,53,Eletrônico,4,149
9781,2024-01-07 19:00:00,104,152,Móvel,2,256
9782,2024-01-07 19:01:00,103,109,Móvel,8,212
9783,2024-01-07 19:02:00,59,57,Vestuário,3,116
9784,2024-01-07 19:03:00,114,98,Brinquedo,2,212
9785,2024-01-07 19:04:00,56,58,Eletrônico,7,114
9786,2024-01-07 19:05:00,57,79,Brinquedo,5,136
9787,2024-01-07 19:06:00,84,71,Vestuário,8,155
9788,2024-01-07 19:07:00,113,50,Eletrônico,6,163
9789,2024-01-07 19:08:00,87,32,Brinquedo,2,119
9790,2024-01-07 19:09:00,43,81,Brinquedo,6,124
9791,2024-01-07 19:10:00,53,55,Eletrônico,2,108
9792,2024-01-07 19:11:00,18,152,Alimento,6,170
9793,2024-01-07 19:12:00,114,44,Eletrônico,4,158
9794,2024-01-07 19:13:00,88,132,Eletrônico,7,220
9795,2024-01-07 19:14:00,112,117,Alimento,9,229
9796,2024-01-07 19:15:00,77,135,Brinquedo,2,212
9797,2024-01-07 19:16:00,85,76,Vestuário,4,161
9798,2024-01-07 19:17:00,115,26,Móvel,9,141
9799,2024-01-07 19:18:00,45,173,Móvel,5,218
9800,2024-01-07 19:19:00,60,34,Brinquedo,5,94
9801,2024-01-07 19:20:00,54,159,Eletrônico,5,213
9802,2024-01-07 19:21:00,36,137,Eletrônico,6,173
9803,2024-01-07 19:22:00,83,17,Vestuário,2,100
9804,2024-01-07 19:23:00,92,24,Alimento,3,116
9805,2024-01-07 19:24:00,57,153,Brinquedo,9,210
9806,2024-01-07 19:25:00,60,73,Alimento,8,133
9807,2024-01-07 19:26:00,33,81,Vestuário,8,114
9808,2024-01-07 19:27:00,58,73,Alimento,3,131
9809,2024-01-07 19:28:00,11,160,Móvel,6,171
9810,2024-01-07 19:29:00,82,45,Eletrônico,3,127
9811,2024-01-07 19:30:00,15,130,Eletrônico,6,145
9812,2024-01-07 19:31:00,46,89,Vestuário,9,135
9813,2024-01-07 19:32:00,101,134,Móvel,5,235
9814,2024-01-07 19:33:00,59,62,Brinquedo,5,121
9815,2024-01-07 19:34:00,49,107,Alimento,3,156
9816,2024-01-07 19:35:00,69,105,Brinquedo,4,174
9817,2024-01-07 19:36:00,36,62,Brinquedo,6,98
9818,2024-01-07 19:37:00,81,55,Vestuário,7,136
9819,2024-01-07 19:38:00,81,174,Alimento,2,255
9820,2024-01-07 19:39:00,47,111,Móvel,9,158
9821,2024-01-07 19:40:00,61,17,Alimento,7,78
9822,2024-01-07 19:41:00,65,59,Alimento,9,124
9823,2024-01-07 19:42:00,34,92,Alimento,6,126
9824,2024-01-07 19:43:00,97,16,Vestuário,7,113
9825,2024-01-07 19:44:00,116,33,Móvel,1,149
9826,2024-01-07 19:45:00,52,72,Brinquedo,1,124
9827,2024-01-07 19:46:00,106,93,Brinquedo,7,199
9828,2024-01-07 19:47:00,17,164,Móvel,9,181
9829,2024-01-07 19:48:00,48,38,Eletrônico,1,86
9830,2024-01-07 19:49:00,25,150,Eletrônico,2,175
9831,2024-01-07 19:50:00,119,78,Alimento,8,197
9832,2024-01-07 19:51:00,28,175,Vestuário,3,203
9833,2024-01-07 19:52:00,109,63,Vestuário,6,172
9834,2024-01-07 19:53:00,113,167,Eletrônico,2,280
9835,2024-01-07 19:54:00,56,100,Eletrônico,9,156
9836,2024-01-07 19:55:00,14,137,Eletrônico,3,151
9837,2024-01-07 19:56:00,26,18,Vestuário,8,44
9838,2024-01-07 19:57:00,72,37,Eletrônico,5,109
9839,2024-01-07 19:58:00,68,155,Eletrônico,2,223
9840,2024-01-07 19:59:00,106,41,Móvel,6,147
9841,2024-01-07 20:00:00,15,84,Alimento,6,99
9842,2024-01-07 20:01:00,11,86,Eletrônico,8,97
9843,2024-01-07 20:02:00,60,21,Móvel,8,81
9844,2024-01-07 20:03:00,67,15,Móvel,1,82
9845,2024-01-07 20:04:00,37,172,Móvel,2,209
9846,2024-01-07 20:05:00,26,62,Brinquedo,9,88
9847,2024-01-07 20:06:00,84,11,Brinquedo,3,95
9848,2024-01-07 20:07:00,33,59,Eletrônico,9,92
9849,2024-01-07 20:08:00,15,177,Vestuário,1,192
9850,2024-01-07 20:09:00,82,58,Móvel,9,140
9851,2024-01-07 20:10:00,22,61,Eletrônico,5,83
9852,2024-01-07 20:11:00,44,79,Vestuário,9,123
9853,2024-01-07 20:12:00,21,119,Brinquedo,9,140
9854,2024-01-07 20:13:00,118,140,Vestuário,3,258
9855,2024-01-07 20:14:00,119,147,Eletrônico,4,266
9856,2024-01-07 20:15:00,108,144,Móvel,4,252
9857,2024-01-07 20:16:00,118,79,Móvel,8,197
9858,2024-01-07 20:17:00,21,148,Móvel,6,169
9859,2024-01-07 20:18:00,47,153,Alimento,6,200
9860,2024-01-07 20:19:00,23,141,Vestuário,6,164
9861,2024-01-07 20:20:00,64,138,Móvel,7,202
9862,2024-01-07 20:21:00,37,171,Eletrônico,4,208
9863,2024-01-07 20:22:00,26,101,Móvel,2,127
9864,2024-01-07 20:23:00,71,92,Alimento,1,163
9865,2024-01-07 20:24:00,34,125,Brinquedo,1,159
9866,2024-01-07 20:25:00,110,165,Móvel,2,275
9867,2024-01-07 20:26:00,65,30,Brinquedo,5,95
9868,2024-01-07 20:27:00,103,27,Alimento,6,130
9869,2024-01-07 20:28:00,31,18,Eletrônico,5,49
9870,2024-01-07 20:29:00,75,127,Brinquedo,6,202
9871,2024-01-07 20:30:00,87,131,Vestuário,2,218
9872,2024-01-07 20:31:00,111,66,Alimento,3,177
9873,2024-01-07 20:32:00,32,135,Vestuário,4,167
9874,2024-01-07 20:33:00,78,129,Vestuário,6,207
9875,2024-01-07 20:34:00,51,97,Alimento,3,148
9876,2024-01-07 20:35:00,79,173,Brinquedo,7,252
9877,2024-01-07 20:36:00,13,147,Vestuário,3,160
9878,2024-01-07 20:37:00,89,136,Móvel,2,225
9879,2024-01-07 20:38:00,79,91,Brinquedo,4,170
9880,2024-01-07 20:39:00,57,93,Alimento,3,150
9881,2024-01-07 20:40:00,88,41,Brinquedo,5,129
9882,2024-01-07 20:41:00,40,111,Vestuário,6,151
9883,2024-01-07 20:42:00,109,116,Eletrônico,2,225
9884,2024-01-07 20:43:00,30,142,Brinquedo,3,172
9885,2024-01-07 20:44:00,68,96,Móvel,8,164
9886,2024-01-07 20:45:00,97,162,Móvel,7,259
9887,2024-01-07 20:46:00,88,50,Móvel,5,138
9888,2024-01-07 20:47:00,111,19,Brinquedo,7,130
9889,2024-01-07 20:48:00,118,141,Alimento,1,259
9890,2024-01-07 20:49:00,25,150,Vestuário,2,175
9891,2024-01-07 20:50:00,33,123,Eletrônico,7,156
9892,2024-01-07 20:51:00,41,145,Brinquedo,1,186
9893,2024-01-07 20:52:00,89,174,Brinquedo,1,263
9894,2024-01-07 20:53:00,101,14,Alimento,9,115
9895,2024-01-07 20:54:00,63,124,Brinquedo,7,187
9896,2024-01-07 20:55:00,55,108,Eletrônico,8,163
9897,2024-01-07 20:56:00,18,118,Vestuário,6,136
9898,2024-01-07 20:57:00,110,20,Móvel,6,130
9899,2024-01-07 20:58:00,13,146,Brinquedo,3,159
9900,2024-01-07 20:59:00,27,145,Eletrônico,6,172
9901,2024-01-07 21:00:00,82,23,Eletrônico,2,105
9902,2024-01-07 21:01:00,21,164,Eletrônico,3,185
9903,2024-01-07 21:02:00,114,138,Vestuário,2,252
9904,2024-01-07 21:03:00,15,139,Alimento,4,154
9905,2024-01-07 21:04:00,27,175,Móvel,6,202
9906,2024-01-07 21:05:00,61,62,Vestuário,5,123
9907,2024-01-07 21:06:00,21,14,Alimento,8,35
9908,2024-01-07 21:07:00,53,120,Eletrônico,6,173
9909,2024-01-07 21:08:00,41,62,Alimento,3,103
9910,2024-01-07 21:09:00,109,154,Vestuário,5,263
9911,2024-01-07 21:10:00,83,177,Alimento,2,260
9912,2024-01-07 21:11:00,32,128,Eletrônico,5,160
9913,2024-01-07 21:12:00,13,56,Vestuário,2,69
9914,2024-01-07 21:13:00,33,135,Vestuário,7,168
9915,2024-01-07 21:14:00,57,100,Móvel,4,157
9916,2024-01-07 21:15:00,100,88,Vestuário,1,188
9917,2024-01-07 21:16:00,20,116,Vestuário,8,136
9918,2024-01-07 21:17:00,81,71,Vestuário,6,152
9919,2024-01-07 21:18:00,49,77,Móvel,2,126
9920,2024-01-07 21:19:00,84,49,Móvel,2,133
9921,2024-01-07 21:20:00,76,42,Vestuário,8,118
9922,2024-01-07 21:21:00,96,142,Vestuário,3,238
9923,2024-01-07 21:22:00,63,91,Eletrônico,7,154
9924,2024-01-07 21:23:00,99,100,Móvel,7,199
9925,2024-01-07 21:24:00,12,126,Eletrônico,9,138
9926,2024-01-07 21:25:00,88,124,Vestuário,8,212
9927,2024-01-07 21:26:00,93,156,Vestuário,7,249
9928,2024-01-07 21:27:00,32,79,Móvel,9,111
9929,2024-01-07 21:28:00,114,169,Vestuário,3,283
9930,2024-01-07 21:29:00,58,93,Vestuário,6,151
9931,2024-01-07 21:30:00,116,58,Vestuário,2,174
9932,2024-01-07 21:31:00,112,117,Vestuário,6,229
9933,2024-01-07 21:32:00,77,48,Móvel,3,125
9934,2024-01-07 21:33:00,41,141,Vestuário,9,182
9935,2024-01-07 21:34:00,17,105,Alimento,2,122
9936,2024-01-07 21:35:00,62,109,Brinquedo,6,171
9937,2024-01-07 21:36:00,70,154,Brinquedo,2,224
9938,2024-01-07 21:37:00,27,16,Alimento,5,43
9939,2024-01-07 21:38:00,51,125,Vestuário,2,176
9940,2024-01-07 21:39:00,48,120,Eletrônico,4,168
9941,2024-01-07 21:40:00,57,24,Vestuário,2,81
9942,2024-01-07 21:41:00,36,142,Brinquedo,5,178
9943,2024-01-07 21:42:00,78,114,Brinquedo,3,192
9944,2024-01-07 21:43:00,104,113,Brinquedo,5,217
9945,2024-01-07 21:44:00,66,15,Brinquedo,4,81
9946,2024-01-07 21:45:00,46,51,Vestuário,3,97
9947,2024-01-07 21:46:00,116,135,Eletrônico,1,251
9948,2024-01-07 21:47:00,49,92,Eletrônico,2,141
9949,2024-01-07 21:48:00,94,167,Alimento,8,261
9950,2024-01-07 21:49:00,81,63,Eletrônico,4,144
9951,2024-01-07 21:50:00,14,108,Móvel,5,122
9952,2024-01-07 21:51:00,116,113,Brinquedo,5,229
9953,2024-01-07 21:52:00,103,50,Vestuário,5,153
9954,2024-01-07 21:53:00,24,166,Eletrônico,6,190
9955,2024-01-07 21:54:00,78,48,Móvel,4,126
9956,2024-01-07 21:55:00,26,145,Móvel,1,171
9957,2024-01-07 21:56:00,86,150,Eletrônico,4,236
9958,2024-01-07 21:57:00,51,178,Móvel,3,229
9959,2024-01-07 21:58:00,112,46,Eletrônico,6,158
9960,2024-01-07 21:59:00,17,73,Alimento,6,90
9961,2024-01-07 22:00:00,93,90,Vestuário,6,183
9962,2024-01-07 22:01:00,73,140,Vestuário,5,213
9963,2024-01-07 22:02:00,31,174,Alimento,2,205
9964,2024-01-07 22:03:00,106,33,Alimento,3,139
9965,2024-01-07 22:04:00,29,156,Brinquedo,8,185
9966,2024-01-07 22:05:00,54,172,Móvel,1,226
9967,2024-01-07 22:06:00,44,12,Eletrônico,6,56
9968,2024-01-07 22:07:00,45,136,Vestuário,1,181
9969,2024-01-07 22:08:00,99,158,Vestuário,6,257
9970,2024-01-07 22:09:00,114,42,Alimento,7,156
9971,2024-01-07 22:10:00,89,43,Vestuário,8,132
9972,2024-01-07 22:11:00,90,76,Vestuário,2,166
9973,2024-01-07 22:12:00,77,90,Móvel,5,167
9974,2024-01-07 22:13:00,32,87,Móvel,8,119
9975,2024-01-07 22:14:00,54,132,Eletrônico,1,186
9976,2024-01-07 22:15:00,75,92,Brinquedo,1,167
9977,2024-01-07 22:16:00,49,17,Brinquedo,9,66
9978,2024-01-07 22:17:00,107,159,Alimento,3,266
9979,2024-01-07 22:18:00,80,23,Vestuário,9,103
9980,2024-01-07 22:19:00,39,84,Vestuário,3,123
9981,2024-01-07 22:20:00,69,135,Eletrônico,1,204
9982,2024-01-07 22:21:00,107,101,Eletrônico,9,208
9983,2024-01-07 22:22:00,76,88,Vestuário,7,164
9984,2024-01-07 22:23:00,73,85,Alimento,2,158
9985,2024-01-07 22:24:00,117,79,Vestuário,9,196
9986,2024-01-07 22:25:00,102,25,Móvel,5,127
9987,2024-01-07 22:26:00,33,137,Brinquedo,7,170
9988,2024-01-07 22:27:00,20,95,Vestuário,8,115
9989,2024-01-07 22:28:00,92,85,Móvel,1,177
9990,2024-01-07 22:29:00,62,177,Eletrônico,9,239
9991,2024-01-07 22:30:00,60,102,Alimento,3,162
9992,2024-01-07 22:31:00,40,56,Eletrônico,5,96
9993,2024-01-07 22:32:00,94,131,Eletrônico,6,225
9994,2024-01-07 22:33:00,92,153,Brinquedo,7,245
9995,2024-01-07 22:34:00,17,52,Alimento,5,69
9996,2024-01-07 22:35:00,84,169,Alimento,9,253
9997,2024-01-07 22:36:00,63,124,Eletrônico,4,187
9998,2024-01-07 22:37:00,99,75,Brinquedo,9,174
9999,2024-01-07 22:38:00,114,145,Eletrônico,6,259
10000,2024-01-07 22:39:00,110,134,Vestuário,8,244
10001,2024-01-07 22:40:00,18,96,Vestuário,6,114
10002,2024-01-07 22:41:00,61,59,Vestuário,3,120
10003,2024-01-07 22:42:00,42,33,Móvel,8,75
10004,2024-01-07 22:43:00,102,92,Eletrônico,1,194
10005,2024-01-07 22:44:00,46,94,Alimento,6,140
10006,2024-01-07 22:45:00,90,84,Brinquedo,2,174
10007,2024-01-07 22:46:00,52,150,Vestuário,8,202
10008,2024-01-07 22:47:00,101,17,Vestuário,3,118
10009,2024-01-07 22:48:00,42,97,Eletrônico,3,139
10010,2024-01-07 22:49:00,16,122,Vestuário,8,138
10011,2024-01-07 22:50:00,78,146,Vestuário,6,224
10012,2024-01-07 22:51:00,59,22,Alimento,2,81
10013,2024-01-07 22:52:00,99,53,Brinquedo,1,152
10014,2024-01-07 22:53:00,65,54,Brinquedo,3,119
10015,2024-01-07 22:54:00,48,89,Vestuário,5,137
10016,2024-01-07 22:55:00,38,91,Eletrônico,4,129
10017,2024-01-07 22:56:00,13,169,Brinquedo,6,182
10018,2024-01-07 22:57:00,22,139,Eletrônico,9,161
10019,2024-01-07 22:58:00,35,94,Móvel,8,129
10020,2024-01-07 22:59:00,42,51,Alimento,1,93
10021,2024-01-07 23:00:00,50,60,Brinquedo,6,110
10022,2024-01-07 23:01:00,118,135,Móvel,7,253
10023,2024-01-07 23:02:00,44,135,Brinquedo,7,179
10024,2024-01-07 23:03:00,10,15,Vestuário,3,25
10025,2024-01-07 23:04:00,45,84,Vestuário,2,129
10026,2024-01-07 23:05:00,69,128,Móvel,9,197
10027,2024-01-07 23:06:00,10,167,Vestuário,6,177
10028,2024-01-07 23:07:00,103,170,Alimento,3,273
10029,2024-01-07 23:08:00,106,146,Eletrônico,7,252
10030,2024-01-07 23:09:00,18,20,Brinquedo,5,38
10031,2024-01-07 23:10:00,64,26,Alimento,7,90
10032,2024-01-07 23:11:00,39,171,Brinquedo,6,210
10033,2024-01-07 23:12:00,70,161,Móvel,8,231
10034,2024-01-07 23:13:00,94,95,Vestuário,1,189
10035,2024-01-07 23:14:00,101,72,Alimento,5,173
10036,2024-01-07 23:15:00,22,28,Eletrônico,8,50
10037,2024-01-07 23:16:00,115,102,Alimento,1,217
10038,2024-01-07 23:17:00,44,125,Vestuário,3,169
10039,2024-01-07 23:18:00,103,84,Móvel,8,187
10040,2024-01-07 23:19:00,93,152,Brinquedo,5,245
10041,2024-01-07 23:20:00,86,107,Brinquedo,5,193
10042,2024-01-07 23:21:00,44,109,Móvel,9,153
10043,2024-01-07 23:22:00,10,107,Móvel,5,117
10044,2024-01-07 23:23:00,55,164,Vestuário,9,219
10045,2024-01-07 23:24:00,76,15,Móvel,2,91
10046,2024-01-07 23:25:00,57,108,Alimento,1,165
10047,2024-01-07 23:26:00,110,11,Eletrônico,7,121
10048,2024-01-07 23:27:00,71,63,Vestuário,6,134
10049,2024-01-07 23:28:00,40,117,Brinquedo,2,157
10050,2024-01-07 23:29:00,68,76,Brinquedo,9,144
10051,2024-01-07 23:30:00,114,43,Eletrônico,2,157
10052,2024-01-07 23:31:00,95,166,Brinquedo,7,261
10053,2024-01-07 23:32:00,24,43,Alimento,1,67
10054,2024-01-07 23:33:00,28,152,Brinquedo,2,180
10055,2024-01-07 23:34:00,106,76,Eletrônico,7,182
10056,2024-01-07 23:35:00,32,79,Móvel,8,111
10057,2024-01-07 23:36:00,51,25,Brinquedo,2,76
10058,2024-01-07 23:37:00,102,151,Eletrônico,9,253
10059,2024-01-07 23:38:00,40,66,Vestuário,7,106
10060,2024-01-07 23:39:00,44,13,Eletrônico,2,57
10061,2024-01-07 23:40:00,65,160,Eletrônico,5,225
10062,2024-01-07 23:41:00,95,89,Alimento,8,184
10063,2024-01-07 23:42:00,59,143,Móvel,5,202
10064,2024-01-07 23:43:00,51,156,Alimento,1,207
10065,2024-01-07 23:44:00,110,107,Eletrônico,7,217
10066,2024-01-07 23:45:00,39,39,Brinquedo,6,78
10067,2024-01-07 23:46:00,43,101,Alimento,9,144
10068,2024-01-07 23:47:00,44,59,Brinquedo,6,103
10069,2024-01-07 23:48:00,53,46,Eletrônico,2,99
10070,2024-01-07 23:49:00,92,12,Vestuário,7,104
10071,2024-01-07 23:50:00,49,141,Vestuário,3,190
10072,2024-01-07 23:51:00,83,162,Eletrônico,6,245
10073,2024-01-07 23:52:00,99,104,Alimento,5,203
10074,2024-01-07 23:53:00,87,99,Brinquedo,7,186
10075,2024-01-07 23:54:00,46,91,Eletrônico,4,137
10076,2024-01-07 23:55:00,108,76,Alimento,2,184
10077,2024-01-07 23:56:00,107,26,Móvel,8,133
10078,2024-01-07 23:57:00,27,28,Eletrônico,2,55
10079,2024-01-07 23:58:00,36,74,Móvel,2,110
10080,2024-01-07 23:59:00,27,52,Móvel,8,79
10081,2024-01-08 00:00:00,105,51,Móvel,4,156
10082,2024-01-08 00:01:00,28,98,Brinquedo,3,126
10083,2024-01-08 00:02:00,111,12,Vestuário,8,123
10084,2024-01-08 00:03:00,86,16,Eletrônico,6,102
10085,2024-01-08 00:04:00,19,117,Eletrônico,4,136
10086,2024-01-08 00:05:00,104,70,Vestuário,1,174
10087,2024-01-08 00:06:00,37,126,Eletrônico,4,163
10088,2024-01-08 00:07:00,102,172,Móvel,8,274
10089,2024-01-08 00:08:00,88,160,Vestuário,8,248
10090,2024-01-08 00:09:00,20,167,Vestuário,4,187
10091,2024-01-08 00:10:00,90,16,Vestuário,4,106
10092,2024-01-08 00:11:00,58,138,Eletrônico,2,196
10093,2024-01-08 00:12:00,43,55,Eletrônico,1,98
10094,2024-01-08 00:13:00,85,128,Móvel,7,213
10095,2024-01-08 00:14:00,56,166,Alimento,1,222
10096,2024-01-08 00:15:00,75,19,Vestuário,5,94
10097,2024-01-08 00:16:00,40,11,Alimento,7,51
10098,2024-01-08 00:17:00,19,40,Vestuário,9,59
10099,2024-01-08 00:18:00,45,62,Vestuário,3,107
10100,2024-01-08 00:19:00,116,154,Brinquedo,7,270
10101,2024-01-08 00:20:00,95,174,Alimento,9,269
10102,2024-01-08 00:21:00,51,34,Móvel,7,85
10103,2024-01-08 00:22:00,26,75,Alimento,4,101
10104,2024-01-08 00:23:00,27,148,Alimento,6,175
10105,2024-01-08 00:24:00,101,145,Alimento,6,246
10106,2024-01-08 00:25:00,108,59,Eletrônico,4,167
10107,2024-01-08 00:26:00,18,103,Alimento,6,121
10108,2024-01-08 00:27:00,101,117,Brinquedo,2,218
10109,2024-01-08 00:28:00,99,22,Eletrônico,1,121
10110,2024-01-08 00:29:00,105,65,Brinquedo,7,170
10111,2024-01-08 00:30:00,69,65,Móvel,9,134
10112,2024-01-08 00:31:00,72,120,Móvel,3,192
10113,2024-01-08 00:32:00,36,103,Alimento,8,139
10114,2024-01-08 00:33:00,48,57,Móvel,1,105
10115,2024-01-08 00:34:00,94,48,Eletrônico,5,142
10116,2024-01-08 00:35:00,92,120,Vestuário,3,212
10117,2024-01-08 00:36:00,54,44,Brinquedo,5,98
10118,2024-01-08 00:37:00,50,154,Vestuário,1,204
10119,2024-01-08 00:38:00,92,144,Eletrônico,2,236
10120,2024-01-08 00:39:00,66,137,Móvel,7,203
10121,2024-01-08 00:40:00,32,66,Alimento,3,98
10122,2024-01-08 00:41:00,65,68,Alimento,8,133
10123,2024-01-08 00:42:00,89,79,Vestuário,7,168
10124,2024-01-08 00:43:00,37,84,Brinquedo,6,121
10125,2024-01-08 00:44:00,27,75,Vestuário,7,102
10126,2024-01-08 00:45:00,113,26,Brinquedo,7,139
10127,2024-01-08 00:46:00,80,59,Vestuário,7,139
10128,2024-01-08 00:47:00,64,103,Brinquedo,2,167
10129,2024-01-08 00:48:00,52,17,Brinquedo,3,69
10130,2024-01-08 00:49:00,104,101,Alimento,8,205
10131,2024-01-08 00:50:00,35,15,Brinquedo,5,50
10132,2024-01-08 00:51:00,77,128,Eletrônico,1,205
10133,2024-01-08 00:52:00,119,122,Vestuário,2,241
10134,2024-01-08 00:53:00,68,21,Brinquedo,1,89
10135,2024-01-08 00:54:00,51,150,Alimento,9,201
10136,2024-01-08 00:55:00,79,68,Brinquedo,7,147
10137,2024-01-08 00:56:00,40,114,Eletrônico,9,154
10138,2024-01-08 00:57:00,105,144,Vestuário,7,249
10139,2024-01-08 00:58:00,97,162,Brinquedo,9,259
10140,2024-01-08 00:59:00,91,167,Eletrônico,3,258
10141,2024-01-08 01:00:00,39,83,Brinquedo,9,122
10142,2024-01-08 01:01:00,48,54,Alimento,4,102
10143,2024-01-08 01:02:00,95,158,Alimento,3,253
10144,2024-01-08 01:03:00,21,78,Alimento,8,99
10145,2024-01-08 01:04:00,85,163,Brinquedo,6,248
10146,2024-01-08 01:05:00,21,87,Vestuário,6,108
10147,2024-01-08 01:06:00,58,68,Brinquedo,4,126
10148,2024-01-08 01:07:00,30,14,Vestuário,1,44
10149,2024-01-08 01:08:00,68,155,Móvel,4,223
10150,2024-01-08 01:09:00,87,167,Brinquedo,8,254
10151,2024-01-08 01:10:00,55,122,Móvel,9,177
10152,2024-01-08 01:11:00,68,59,Vestuário,3,127
10153,2024-01-08 01:12:00,114,95,Vestuário,7,209
10154,2024-01-08 01:13:00,118,69,Vestuário,9,187
10155,2024-01-08 01:14:00,49,77,Eletrônico,3,126
10156,2024-01-08 01:15:00,43,138,Móvel,7,181
10157,2024-01-08 01:16:00,33,165,Vestuário,1,198
10158,2024-01-08 01:17:00,116,176,Vestuário,3,292
10159,2024-01-08 01:18:00,22,43,Eletrônico,9,65
10160,2024-01-08 01:19:00,39,18,Vestuário,1,57
10161,2024-01-08 01:20:00,118,169,Eletrônico,1,287
10162,2024-01-08 01:21:00,65,154,Eletrônico,7,219
10163,2024-01-08 01:22:00,29,52,Brinquedo,7,81
10164,2024-01-08 01:23:00,95,149,Vestuário,8,244
10165,2024-01-08 01:24:00,59,155,Eletrônico,2,214
10166,2024-01-08 01:25:00,42,96,Brinquedo,2,138
10167,2024-01-08 01:26:00,72,145,Vestuário,4,217
10168,2024-01-08 01:27:00,65,104,Vestuário,7,169
10169,2024-01-08 01:28:00,99,147,Eletrônico,3,246
10170,2024-01-08 01:29:00,45,165,Brinquedo,9,210
10171,2024-01-08 01:30:00,100,100,Brinquedo,2,200
10172,2024-01-08 01:31:00,40,107,Eletrônico,7,147
10173,2024-01-08 01:32:00,111,147,Vestuário,2,258
10174,2024-01-08 01:33:00,61,41,Eletrônico,4,102
10175,2024-01-08 01:34:00,77,16,Alimento,1,93
10176,2024-01-08 01:35:00,108,110,Vestuário,4,218
10177,2024-01-08 01:36:00,54,110,Móvel,9,164
10178,2024-01-08 01:37:00,15,110,Vestuário,6,125
10179,2024-01-08 01:38:00,92,18,Vestuário,8,110
10180,2024-01-08 01:39:00,85,119,Brinquedo,3,204
10181,2024-01-08 01:40:00,45,56,Móvel,1,101
10182,2024-01-08 01:41:00,56,168,Brinquedo,6,224
10183,2024-01-08 01:42:00,27,50,Móvel,2,77
10184,2024-01-08 01:43:00,22,110,Vestuário,8,132
10185,2024-01-08 01:44:00,74,63,Eletrônico,7,137
10186,2024-01-08 01:45:00,56,38,Vestuário,5,94
10187,2024-01-08 01:46:00,42,135,Alimento,2,177
10188,2024-01-08 01:47:00,39,24,Eletrônico,8,63
10189,2024-01-08 01:48:00,107,41,Alimento,6,148
10190,2024-01-08 01:49:00,87,107,Vestuário,2,194
10191,2024-01-08 01:50:00,18,60,Alimento,6,78
10192,2024-01-08 01:51:00,14,161,Alimento,4,175
10193,2024-01-08 01:52:00,43,161,Eletrônico,3,204
10194,2024-01-08 01:53:00,24,119,Móvel,5,143
10195,2024-01-08 01:54:00,110,30,Móvel,8,140
10196,2024-01-08 01:55:00,102,23,Móvel,2,125
10197,2024-01-08 01:56:00,78,26,Brinquedo,8,104
10198,2024-01-08 01:57:00,33,39,Brinquedo,7,72
10199,2024-01-08 01:58:00,62,10,Móvel,3,72
10200,2024-01-08 01:59:00,79,92,Alimento,5,171
10201,2024-01-08 02:00:00,113,165,Vestuário,8,278
10202,2024-01-08 02:01:00,96,129,Brinquedo,7,225
10203,2024-01-08 02:02:00,51,91,Alimento,6,142
10204,2024-01-08 02:03:00,12,164,Móvel,5,176
10205,2024-01-08 02:04:00,87,169,Vestuário,1,256
10206,2024-01-08 02:05:00,27,101,Vestuário,5,128
10207,2024-01-08 02:06:00,93,15,Eletrônico,5,108
10208,2024-01-08 02:07:00,109,106,Móvel,6,215
10209,2024-01-08 02:08:00,22,168,Alimento,9,190
10210,2024-01-08 02:09:00,110,156,Móvel,1,266
10211,2024-01-08 02:10:00,27,55,Eletrônico,3,82
10212,2024-01-08 02:11:00,84,42,Brinquedo,4,126
10213,2024-01-08 02:12:00,48,110,Alimento,5,158
10214,2024-01-08 02:13:00,76,118,Móvel,2,194
10215,2024-01-08 02:14:00,61,101,Vestuário,8,162
10216,2024-01-08 02:15:00,49,114,Vestuário,7,163
10217,2024-01-08 02:16:00,78,131,Móvel,5,209
10218,2024-01-08 02:17:00,55,133,Alimento,1,188
10219,2024-01-08 02:18:00,117,49,Móvel,4,166
10220,2024-01-08 02:19:00,18,53,Vestuário,5,71
10221,2024-01-08 02:20:00,34,116,Alimento,9,150
10222,2024-01-08 02:21:00,55,83,Alimento,4,138
10223,2024-01-08 02:22:00,15,156,Móvel,4,171
10224,2024-01-08 02:23:00,11,112,Móvel,6,123
10225,2024-01-08 02:24:00,20,176,Eletrônico,2,196
10226,2024-01-08 02:25:00,68,29,Alimento,4,97
10227,2024-01-08 02:26:00,32,96,Alimento,9,128
10228,2024-01-08 02:27:00,38,41,Brinquedo,6,79
10229,2024-01-08 02:28:00,115,105,Brinquedo,5,220
10230,2024-01-08 02:29:00,31,69,Alimento,8,100
10231,2024-01-08 02:30:00,47,80,Móvel,2,127
10232,2024-01-08 02:31:00,94,52,Móvel,3,146
10233,2024-01-08 02:32:00,34,35,Brinquedo,1,69
10234,2024-01-08 02:33:00,33,44,Brinquedo,2,77
10235,2024-01-08 02:34:00,60,164,Brinquedo,6,224
10236,2024-01-08 02:35:00,65,167,Brinquedo,8,232
10237,2024-01-08 02:36:00,53,78,Eletrônico,6,131
10238,2024-01-08 02:37:00,12,144,Alimento,4,156
10239,2024-01-08 02:38:00,74,37,Brinquedo,2,111
10240,2024-01-08 02:39:00,80,43,Alimento,3,123
10241,2024-01-08 02:40:00,10,51,Vestuário,4,61
10242,2024-01-08 02:41:00,118,125,Vestuário,9,243
10243,2024-01-08 02:42:00,84,44,Vestuário,4,128
10244,2024-01-08 02:43:00,42,81,Eletrônico,7,123
10245,2024-01-08 02:44:00,88,76,Eletrônico,9,164
10246,2024-01-08 02:45:00,44,118,Alimento,8,162
10247,2024-01-08 02:46:00,65,165,Móvel,3,230
10248,2024-01-08 02:47:00,48,162,Alimento,8,210
10249,2024-01-08 02:48:00,92,175,Brinquedo,5,267
10250,2024-01-08 02:49:00,34,170,Alimento,9,204
10251,2024-01-08 02:50:00,97,28,Móvel,6,125
10252,2024-01-08 02:51:00,109,151,Eletrônico,4,260
10253,2024-01-08 02:52:00,56,83,Alimento,2,139
10254,2024-01-08 02:53:00,78,163,Eletrônico,8,241
10255,2024-01-08 02:54:00,106,42,Brinquedo,7,148
10256,2024-01-08 02:55:00,81,117,Brinquedo,7,198
10257,2024-01-08 02:56:00,49,44,Vestuário,2,93
10258,2024-01-08 02:57:00,55,17,Móvel,6,72
10259,2024-01-08 02:58:00,41,14,Vestuário,6,55
10260,2024-01-08 02:59:00,11,73,Vestuário,5,84
10261,2024-01-08 03:00:00,17,108,Alimento,9,125
10262,2024-01-08 03:01:00,101,46,Eletrônico,5,147
10263,2024-01-08 03:02:00,61,97,Vestuário,6,158
10264,2024-01-08 03:03:00,39,114,Vestuário,7,153
10265,2024-01-08 03:04:00,53,46,Vestuário,1,99
10266,2024-01-08 03:05:00,102,160,Brinquedo,1,262
10267,2024-01-08 03:06:00,16,154,Alimento,3,170
10268,2024-01-08 03:07:00,106,34,Alimento,8,140
10269,2024-01-08 03:08:00,94,170,Vestuário,1,264
10270,2024-01-08 03:09:00,42,108,Brinquedo,1,150
10271,2024-01-08 03:10:00,109,23,Brinquedo,8,132
10272,2024-01-08 03:11:00,51,57,Vestuário,7,108
10273,2024-01-08 03:12:00,12,130,Eletrônico,6,142
10274,2024-01-08 03:13:00,31,90,Vestuário,5,121
10275,2024-01-08 03:14:00,87,109,Eletrônico,8,196
10276,2024-01-08 03:15:00,25,51,Móvel,2,76
10277,2024-01-08 03:16:00,81,153,Vestuário,8,234
10278,2024-01-08 03:17:00,67,91,Vestuário,4,158
10279,2024-01-08 03:18:00,64,158,Alimento,3,222
10280,2024-01-08 03:19:00,57,80,Eletrônico,7,137
10281,2024-01-08 03:20:00,104,174,Eletrônico,7,278
10282,2024-01-08 03:21:00,13,102,Brinquedo,6,115
10283,2024-01-08 03:22:00,21,87,Vestuário,2,108
10284,2024-01-08 03:23:00,73,30,Eletrônico,2,103
10285,2024-01-08 03:24:00,35,25,Alimento,2,60
10286,2024-01-08 03:25:00,100,87,Brinquedo,8,187
10287,2024-01-08 03:26:00,18,31,Brinquedo,1,49
10288,2024-01-08 03:27:00,85,20,Eletrônico,8,105
10289,2024-01-08 03:28:00,46,82,Vestuário,1,128
10290,2024-01-08 03:29:00,39,169,Móvel,5,208
10291,2024-01-08 03:30:00,55,70,Alimento,3,125
10292,2024-01-08 03:31:00,37,38,Vestuário,2,75
10293,2024-01-08 03:32:00,76,152,Móvel,1,228
10294,2024-01-08 03:33:00,76,102,Móvel,9,178
10295,2024-01-08 03:34:00,81,73,Vestuário,3,154
10296,2024-01-08 03:35:00,11,177,Móvel,2,188
10297,2024-01-08 03:36:00,57,178,Vestuário,9,235
10298,2024-01-08 03:37:00,75,118,Brinquedo,7,193
10299,2024-01-08 03:38:00,59,117,Móvel,2,176
10300,2024-01-08 03:39:00,92,145,Vestuário,1,237
10301,2024-01-08 03:40:00,101,128,Móvel,9,229
10302,2024-01-08 03:41:00,59,58,Eletrônico,3,117
10303,2024-01-08 03:42:00,83,107,Brinquedo,2,190
10304,2024-01-08 03:43:00,11,29,Móvel,6,40
10305,2024-01-08 03:44:00,57,88,Eletrônico,5,145
10306,2024-01-08 03:45:00,88,57,Eletrônico,3,145
10307,2024-01-08 03:46:00,76,60,Eletrônico,3,136
10308,2024-01-08 03:47:00,22,166,Alimento,3,188
10309,2024-01-08 03:48:00,54,116,Vestuário,4,170
10310,2024-01-08 03:49:00,76,172,Eletrônico,2,248
10311,2024-01-08 03:50:00,49,131,Brinquedo,5,180
10312,2024-01-08 03:51:00,60,23,Móvel,6,83
10313,2024-01-08 03:52:00,31,128,Brinquedo,7,159
10314,2024-01-08 03:53:00,100,115,Brinquedo,4,215
10315,2024-01-08 03:54:00,106,150,Móvel,4,256
10316,2024-01-08 03:55:00,31,110,Vestuário,8,141
10317,2024-01-08 03:56:00,62,75,Eletrônico,1,137
10318,2024-01-08 03:57:00,21,15,Eletrônico,8,36
10319,2024-01-08 03:58:00,69,118,Brinquedo,1,187
10320,2024-01-08 03:59:00,79,38,Móvel,9,117
10321,2024-01-08 04:00:00,118,87,Móvel,7,205
10322,2024-01-08 04:01:00,55,14,Brinquedo,6,69
10323,2024-01-08 04:02:00,42,137,Móvel,1,179
10324,2024-01-08 04:03:00,99,163,Eletrônico,6,262
10325,2024-01-08 04:04:00,66,27,Eletrônico,9,93
10326,2024-01-08 04:05:00,103,73,Vestuário,9,176
10327,2024-01-08 04:06:00,25,110,Móvel,7,135
10328,2024-01-08 04:07:00,90,178,Alimento,7,268
10329,2024-01-08 04:08:00,71,93,Móvel,7,164
10330,2024-01-08 04:09:00,25,97,Móvel,9,122
10331,2024-01-08 04:10:00,33,19,Móvel,3,52
10332,2024-01-08 04:11:00,46,86,Vestuário,2,132
10333,2024-01-08 04:12:00,30,122,Eletrônico,5,152
10334,2024-01-08 04:13:00,63,78,Vestuário,2,141
10335,2024-01-08 04:14:00,23,88,Móvel,8,111
10336,2024-01-08 04:15:00,42,94,Eletrônico,4,136
10337,2024-01-08 04:16:00,18,113,Alimento,5,131
10338,2024-01-08 04:17:00,111,128,Brinquedo,6,239
10339,2024-01-08 04:18:00,43,21,Alimento,6,64
10340,2024-01-08 04:19:00,48,82,Brinquedo,7,130
10341,2024-01-08 04:20:00,72,90,Eletrônico,7,162
10342,2024-01-08 04:21:00,27,48,Móvel,7,75
10343,2024-01-08 04:22:00,87,55,Móvel,2,142
10344,2024-01-08 04:23:00,67,178,Brinquedo,6,245
10345,2024-01-08 04:24:00,37,167,Alimento,6,204
10346,2024-01-08 04:25:00,33,165,Eletrônico,7,198
10347,2024-01-08 04:26:00,78,60,Móvel,5,138
10348,2024-01-08 04:27:00,26,149,Móvel,1,175
10349,2024-01-08 04:28:00,14,88,Alimento,3,102
10350,2024-01-08 04:29:00,40,156,Alimento,1,196
10351,2024-01-08 04:30:00,51,136,Brinquedo,6,187
10352,2024-01-08 04:31:00,57,165,Eletrônico,1,222
10353,2024-01-08 04:32:00,10,36,Brinquedo,8,46
10354,2024-01-08 04:33:00,86,176,Vestuário,9,262
10355,2024-01-08 04:34:00,119,18,Vestuário,1,137
10356,2024-01-08 04:35:00,67,18,Vestuário,9,85
10357,2024-01-08 04:36:00,52,105,Brinquedo,9,157
10358,2024-01-08 04:37:00,69,15,Vestuário,6,84
10359,2024-01-08 04:38:00,72,139,Móvel,3,211
10360,2024-01-08 04:39:00,35,35,Móvel,3,70
10361,2024-01-08 04:40:00,78,12,Móvel,1,90
10362,2024-01-08 04:41:00,95,98,Vestuário,3,193
10363,2024-01-08 04:42:00,49,65,Eletrônico,6,114
10364,2024-01-08 04:43:00,42,73,Brinquedo,7,115
10365,2024-01-08 04:44:00,64,120,Eletrônico,9,184
10366,2024-01-08 04:45:00,43,156,Vestuário,8,199
10367,2024-01-08 04:46:00,67,162,Móvel,7,229
10368,2024-01-08 04:47:00,76,157,Alimento,5,233
10369,2024-01-08 04:48:00,49,95,Vestuário,1,144
10370,2024-01-08 04:49:00,105,45,Eletrônico,3,150
10371,2024-01-08 04:50:00,43,132,Vestuário,7,175
10372,2024-01-08 04:51:00,30,147,Móvel,3,177
10373,2024-01-08 04:52:00,39,108,Alimento,6,147
10374,2024-01-08 04:53:00,68,66,Vestuário,7,134
10375,2024-01-08 04:54:00,77,164,Vestuário,1,241
10376,2024-01-08 04:55:00,103,133,Brinquedo,2,236
10377,2024-01-08 04:56:00,46,122,Brinquedo,4,168
10378,2024-01-08 04:57:00,99,19,Vestuário,2,118
10379,2024-01-08 04:58:00,105,13,Brinquedo,9,118
10380,2024-01-08 04:59:00,33,31,Móvel,6,64
10381,2024-01-08 05:00:00,10,144,Alimento,8,154
10382,2024-01-08 05:01:00,80,175,Vestuário,8,255
10383,2024-01-08 05:02:00,103,30,Vestuário,4,133
10384,2024-01-08 05:03:00,79,26,Brinquedo,2,105
10385,2024-01-08 05:04:00,109,98,Eletrônico,1,207
10386,2024-01-08 05:05:00,18,87,Alimento,3,105
10387,2024-01-08 05:06:00,96,48,Eletrônico,6,144
10388,2024-01-08 05:07:00,43,149,Alimento,1,192
10389,2024-01-08 05:08:00,55,48,Vestuário,2,103
10390,2024-01-08 05:09:00,11,155,Vestuário,3,166
10391,2024-01-08 05:10:00,69,27,Vestuário,4,96
10392,2024-01-08 05:11:00,89,146,Eletrônico,5,235
10393,2024-01-08 05:12:00,64,109,Eletrônico,4,173
10394,2024-01-08 05:13:00,53,70,Vestuário,2,123
10395,2024-01-08 05:14:00,109,162,Móvel,1,271
10396,2024-01-08 05:15:00,75,76,Vestuário,8,151
10397,2024-01-08 05:16:00,112,108,Móvel,1,220
10398,2024-01-08 05:17:00,21,128,Eletrônico,8,149
10399,2024-01-08 05:18:00,102,87,Alimento,4,189
10400,2024-01-08 05:19:00,90,33,Brinquedo,4,123
10401,2024-01-08 05:20:00,42,177,Brinquedo,5,219
10402,2024-01-08 05:21:00,75,114,Vestuário,4,189
10403,2024-01-08 05:22:00,90,159,Vestuário,2,249
10404,2024-01-08 05:23:00,59,68,Móvel,4,127
10405,2024-01-08 05:24:00,39,109,Eletrônico,5,148
10406,2024-01-08 05:25:00,88,65,Vestuário,2,153
10407,2024-01-08 05:26:00,12,119,Vestuário,8,131
10408,2024-01-08 05:27:00,10,47,Alimento,3,57
10409,2024-01-08 05:28:00,50,31,Brinquedo,7,81
10410,2024-01-08 05:29:00,108,61,Vestuário,5,169
10411,2024-01-08 05:30:00,44,43,Móvel,5,87
10412,2024-01-08 05:31:00,89,34,Vestuário,1,123
10413,2024-01-08 05:32:00,75,15,Alimento,7,90
10414,2024-01-08 05:33:00,119,72,Vestuário,1,191
10415,2024-01-08 05:34:00,69,72,Brinquedo,4,141
10416,2024-01-08 05:35:00,43,75,Vestuário,4,118
10417,2024-01-08 05:36:00,110,158,Brinquedo,6,268
10418,2024-01-08 05:37:00,77,108,Alimento,2,185
10419,2024-01-08 05:38:00,102,42,Móvel,4,144
10420,2024-01-08 05:39:00,98,175,Eletrônico,6,273
10421,2024-01-08 05:40:00,26,133,Móvel,9,159
10422,2024-01-08 05:41:00,79,97,Móvel,6,176
10423,2024-01-08 05:42:00,24,51,Eletrônico,7,75
10424,2024-01-08 05:43:00,92,179,Vestuário,4,271
10425,2024-01-08 05:44:00,66,66,Alimento,3,132
10426,2024-01-08 05:45:00,35,43,Alimento,4,78
10427,2024-01-08 05:46:00,92,141,Alimento,6,233
10428,2024-01-08 05:47:00,29,119,Brinquedo,9,148
10429,2024-01-08 05:48:00,116,13,Brinquedo,4,129
10430,2024-01-08 05:49:00,42,64,Alimento,4,106
10431,2024-01-08 05:50:00,118,74,Alimento,1,192
10432,2024-01-08 05:51:00,41,90,Vestuário,7,131
10433,2024-01-08 05:52:00,98,161,Móvel,4,259
10434,2024-01-08 05:53:00,81,146,Eletrônico,7,227
10435,2024-01-08 05:54:00,108,93,Móvel,4,201
10436,2024-01-08 05:55:00,89,20,Brinquedo,8,109
10437,2024-01-08 05:56:00,80,176,Vestuário,7,256
10438,2024-01-08 05:57:00,39,171,Eletrônico,6,210
10439,2024-01-08 05:58:00,31,139,Eletrônico,6,170
10440,2024-01-08 05:59:00,118,145,Alimento,8,263
10441,2024-01-08 06:00:00,30,58,Vestuário,3,88
10442,2024-01-08 06:01:00,113,136,Vestuário,4,249
10443,2024-01-08 06:02:00,49,67,Eletrônico,5,116
10444,2024-01-08 06:03:00,89,140,Móvel,5,229
10445,2024-01-08 06:04:00,20,85,Eletrônico,9,105
10446,2024-01-08 06:05:00,88,78,Alimento,4,166
10447,2024-01-08 06:06:00,83,105,Alimento,8,188
10448,2024-01-08 06:07:00,69,154,Móvel,9,223
10449,2024-01-08 06:08:00,63,35,Eletrônico,3,98
10450,2024-01-08 06:09:00,22,102,Móvel,3,124
10451,2024-01-08 06:10:00,43,21,Vestuário,3,64
10452,2024-01-08 06:11:00,25,18,Alimento,1,43
10453,2024-01-08 06:12:00,80,24,Alimento,5,104
10454,2024-01-08 06:13:00,36,119,Brinquedo,5,155
10455,2024-01-08 06:14:00,13,147,Eletrônico,7,160
10456,2024-01-08 06:15:00,31,73,Vestuário,7,104
10457,2024-01-08 06:16:00,78,31,Vestuário,1,109
10458,2024-01-08 06:17:00,23,152,Móvel,5,175
10459,2024-01-08 06:18:00,59,113,Alimento,3,172
10460,2024-01-08 06:19:00,79,46,Alimento,1,125
10461,2024-01-08 06:20:00,108,110,Vestuário,4,218
10462,2024-01-08 06:21:00,18,69,Eletrônico,3,87
10463,2024-01-08 06:22:00,95,34,Vestuário,6,129
10464,2024-01-08 06:23:00,113,65,Eletrônico,6,178
10465,2024-01-08 06:24:00,50,151,Vestuário,7,201
10466,2024-01-08 06:25:00,48,163,Alimento,8,211
10467,2024-01-08 06:26:00,21,115,Brinquedo,1,136
10468,2024-01-08 06:27:00,37,101,Brinquedo,5,138
10469,2024-01-08 06:28:00,96,21,Eletrônico,9,117
10470,2024-01-08 06:29:00,64,179,Brinquedo,2,243
10471,2024-01-08 06:30:00,63,30,Móvel,3,93
10472,2024-01-08 06:31:00,100,123,Brinquedo,1,223
10473,2024-01-08 06:32:00,16,52,Alimento,8,68
10474,2024-01-08 06:33:00,80,127,Eletrônico,3,207
10475,2024-01-08 06:34:00,91,77,Brinquedo,3,168
10476,2024-01-08 06:35:00,42,88,Eletrônico,4,130
10477,2024-01-08 06:36:00,92,64,Vestuário,7,156
10478,2024-01-08 06:37:00,18,25,Vestuário,7,43
10479,2024-01-08 06:38:00,106,40,Eletrônico,2,146
10480,2024-01-08 06:39:00,35,19,Brinquedo,7,54
10481,2024-01-08 06:40:00,99,143,Brinquedo,1,242
10482,2024-01-08 06:41:00,37,113,Móvel,4,150
10483,2024-01-08 06:42:00,52,29,Eletrônico,5,81
10484,2024-01-08 06:43:00,66,109,Eletrônico,1,175
10485,2024-01-08 06:44:00,97,52,Móvel,6,149
10486,2024-01-08 06:45:00,114,110,Alimento,2,224
10487,2024-01-08 06:46:00,42,111,Brinquedo,5,153
10488,2024-01-08 06:47:00,14,66,Móvel,7,80
10489,2024-01-08 06:48:00,55,26,Vestuário,1,81
10490,2024-01-08 06:49:00,113,172,Brinquedo,3,285
10491,2024-01-08 06:50:00,64,26,Móvel,8,90
10492,2024-01-08 06:51:00,41,78,Eletrônico,3,119
10493,2024-01-08 06:52:00,38,16,Vestuário,6,54
10494,2024-01-08 06:53:00,42,171,Móvel,5,213
10495,2024-01-08 06:54:00,58,142,Eletrônico,7,200
10496,2024-01-08 06:55:00,12,105,Brinquedo,1,117
10497,2024-01-08 06:56:00,24,32,Vestuário,6,56
10498,2024-01-08 06:57:00,84,123,Brinquedo,9,207
10499,2024-01-08 06:58:00,75,161,Eletrônico,8,236
10500,2024-01-08 06:59:00,116,45,Vestuário,1,161
10501,2024-01-08 07:00:00,112,27,Vestuário,6,139
10502,2024-01-08 07:01:00,23,174,Alimento,3,197
10503,2024-01-08 07:02:00,28,35,Brinquedo,4,63
10504,2024-01-08 07:03:00,90,24,Brinquedo,6,114
10505,2024-01-08 07:04:00,28,144,Brinquedo,4,172
10506,2024-01-08 07:05:00,85,87,Alimento,9,172
10507,2024-01-08 07:06:00,45,95,Vestuário,7,140
10508,2024-01-08 07:07:00,56,91,Brinquedo,1,147
10509,2024-01-08 07:08:00,45,126,Brinquedo,4,171
10510,2024-01-08 07:09:00,36,100,Alimento,5,136
10511,2024-01-08 07:10:00,79,156,Brinquedo,7,235
10512,2024-01-08 07:11:00,22,49,Móvel,3,71
10513,2024-01-08 07:12:00,92,31,Brinquedo,2,123
10514,2024-01-08 07:13:00,103,51,Vestuário,2,154
10515,2024-01-08 07:14:00,18,137,Alimento,2,155
10516,2024-01-08 07:15:00,48,124,Eletrônico,9,172
10517,2024-01-08 07:16:00,22,86,Brinquedo,1,108
10518,2024-01-08 07:17:00,110,174,Brinquedo,2,284
10519,2024-01-08 07:18:00,110,79,Vestuário,7,189
10520,2024-01-08 07:19:00,105,72,Vestuário,2,177
10521,2024-01-08 07:20:00,86,17,Móvel,3,103
10522,2024-01-08 07:21:00,108,67,Móvel,3,175
10523,2024-01-08 07:22:00,13,112,Vestuário,5,125
10524,2024-01-08 07:23:00,73,18,Vestuário,5,91
10525,2024-01-08 07:24:00,89,102,Móvel,8,191
10526,2024-01-08 07:25:00,97,42,Alimento,7,139
10527,2024-01-08 07:26:00,80,32,Brinquedo,9,112
10528,2024-01-08 07:27:00,18,28,Móvel,7,46
10529,2024-01-08 07:28:00,75,92,Móvel,8,167
10530,2024-01-08 07:29:00,65,91,Alimento,2,156
10531,2024-01-08 07:30:00,83,125,Móvel,7,208
10532,2024-01-08 07:31:00,53,115,Alimento,8,168
10533,2024-01-08 07:32:00,76,156,Eletrônico,8,232
10534,2024-01-08 07:33:00,94,37,Eletrônico,5,131
10535,2024-01-08 07:34:00,66,71,Alimento,2,137
10536,2024-01-08 07:35:00,35,156,Eletrônico,7,191
10537,2024-01-08 07:36:00,83,54,Alimento,6,137
10538,2024-01-08 07:37:00,17,155,Brinquedo,6,172
10539,2024-01-08 07:38:00,76,97,Alimento,9,173
10540,2024-01-08 07:39:00,92,37,Eletrônico,4,129
10541,2024-01-08 07:40:00,43,170,Alimento,3,213
10542,2024-01-08 07:41:00,18,97,Móvel,4,115
10543,2024-01-08 07:42:00,18,155,Móvel,5,173
10544,2024-01-08 07:43:00,45,79,Móvel,2,124
10545,2024-01-08 07:44:00,47,158,Vestuário,8,205
10546,2024-01-08 07:45:00,34,147,Vestuário,1,181
10547,2024-01-08 07:46:00,56,26,Móvel,7,82
10548,2024-01-08 07:47:00,56,37,Móvel,8,93
10549,2024-01-08 07:48:00,30,34,Vestuário,9,64
10550,2024-01-08 07:49:00,72,23,Móvel,9,95
10551,2024-01-08 07:50:00,79,109,Alimento,7,188
10552,2024-01-08 07:51:00,66,15,Eletrônico,4,81
10553,2024-01-08 07:52:00,82,65,Móvel,1,147
10554,2024-01-08 07:53:00,20,25,Alimento,4,45
10555,2024-01-08 07:54:00,74,67,Eletrônico,9,141
10556,2024-01-08 07:55:00,99,28,Alimento,5,127
10557,2024-01-08 07:56:00,98,12,Brinquedo,7,110
10558,2024-01-08 07:57:00,94,14,Eletrônico,4,108
10559,2024-01-08 07:58:00,100,28,Eletrônico,3,128
10560,2024-01-08 07:59:00,36,154,Eletrônico,7,190
10561,2024-01-08 08:00:00,26,23,Eletrônico,4,49
10562,2024-01-08 08:01:00,91,93,Móvel,4,184
10563,2024-01-08 08:02:00,60,173,Alimento,4,233
10564,2024-01-08 08:03:00,106,134,Brinquedo,7,240
10565,2024-01-08 08:04:00,44,67,Vestuário,2,111
10566,2024-01-08 08:05:00,45,15,Vestuário,6,60
10567,2024-01-08 08:06:00,41,66,Vestuário,1,107
10568,2024-01-08 08:07:00,30,64,Móvel,9,94
10569,2024-01-08 08:08:00,29,166,Móvel,5,195
10570,2024-01-08 08:09:00,96,102,Móvel,7,198
10571,2024-01-08 08:10:00,86,104,Alimento,1,190
10572,2024-01-08 08:11:00,17,39,Vestuário,5,56
10573,2024-01-08 08:12:00,24,49,Vestuário,6,73
10574,2024-01-08 08:13:00,34,124,Vestuário,3,158
10575,2024-01-08 08:14:00,79,33,Eletrônico,4,112
10576,2024-01-08 08:15:00,94,130,Vestuário,6,224
10577,2024-01-08 08:16:00,100,71,Móvel,7,171
10578,2024-01-08 08:17:00,70,52,Alimento,6,122
10579,2024-01-08 08:18:00,69,167,Eletrônico,1,236
10580,2024-01-08 08:19:00,45,43,Eletrônico,5,88
10581,2024-01-08 08:20:00,24,60,Vestuário,1,84
10582,2024-01-08 08:21:00,75,130,Vestuário,1,205
10583,2024-01-08 08:22:00,63,160,Alimento,5,223
10584,2024-01-08 08:23:00,66,12,Brinquedo,6,78
10585,2024-01-08 08:24:00,54,40,Eletrônico,3,94
10586,2024-01-08 08:25:00,20,136,Brinquedo,1,156
10587,2024-01-08 08:26:00,72,96,Eletrônico,7,168
10588,2024-01-08 08:27:00,11,26,Móvel,3,37
10589,2024-01-08 08:28:00,47,176,Brinquedo,5,223
10590,2024-01-08 08:29:00,63,175,Móvel,1,238
10591,2024-01-08 08:30:00,68,14,Alimento,3,82
10592,2024-01-08 08:31:00,110,144,Eletrônico,1,254
10593,2024-01-08 08:32:00,27,64,Alimento,2,91
10594,2024-01-08 08:33:00,30,135,Eletrônico,4,165
10595,2024-01-08 08:34:00,55,118,Alimento,1,173
10596,2024-01-08 08:35:00,22,38,Brinquedo,5,60
10597,2024-01-08 08:36:00,35,98,Alimento,4,133
10598,2024-01-08 08:37:00,94,82,Móvel,9,176
10599,2024-01-08 08:38:00,18,18,Móvel,4,36
10600,2024-01-08 08:39:00,101,21,Alimento,9,122
10601,2024-01-08 08:40:00,94,99,Vestuário,5,193
10602,2024-01-08 08:41:00,117,19,Brinquedo,8,136
10603,2024-01-08 08:42:00,34,179,Alimento,5,213
10604,2024-01-08 08:43:00,48,136,Alimento,8,184
10605,2024-01-08 08:44:00,94,139,Vestuário,8,233
10606,2024-01-08 08:45:00,69,141,Alimento,3,210
10607,2024-01-08 08:46:00,119,122,Móvel,2,241
10608,2024-01-08 08:47:00,102,51,Alimento,1,153
10609,2024-01-08 08:48:00,105,143,Vestuário,9,248
10610,2024-01-08 08:49:00,108,65,Vestuário,4,173
10611,2024-01-08 08:50:00,116,124,Eletrônico,2,240
10612,2024-01-08 08:51:00,97,129,Eletrônico,7,226
10613,2024-01-08 08:52:00,100,170,Móvel,1,270
10614,2024-01-08 08:53:00,92,113,Móvel,6,205
10615,2024-01-08 08:54:00,88,47,Vestuário,5,135
10616,2024-01-08 08:55:00,115,79,Alimento,6,194
10617,2024-01-08 08:56:00,97,40,Móvel,2,137
10618,2024-01-08 08:57:00,83,22,Vestuário,8,105
10619,2024-01-08 08:58:00,50,166,Móvel,2,216
10620,2024-01-08 08:59:00,43,72,Vestuário,9,115
10621,2024-01-08 09:00:00,50,170,Eletrônico,9,220
10622,2024-01-08 09:01:00,26,26,Brinquedo,1,52
10623,2024-01-08 09:02:00,74,167,Alimento,9,241
10624,2024-01-08 09:03:00,38,130,Vestuário,7,168
10625,2024-01-08 09:04:00,107,163,Brinquedo,7,270
10626,2024-01-08 09:05:00,75,135,Eletrônico,7,210
10627,2024-01-08 09:06:00,11,140,Vestuário,8,151
10628,2024-01-08 09:07:00,35,27,Vestuário,7,62
10629,2024-01-08 09:08:00,117,73,Vestuário,4,190
10630,2024-01-08 09:09:00,45,177,Alimento,7,222
10631,2024-01-08 09:10:00,110,79,Móvel,3,189
10632,2024-01-08 09:11:00,50,44,Brinquedo,5,94
10633,2024-01-08 09:12:00,56,149,Vestuário,6,205
10634,2024-01-08 09:13:00,73,121,Alimento,5,194
10635,2024-01-08 09:14:00,62,19,Vestuário,7,81
10636,2024-01-08 09:15:00,69,23,Alimento,4,92
10637,2024-01-08 09:16:00,103,43,Vestuário,2,146
10638,2024-01-08 09:17:00,94,70,Alimento,1,164
10639,2024-01-08 09:18:00,119,35,Alimento,8,154
10640,2024-01-08 09:19:00,108,124,Móvel,3,232
10641,2024-01-08 09:20:00,11,45,Brinquedo,2,56
10642,2024-01-08 09:21:00,69,84,Vestuário,8,153
10643,2024-01-08 09:22:00,119,173,Móvel,2,292
10644,2024-01-08 09:23:00,70,134,Brinquedo,6,204
10645,2024-01-08 09:24:00,57,122,Vestuário,1,179
10646,2024-01-08 09:25:00,57,43,Alimento,3,100
10647,2024-01-08 09:26:00,14,23,Vestuário,6,37
10648,2024-01-08 09:27:00,32,162,Vestuário,7,194
10649,2024-01-08 09:28:00,23,123,Móvel,9,146
10650,2024-01-08 09:29:00,86,73,Alimento,4,159
10651,2024-01-08 09:30:00,90,58,Móvel,5,148
10652,2024-01-08 09:31:00,112,83,Eletrônico,7,195
10653,2024-01-08 09:32:00,70,80,Vestuário,1,150
10654,2024-01-08 09:33:00,92,123,Móvel,7,215
10655,2024-01-08 09:34:00,94,167,Vestuário,1,261
10656,2024-01-08 09:35:00,49,44,Vestuário,1,93
10657,2024-01-08 09:36:00,67,75,Vestuário,3,142
10658,2024-01-08 09:37:00,25,34,Vestuário,3,59
10659,2024-01-08 09:38:00,71,136,Móvel,6,207
10660,2024-01-08 09:39:00,110,30,Eletrônico,4,140
10661,2024-01-08 09:40:00,87,140,Vestuário,7,227
10662,2024-01-08 09:41:00,85,175,Alimento,6,260
10663,2024-01-08 09:42:00,115,66,Vestuário,1,181
10664,2024-01-08 09:43:00,83,68,Vestuário,2,151
10665,2024-01-08 09:44:00,13,152,Vestuário,1,165
10666,2024-01-08 09:45:00,114,71,Alimento,9,185
10667,2024-01-08 09:46:00,73,77,Alimento,7,150
10668,2024-01-08 09:47:00,65,27,Móvel,7,92
10669,2024-01-08 09:48:00,82,77,Eletrônico,1,159
10670,2024-01-08 09:49:00,74,153,Brinquedo,6,227
10671,2024-01-08 09:50:00,32,33,Vestuário,3,65
10672,2024-01-08 09:51:00,115,59,Vestuário,7,174
10673,2024-01-08 09:52:00,39,99,Vestuário,6,138
10674,2024-01-08 09:53:00,10,129,Alimento,2,139
10675,2024-01-08 09:54:00,48,49,Alimento,6,97
10676,2024-01-08 09:55:00,100,133,Móvel,2,233
10677,2024-01-08 09:56:00,60,120,Móvel,5,180
10678,2024-01-08 09:57:00,78,155,Alimento,8,233
10679,2024-01-08 09:58:00,28,74,Eletrônico,2,102
10680,2024-01-08 09:59:00,66,126,Alimento,6,192
10681,2024-01-08 10:00:00,71,24,Móvel,9,95
10682,2024-01-08 10:01:00,24,27,Vestuário,5,51
10683,2024-01-08 10:02:00,110,122,Móvel,7,232
10684,2024-01-08 10:03:00,56,101,Vestuário,6,157
10685,2024-01-08 10:04:00,42,58,Eletrônico,3,100
10686,2024-01-08 10:05:00,108,37,Vestuário,8,145
10687,2024-01-08 10:06:00,76,95,Eletrônico,8,171
10688,2024-01-08 10:07:00,98,126,Alimento,8,224
10689,2024-01-08 10:08:00,50,143,Vestuário,4,193
10690,2024-01-08 10:09:00,13,153,Vestuário,9,166
10691,2024-01-08 10:10:00,105,69,Móvel,1,174
10692,2024-01-08 10:11:00,75,79,Eletrônico,6,154
10693,2024-01-08 10:12:00,13,91,Alimento,6,104
10694,2024-01-08 10:13:00,110,17,Brinquedo,5,127
10695,2024-01-08 10:14:00,106,156,Brinquedo,1,262
10696,2024-01-08 10:15:00,109,152,Móvel,2,261
10697,2024-01-08 10:16:00,57,156,Alimento,1,213
10698,2024-01-08 10:17:00,12,42,Eletrônico,9,54
10699,2024-01-08 10:18:00,21,134,Vestuário,9,155
10700,2024-01-08 10:19:00,63,163,Vestuário,4,226
10701,2024-01-08 10:20:00,44,144,Brinquedo,6,188
10702,2024-01-08 10:21:00,62,153,Brinquedo,8,215
10703,2024-01-08 10:22:00,79,33,Móvel,4,112
10704,2024-01-08 10:23:00,10,163,Eletrônico,9,173
10705,2024-01-08 10:24:00,118,105,Vestuário,9,223
10706,2024-01-08 10:25:00,108,71,Alimento,7,179
10707,2024-01-08 10:26:00,32,128,Vestuário,6,160
10708,2024-01-08 10:27:00,32,72,Brinquedo,3,104
10709,2024-01-08 10:28:00,113,130,Eletrônico,7,243
10710,2024-01-08 10:29:00,111,63,Eletrônico,1,174
10711,2024-01-08 10:30:00,114,117,Vestuário,2,231
10712,2024-01-08 10:31:00,80,22,Alimento,7,102
10713,2024-01-08 10:32:00,41,97,Alimento,9,138
10714,2024-01-08 10:33:00,35,78,Eletrônico,7,113
10715,2024-01-08 10:34:00,98,130,Móvel,6,228
10716,2024-01-08 10:35:00,111,89,Móvel,1,200
10717,2024-01-08 10:36:00,49,125,Vestuário,6,174
10718,2024-01-08 10:37:00,113,15,Brinquedo,8,128
10719,2024-01-08 10:38:00,97,112,Móvel,1,209
10720,2024-01-08 10:39:00,11,142,Móvel,1,153
10721,2024-01-08 10:40:00,65,55,Brinquedo,9,120
10722,2024-01-08 10:41:00,92,64,Móvel,4,156
10723,2024-01-08 10:42:00,66,29,Brinquedo,6,95
10724,2024-01-08 10:43:00,113,166,Brinquedo,6,279
10725,2024-01-08 10:44:00,71,56,Vestuário,6,127
10726,2024-01-08 10:45:00,42,21,Vestuário,7,63
10727,2024-01-08 10:46:00,63,48,Vestuário,1,111
10728,2024-01-08 10:47:00,82,155,Alimento,6,237
10729,2024-01-08 10:48:00,17,18,Vestuário,7,35
10730,2024-01-08 10:49:00,57,16,Móvel,1,73
10731,2024-01-08 10:50:00,115,174,Móvel,1,289
10732,2024-01-08 10:51:00,93,154,Brinquedo,3,247
10733,2024-01-08 10:52:00,91,38,Eletrônico,4,129
10734,2024-01-08 10:53:00,68,84,Eletrônico,8,152
10735,2024-01-08 10:54:00,116,36,Eletrônico,2,152
10736,2024-01-08 10:55:00,52,102,Eletrônico,2,154
10737,2024-01-08 10:56:00,98,160,Brinquedo,4,258
10738,2024-01-08 10:57:00,19,39,Alimento,5,58
10739,2024-01-08 10:58:00,33,177,Brinquedo,9,210
10740,2024-01-08 10:59:00,51,18,Eletrônico,7,69
10741,2024-01-08 11:00:00,71,154,Brinquedo,1,225
10742,2024-01-08 11:01:00,30,70,Vestuário,8,100
10743,2024-01-08 11:02:00,22,48,Brinquedo,1,70
10744,2024-01-08 11:03:00,98,155,Brinquedo,3,253
10745,2024-01-08 11:04:00,73,119,Móvel,9,192
10746,2024-01-08 11:05:00,81,47,Vestuário,9,128
10747,2024-01-08 11:06:00,59,89,Eletrônico,8,148
10748,2024-01-08 11:07:00,10,68,Brinquedo,7,78
10749,2024-01-08 11:08:00,12,63,Alimento,7,75
10750,2024-01-08 11:09:00,56,35,Móvel,8,91
10751,2024-01-08 11:10:00,106,156,Brinquedo,9,262
10752,2024-01-08 11:11:00,103,29,Alimento,7,132
10753,2024-01-08 11:12:00,53,14,Móvel,6,67
10754,2024-01-08 11:13:00,105,103,Vestuário,6,208
10755,2024-01-08 11:14:00,64,153,Eletrônico,8,217
10756,2024-01-08 11:15:00,114,107,Alimento,2,221
10757,2024-01-08 11:16:00,113,72,Móvel,3,185
10758,2024-01-08 11:17:00,96,68,Móvel,5,164
10759,2024-01-08 11:18:00,37,41,Alimento,6,78
10760,2024-01-08 11:19:00,61,46,Brinquedo,2,107
10761,2024-01-08 11:20:00,64,51,Alimento,2,115
10762,2024-01-08 11:21:00,16,53,Brinquedo,3,69
10763,2024-01-08 11:22:00,38,23,Móvel,2,61
10764,2024-01-08 11:23:00,110,171,Brinquedo,6,281
10765,2024-01-08 11:24:00,16,59,Vestuário,4,75
10766,2024-01-08 11:25:00,54,154,Alimento,5,208
10767,2024-01-08 11:26:00,11,107,Vestuário,7,118
10768,2024-01-08 11:27:00,31,32,Vestuário,4,63
10769,2024-01-08 11:28:00,49,60,Eletrônico,9,109
10770,2024-01-08 11:29:00,92,16,Brinquedo,4,108
10771,2024-01-08 11:30:00,98,40,Eletrônico,6,138
10772,2024-01-08 11:31:00,13,146,Eletrônico,4,159
10773,2024-01-08 11:32:00,107,50,Eletrônico,5,157
10774,2024-01-08 11:33:00,88,83,Brinquedo,7,171
10775,2024-01-08 11:34:00,52,58,Vestuário,8,110
10776,2024-01-08 11:35:00,72,99,Brinquedo,3,171
10777,2024-01-08 11:36:00,116,58,Vestuário,5,174
10778,2024-01-08 11:37:00,82,105,Eletrônico,9,187
10779,2024-01-08 11:38:00,40,86,Eletrônico,1,126
10780,2024-01-08 11:39:00,77,129,Eletrônico,9,206
10781,2024-01-08 11:40:00,28,13,Alimento,2,41
10782,2024-01-08 11:41:00,92,120,Vestuário,8,212
10783,2024-01-08 11:42:00,38,153,Alimento,9,191
10784,2024-01-08 11:43:00,95,179,Alimento,2,274
10785,2024-01-08 11:44:00,106,16,Móvel,4,122
10786,2024-01-08 11:45:00,72,50,Móvel,1,122
10787,2024-01-08 11:46:00,56,37,Alimento,8,93
10788,2024-01-08 11:47:00,12,54,Móvel,2,66
10789,2024-01-08 11:48:00,13,179,Eletrônico,8,192
10790,2024-01-08 11:49:00,81,148,Eletrônico,4,229
10791,2024-01-08 11:50:00,14,43,Brinquedo,8,57
10792,2024-01-08 11:51:00,95,149,Alimento,9,244
10793,2024-01-08 11:52:00,62,102,Móvel,7,164
10794,2024-01-08 11:53:00,12,100,Brinquedo,7,112
10795,2024-01-08 11:54:00,87,154,Eletrônico,6,241
10796,2024-01-08 11:55:00,60,125,Móvel,6,185
10797,2024-01-08 11:56:00,79,67,Brinquedo,2,146
10798,2024-01-08 11:57:00,60,76,Eletrônico,5,136
10799,2024-01-08 11:58:00,66,113,Alimento,3,179
10800,2024-01-08 11:59:00,29,171,Móvel,3,200
10801,2024-01-08 12:00:00,103,33,Alimento,6,136
10802,2024-01-08 12:01:00,40,138,Móvel,3,178
10803,2024-01-08 12:02:00,108,158,Eletrônico,5,266
10804,2024-01-08 12:03:00,87,53,Alimento,8,140
10805,2024-01-08 12:04:00,34,58,Móvel,5,92
10806,2024-01-08 12:05:00,67,13,Móvel,6,80
10807,2024-01-08 12:06:00,52,43,Eletrônico,1,95
10808,2024-01-08 12:07:00,35,72,Móvel,8,107
10809,2024-01-08 12:08:00,97,37,Brinquedo,7,134
10810,2024-01-08 12:09:00,62,66,Móvel,1,128
10811,2024-01-08 12:10:00,100,38,Brinquedo,5,138
10812,2024-01-08 12:11:00,68,101,Alimento,8,169
10813,2024-01-08 12:12:00,67,13,Brinquedo,1,80
10814,2024-01-08 12:13:00,57,166,Brinquedo,9,223
10815,2024-01-08 12:14:00,91,22,Alimento,3,113
10816,2024-01-08 12:15:00,61,40,Móvel,3,101
10817,2024-01-08 12:16:00,30,98,Brinquedo,7,128
10818,2024-01-08 12:17:00,57,169,Eletrônico,9,226
10819,2024-01-08 12:18:00,26,73,Brinquedo,1,99
10820,2024-01-08 12:19:00,28,43,Alimento,8,71
10821,2024-01-08 12:20:00,43,56,Móvel,3,99
10822,2024-01-08 12:21:00,119,13,Eletrônico,2,132
10823,2024-01-08 12:22:00,25,29,Móvel,6,54
10824,2024-01-08 12:23:00,83,116,Vestuário,8,199
10825,2024-01-08 12:24:00,69,139,Brinquedo,9,208
10826,2024-01-08 12:25:00,32,170,Vestuário,1,202
10827,2024-01-08 12:26:00,90,82,Eletrônico,1,172
10828,2024-01-08 12:27:00,61,50,Alimento,6,111
10829,2024-01-08 12:28:00,34,124,Vestuário,8,158
10830,2024-01-08 12:29:00,84,134,Móvel,4,218
10831,2024-01-08 12:30:00,36,107,Brinquedo,2,143
10832,2024-01-08 12:31:00,31,127,Alimento,3,158
10833,2024-01-08 12:32:00,81,19,Eletrônico,8,100
10834,2024-01-08 12:33:00,108,159,Vestuário,4,267
10835,2024-01-08 12:34:00,94,33,Vestuário,7,127
10836,2024-01-08 12:35:00,23,72,Vestuário,4,95
10837,2024-01-08 12:36:00,42,173,Alimento,3,215
10838,2024-01-08 12:37:00,50,30,Alimento,1,80
10839,2024-01-08 12:38:00,81,159,Móvel,4,240
10840,2024-01-08 12:39:00,64,119,Vestuário,4,183
10841,2024-01-08 12:40:00,53,100,Vestuário,2,153
10842,2024-01-08 12:41:00,60,23,Móvel,6,83
10843,2024-01-08 12:42:00,41,149,Vestuário,2,190
10844,2024-01-08 12:43:00,46,167,Alimento,5,213
10845,2024-01-08 12:44:00,51,104,Vestuário,2,155
10846,2024-01-08 12:45:00,69,178,Alimento,6,247
10847,2024-01-08 12:46:00,81,71,Eletrônico,8,152
10848,2024-01-08 12:47:00,23,71,Móvel,5,94
10849,2024-01-08 12:48:00,72,66,Eletrônico,5,138
10850,2024-01-08 12:49:00,92,152,Móvel,2,244
10851,2024-01-08 12:50:00,32,91,Brinquedo,3,123
10852,2024-01-08 12:51:00,56,46,Eletrônico,9,102
10853,2024-01-08 12:52:00,25,91,Móvel,2,116
10854,2024-01-08 12:53:00,50,21,Eletrônico,3,71
10855,2024-01-08 12:54:00,69,17,Brinquedo,5,86
10856,2024-01-08 12:55:00,68,80,Vestuário,2,148
10857,2024-01-08 12:56:00,13,48,Vestuário,2,61
10858,2024-01-08 12:57:00,19,77,Alimento,7,96
10859,2024-01-08 12:58:00,94,131,Alimento,7,225
10860,2024-01-08 12:59:00,11,86,Brinquedo,7,97
10861,2024-01-08 13:00:00,102,82,Vestuário,2,184
10862,2024-01-08 13:01:00,40,41,Vestuário,9,81
10863,2024-01-08 13:02:00,104,159,Móvel,2,263
10864,2024-01-08 13:03:00,91,35,Vestuário,1,126
10865,2024-01-08 13:04:00,23,104,Brinquedo,7,127
10866,2024-01-08 13:05:00,65,86,Vestuário,7,151
10867,2024-01-08 13:06:00,40,15,Brinquedo,4,55
10868,2024-01-08 13:07:00,48,12,Alimento,2,60
10869,2024-01-08 13:08:00,61,82,Vestuário,3,143
10870,2024-01-08 13:09:00,12,100,Vestuário,7,112
10871,2024-01-08 13:10:00,85,84,Brinquedo,6,169
10872,2024-01-08 13:11:00,108,36,Vestuário,4,144
10873,2024-01-08 13:12:00,22,118,Alimento,6,140
10874,2024-01-08 13:13:00,89,158,Alimento,1,247
10875,2024-01-08 13:14:00,38,128,Eletrônico,2,166
10876,2024-01-08 13:15:00,54,36,Móvel,2,90
10877,2024-01-08 13:16:00,117,168,Eletrônico,2,285
10878,2024-01-08 13:17:00,52,73,Vestuário,2,125
10879,2024-01-08 13:18:00,95,136,Eletrônico,7,231
10880,2024-01-08 13:19:00,107,50,Alimento,9,157
10881,2024-01-08 13:20:00,17,32,Vestuário,3,49
10882,2024-01-08 13:21:00,49,179,Vestuário,3,228
10883,2024-01-08 13:22:00,25,149,Alimento,4,174
10884,2024-01-08 13:23:00,29,52,Alimento,2,81
10885,2024-01-08 13:24:00,113,135,Vestuário,6,248
10886,2024-01-08 13:25:00,89,75,Vestuário,7,164
10887,2024-01-08 13:26:00,101,48,Móvel,4,149
10888,2024-01-08 13:27:00,42,147,Móvel,8,189
10889,2024-01-08 13:28:00,52,101,Vestuário,8,153
10890,2024-01-08 13:29:00,53,83,Móvel,8,136
10891,2024-01-08 13:30:00,86,51,Brinquedo,7,137
10892,2024-01-08 13:31:00,79,40,Móvel,8,119
10893,2024-01-08 13:32:00,64,99,Brinquedo,2,163
10894,2024-01-08 13:33:00,49,155,Eletrônico,5,204
10895,2024-01-08 13:34:00,61,16,Brinquedo,5,77
10896,2024-01-08 13:35:00,108,27,Eletrônico,9,135
10897,2024-01-08 13:36:00,83,40,Eletrônico,5,123
10898,2024-01-08 13:37:00,19,44,Eletrônico,4,63
10899,2024-01-08 13:38:00,22,164,Brinquedo,7,186
10900,2024-01-08 13:39:00,38,148,Brinquedo,8,186
10901,2024-01-08 13:40:00,82,158,Vestuário,1,240
10902,2024-01-08 13:41:00,26,155,Alimento,3,181
10903,2024-01-08 13:42:00,42,44,Brinquedo,8,86
10904,2024-01-08 13:43:00,113,73,Brinquedo,2,186
10905,2024-01-08 13:44:00,77,12,Móvel,9,89
10906,2024-01-08 13:45:00,66,86,Brinquedo,9,152
10907,2024-01-08 13:46:00,44,76,Vestuário,7,120
10908,2024-01-08 13:47:00,46,114,Vestuário,4,160
10909,2024-01-08 13:48:00,67,103,Móvel,3,170
10910,2024-01-08 13:49:00,82,97,Móvel,1,179
10911,2024-01-08 13:50:00,83,21,Móvel,1,104
10912,2024-01-08 13:51:00,36,146,Brinquedo,9,182
10913,2024-01-08 13:52:00,93,119,Eletrônico,9,212
10914,2024-01-08 13:53:00,22,109,Móvel,3,131
10915,2024-01-08 13:54:00,47,128,Vestuário,4,175
10916,2024-01-08 13:55:00,119,141,Eletrônico,8,260
10917,2024-01-08 13:56:00,46,45,Alimento,5,91
10918,2024-01-08 13:57:00,108,15,Vestuário,4,123
10919,2024-01-08 13:58:00,108,98,Móvel,3,206
10920,2024-01-08 13:59:00,39,171,Vestuário,5,210
10921,2024-01-08 14:00:00,79,24,Brinquedo,9,103
10922,2024-01-08 14:01:00,106,117,Alimento,2,223
10923,2024-01-08 14:02:00,67,83,Brinquedo,8,150
10924,2024-01-08 14:03:00,21,110,Alimento,1,131
10925,2024-01-08 14:04:00,73,79,Alimento,8,152
10926,2024-01-08 14:05:00,69,146,Brinquedo,5,215
10927,2024-01-08 14:06:00,71,110,Alimento,5,181
10928,2024-01-08 14:07:00,32,54,Brinquedo,7,86
10929,2024-01-08 14:08:00,45,163,Eletrônico,9,208
10930,2024-01-08 14:09:00,36,100,Vestuário,2,136
10931,2024-01-08 14:10:00,65,171,Móvel,4,236
10932,2024-01-08 14:11:00,105,57,Móvel,4,162
10933,2024-01-08 14:12:00,90,167,Alimento,2,257
10934,2024-01-08 14:13:00,48,17,Alimento,2,65
10935,2024-01-08 14:14:00,47,110,Vestuário,3,157
10936,2024-01-08 14:15:00,19,115,Alimento,4,134
10937,2024-01-08 14:16:00,49,50,Móvel,6,99
10938,2024-01-08 14:17:00,70,171,Alimento,1,241
10939,2024-01-08 14:18:00,67,24,Vestuário,6,91
10940,2024-01-08 14:19:00,33,48,Móvel,3,81
10941,2024-01-08 14:20:00,69,121,Brinquedo,2,190
10942,2024-01-08 14:21:00,13,87,Móvel,4,100
10943,2024-01-08 14:22:00,83,84,Móvel,2,167
10944,2024-01-08 14:23:00,60,155,Vestuário,3,215
10945,2024-01-08 14:24:00,76,72,Eletrônico,7,148
10946,2024-01-08 14:25:00,26,93,Alimento,2,119
10947,2024-01-08 14:26:00,86,111,Móvel,3,197
10948,2024-01-08 14:27:00,75,122,Eletrônico,6,197
10949,2024-01-08 14:28:00,30,61,Brinquedo,7,91
10950,2024-01-08 14:29:00,43,33,Móvel,5,76
10951,2024-01-08 14:30:00,79,18,Vestuário,7,97
10952,2024-01-08 14:31:00,24,41,Brinquedo,5,65
10953,2024-01-08 14:32:00,61,38,Alimento,3,99
10954,2024-01-08 14:33:00,79,108,Vestuário,1,187
10955,2024-01-08 14:34:00,35,119,Vestuário,3,154
10956,2024-01-08 14:35:00,11,69,Vestuário,2,80
10957,2024-01-08 14:36:00,39,160,Alimento,4,199
10958,2024-01-08 14:37:00,71,100,Vestuário,2,171
10959,2024-01-08 14:38:00,31,109,Brinquedo,7,140
10960,2024-01-08 14:39:00,40,54,Vestuário,1,94
10961,2024-01-08 14:40:00,69,81,Brinquedo,4,150
10962,2024-01-08 14:41:00,106,41,Brinquedo,7,147
10963,2024-01-08 14:42:00,21,164,Alimento,1,185
10964,2024-01-08 14:43:00,109,12,Brinquedo,8,121
10965,2024-01-08 14:44:00,54,72,Alimento,9,126
10966,2024-01-08 14:45:00,90,105,Brinquedo,4,195
10967,2024-01-08 14:46:00,43,116,Vestuário,3,159
10968,2024-01-08 14:47:00,94,108,Vestuário,5,202
10969,2024-01-08 14:48:00,36,74,Vestuário,4,110
10970,2024-01-08 14:49:00,58,179,Móvel,6,237
10971,2024-01-08 14:50:00,27,17,Brinquedo,5,44
10972,2024-01-08 14:51:00,107,129,Eletrônico,1,236
10973,2024-01-08 14:52:00,110,38,Eletrônico,3,148
10974,2024-01-08 14:53:00,79,26,Brinquedo,7,105
10975,2024-01-08 14:54:00,76,110,Alimento,4,186
10976,2024-01-08 14:55:00,39,39,Vestuário,8,78
10977,2024-01-08 14:56:00,80,110,Móvel,2,190
10978,2024-01-08 14:57:00,12,70,Eletrônico,3,82
10979,2024-01-08 14:58:00,40,55,Eletrônico,2,95
10980,2024-01-08 14:59:00,32,81,Brinquedo,2,113
10981,2024-01-08 15:00:00,118,98,Móvel,5,216
10982,2024-01-08 15:01:00,103,64,Vestuário,8,167
10983,2024-01-08 15:02:00,70,31,Brinquedo,9,101
10984,2024-01-08 15:03:00,14,27,Alimento,3,41
10985,2024-01-08 15:04:00,89,51,Móvel,8,140
10986,2024-01-08 15:05:00,80,61,Eletrônico,5,141
10987,2024-01-08 15:06:00,39,15,Alimento,9,54
10988,2024-01-08 15:07:00,25,45,Móvel,6,70
10989,2024-01-08 15:08:00,51,169,Brinquedo,8,220
10990,2024-01-08 15:09:00,112,64,Vestuário,6,176
10991,2024-01-08 15:10:00,34,52,Móvel,2,86
10992,2024-01-08 15:11:00,43,48,Eletrônico,3,91
10993,2024-01-08 15:12:00,93,74,Vestuário,8,167
10994,2024-01-08 15:13:00,106,52,Eletrônico,5,158
10995,2024-01-08 15:14:00,73,151,Brinquedo,6,224
10996,2024-01-08 15:15:00,56,68,Vestuário,7,124
10997,2024-01-08 15:16:00,79,108,Vestuário,4,187
10998,2024-01-08 15:17:00,22,114,Alimento,3,136
10999,2024-01-08 15:18:00,88,118,Eletrônico,8,206
11000,2024-01-08 15:19:00,25,13,Móvel,9,38
11001,2024-01-08 15:20:00,86,135,Móvel,2,221
11002,2024-01-08 15:21:00,74,160,Brinquedo,9,234
11003,2024-01-08 15:22:00,57,173,Alimento,8,230
11004,2024-01-08 15:23:00,18,34,Brinquedo,1,52
11005,2024-01-08 15:24:00,67,137,Brinquedo,4,204
11006,2024-01-08 15:25:00,119,158,Brinquedo,3,277
11007,2024-01-08 15:26:00,45,49,Eletrônico,9,94
11008,2024-01-08 15:27:00,89,29,Vestuário,6,118
11009,2024-01-08 15:28:00,16,63,Eletrônico,4,79
11010,2024-01-08 15:29:00,65,46,Eletrônico,7,111
11011,2024-01-08 15:30:00,65,158,Brinquedo,2,223
11012,2024-01-08 15:31:00,119,79,Móvel,7,198
11013,2024-01-08 15:32:00,48,25,Alimento,6,73
11014,2024-01-08 15:33:00,80,83,Brinquedo,2,163
11015,2024-01-08 15:34:00,84,90,Móvel,8,174
11016,2024-01-08 15:35:00,58,39,Vestuário,7,97
11017,2024-01-08 15:36:00,113,129,Alimento,8,242
11018,2024-01-08 15:37:00,72,130,Alimento,9,202
11019,2024-01-08 15:38:00,65,168,Eletrônico,8,233
11020,2024-01-08 15:39:00,40,28,Alimento,1,68
11021,2024-01-08 15:40:00,92,141,Eletrônico,2,233
11022,2024-01-08 15:41:00,92,112,Alimento,8,204
11023,2024-01-08 15:42:00,111,13,Brinquedo,3,124
11024,2024-01-08 15:43:00,84,112,Móvel,8,196
11025,2024-01-08 15:44:00,87,161,Eletrônico,8,248
11026,2024-01-08 15:45:00,80,40,Brinquedo,9,120
11027,2024-01-08 15:46:00,42,164,Eletrônico,7,206
11028,2024-01-08 15:47:00,106,128,Eletrônico,7,234
11029,2024-01-08 15:48:00,100,126,Alimento,3,226
11030,2024-01-08 15:49:00,14,25,Vestuário,6,39
11031,2024-01-08 15:50:00,26,97,Vestuário,8,123
11032,2024-01-08 15:51:00,42,157,Móvel,7,199
11033,2024-01-08 15:52:00,69,11,Móvel,5,80
11034,2024-01-08 15:53:00,107,147,Alimento,2,254
11035,2024-01-08 15:54:00,19,63,Brinquedo,3,82
11036,2024-01-08 15:55:00,28,81,Eletrônico,6,109
11037,2024-01-08 15:56:00,80,151,Brinquedo,6,231
11038,2024-01-08 15:57:00,67,135,Vestuário,4,202
11039,2024-01-08 15:58:00,56,76,Vestuário,6,132
11040,2024-01-08 15:59:00,90,15,Alimento,1,105
11041,2024-01-08 16:00:00,61,114,Eletrônico,4,175
11042,2024-01-08 16:01:00,64,32,Móvel,9,96
11043,2024-01-08 16:02:00,21,60,Móvel,3,81
11044,2024-01-08 16:03:00,23,98,Eletrônico,5,121
11045,2024-01-08 16:04:00,99,25,Alimento,7,124
11046,2024-01-08 16:05:00,103,37,Móvel,9,140
11047,2024-01-08 16:06:00,112,69,Vestuário,4,181
11048,2024-01-08 16:07:00,58,177,Móvel,4,235
11049,2024-01-08 16:08:00,105,165,Móvel,2,270
11050,2024-01-08 16:09:00,92,31,Brinquedo,7,123
11051,2024-01-08 16:10:00,83,63,Alimento,8,146
11052,2024-01-08 16:11:00,40,177,Vestuário,3,217
11053,2024-01-08 16:12:00,92,82,Vestuário,9,174
11054,2024-01-08 16:13:00,83,169,Brinquedo,3,252
11055,2024-01-08 16:14:00,21,70,Alimento,8,91
11056,2024-01-08 16:15:00,78,78,Alimento,8,156
11057,2024-01-08 16:16:00,96,167,Brinquedo,8,263
11058,2024-01-08 16:17:00,114,70,Móvel,8,184
11059,2024-01-08 16:18:00,31,117,Brinquedo,4,148
11060,2024-01-08 16:19:00,43,159,Móvel,2,202
11061,2024-01-08 16:20:00,70,64,Vestuário,1,134
11062,2024-01-08 16:21:00,109,77,Alimento,1,186
11063,2024-01-08 16:22:00,35,10,Eletrônico,7,45
11064,2024-01-08 16:23:00,14,120,Móvel,6,134
11065,2024-01-08 16:24:00,34,85,Alimento,3,119
11066,2024-01-08 16:25:00,39,28,Vestuário,1,67
11067,2024-01-08 16:26:00,78,70,Brinquedo,4,148
11068,2024-01-08 16:27:00,10,57,Alimento,7,67
11069,2024-01-08 16:28:00,89,70,Vestuário,2,159
11070,2024-01-08 16:29:00,28,154,Eletrônico,3,182
11071,2024-01-08 16:30:00,19,64,Eletrônico,8,83
11072,2024-01-08 16:31:00,74,150,Eletrônico,3,224
11073,2024-01-08 16:32:00,44,162,Brinquedo,1,206
11074,2024-01-08 16:33:00,67,119,Móvel,9,186
11075,2024-01-08 16:34:00,39,27,Alimento,2,66
11076,2024-01-08 16:35:00,80,169,Vestuário,3,249
11077,2024-01-08 16:36:00,47,135,Vestuário,9,182
11078,2024-01-08 16:37:00,30,144,Eletrônico,1,174
11079,2024-01-08 16:38:00,21,92,Eletrônico,7,113
11080,2024-01-08 16:39:00,34,118,Alimento,3,152
11081,2024-01-08 16:40:00,42,28,Brinquedo,5,70
11082,2024-01-08 16:41:00,109,40,Brinquedo,2,149
11083,2024-01-08 16:42:00,57,136,Móvel,7,193
11084,2024-01-08 16:43:00,74,33,Vestuário,8,107
11085,2024-01-08 16:44:00,30,158,Vestuário,4,188
11086,2024-01-08 16:45:00,35,169,Brinquedo,7,204
11087,2024-01-08 16:46:00,76,49,Eletrônico,2,125
11088,2024-01-08 16:47:00,84,11,Vestuário,2,95
11089,2024-01-08 16:48:00,47,90,Brinquedo,5,137
11090,2024-01-08 16:49:00,26,112,Eletrônico,1,138
11091,2024-01-08 16:50:00,94,43,Móvel,8,137
11092,2024-01-08 16:51:00,104,119,Alimento,3,223
11093,2024-01-08 16:52:00,36,166,Eletrônico,1,202
11094,2024-01-08 16:53:00,31,23,Eletrônico,8,54
11095,2024-01-08 16:54:00,17,19,Vestuário,7,36
11096,2024-01-08 16:55:00,38,29,Móvel,1,67
11097,2024-01-08 16:56:00,16,85,Eletrônico,5,101
11098,2024-01-08 16:57:00,61,104,Eletrônico,7,165
11099,2024-01-08 16:58:00,117,84,Móvel,6,201
11100,2024-01-08 16:59:00,63,55,Móvel,6,118
11101,2024-01-08 17:00:00,87,146,Vestuário,8,233
11102,2024-01-08 17:01:00,110,131,Brinquedo,2,241
11103,2024-01-08 17:02:00,88,172,Vestuário,8,260
11104,2024-01-08 17:03:00,56,24,Brinquedo,8,80
11105,2024-01-08 17:04:00,56,92,Eletrônico,8,148
11106,2024-01-08 17:05:00,89,45,Brinquedo,2,134
11107,2024-01-08 17:06:00,63,151,Eletrônico,6,214
11108,2024-01-08 17:07:00,97,161,Eletrônico,8,258
11109,2024-01-08 17:08:00,28,78,Alimento,5,106
11110,2024-01-08 17:09:00,52,27,Vestuário,3,79
11111,2024-01-08 17:10:00,38,59,Vestuário,1,97
11112,2024-01-08 17:11:00,36,139,Alimento,8,175
11113,2024-01-08 17:12:00,87,138,Móvel,1,225
11114,2024-01-08 17:13:00,58,105,Alimento,6,163
11115,2024-01-08 17:14:00,31,97,Móvel,7,128
11116,2024-01-08 17:15:00,11,143,Alimento,2,154
11117,2024-01-08 17:16:00,93,83,Móvel,2,176
11118,2024-01-08 17:17:00,42,48,Eletrônico,3,90
11119,2024-01-08 17:18:00,77,167,Móvel,5,244
11120,2024-01-08 17:19:00,73,29,Móvel,4,102
11121,2024-01-08 17:20:00,44,70,Móvel,4,114
11122,2024-01-08 17:21:00,30,80,Alimento,3,110
11123,2024-01-08 17:22:00,99,52,Brinquedo,6,151
11124,2024-01-08 17:23:00,85,104,Vestuário,9,189
11125,2024-01-08 17:24:00,28,28,Eletrônico,7,56
11126,2024-01-08 17:25:00,29,49,Móvel,7,78
11127,2024-01-08 17:26:00,116,18,Eletrônico,7,134
11128,2024-01-08 17:27:00,50,152,Eletrônico,3,202
11129,2024-01-08 17:28:00,54,133,Brinquedo,5,187
11130,2024-01-08 17:29:00,15,13,Vestuário,4,28
11131,2024-01-08 17:30:00,44,112,Vestuário,1,156
11132,2024-01-08 17:31:00,78,127,Vestuário,7,205
11133,2024-01-08 17:32:00,71,72,Vestuário,8,143
11134,2024-01-08 17:33:00,108,168,Eletrônico,1,276
11135,2024-01-08 17:34:00,69,40,Brinquedo,6,109
11136,2024-01-08 17:35:00,92,67,Eletrônico,3,159
11137,2024-01-08 17:36:00,13,121,Alimento,8,134
11138,2024-01-08 17:37:00,77,93,Brinquedo,8,170
11139,2024-01-08 17:38:00,63,85,Móvel,2,148
11140,2024-01-08 17:39:00,76,70,Vestuário,3,146
11141,2024-01-08 17:40:00,29,179,Móvel,3,208
11142,2024-01-08 17:41:00,77,17,Alimento,5,94
11143,2024-01-08 17:42:00,44,82,Alimento,6,126
11144,2024-01-08 17:43:00,92,151,Móvel,2,243
11145,2024-01-08 17:44:00,73,138,Brinquedo,4,211
11146,2024-01-08 17:45:00,102,90,Móvel,8,192
11147,2024-01-08 17:46:00,73,64,Brinquedo,9,137
11148,2024-01-08 17:47:00,98,60,Eletrônico,5,158
11149,2024-01-08 17:48:00,96,61,Brinquedo,2,157
11150,2024-01-08 17:49:00,83,102,Eletrônico,4,185
11151,2024-01-08 17:50:00,76,135,Móvel,1,211
11152,2024-01-08 17:51:00,89,93,Alimento,5,182
11153,2024-01-08 17:52:00,65,15,Móvel,7,80
11154,2024-01-08 17:53:00,100,84,Vestuário,3,184
11155,2024-01-08 17:54:00,17,78,Brinquedo,1,95
11156,2024-01-08 17:55:00,11,153,Brinquedo,3,164
11157,2024-01-08 17:56:00,112,123,Vestuário,7,235
11158,2024-01-08 17:57:00,118,50,Vestuário,4,168
11159,2024-01-08 17:58:00,114,14,Eletrônico,4,128
11160,2024-01-08 17:59:00,57,65,Alimento,3,122
11161,2024-01-08 18:00:00,96,24,Móvel,5,120
11162,2024-01-08 18:01:00,69,148,Vestuário,7,217
11163,2024-01-08 18:02:00,87,28,Móvel,7,115
11164,2024-01-08 18:03:00,118,34,Vestuário,1,152
11165,2024-01-08 18:04:00,39,165,Móvel,5,204
11166,2024-01-08 18:05:00,64,98,Móvel,9,162
11167,2024-01-08 18:06:00,83,177,Eletrônico,3,260
11168,2024-01-08 18:07:00,50,43,Alimento,5,93
11169,2024-01-08 18:08:00,78,10,Brinquedo,4,88
11170,2024-01-08 18:09:00,64,103,Móvel,8,167
11171,2024-01-08 18:10:00,67,75,Alimento,7,142
11172,2024-01-08 18:11:00,79,106,Brinquedo,7,185
11173,2024-01-08 18:12:00,87,179,Vestuário,5,266
11174,2024-01-08 18:13:00,46,162,Alimento,4,208
11175,2024-01-08 18:14:00,59,32,Alimento,1,91
11176,2024-01-08 18:15:00,20,30,Móvel,7,50
11177,2024-01-08 18:16:00,70,117,Alimento,9,187
11178,2024-01-08 18:17:00,23,130,Eletrônico,2,153
11179,2024-01-08 18:18:00,57,109,Eletrônico,2,166
11180,2024-01-08 18:19:00,90,100,Eletrônico,5,190
11181,2024-01-08 18:20:00,82,67,Eletrônico,1,149
11182,2024-01-08 18:21:00,56,152,Vestuário,1,208
11183,2024-01-08 18:22:00,29,179,Vestuário,9,208
11184,2024-01-08 18:23:00,66,94,Móvel,7,160
11185,2024-01-08 18:24:00,41,102,Eletrônico,5,143
11186,2024-01-08 18:25:00,65,95,Eletrônico,3,160
11187,2024-01-08 18:26:00,31,171,Eletrônico,3,202
11188,2024-01-08 18:27:00,101,99,Alimento,1,200
11189,2024-01-08 18:28:00,75,139,Móvel,7,214
11190,2024-01-08 18:29:00,43,164,Vestuário,7,207
11191,2024-01-08 18:30:00,53,162,Vestuário,9,215
11192,2024-01-08 18:31:00,15,118,Eletrônico,2,133
11193,2024-01-08 18:32:00,11,56,Móvel,7,67
11194,2024-01-08 18:33:00,23,110,Vestuário,5,133
11195,2024-01-08 18:34:00,16,52,Brinquedo,2,68
11196,2024-01-08 18:35:00,57,27,Vestuário,4,84
11197,2024-01-08 18:36:00,112,30,Alimento,5,142
11198,2024-01-08 18:37:00,92,53,Eletrônico,8,145
11199,2024-01-08 18:38:00,74,145,Alimento,6,219
11200,2024-01-08 18:39:00,119,140,Alimento,9,259
11201,2024-01-08 18:40:00,47,59,Eletrônico,3,106
11202,2024-01-08 18:41:00,104,135,Móvel,1,239
11203,2024-01-08 18:42:00,90,68,Vestuário,1,158
11204,2024-01-08 18:43:00,44,137,Eletrônico,3,181
11205,2024-01-08 18:44:00,100,12,Vestuário,2,112
11206,2024-01-08 18:45:00,112,84,Brinquedo,3,196
11207,2024-01-08 18:46:00,59,71,Móvel,2,130
11208,2024-01-08 18:47:00,57,116,Brinquedo,4,173
11209,2024-01-08 18:48:00,110,13,Brinquedo,1,123
11210,2024-01-08 18:49:00,52,148,Vestuário,4,200
11211,2024-01-08 18:50:00,60,179,Vestuário,9,239
11212,2024-01-08 18:51:00,90,70,Móvel,2,160
11213,2024-01-08 18:52:00,117,26,Vestuário,5,143
11214,2024-01-08 18:53:00,87,17,Alimento,5,104
11215,2024-01-08 18:54:00,91,126,Vestuário,1,217
11216,2024-01-08 18:55:00,24,98,Móvel,6,122
11217,2024-01-08 18:56:00,112,175,Eletrônico,4,287
11218,2024-01-08 18:57:00,93,178,Brinquedo,9,271
11219,2024-01-08 18:58:00,80,75,Vestuário,8,155
11220,2024-01-08 18:59:00,62,56,Brinquedo,1,118
11221,2024-01-08 19:00:00,78,126,Eletrônico,3,204
11222,2024-01-08 19:01:00,29,117,Móvel,8,146
11223,2024-01-08 19:02:00,113,97,Brinquedo,6,210
11224,2024-01-08 19:03:00,22,93,Vestuário,1,115
11225,2024-01-08 19:04:00,13,138,Vestuário,2,151
11226,2024-01-08 19:05:00,89,48,Brinquedo,5,137
11227,2024-01-08 19:06:00,35,158,Móvel,8,193
11228,2024-01-08 19:07:00,15,171,Brinquedo,3,186
11229,2024-01-08 19:08:00,107,14,Móvel,5,121
11230,2024-01-08 19:09:00,18,91,Móvel,3,109
11231,2024-01-08 19:10:00,76,27,Vestuário,1,103
11232,2024-01-08 19:11:00,35,178,Alimento,2,213
11233,2024-01-08 19:12:00,103,154,Brinquedo,8,257
11234,2024-01-08 19:13:00,96,127,Vestuário,6,223
11235,2024-01-08 19:14:00,107,138,Brinquedo,6,245
11236,2024-01-08 19:15:00,59,16,Eletrônico,1,75
11237,2024-01-08 19:16:00,84,165,Brinquedo,8,249
11238,2024-01-08 19:17:00,46,152,Brinquedo,9,198
11239,2024-01-08 19:18:00,57,58,Brinquedo,7,115
11240,2024-01-08 19:19:00,108,140,Vestuário,5,248
11241,2024-01-08 19:20:00,41,100,Móvel,2,141
11242,2024-01-08 19:21:00,93,78,Alimento,4,171
11243,2024-01-08 19:22:00,88,41,Alimento,8,129
11244,2024-01-08 19:23:00,56,137,Brinquedo,3,193
11245,2024-01-08 19:24:00,78,14,Eletrônico,3,92
11246,2024-01-08 19:25:00,50,147,Móvel,4,197
11247,2024-01-08 19:26:00,65,51,Brinquedo,7,116
11248,2024-01-08 19:27:00,44,157,Eletrônico,8,201
11249,2024-01-08 19:28:00,59,99,Eletrônico,9,158
11250,2024-01-08 19:29:00,47,145,Eletrônico,4,192
11251,2024-01-08 19:30:00,24,33,Brinquedo,3,57
11252,2024-01-08 19:31:00,49,14,Brinquedo,2,63
11253,2024-01-08 19:32:00,45,23,Eletrônico,6,68
11254,2024-01-08 19:33:00,91,45,Móvel,2,136
11255,2024-01-08 19:34:00,70,148,Móvel,9,218
11256,2024-01-08 19:35:00,34,35,Brinquedo,2,69
11257,2024-01-08 19:36:00,57,25,Vestuário,5,82
11258,2024-01-08 19:37:00,72,122,Móvel,9,194
11259,2024-01-08 19:38:00,106,31,Móvel,6,137
11260,2024-01-08 19:39:00,94,176,Brinquedo,8,270
11261,2024-01-08 19:40:00,12,86,Móvel,3,98
11262,2024-01-08 19:41:00,11,11,Brinquedo,9,22
11263,2024-01-08 19:42:00,22,13,Eletrônico,9,35
11264,2024-01-08 19:43:00,17,99,Móvel,4,116
11265,2024-01-08 19:44:00,61,159,Móvel,3,220
11266,2024-01-08 19:45:00,51,174,Móvel,9,225
11267,2024-01-08 19:46:00,18,107,Alimento,1,125
11268,2024-01-08 19:47:00,48,102,Móvel,4,150
11269,2024-01-08 19:48:00,107,25,Alimento,1,132
11270,2024-01-08 19:49:00,113,166,Vestuário,7,279
11271,2024-01-08 19:50:00,12,147,Eletrônico,6,159
11272,2024-01-08 19:51:00,76,114,Alimento,5,190
11273,2024-01-08 19:52:00,40,170,Eletrônico,1,210
11274,2024-01-08 19:53:00,12,95,Alimento,9,107
11275,2024-01-08 19:54:00,54,52,Móvel,1,106
11276,2024-01-08 19:55:00,46,46,Vestuário,2,92
11277,2024-01-08 19:56:00,33,79,Vestuário,4,112
11278,2024-01-08 19:57:00,13,153,Alimento,4,166
11279,2024-01-08 19:58:00,81,102,Eletrônico,9,183
11280,2024-01-08 19:59:00,31,50,Móvel,1,81
11281,2024-01-08 20:00:00,74,10,Eletrônico,7,84
11282,2024-01-08 20:01:00,42,94,Alimento,7,136
11283,2024-01-08 20:02:00,55,111,Alimento,2,166
11284,2024-01-08 20:03:00,100,47,Alimento,4,147
11285,2024-01-08 20:04:00,65,123,Móvel,5,188
11286,2024-01-08 20:05:00,65,122,Alimento,7,187
11287,2024-01-08 20:06:00,108,27,Vestuário,2,135
11288,2024-01-08 20:07:00,28,23,Móvel,8,51
11289,2024-01-08 20:08:00,96,171,Alimento,5,267
11290,2024-01-08 20:09:00,52,115,Eletrônico,1,167
11291,2024-01-08 20:10:00,39,130,Alimento,4,169
11292,2024-01-08 20:11:00,99,29,Alimento,7,128
11293,2024-01-08 20:12:00,52,177,Móvel,6,229
11294,2024-01-08 20:13:00,62,96,Vestuário,5,158
11295,2024-01-08 20:14:00,76,66,Brinquedo,7,142
11296,2024-01-08 20:15:00,96,13,Vestuário,7,109
11297,2024-01-08 20:16:00,91,30,Móvel,9,121
11298,2024-01-08 20:17:00,31,134,Alimento,5,165
11299,2024-01-08 20:18:00,42,127,Eletrônico,6,169
11300,2024-01-08 20:19:00,34,83,Eletrônico,2,117
11301,2024-01-08 20:20:00,103,16,Móvel,1,119
11302,2024-01-08 20:21:00,74,151,Alimento,6,225
11303,2024-01-08 20:22:00,37,154,Eletrônico,4,191
11304,2024-01-08 20:23:00,79,54,Brinquedo,6,133
11305,2024-01-08 20:24:00,110,49,Eletrônico,1,159
11306,2024-01-08 20:25:00,67,65,Vestuário,6,132
11307,2024-01-08 20:26:00,115,116,Eletrônico,6,231
11308,2024-01-08 20:27:00,32,122,Móvel,2,154
11309,2024-01-08 20:28:00,104,19,Eletrônico,6,123
11310,2024-01-08 20:29:00,92,58,Alimento,2,150
11311,2024-01-08 20:30:00,104,136,Eletrônico,1,240
11312,2024-01-08 20:31:00,34,79,Móvel,1,113
11313,2024-01-08 20:32:00,83,106,Vestuário,7,189
11314,2024-01-08 20:33:00,89,64,Vestuário,6,153
11315,2024-01-08 20:34:00,59,69,Vestuário,4,128
11316,2024-01-08 20:35:00,94,105,Alimento,9,199
11317,2024-01-08 20:36:00,81,31,Brinquedo,7,112
11318,2024-01-08 20:37:00,31,140,Vestuário,3,171
11319,2024-01-08 20:38:00,112,69,Vestuário,6,181
11320,2024-01-08 20:39:00,41,65,Eletrônico,3,106
11321,2024-01-08 20:40:00,100,128,Alimento,5,228
11322,2024-01-08 20:41:00,52,108,Vestuário,3,160
11323,2024-01-08 20:42:00,56,16,Vestuário,5,72
11324,2024-01-08 20:43:00,56,49,Eletrônico,6,105
11325,2024-01-08 20:44:00,80,178,Eletrônico,6,258
11326,2024-01-08 20:45:00,117,87,Vestuário,6,204
11327,2024-01-08 20:46:00,101,32,Brinquedo,1,133
11328,2024-01-08 20:47:00,107,161,Eletrônico,4,268
11329,2024-01-08 20:48:00,40,22,Móvel,4,62
11330,2024-01-08 20:49:00,97,22,Brinquedo,2,119
11331,2024-01-08 20:50:00,36,15,Brinquedo,9,51
11332,2024-01-08 20:51:00,100,146,Vestuário,5,246
11333,2024-01-08 20:52:00,29,151,Brinquedo,3,180
11334,2024-01-08 20:53:00,32,111,Alimento,8,143
11335,2024-01-08 20:54:00,116,10,Móvel,5,126
11336,2024-01-08 20:55:00,63,115,Móvel,8,178
11337,2024-01-08 20:56:00,111,155,Brinquedo,4,266
11338,2024-01-08 20:57:00,113,15,Eletrônico,4,128
11339,2024-01-08 20:58:00,113,115,Eletrônico,3,228
11340,2024-01-08 20:59:00,10,126,Móvel,9,136
11341,2024-01-08 21:00:00,41,87,Brinquedo,7,128
11342,2024-01-08 21:01:00,41,174,Brinquedo,1,215
11343,2024-01-08 21:02:00,92,68,Móvel,2,160
11344,2024-01-08 21:03:00,68,162,Móvel,4,230
11345,2024-01-08 21:04:00,72,45,Móvel,3,117
11346,2024-01-08 21:05:00,55,15,Eletrônico,8,70
11347,2024-01-08 21:06:00,88,104,Móvel,8,192
11348,2024-01-08 21:07:00,90,74,Eletrônico,1,164
11349,2024-01-08 21:08:00,62,54,Móvel,6,116
11350,2024-01-08 21:09:00,17,148,Brinquedo,6,165
11351,2024-01-08 21:10:00,109,30,Alimento,9,139
11352,2024-01-08 21:11:00,116,104,Brinquedo,2,220
11353,2024-01-08 21:12:00,87,128,Brinquedo,4,215
11354,2024-01-08 21:13:00,102,105,Móvel,7,207
11355,2024-01-08 21:14:00,50,100,Vestuário,8,150
11356,2024-01-08 21:15:00,100,60,Eletrônico,5,160
11357,2024-01-08 21:16:00,22,44,Brinquedo,8,66
11358,2024-01-08 21:17:00,84,174,Vestuário,7,258
11359,2024-01-08 21:18:00,43,125,Brinquedo,2,168
11360,2024-01-08 21:19:00,49,151,Alimento,5,200
11361,2024-01-08 21:20:00,38,81,Brinquedo,5,119
11362,2024-01-08 21:21:00,57,24,Móvel,7,81
11363,2024-01-08 21:22:00,106,128,Eletrônico,7,234
11364,2024-01-08 21:23:00,103,122,Móvel,2,225
11365,2024-01-08 21:24:00,39,96,Brinquedo,6,135
11366,2024-01-08 21:25:00,28,156,Eletrônico,3,184
11367,2024-01-08 21:26:00,101,67,Eletrônico,9,168
11368,2024-01-08 21:27:00,10,104,Vestuário,1,114
11369,2024-01-08 21:28:00,104,67,Móvel,1,171
11370,2024-01-08 21:29:00,100,100,Móvel,2,200
11371,2024-01-08 21:30:00,86,18,Alimento,2,104
11372,2024-01-08 21:31:00,21,154,Vestuário,1,175
11373,2024-01-08 21:32:00,33,57,Vestuário,1,90
11374,2024-01-08 21:33:00,14,52,Brinquedo,3,66
11375,2024-01-08 21:34:00,39,170,Alimento,9,209
11376,2024-01-08 21:35:00,49,33,Alimento,5,82
11377,2024-01-08 21:36:00,25,85,Alimento,6,110
11378,2024-01-08 21:37:00,54,170,Móvel,1,224
11379,2024-01-08 21:38:00,17,166,Brinquedo,5,183
11380,2024-01-08 21:39:00,93,101,Vestuário,3,194
11381,2024-01-08 21:40:00,35,15,Alimento,3,50
11382,2024-01-08 21:41:00,80,61,Alimento,8,141
11383,2024-01-08 21:42:00,84,77,Vestuário,2,161
11384,2024-01-08 21:43:00,65,71,Eletrônico,7,136
11385,2024-01-08 21:44:00,62,113,Brinquedo,8,175
11386,2024-01-08 21:45:00,76,110,Brinquedo,4,186
11387,2024-01-08 21:46:00,73,34,Alimento,5,107
11388,2024-01-08 21:47:00,19,156,Vestuário,7,175
11389,2024-01-08 21:48:00,45,176,Alimento,9,221
11390,2024-01-08 21:49:00,15,90,Vestuário,6,105
11391,2024-01-08 21:50:00,117,106,Brinquedo,4,223
11392,2024-01-08 21:51:00,55,74,Brinquedo,6,129
11393,2024-01-08 21:52:00,16,111,Vestuário,1,127
11394,2024-01-08 21:53:00,70,108,Brinquedo,2,178
11395,2024-01-08 21:54:00,36,99,Eletrônico,3,135
11396,2024-01-08 21:55:00,43,152,Vestuário,6,195
11397,2024-01-08 21:56:00,114,69,Móvel,3,183
11398,2024-01-08 21:57:00,92,131,Brinquedo,9,223
11399,2024-01-08 21:58:00,115,89,Móvel,6,204
11400,2024-01-08 21:59:00,22,28,Móvel,4,50
11401,2024-01-08 22:00:00,29,146,Brinquedo,2,175
11402,2024-01-08 22:01:00,43,47,Vestuário,9,90
11403,2024-01-08 22:02:00,59,78,Vestuário,7,137
11404,2024-01-08 22:03:00,45,176,Brinquedo,8,221
11405,2024-01-08 22:04:00,23,51,Brinquedo,7,74
11406,2024-01-08 22:05:00,39,57,Móvel,4,96
11407,2024-01-08 22:06:00,34,40,Móvel,6,74
11408,2024-01-08 22:07:00,67,32,Móvel,6,99
11409,2024-01-08 22:08:00,37,134,Móvel,2,171
11410,2024-01-08 22:09:00,50,25,Eletrônico,8,75
11411,2024-01-08 22:10:00,58,168,Móvel,7,226
11412,2024-01-08 22:11:00,20,17,Vestuário,8,37
11413,2024-01-08 22:12:00,103,149,Eletrônico,3,252
11414,2024-01-08 22:13:00,71,52,Eletrônico,3,123
11415,2024-01-08 22:14:00,16,87,Vestuário,1,103
11416,2024-01-08 22:15:00,27,74,Brinquedo,8,101
11417,2024-01-08 22:16:00,84,36,Móvel,3,120
11418,2024-01-08 22:17:00,119,119,Móvel,2,238
11419,2024-01-08 22:18:00,85,60,Vestuário,4,145
11420,2024-01-08 22:19:00,88,169,Vestuário,7,257
11421,2024-01-08 22:20:00,22,10,Brinquedo,4,32
11422,2024-01-08 22:21:00,60,172,Alimento,6,232
11423,2024-01-08 22:22:00,65,26,Vestuário,6,91
11424,2024-01-08 22:23:00,46,78,Eletrônico,3,124
11425,2024-01-08 22:24:00,108,33,Eletrônico,6,141
11426,2024-01-08 22:25:00,81,111,Brinquedo,6,192
11427,2024-01-08 22:26:00,76,74,Vestuário,1,150
11428,2024-01-08 22:27:00,38,142,Móvel,2,180
11429,2024-01-08 22:28:00,12,55,Móvel,6,67
11430,2024-01-08 22:29:00,69,138,Vestuário,9,207
11431,2024-01-08 22:30:00,33,17,Móvel,8,50
11432,2024-01-08 22:31:00,24,78,Vestuário,8,102
11433,2024-01-08 22:32:00,63,50,Brinquedo,6,113
11434,2024-01-08 22:33:00,103,49,Eletrônico,4,152
11435,2024-01-08 22:34:00,34,32,Vestuário,6,66
11436,2024-01-08 22:35:00,85,56,Móvel,5,141
11437,2024-01-08 22:36:00,48,16,Eletrônico,2,64
11438,2024-01-08 22:37:00,84,15,Eletrônico,1,99
11439,2024-01-08 22:38:00,15,162,Eletrônico,2,177
11440,2024-01-08 22:39:00,80,87,Vestuário,9,167
11441,2024-01-08 22:40:00,42,45,Vestuário,9,87
11442,2024-01-08 22:41:00,72,42,Alimento,9,114
11443,2024-01-08 22:42:00,13,176,Brinquedo,2,189
11444,2024-01-08 22:43:00,44,98,Móvel,7,142
11445,2024-01-08 22:44:00,23,74,Móvel,9,97
11446,2024-01-08 22:45:00,69,167,Brinquedo,6,236
11447,2024-01-08 22:46:00,23,105,Eletrônico,6,128
11448,2024-01-08 22:47:00,116,69,Brinquedo,9,185
11449,2024-01-08 22:48:00,82,123,Alimento,7,205
11450,2024-01-08 22:49:00,51,90,Móvel,2,141
11451,2024-01-08 22:50:00,39,153,Brinquedo,4,192
11452,2024-01-08 22:51:00,61,15,Eletrônico,2,76
11453,2024-01-08 22:52:00,119,45,Eletrônico,7,164
11454,2024-01-08 22:53:00,66,125,Alimento,1,191
11455,2024-01-08 22:54:00,61,133,Eletrônico,5,194
11456,2024-01-08 22:55:00,115,69,Eletrônico,8,184
11457,2024-01-08 22:56:00,98,48,Vestuário,5,146
11458,2024-01-08 22:57:00,111,63,Brinquedo,4,174
11459,2024-01-08 22:58:00,85,168,Eletrônico,1,253
11460,2024-01-08 22:59:00,55,179,Brinquedo,9,234
11461,2024-01-08 23:00:00,22,10,Alimento,3,32
11462,2024-01-08 23:01:00,101,112,Eletrônico,3,213
11463,2024-01-08 23:02:00,85,56,Alimento,6,141
11464,2024-01-08 23:03:00,35,121,Eletrônico,6,156
11465,2024-01-08 23:04:00,34,114,Alimento,2,148
11466,2024-01-08 23:05:00,89,89,Móvel,1,178
11467,2024-01-08 23:06:00,117,158,Móvel,8,275
11468,2024-01-08 23:07:00,28,141,Eletrônico,4,169
11469,2024-01-08 23:08:00,93,45,Brinquedo,5,138
11470,2024-01-08 23:09:00,63,171,Brinquedo,3,234
11471,2024-01-08 23:10:00,34,90,Alimento,2,124
11472,2024-01-08 23:11:00,32,61,Vestuário,6,93
11473,2024-01-08 23:12:00,83,24,Móvel,4,107
11474,2024-01-08 23:13:00,40,174,Eletrônico,3,214
11475,2024-01-08 23:14:00,20,135,Alimento,1,155
11476,2024-01-08 23:15:00,93,163,Eletrônico,7,256
11477,2024-01-08 23:16:00,14,40,Móvel,6,54
11478,2024-01-08 23:17:00,95,78,Brinquedo,4,173
11479,2024-01-08 23:18:00,114,179,Eletrônico,6,293
11480,2024-01-08 23:19:00,88,15,Vestuário,4,103
11481,2024-01-08 23:20:00,73,118,Alimento,9,191
11482,2024-01-08 23:21:00,46,165,Móvel,4,211
11483,2024-01-08 23:22:00,77,90,Vestuário,3,167
11484,2024-01-08 23:23:00,119,59,Eletrônico,8,178
11485,2024-01-08 23:24:00,79,97,Brinquedo,9,176
11486,2024-01-08 23:25:00,66,56,Eletrônico,8,122
11487,2024-01-08 23:26:00,114,18,Móvel,3,132
11488,2024-01-08 23:27:00,41,59,Eletrônico,7,100
11489,2024-01-08 23:28:00,94,118,Vestuário,6,212
11490,2024-01-08 23:29:00,64,79,Móvel,7,143
11491,2024-01-08 23:30:00,100,156,Brinquedo,1,256
11492,2024-01-08 23:31:00,36,138,Vestuário,2,174
11493,2024-01-08 23:32:00,11,48,Vestuário,8,59
11494,2024-01-08 23:33:00,110,141,Móvel,4,251
11495,2024-01-08 23:34:00,38,69,Alimento,8,107
11496,2024-01-08 23:35:00,52,124,Brinquedo,4,176
11497,2024-01-08 23:36:00,37,82,Vestuário,9,119
11498,2024-01-08 23:37:00,93,99,Eletrônico,7,192
11499,2024-01-08 23:38:00,38,56,Alimento,4,94
11500,2024-01-08 23:39:00,70,103,Móvel,3,173
11501,2024-01-08 23:40:00,57,171,Alimento,9,228
11502,2024-01-08 23:41:00,35,153,Vestuário,7,188
11503,2024-01-08 23:42:00,39,16,Eletrônico,9,55
11504,2024-01-08 23:43:00,10,153,Móvel,6,163
11505,2024-01-08 23:44:00,26,81,Móvel,6,107
11506,2024-01-08 23:45:00,102,48,Alimento,5,150
11507,2024-01-08 23:46:00,32,102,Eletrônico,8,134
11508,2024-01-08 23:47:00,96,87,Brinquedo,7,183
11509,2024-01-08 23:48:00,64,95,Eletrônico,1,159
11510,2024-01-08 23:49:00,93,23,Vestuário,8,116
11511,2024-01-08 23:50:00,15,162,Móvel,7,177
11512,2024-01-08 23:51:00,53,40,Eletrônico,3,93
11513,2024-01-08 23:52:00,52,45,Alimento,6,97
11514,2024-01-08 23:53:00,71,131,Vestuário,3,202
11515,2024-01-08 23:54:00,35,93,Brinquedo,1,128
11516,2024-01-08 23:55:00,37,95,Alimento,2,132
11517,2024-01-08 23:56:00,65,42,Brinquedo,3,107
11518,2024-01-08 23:57:00,10,144,Brinquedo,9,154
11519,2024-01-08 23:58:00,118,128,Brinquedo,3,246
11520,2024-01-08 23:59:00,18,49,Vestuário,1,67
11521,2024-01-09 00:00:00,108,140,Eletrônico,7,248
11522,2024-01-09 00:01:00,66,57,Vestuário,7,123
11523,2024-01-09 00:02:00,57,129,Eletrônico,5,186
11524,2024-01-09 00:03:00,32,128,Alimento,9,160
11525,2024-01-09 00:04:00,51,49,Vestuário,6,100
11526,2024-01-09 00:05:00,35,69,Eletrônico,8,104
11527,2024-01-09 00:06:00,95,168,Vestuário,6,263
11528,2024-01-09 00:07:00,38,146,Eletrônico,1,184
11529,2024-01-09 00:08:00,105,135,Alimento,2,240
11530,2024-01-09 00:09:00,59,145,Móvel,8,204
11531,2024-01-09 00:10:00,66,134,Móvel,9,200
11532,2024-01-09 00:11:00,43,44,Brinquedo,3,87
11533,2024-01-09 00:12:00,87,127,Vestuário,8,214
11534,2024-01-09 00:13:00,75,71,Alimento,4,146
11535,2024-01-09 00:14:00,65,101,Vestuário,2,166
11536,2024-01-09 00:15:00,116,50,Alimento,9,166
11537,2024-01-09 00:16:00,115,154,Alimento,3,269
11538,2024-01-09 00:17:00,22,172,Alimento,7,194
11539,2024-01-09 00:18:00,103,138,Alimento,1,241
11540,2024-01-09 00:19:00,55,151,Eletrônico,3,206
11541,2024-01-09 00:20:00,83,46,Eletrônico,7,129
11542,2024-01-09 00:21:00,110,42,Eletrônico,1,152
11543,2024-01-09 00:22:00,20,91,Vestuário,8,111
11544,2024-01-09 00:23:00,72,31,Eletrônico,7,103
11545,2024-01-09 00:24:00,100,71,Alimento,9,171
11546,2024-01-09 00:25:00,49,22,Móvel,4,71
11547,2024-01-09 00:26:00,34,40,Eletrônico,8,74
11548,2024-01-09 00:27:00,84,18,Alimento,7,102
11549,2024-01-09 00:28:00,71,82,Eletrônico,1,153
11550,2024-01-09 00:29:00,18,151,Vestuário,8,169
11551,2024-01-09 00:30:00,19,37,Móvel,3,56
11552,2024-01-09 00:31:00,103,13,Móvel,1,116
11553,2024-01-09 00:32:00,57,77,Móvel,8,134
11554,2024-01-09 00:33:00,63,130,Alimento,1,193
11555,2024-01-09 00:34:00,70,66,Móvel,6,136
11556,2024-01-09 00:35:00,107,105,Brinquedo,8,212
11557,2024-01-09 00:36:00,119,111,Brinquedo,4,230
11558,2024-01-09 00:37:00,44,143,Brinquedo,8,187
11559,2024-01-09 00:38:00,96,81,Móvel,3,177
11560,2024-01-09 00:39:00,95,170,Eletrônico,3,265
11561,2024-01-09 00:40:00,20,135,Brinquedo,5,155
11562,2024-01-09 00:41:00,17,103,Vestuário,7,120
11563,2024-01-09 00:42:00,109,84,Brinquedo,9,193
11564,2024-01-09 00:43:00,114,147,Alimento,8,261
11565,2024-01-09 00:44:00,91,36,Eletrônico,7,127
11566,2024-01-09 00:45:00,92,76,Eletrônico,5,168
11567,2024-01-09 00:46:00,81,30,Vestuário,8,111
11568,2024-01-09 00:47:00,99,30,Brinquedo,6,129
11569,2024-01-09 00:48:00,48,98,Eletrônico,8,146
11570,2024-01-09 00:49:00,52,132,Brinquedo,2,184
11571,2024-01-09 00:50:00,30,164,Brinquedo,2,194
11572,2024-01-09 00:51:00,50,103,Vestuário,6,153
11573,2024-01-09 00:52:00,56,15,Móvel,7,71
11574,2024-01-09 00:53:00,89,24,Vestuário,8,113
11575,2024-01-09 00:54:00,64,131,Brinquedo,5,195
11576,2024-01-09 00:55:00,91,66,Brinquedo,4,157
11577,2024-01-09 00:56:00,119,31,Vestuário,8,150
11578,2024-01-09 00:57:00,21,34,Eletrônico,8,55
11579,2024-01-09 00:58:00,20,117,Brinquedo,7,137
11580,2024-01-09 00:59:00,95,164,Vestuário,3,259
11581,2024-01-09 01:00:00,57,124,Eletrônico,9,181
11582,2024-01-09 01:01:00,12,72,Vestuário,9,84
11583,2024-01-09 01:02:00,75,94,Eletrônico,3,169
11584,2024-01-09 01:03:00,103,62,Vestuário,4,165
11585,2024-01-09 01:04:00,117,106,Eletrônico,6,223
11586,2024-01-09 01:05:00,110,54,Móvel,4,164
11587,2024-01-09 01:06:00,114,48,Eletrônico,1,162
11588,2024-01-09 01:07:00,27,97,Brinquedo,4,124
11589,2024-01-09 01:08:00,92,46,Móvel,2,138
11590,2024-01-09 01:09:00,73,133,Vestuário,2,206
11591,2024-01-09 01:10:00,92,116,Brinquedo,6,208
11592,2024-01-09 01:11:00,28,177,Brinquedo,7,205
11593,2024-01-09 01:12:00,116,93,Vestuário,6,209
11594,2024-01-09 01:13:00,15,72,Eletrônico,5,87
11595,2024-01-09 01:14:00,60,128,Móvel,3,188
11596,2024-01-09 01:15:00,112,41,Móvel,1,153
11597,2024-01-09 01:16:00,101,106,Alimento,4,207
11598,2024-01-09 01:17:00,105,167,Brinquedo,3,272
11599,2024-01-09 01:18:00,23,179,Brinquedo,2,202
11600,2024-01-09 01:19:00,85,172,Alimento,2,257
11601,2024-01-09 01:20:00,92,101,Brinquedo,9,193
11602,2024-01-09 01:21:00,48,56,Brinquedo,9,104
11603,2024-01-09 01:22:00,18,173,Brinquedo,5,191
11604,2024-01-09 01:23:00,110,59,Eletrônico,3,169
11605,2024-01-09 01:24:00,54,129,Vestuário,5,183
11606,2024-01-09 01:25:00,18,173,Vestuário,7,191
11607,2024-01-09 01:26:00,110,53,Vestuário,7,163
11608,2024-01-09 01:27:00,20,35,Eletrônico,7,55
11609,2024-01-09 01:28:00,85,106,Alimento,9,191
11610,2024-01-09 01:29:00,32,77,Móvel,9,109
11611,2024-01-09 01:30:00,91,47,Brinquedo,6,138
11612,2024-01-09 01:31:00,43,135,Móvel,3,178
11613,2024-01-09 01:32:00,78,86,Vestuário,1,164
11614,2024-01-09 01:33:00,108,44,Móvel,8,152
11615,2024-01-09 01:34:00,13,80,Alimento,8,93
11616,2024-01-09 01:35:00,45,16,Alimento,2,61
11617,2024-01-09 01:36:00,29,114,Brinquedo,5,143
11618,2024-01-09 01:37:00,75,22,Brinquedo,4,97
11619,2024-01-09 01:38:00,74,168,Eletrônico,8,242
11620,2024-01-09 01:39:00,95,110,Brinquedo,9,205
11621,2024-01-09 01:40:00,47,142,Alimento,4,189
11622,2024-01-09 01:41:00,59,104,Alimento,3,163
11623,2024-01-09 01:42:00,53,119,Alimento,5,172
11624,2024-01-09 01:43:00,38,50,Vestuário,8,88
11625,2024-01-09 01:44:00,100,162,Alimento,5,262
11626,2024-01-09 01:45:00,40,156,Vestuário,6,196
11627,2024-01-09 01:46:00,93,33,Eletrônico,6,126
11628,2024-01-09 01:47:00,16,52,Brinquedo,1,68
11629,2024-01-09 01:48:00,14,160,Móvel,4,174
11630,2024-01-09 01:49:00,92,170,Alimento,7,262
11631,2024-01-09 01:50:00,42,75,Brinquedo,3,117
11632,2024-01-09 01:51:00,18,29,Móvel,9,47
11633,2024-01-09 01:52:00,82,120,Eletrônico,7,202
11634,2024-01-09 01:53:00,68,77,Vestuário,1,145
11635,2024-01-09 01:54:00,36,162,Alimento,8,198
11636,2024-01-09 01:55:00,32,36,Eletrônico,4,68
11637,2024-01-09 01:56:00,116,47,Eletrônico,1,163
11638,2024-01-09 01:57:00,20,140,Alimento,3,160
11639,2024-01-09 01:58:00,25,147,Vestuário,2,172
11640,2024-01-09 01:59:00,102,173,Vestuário,9,275
11641,2024-01-09 02:00:00,69,53,Alimento,2,122
11642,2024-01-09 02:01:00,51,163,Alimento,3,214
11643,2024-01-09 02:02:00,96,167,Alimento,1,263
11644,2024-01-09 02:03:00,74,169,Brinquedo,7,243
11645,2024-01-09 02:04:00,114,24,Alimento,6,138
11646,2024-01-09 02:05:00,24,48,Alimento,9,72
11647,2024-01-09 02:06:00,55,36,Móvel,9,91
11648,2024-01-09 02:07:00,92,115,Móvel,7,207
11649,2024-01-09 02:08:00,30,136,Móvel,7,166
11650,2024-01-09 02:09:00,23,12,Móvel,2,35
11651,2024-01-09 02:10:00,60,138,Móvel,1,198
11652,2024-01-09 02:11:00,35,156,Vestuário,9,191
11653,2024-01-09 02:12:00,49,92,Eletrônico,6,141
11654,2024-01-09 02:13:00,68,175,Brinquedo,8,243
11655,2024-01-09 02:14:00,44,135,Brinquedo,7,179
11656,2024-01-09 02:15:00,113,156,Brinquedo,5,269
11657,2024-01-09 02:16:00,45,53,Alimento,5,98
11658,2024-01-09 02:17:00,68,111,Brinquedo,8,179
11659,2024-01-09 02:18:00,59,163,Móvel,3,222
11660,2024-01-09 02:19:00,34,168,Vestuário,7,202
11661,2024-01-09 02:20:00,116,72,Eletrônico,6,188
11662,2024-01-09 02:21:00,87,10,Vestuário,4,97
11663,2024-01-09 02:22:00,49,97,Eletrônico,3,146
11664,2024-01-09 02:23:00,25,30,Alimento,7,55
11665,2024-01-09 02:24:00,18,134,Brinquedo,4,152
11666,2024-01-09 02:25:00,57,142,Brinquedo,3,199
11667,2024-01-09 02:26:00,81,24,Brinquedo,1,105
11668,2024-01-09 02:27:00,94,127,Eletrônico,2,221
11669,2024-01-09 02:28:00,108,173,Móvel,8,281
11670,2024-01-09 02:29:00,92,61,Vestuário,9,153
11671,2024-01-09 02:30:00,111,174,Brinquedo,6,285
11672,2024-01-09 02:31:00,28,147,Vestuário,5,175
11673,2024-01-09 02:32:00,81,129,Brinquedo,2,210
11674,2024-01-09 02:33:00,53,139,Brinquedo,6,192
11675,2024-01-09 02:34:00,93,172,Brinquedo,3,265
11676,2024-01-09 02:35:00,108,45,Vestuário,5,153
11677,2024-01-09 02:36:00,72,79,Móvel,8,151
11678,2024-01-09 02:37:00,94,178,Alimento,6,272
11679,2024-01-09 02:38:00,103,100,Eletrônico,4,203
11680,2024-01-09 02:39:00,15,96,Brinquedo,4,111
11681,2024-01-09 02:40:00,91,110,Vestuário,6,201
11682,2024-01-09 02:41:00,36,20,Móvel,5,56
11683,2024-01-09 02:42:00,84,140,Eletrônico,5,224
11684,2024-01-09 02:43:00,115,161,Móvel,4,276
11685,2024-01-09 02:44:00,40,21,Brinquedo,7,61
11686,2024-01-09 02:45:00,96,129,Vestuário,8,225
11687,2024-01-09 02:46:00,55,102,Móvel,2,157
11688,2024-01-09 02:47:00,59,111,Eletrônico,1,170
11689,2024-01-09 02:48:00,83,106,Móvel,7,189
11690,2024-01-09 02:49:00,17,13,Alimento,7,30
11691,2024-01-09 02:50:00,47,93,Alimento,5,140
11692,2024-01-09 02:51:00,85,93,Brinquedo,9,178
11693,2024-01-09 02:52:00,17,155,Brinquedo,2,172
11694,2024-01-09 02:53:00,99,25,Móvel,2,124
11695,2024-01-09 02:54:00,55,144,Vestuário,1,199
11696,2024-01-09 02:55:00,42,99,Alimento,4,141
11697,2024-01-09 02:56:00,91,22,Vestuário,9,113
11698,2024-01-09 02:57:00,99,122,Eletrônico,5,221
11699,2024-01-09 02:58:00,59,105,Eletrônico,5,164
11700,2024-01-09 02:59:00,103,17,Móvel,3,120
11701,2024-01-09 03:00:00,33,81,Móvel,4,114
11702,2024-01-09 03:01:00,42,18,Brinquedo,5,60
11703,2024-01-09 03:02:00,72,95,Eletrônico,3,167
11704,2024-01-09 03:03:00,70,164,Eletrônico,5,234
11705,2024-01-09 03:04:00,42,47,Vestuário,9,89
11706,2024-01-09 03:05:00,15,23,Brinquedo,4,38
11707,2024-01-09 03:06:00,89,74,Vestuário,9,163
11708,2024-01-09 03:07:00,38,168,Brinquedo,3,206
11709,2024-01-09 03:08:00,14,175,Alimento,6,189
11710,2024-01-09 03:09:00,47,18,Móvel,8,65
11711,2024-01-09 03:10:00,87,68,Alimento,5,155
11712,2024-01-09 03:11:00,21,79,Brinquedo,1,100
11713,2024-01-09 03:12:00,89,13,Móvel,8,102
11714,2024-01-09 03:13:00,10,104,Móvel,4,114
11715,2024-01-09 03:14:00,80,47,Móvel,8,127
11716,2024-01-09 03:15:00,50,25,Eletrônico,1,75
11717,2024-01-09 03:16:00,75,146,Móvel,8,221
11718,2024-01-09 03:17:00,54,21,Eletrônico,9,75
11719,2024-01-09 03:18:00,67,137,Brinquedo,2,204
11720,2024-01-09 03:19:00,102,112,Vestuário,3,214
11721,2024-01-09 03:20:00,109,25,Brinquedo,2,134
11722,2024-01-09 03:21:00,88,156,Alimento,4,244
11723,2024-01-09 03:22:00,117,57,Vestuário,9,174
11724,2024-01-09 03:23:00,104,44,Vestuário,7,148
11725,2024-01-09 03:24:00,37,21,Brinquedo,1,58
11726,2024-01-09 03:25:00,83,52,Vestuário,6,135
11727,2024-01-09 03:26:00,24,169,Vestuário,3,193
11728,2024-01-09 03:27:00,13,150,Vestuário,4,163
11729,2024-01-09 03:28:00,74,163,Móvel,2,237
11730,2024-01-09 03:29:00,53,144,Brinquedo,7,197
11731,2024-01-09 03:30:00,80,115,Vestuário,9,195
11732,2024-01-09 03:31:00,81,140,Móvel,4,221
11733,2024-01-09 03:32:00,69,34,Brinquedo,8,103
11734,2024-01-09 03:33:00,112,23,Móvel,5,135
11735,2024-01-09 03:34:00,119,65,Brinquedo,1,184
11736,2024-01-09 03:35:00,115,52,Alimento,1,167
11737,2024-01-09 03:36:00,58,164,Alimento,9,222
11738,2024-01-09 03:37:00,94,35,Alimento,4,129
11739,2024-01-09 03:38:00,108,29,Eletrônico,3,137
11740,2024-01-09 03:39:00,93,151,Alimento,7,244
11741,2024-01-09 03:40:00,102,61,Vestuário,7,163
11742,2024-01-09 03:41:00,51,70,Móvel,1,121
11743,2024-01-09 03:42:00,36,33,Eletrônico,2,69
11744,2024-01-09 03:43:00,95,166,Eletrônico,9,261
11745,2024-01-09 03:44:00,21,27,Móvel,1,48
11746,2024-01-09 03:45:00,10,158,Brinquedo,7,168
11747,2024-01-09 03:46:00,21,177,Móvel,8,198
11748,2024-01-09 03:47:00,33,107,Vestuário,9,140
11749,2024-01-09 03:48:00,22,124,Móvel,3,146
11750,2024-01-09 03:49:00,47,75,Alimento,2,122
11751,2024-01-09 03:50:00,19,15,Alimento,6,34
11752,2024-01-09 03:51:00,83,22,Alimento,9,105
11753,2024-01-09 03:52:00,108,179,Eletrônico,3,287
11754,2024-01-09 03:53:00,107,15,Alimento,3,122
11755,2024-01-09 03:54:00,28,140,Móvel,9,168
11756,2024-01-09 03:55:00,82,104,Alimento,4,186
11757,2024-01-09 03:56:00,57,159,Alimento,6,216
11758,2024-01-09 03:57:00,13,74,Móvel,4,87
11759,2024-01-09 03:58:00,30,72,Eletrônico,4,102
11760,2024-01-09 03:59:00,17,151,Vestuário,4,168
11761,2024-01-09 04:00:00,38,52,Móvel,4,90
11762,2024-01-09 04:01:00,100,25,Vestuário,3,125
11763,2024-01-09 04:02:00,45,108,Vestuário,3,153
11764,2024-01-09 04:03:00,90,91,Eletrônico,3,181
11765,2024-01-09 04:04:00,87,160,Eletrônico,4,247
11766,2024-01-09 04:05:00,114,113,Brinquedo,8,227
11767,2024-01-09 04:06:00,10,20,Vestuário,5,30
11768,2024-01-09 04:07:00,37,20,Móvel,4,57
11769,2024-01-09 04:08:00,33,171,Brinquedo,5,204
11770,2024-01-09 04:09:00,59,74,Vestuário,4,133
11771,2024-01-09 04:10:00,23,155,Eletrônico,2,178
11772,2024-01-09 04:11:00,24,81,Alimento,2,105
11773,2024-01-09 04:12:00,59,86,Brinquedo,6,145
11774,2024-01-09 04:13:00,10,56,Alimento,5,66
11775,2024-01-09 04:14:00,60,141,Brinquedo,3,201
11776,2024-01-09 04:15:00,111,156,Alimento,2,267
11777,2024-01-09 04:16:00,56,58,Alimento,9,114
11778,2024-01-09 04:17:00,89,66,Vestuário,1,155
11779,2024-01-09 04:18:00,87,29,Alimento,5,116
11780,2024-01-09 04:19:00,55,62,Alimento,1,117
11781,2024-01-09 04:20:00,61,41,Brinquedo,2,102
11782,2024-01-09 04:21:00,56,149,Eletrônico,5,205
11783,2024-01-09 04:22:00,46,150,Vestuário,5,196
11784,2024-01-09 04:23:00,62,163,Alimento,2,225
11785,2024-01-09 04:24:00,64,158,Vestuário,1,222
11786,2024-01-09 04:25:00,61,19,Brinquedo,2,80
11787,2024-01-09 04:26:00,116,60,Móvel,5,176
11788,2024-01-09 04:27:00,70,171,Vestuário,2,241
11789,2024-01-09 04:28:00,58,169,Brinquedo,9,227
11790,2024-01-09 04:29:00,111,167,Vestuário,3,278
11791,2024-01-09 04:30:00,83,169,Alimento,7,252
11792,2024-01-09 04:31:00,37,35,Brinquedo,7,72
11793,2024-01-09 04:32:00,105,44,Alimento,9,149
11794,2024-01-09 04:33:00,104,39,Brinquedo,6,143
11795,2024-01-09 04:34:00,90,97,Brinquedo,6,187
11796,2024-01-09 04:35:00,62,94,Vestuário,7,156
11797,2024-01-09 04:36:00,115,83,Eletrônico,2,198
11798,2024-01-09 04:37:00,51,131,Alimento,1,182
11799,2024-01-09 04:38:00,11,134,Móvel,6,145
11800,2024-01-09 04:39:00,64,123,Alimento,4,187
11801,2024-01-09 04:40:00,85,97,Alimento,4,182
11802,2024-01-09 04:41:00,39,94,Alimento,7,133
11803,2024-01-09 04:42:00,104,132,Brinquedo,8,236
11804,2024-01-09 04:43:00,87,87,Eletrônico,7,174
11805,2024-01-09 04:44:00,55,142,Móvel,3,197
11806,2024-01-09 04:45:00,80,111,Brinquedo,3,191
11807,2024-01-09 04:46:00,112,30,Vestuário,6,142
11808,2024-01-09 04:47:00,85,108,Eletrônico,4,193
11809,2024-01-09 04:48:00,72,67,Eletrônico,2,139
11810,2024-01-09 04:49:00,84,80,Eletrônico,7,164
11811,2024-01-09 04:50:00,70,82,Alimento,5,152
11812,2024-01-09 04:51:00,111,121,Eletrônico,3,232
11813,2024-01-09 04:52:00,90,142,Alimento,9,232
11814,2024-01-09 04:53:00,21,63,Alimento,4,84
11815,2024-01-09 04:54:00,94,127,Eletrônico,1,221
11816,2024-01-09 04:55:00,97,139,Vestuário,3,236
11817,2024-01-09 04:56:00,99,142,Alimento,3,241
11818,2024-01-09 04:57:00,76,118,Vestuário,2,194
11819,2024-01-09 04:58:00,78,63,Vestuário,7,141
11820,2024-01-09 04:59:00,114,77,Alimento,5,191
11821,2024-01-09 05:00:00,100,123,Alimento,4,223
11822,2024-01-09 05:01:00,60,44,Brinquedo,7,104
11823,2024-01-09 05:02:00,30,118,Eletrônico,3,148
11824,2024-01-09 05:03:00,32,113,Alimento,5,145
11825,2024-01-09 05:04:00,49,161,Eletrônico,8,210
11826,2024-01-09 05:05:00,111,68,Eletrônico,9,179
11827,2024-01-09 05:06:00,30,137,Eletrônico,9,167
11828,2024-01-09 05:07:00,48,42,Móvel,6,90
11829,2024-01-09 05:08:00,30,132,Eletrônico,3,162
11830,2024-01-09 05:09:00,101,50,Vestuário,9,151
11831,2024-01-09 05:10:00,107,179,Eletrônico,4,286
11832,2024-01-09 05:11:00,81,179,Vestuário,2,260
11833,2024-01-09 05:12:00,84,13,Brinquedo,9,97
11834,2024-01-09 05:13:00,78,147,Eletrônico,9,225
11835,2024-01-09 05:14:00,108,133,Eletrônico,5,241
11836,2024-01-09 05:15:00,54,162,Vestuário,4,216
11837,2024-01-09 05:16:00,38,14,Eletrônico,1,52
11838,2024-01-09 05:17:00,43,102,Alimento,2,145
11839,2024-01-09 05:18:00,110,175,Alimento,8,285
11840,2024-01-09 05:19:00,52,96,Brinquedo,2,148
11841,2024-01-09 05:20:00,12,141,Brinquedo,9,153
11842,2024-01-09 05:21:00,77,172,Eletrônico,7,249
11843,2024-01-09 05:22:00,15,80,Vestuário,5,95
11844,2024-01-09 05:23:00,67,32,Alimento,9,99
11845,2024-01-09 05:24:00,24,86,Alimento,9,110
11846,2024-01-09 05:25:00,94,57,Móvel,7,151
11847,2024-01-09 05:26:00,15,139,Vestuário,6,154
11848,2024-01-09 05:27:00,89,104,Brinquedo,3,193
11849,2024-01-09 05:28:00,98,84,Brinquedo,8,182
11850,2024-01-09 05:29:00,32,33,Alimento,3,65
11851,2024-01-09 05:30:00,50,83,Alimento,4,133
11852,2024-01-09 05:31:00,12,171,Móvel,7,183
11853,2024-01-09 05:32:00,93,115,Alimento,9,208
11854,2024-01-09 05:33:00,73,157,Eletrônico,8,230
11855,2024-01-09 05:34:00,100,35,Vestuário,9,135
11856,2024-01-09 05:35:00,32,40,Brinquedo,8,72
11857,2024-01-09 05:36:00,58,60,Móvel,7,118
11858,2024-01-09 05:37:00,65,51,Alimento,1,116
11859,2024-01-09 05:38:00,57,17,Eletrônico,9,74
11860,2024-01-09 05:39:00,13,157,Eletrônico,5,170
11861,2024-01-09 05:40:00,36,171,Eletrônico,3,207
11862,2024-01-09 05:41:00,96,75,Brinquedo,8,171
11863,2024-01-09 05:42:00,39,177,Eletrônico,5,216
11864,2024-01-09 05:43:00,82,176,Vestuário,5,258
11865,2024-01-09 05:44:00,27,134,Vestuário,4,161
11866,2024-01-09 05:45:00,56,137,Alimento,5,193
11867,2024-01-09 05:46:00,26,25,Móvel,4,51
11868,2024-01-09 05:47:00,16,16,Eletrônico,4,32
11869,2024-01-09 05:48:00,34,134,Alimento,8,168
11870,2024-01-09 05:49:00,114,45,Vestuário,8,159
11871,2024-01-09 05:50:00,105,151,Móvel,9,256
11872,2024-01-09 05:51:00,10,72,Eletrônico,8,82
11873,2024-01-09 05:52:00,18,145,Eletrônico,7,163
11874,2024-01-09 05:53:00,82,98,Móvel,6,180
11875,2024-01-09 05:54:00,47,148,Brinquedo,1,195
11876,2024-01-09 05:55:00,75,138,Alimento,9,213
11877,2024-01-09 05:56:00,46,41,Móvel,8,87
11878,2024-01-09 05:57:00,92,32,Vestuário,7,124
11879,2024-01-09 05:58:00,50,127,Brinquedo,2,177
11880,2024-01-09 05:59:00,53,84,Vestuário,1,137
11881,2024-01-09 06:00:00,31,71,Brinquedo,3,102
11882,2024-01-09 06:01:00,64,87,Alimento,5,151
11883,2024-01-09 06:02:00,27,92,Vestuário,8,119
11884,2024-01-09 06:03:00,69,134,Brinquedo,9,203
11885,2024-01-09 06:04:00,87,48,Vestuário,4,135
11886,2024-01-09 06:05:00,83,70,Brinquedo,5,153
11887,2024-01-09 06:06:00,48,83,Móvel,7,131
11888,2024-01-09 06:07:00,111,130,Eletrônico,1,241
11889,2024-01-09 06:08:00,19,45,Vestuário,1,64
11890,2024-01-09 06:09:00,69,53,Vestuário,3,122
11891,2024-01-09 06:10:00,72,77,Vestuário,8,149
11892,2024-01-09 06:11:00,84,148,Móvel,3,232
11893,2024-01-09 06:12:00,119,176,Vestuário,1,295
11894,2024-01-09 06:13:00,106,83,Móvel,5,189
11895,2024-01-09 06:14:00,117,113,Móvel,7,230
11896,2024-01-09 06:15:00,94,37,Móvel,3,131
11897,2024-01-09 06:16:00,90,51,Brinquedo,9,141
11898,2024-01-09 06:17:00,32,45,Vestuário,9,77
11899,2024-01-09 06:18:00,76,120,Vestuário,1,196
11900,2024-01-09 06:19:00,15,141,Eletrônico,3,156
11901,2024-01-09 06:20:00,15,55,Brinquedo,2,70
11902,2024-01-09 06:21:00,30,166,Brinquedo,4,196
11903,2024-01-09 06:22:00,37,149,Vestuário,6,186
11904,2024-01-09 06:23:00,14,14,Vestuário,9,28
11905,2024-01-09 06:24:00,81,153,Vestuário,8,234
11906,2024-01-09 06:25:00,48,153,Vestuário,7,201
11907,2024-01-09 06:26:00,96,43,Móvel,3,139
11908,2024-01-09 06:27:00,80,69,Vestuário,2,149
11909,2024-01-09 06:28:00,67,39,Alimento,6,106
11910,2024-01-09 06:29:00,24,173,Vestuário,3,197
11911,2024-01-09 06:30:00,103,169,Vestuário,8,272
11912,2024-01-09 06:31:00,55,177,Eletrônico,9,232
11913,2024-01-09 06:32:00,74,105,Vestuário,6,179
11914,2024-01-09 06:33:00,94,121,Móvel,2,215
11915,2024-01-09 06:34:00,109,155,Vestuário,6,264
11916,2024-01-09 06:35:00,25,149,Alimento,6,174
11917,2024-01-09 06:36:00,21,102,Alimento,2,123
11918,2024-01-09 06:37:00,21,118,Alimento,2,139
11919,2024-01-09 06:38:00,71,166,Eletrônico,8,237
11920,2024-01-09 06:39:00,89,11,Eletrônico,3,100
11921,2024-01-09 06:40:00,62,81,Móvel,7,143
11922,2024-01-09 06:41:00,45,91,Brinquedo,1,136
11923,2024-01-09 06:42:00,31,108,Alimento,1,139
11924,2024-01-09 06:43:00,74,132,Eletrônico,1,206
11925,2024-01-09 06:44:00,119,79,Brinquedo,4,198
11926,2024-01-09 06:45:00,55,75,Móvel,8,130
11927,2024-01-09 06:46:00,93,113,Brinquedo,5,206
11928,2024-01-09 06:47:00,76,84,Vestuário,5,160
11929,2024-01-09 06:48:00,26,18,Móvel,8,44
11930,2024-01-09 06:49:00,111,38,Alimento,4,149
11931,2024-01-09 06:50:00,83,120,Alimento,3,203
11932,2024-01-09 06:51:00,59,14,Alimento,1,73
11933,2024-01-09 06:52:00,113,128,Móvel,4,241
11934,2024-01-09 06:53:00,105,58,Alimento,2,163
11935,2024-01-09 06:54:00,75,26,Eletrônico,1,101
11936,2024-01-09 06:55:00,25,170,Eletrônico,2,195
11937,2024-01-09 06:56:00,99,153,Móvel,8,252
11938,2024-01-09 06:57:00,20,53,Vestuário,7,73
11939,2024-01-09 06:58:00,74,21,Alimento,6,95
11940,2024-01-09 06:59:00,89,84,Móvel,1,173
11941,2024-01-09 07:00:00,79,18,Alimento,2,97
11942,2024-01-09 07:01:00,98,167,Vestuário,2,265
11943,2024-01-09 07:02:00,59,44,Brinquedo,2,103
11944,2024-01-09 07:03:00,67,163,Vestuário,5,230
11945,2024-01-09 07:04:00,79,85,Brinquedo,5,164
11946,2024-01-09 07:05:00,108,23,Móvel,8,131
11947,2024-01-09 07:06:00,28,174,Móvel,7,202
11948,2024-01-09 07:07:00,66,115,Móvel,9,181
11949,2024-01-09 07:08:00,44,14,Eletrônico,7,58
11950,2024-01-09 07:09:00,91,154,Móvel,3,245
11951,2024-01-09 07:10:00,85,154,Alimento,2,239
11952,2024-01-09 07:11:00,61,175,Alimento,4,236
11953,2024-01-09 07:12:00,27,147,Móvel,9,174
11954,2024-01-09 07:13:00,52,153,Alimento,2,205
11955,2024-01-09 07:14:00,79,14,Eletrônico,8,93
11956,2024-01-09 07:15:00,76,20,Móvel,7,96
11957,2024-01-09 07:16:00,100,97,Eletrônico,9,197
11958,2024-01-09 07:17:00,74,20,Alimento,6,94
11959,2024-01-09 07:18:00,87,53,Brinquedo,3,140
11960,2024-01-09 07:19:00,24,108,Móvel,3,132
11961,2024-01-09 07:20:00,97,12,Vestuário,8,109
11962,2024-01-09 07:21:00,57,55,Alimento,2,112
11963,2024-01-09 07:22:00,54,54,Alimento,6,108
11964,2024-01-09 07:23:00,21,48,Alimento,1,69
11965,2024-01-09 07:24:00,94,169,Alimento,4,263
11966,2024-01-09 07:25:00,108,81,Móvel,8,189
11967,2024-01-09 07:26:00,27,121,Eletrônico,9,148
11968,2024-01-09 07:27:00,62,144,Brinquedo,5,206
11969,2024-01-09 07:28:00,108,50,Vestuário,4,158
11970,2024-01-09 07:29:00,13,98,Brinquedo,6,111
11971,2024-01-09 07:30:00,117,42,Brinquedo,5,159
11972,2024-01-09 07:31:00,11,163,Eletrônico,6,174
11973,2024-01-09 07:32:00,106,16,Alimento,6,122
11974,2024-01-09 07:33:00,31,179,Brinquedo,3,210
11975,2024-01-09 07:34:00,84,77,Vestuário,4,161
11976,2024-01-09 07:35:00,47,82,Móvel,6,129
11977,2024-01-09 07:36:00,85,154,Vestuário,3,239
11978,2024-01-09 07:37:00,19,173,Brinquedo,6,192
11979,2024-01-09 07:38:00,78,144,Alimento,8,222
11980,2024-01-09 07:39:00,82,123,Móvel,7,205
11981,2024-01-09 07:40:00,34,83,Eletrônico,5,117
11982,2024-01-09 07:41:00,76,114,Brinquedo,5,190
11983,2024-01-09 07:42:00,54,77,Alimento,4,131
11984,2024-01-09 07:43:00,43,161,Vestuário,8,204
11985,2024-01-09 07:44:00,70,41,Vestuário,5,111
11986,2024-01-09 07:45:00,86,121,Móvel,6,207
11987,2024-01-09 07:46:00,28,116,Brinquedo,6,144
11988,2024-01-09 07:47:00,45,178,Eletrônico,4,223
11989,2024-01-09 07:48:00,94,135,Móvel,9,229
11990,2024-01-09 07:49:00,69,46,Brinquedo,8,115
11991,2024-01-09 07:50:00,61,88,Eletrônico,5,149
11992,2024-01-09 07:51:00,75,41,Brinquedo,2,116
11993,2024-01-09 07:52:00,79,84,Eletrônico,5,163
11994,2024-01-09 07:53:00,93,80,Móvel,6,173
11995,2024-01-09 07:54:00,14,122,Eletrônico,4,136
11996,2024-01-09 07:55:00,90,100,Eletrônico,4,190
11997,2024-01-09 07:56:00,13,124,Vestuário,1,137
11998,2024-01-09 07:57:00,42,78,Alimento,1,120
11999,2024-01-09 07:58:00,90,92,Brinquedo,7,182
12000,2024-01-09 07:59:00,15,75,Eletrônico,7,90
12001,2024-01-09 08:00:00,83,162,Alimento,4,245
12002,2024-01-09 08:01:00,91,132,Brinquedo,8,223
12003,2024-01-09 08:02:00,88,104,Alimento,2,192
12004,2024-01-09 08:03:00,88,43,Alimento,2,131
12005,2024-01-09 08:04:00,39,142,Vestuário,9,181
12006,2024-01-09 08:05:00,65,88,Alimento,2,153
12007,2024-01-09 08:06:00,110,51,Brinquedo,7,161
12008,2024-01-09 08:07:00,40,98,Eletrônico,5,138
12009,2024-01-09 08:08:00,85,65,Eletrônico,7,150
12010,2024-01-09 08:09:00,101,76,Alimento,8,177
12011,2024-01-09 08:10:00,20,167,Alimento,8,187
12012,2024-01-09 08:11:00,19,106,Brinquedo,5,125
12013,2024-01-09 08:12:00,73,109,Móvel,3,182
12014,2024-01-09 08:13:00,60,96,Móvel,9,156
12015,2024-01-09 08:14:00,57,167,Vestuário,9,224
12016,2024-01-09 08:15:00,53,138,Vestuário,1,191
12017,2024-01-09 08:16:00,118,111,Eletrônico,8,229
12018,2024-01-09 08:17:00,98,75,Alimento,7,173
12019,2024-01-09 08:18:00,10,109,Móvel,5,119
12020,2024-01-09 08:19:00,78,96,Móvel,2,174
12021,2024-01-09 08:20:00,118,88,Alimento,8,206
12022,2024-01-09 08:21:00,102,123,Eletrônico,4,225
12023,2024-01-09 08:22:00,43,12,Alimento,3,55
12024,2024-01-09 08:23:00,107,133,Móvel,9,240
12025,2024-01-09 08:24:00,18,18,Móvel,5,36
12026,2024-01-09 08:25:00,98,47,Vestuário,1,145
12027,2024-01-09 08:26:00,106,171,Brinquedo,1,277
12028,2024-01-09 08:27:00,58,123,Eletrônico,5,181
12029,2024-01-09 08:28:00,82,24,Móvel,6,106
12030,2024-01-09 08:29:00,77,131,Vestuário,3,208
12031,2024-01-09 08:30:00,99,94,Eletrônico,6,193
12032,2024-01-09 08:31:00,29,28,Móvel,8,57
12033,2024-01-09 08:32:00,30,144,Brinquedo,4,174
12034,2024-01-09 08:33:00,24,112,Vestuário,1,136
12035,2024-01-09 08:34:00,95,159,Vestuário,2,254
12036,2024-01-09 08:35:00,27,16,Brinquedo,4,43
12037,2024-01-09 08:36:00,40,30,Vestuário,9,70
12038,2024-01-09 08:37:00,46,171,Eletrônico,2,217
12039,2024-01-09 08:38:00,82,100,Alimento,8,182
12040,2024-01-09 08:39:00,52,20,Eletrônico,1,72
12041,2024-01-09 08:40:00,106,174,Brinquedo,6,280
12042,2024-01-09 08:41:00,113,115,Alimento,5,228
12043,2024-01-09 08:42:00,30,11,Brinquedo,3,41
12044,2024-01-09 08:43:00,29,56,Vestuário,1,85
12045,2024-01-09 08:44:00,91,101,Móvel,8,192
12046,2024-01-09 08:45:00,44,84,Móvel,2,128
12047,2024-01-09 08:46:00,48,33,Vestuário,8,81
12048,2024-01-09 08:47:00,14,107,Móvel,5,121
12049,2024-01-09 08:48:00,29,11,Eletrônico,2,40
12050,2024-01-09 08:49:00,58,141,Vestuário,3,199
12051,2024-01-09 08:50:00,37,12,Eletrônico,5,49
12052,2024-01-09 08:51:00,18,114,Brinquedo,8,132
12053,2024-01-09 08:52:00,19,50,Alimento,8,69
12054,2024-01-09 08:53:00,111,84,Alimento,7,195
12055,2024-01-09 08:54:00,58,25,Brinquedo,5,83
12056,2024-01-09 08:55:00,77,143,Brinquedo,1,220
12057,2024-01-09 08:56:00,30,156,Alimento,5,186
12058,2024-01-09 08:57:00,87,41,Móvel,4,128
12059,2024-01-09 08:58:00,72,165,Brinquedo,3,237
12060,2024-01-09 08:59:00,57,117,Brinquedo,5,174
12061,2024-01-09 09:00:00,28,24,Eletrônico,7,52
12062,2024-01-09 09:01:00,14,120,Eletrônico,9,134
12063,2024-01-09 09:02:00,36,35,Alimento,9,71
12064,2024-01-09 09:03:00,71,82,Vestuário,3,153
12065,2024-01-09 09:04:00,14,106,Eletrônico,8,120
12066,2024-01-09 09:05:00,20,38,Brinquedo,1,58
12067,2024-01-09 09:06:00,109,122,Móvel,2,231
12068,2024-01-09 09:07:00,27,40,Brinquedo,7,67
12069,2024-01-09 09:08:00,48,57,Vestuário,2,105
12070,2024-01-09 09:09:00,55,163,Brinquedo,4,218
12071,2024-01-09 09:10:00,12,50,Alimento,8,62
12072,2024-01-09 09:11:00,21,65,Eletrônico,3,86
12073,2024-01-09 09:12:00,108,77,Eletrônico,7,185
12074,2024-01-09 09:13:00,80,155,Vestuário,6,235
12075,2024-01-09 09:14:00,39,24,Eletrônico,6,63
12076,2024-01-09 09:15:00,90,161,Móvel,4,251
12077,2024-01-09 09:16:00,90,149,Eletrônico,2,239
12078,2024-01-09 09:17:00,71,88,Vestuário,8,159
12079,2024-01-09 09:18:00,100,49,Vestuário,3,149
12080,2024-01-09 09:19:00,111,69,Vestuário,3,180
12081,2024-01-09 09:20:00,94,151,Eletrônico,5,245
12082,2024-01-09 09:21:00,69,15,Brinquedo,2,84
12083,2024-01-09 09:22:00,61,17,Vestuário,4,78
12084,2024-01-09 09:23:00,72,96,Móvel,7,168
12085,2024-01-09 09:24:00,105,115,Vestuário,8,220
12086,2024-01-09 09:25:00,68,70,Móvel,6,138
12087,2024-01-09 09:26:00,105,175,Brinquedo,5,280
12088,2024-01-09 09:27:00,52,114,Móvel,8,166
12089,2024-01-09 09:28:00,75,76,Eletrônico,9,151
12090,2024-01-09 09:29:00,58,134,Vestuário,4,192
12091,2024-01-09 09:30:00,50,45,Vestuário,3,95
12092,2024-01-09 09:31:00,75,59,Eletrônico,6,134
12093,2024-01-09 09:32:00,36,66,Vestuário,1,102
12094,2024-01-09 09:33:00,23,80,Vestuário,3,103
12095,2024-01-09 09:34:00,37,113,Brinquedo,1,150
12096,2024-01-09 09:35:00,75,22,Vestuário,6,97
12097,2024-01-09 09:36:00,34,76,Alimento,6,110
12098,2024-01-09 09:37:00,24,69,Móvel,4,93
12099,2024-01-09 09:38:00,26,131,Vestuário,1,157
12100,2024-01-09 09:39:00,33,69,Móvel,9,102
12101,2024-01-09 09:40:00,119,126,Móvel,8,245
12102,2024-01-09 09:41:00,118,92,Brinquedo,5,210
12103,2024-01-09 09:42:00,101,85,Brinquedo,5,186
12104,2024-01-09 09:43:00,89,161,Brinquedo,8,250
12105,2024-01-09 09:44:00,69,45,Brinquedo,9,114
12106,2024-01-09 09:45:00,119,132,Vestuário,1,251
12107,2024-01-09 09:46:00,109,116,Eletrônico,1,225
12108,2024-01-09 09:47:00,18,102,Eletrônico,4,120
12109,2024-01-09 09:48:00,106,17,Alimento,5,123
12110,2024-01-09 09:49:00,49,60,Alimento,4,109
12111,2024-01-09 09:50:00,43,117,Brinquedo,6,160
12112,2024-01-09 09:51:00,38,63,Brinquedo,4,101
12113,2024-01-09 09:52:00,87,148,Brinquedo,4,235
12114,2024-01-09 09:53:00,119,150,Eletrônico,4,269
12115,2024-01-09 09:54:00,85,19,Móvel,6,104
12116,2024-01-09 09:55:00,99,33,Móvel,3,132
12117,2024-01-09 09:56:00,12,48,Alimento,9,60
12118,2024-01-09 09:57:00,20,22,Vestuário,5,42
12119,2024-01-09 09:58:00,53,97,Eletrônico,3,150
12120,2024-01-09 09:59:00,47,143,Vestuário,7,190
12121,2024-01-09 10:00:00,10,160,Brinquedo,1,170
12122,2024-01-09 10:01:00,11,29,Eletrônico,7,40
12123,2024-01-09 10:02:00,82,49,Vestuário,9,131
12124,2024-01-09 10:03:00,98,170,Móvel,8,268
12125,2024-01-09 10:04:00,17,136,Móvel,3,153
12126,2024-01-09 10:05:00,90,128,Brinquedo,4,218
12127,2024-01-09 10:06:00,97,147,Eletrônico,8,244
12128,2024-01-09 10:07:00,70,77,Alimento,8,147
12129,2024-01-09 10:08:00,27,32,Brinquedo,7,59
12130,2024-01-09 10:09:00,88,137,Brinquedo,2,225
12131,2024-01-09 10:10:00,47,67,Eletrônico,9,114
12132,2024-01-09 10:11:00,96,157,Vestuário,9,253
12133,2024-01-09 10:12:00,115,111,Brinquedo,9,226
12134,2024-01-09 10:13:00,113,173,Móvel,7,286
12135,2024-01-09 10:14:00,78,154,Brinquedo,6,232
12136,2024-01-09 10:15:00,14,90,Brinquedo,6,104
12137,2024-01-09 10:16:00,59,157,Vestuário,5,216
12138,2024-01-09 10:17:00,54,40,Móvel,8,94
12139,2024-01-09 10:18:00,37,158,Eletrônico,1,195
12140,2024-01-09 10:19:00,70,18,Eletrônico,2,88
12141,2024-01-09 10:20:00,28,32,Vestuário,3,60
12142,2024-01-09 10:21:00,19,172,Vestuário,7,191
12143,2024-01-09 10:22:00,115,114,Alimento,3,229
12144,2024-01-09 10:23:00,100,53,Vestuário,9,153
12145,2024-01-09 10:24:00,35,68,Eletrônico,3,103
12146,2024-01-09 10:25:00,71,179,Móvel,7,250
12147,2024-01-09 10:26:00,114,15,Vestuário,2,129
12148,2024-01-09 10:27:00,100,52,Vestuário,8,152
12149,2024-01-09 10:28:00,18,65,Móvel,2,83
12150,2024-01-09 10:29:00,27,47,Vestuário,7,74
12151,2024-01-09 10:30:00,90,144,Brinquedo,6,234
12152,2024-01-09 10:31:00,14,61,Eletrônico,8,75
12153,2024-01-09 10:32:00,93,126,Vestuário,2,219
12154,2024-01-09 10:33:00,79,18,Vestuário,1,97
12155,2024-01-09 10:34:00,101,54,Eletrônico,8,155
12156,2024-01-09 10:35:00,25,13,Eletrônico,6,38
12157,2024-01-09 10:36:00,64,110,Brinquedo,7,174
12158,2024-01-09 10:37:00,13,61,Vestuário,6,74
12159,2024-01-09 10:38:00,82,178,Eletrônico,6,260
12160,2024-01-09 10:39:00,83,113,Alimento,2,196
12161,2024-01-09 10:40:00,106,12,Eletrônico,1,118
12162,2024-01-09 10:41:00,96,23,Vestuário,9,119
12163,2024-01-09 10:42:00,14,27,Vestuário,3,41
12164,2024-01-09 10:43:00,33,49,Alimento,8,82
12165,2024-01-09 10:44:00,43,149,Móvel,6,192
12166,2024-01-09 10:45:00,48,89,Brinquedo,4,137
12167,2024-01-09 10:46:00,55,102,Alimento,5,157
12168,2024-01-09 10:47:00,52,168,Eletrônico,7,220
12169,2024-01-09 10:48:00,67,79,Brinquedo,8,146
12170,2024-01-09 10:49:00,24,73,Alimento,2,97
12171,2024-01-09 10:50:00,108,104,Vestuário,2,212
12172,2024-01-09 10:51:00,102,113,Alimento,4,215
12173,2024-01-09 10:52:00,35,85,Móvel,1,120
12174,2024-01-09 10:53:00,95,169,Eletrônico,5,264
12175,2024-01-09 10:54:00,63,166,Eletrônico,8,229
12176,2024-01-09 10:55:00,64,123,Alimento,2,187
12177,2024-01-09 10:56:00,52,54,Vestuário,2,106
12178,2024-01-09 10:57:00,53,62,Vestuário,6,115
12179,2024-01-09 10:58:00,53,66,Eletrônico,7,119
12180,2024-01-09 10:59:00,33,169,Móvel,3,202
12181,2024-01-09 11:00:00,97,132,Móvel,8,229
12182,2024-01-09 11:01:00,67,10,Móvel,2,77
12183,2024-01-09 11:02:00,32,53,Vestuário,4,85
12184,2024-01-09 11:03:00,34,31,Vestuário,8,65
12185,2024-01-09 11:04:00,11,158,Brinquedo,9,169
12186,2024-01-09 11:05:00,91,10,Móvel,6,101
12187,2024-01-09 11:06:00,18,107,Brinquedo,2,125
12188,2024-01-09 11:07:00,16,113,Móvel,3,129
12189,2024-01-09 11:08:00,74,103,Eletrônico,2,177
12190,2024-01-09 11:09:00,29,64,Alimento,4,93
12191,2024-01-09 11:10:00,112,38,Alimento,8,150
12192,2024-01-09 11:11:00,80,115,Brinquedo,1,195
12193,2024-01-09 11:12:00,82,136,Alimento,6,218
12194,2024-01-09 11:13:00,90,16,Vestuário,3,106
12195,2024-01-09 11:14:00,92,177,Brinquedo,4,269
12196,2024-01-09 11:15:00,26,24,Móvel,9,50
12197,2024-01-09 11:16:00,15,135,Alimento,4,150
12198,2024-01-09 11:17:00,111,44,Eletrônico,5,155
12199,2024-01-09 11:18:00,111,27,Brinquedo,6,138
12200,2024-01-09 11:19:00,20,110,Eletrônico,8,130
12201,2024-01-09 11:20:00,37,49,Alimento,4,86
12202,2024-01-09 11:21:00,17,173,Brinquedo,9,190
12203,2024-01-09 11:22:00,32,69,Alimento,1,101
12204,2024-01-09 11:23:00,34,123,Vestuário,4,157
12205,2024-01-09 11:24:00,18,41,Móvel,6,59
12206,2024-01-09 11:25:00,20,11,Brinquedo,3,31
12207,2024-01-09 11:26:00,57,65,Vestuário,9,122
12208,2024-01-09 11:27:00,17,86,Alimento,4,103
12209,2024-01-09 11:28:00,97,54,Vestuário,9,151
12210,2024-01-09 11:29:00,13,78,Móvel,9,91
12211,2024-01-09 11:30:00,83,64,Eletrônico,2,147
12212,2024-01-09 11:31:00,28,76,Brinquedo,3,104
12213,2024-01-09 11:32:00,93,174,Eletrônico,6,267
12214,2024-01-09 11:33:00,48,65,Eletrônico,7,113
12215,2024-01-09 11:34:00,74,122,Brinquedo,5,196
12216,2024-01-09 11:35:00,118,22,Móvel,2,140
12217,2024-01-09 11:36:00,42,110,Vestuário,6,152
12218,2024-01-09 11:37:00,12,112,Móvel,5,124
12219,2024-01-09 11:38:00,49,24,Eletrônico,7,73
12220,2024-01-09 11:39:00,38,81,Alimento,3,119
12221,2024-01-09 11:40:00,75,37,Vestuário,6,112
12222,2024-01-09 11:41:00,42,94,Eletrônico,1,136
12223,2024-01-09 11:42:00,22,139,Eletrônico,9,161
12224,2024-01-09 11:43:00,96,30,Eletrônico,2,126
12225,2024-01-09 11:44:00,48,144,Vestuário,4,192
12226,2024-01-09 11:45:00,14,83,Brinquedo,9,97
12227,2024-01-09 11:46:00,54,176,Móvel,2,230
12228,2024-01-09 11:47:00,64,131,Eletrônico,4,195
12229,2024-01-09 11:48:00,119,56,Alimento,4,175
12230,2024-01-09 11:49:00,66,99,Eletrônico,5,165
12231,2024-01-09 11:50:00,44,122,Móvel,8,166
12232,2024-01-09 11:51:00,77,75,Móvel,1,152
12233,2024-01-09 11:52:00,45,92,Alimento,5,137
12234,2024-01-09 11:53:00,65,36,Vestuário,7,101
12235,2024-01-09 11:54:00,63,93,Vestuário,3,156
12236,2024-01-09 11:55:00,70,65,Brinquedo,1,135
12237,2024-01-09 11:56:00,33,129,Eletrônico,1,162
12238,2024-01-09 11:57:00,96,88,Alimento,8,184
12239,2024-01-09 11:58:00,27,24,Eletrônico,6,51
12240,2024-01-09 11:59:00,86,55,Brinquedo,5,141
12241,2024-01-09 12:00:00,117,94,Eletrônico,6,211
12242,2024-01-09 12:01:00,96,33,Móvel,2,129
12243,2024-01-09 12:02:00,49,131,Vestuário,4,180
12244,2024-01-09 12:03:00,10,112,Brinquedo,5,122
12245,2024-01-09 12:04:00,108,90,Brinquedo,8,198
12246,2024-01-09 12:05:00,22,92,Eletrônico,5,114
12247,2024-01-09 12:06:00,43,131,Brinquedo,9,174
12248,2024-01-09 12:07:00,15,88,Alimento,4,103
12249,2024-01-09 12:08:00,54,77,Eletrônico,4,131
12250,2024-01-09 12:09:00,29,49,Móvel,2,78
12251,2024-01-09 12:10:00,119,76,Móvel,2,195
12252,2024-01-09 12:11:00,65,30,Vestuário,4,95
12253,2024-01-09 12:12:00,40,54,Alimento,3,94
12254,2024-01-09 12:13:00,20,123,Eletrônico,2,143
12255,2024-01-09 12:14:00,54,119,Eletrônico,7,173
12256,2024-01-09 12:15:00,76,170,Alimento,7,246
12257,2024-01-09 12:16:00,116,150,Alimento,6,266
12258,2024-01-09 12:17:00,105,135,Brinquedo,6,240
12259,2024-01-09 12:18:00,53,86,Alimento,5,139
12260,2024-01-09 12:19:00,68,107,Alimento,8,175
12261,2024-01-09 12:20:00,24,169,Eletrônico,5,193
12262,2024-01-09 12:21:00,69,163,Móvel,5,232
12263,2024-01-09 12:22:00,100,80,Alimento,6,180
12264,2024-01-09 12:23:00,98,28,Móvel,8,126
12265,2024-01-09 12:24:00,32,117,Móvel,6,149
12266,2024-01-09 12:25:00,99,77,Vestuário,7,176
12267,2024-01-09 12:26:00,53,52,Brinquedo,5,105
12268,2024-01-09 12:27:00,113,56,Vestuário,8,169
12269,2024-01-09 12:28:00,73,98,Brinquedo,3,171
12270,2024-01-09 12:29:00,83,140,Vestuário,6,223
12271,2024-01-09 12:30:00,57,114,Alimento,5,171
12272,2024-01-09 12:31:00,116,173,Vestuário,9,289
12273,2024-01-09 12:32:00,29,13,Alimento,8,42
12274,2024-01-09 12:33:00,115,84,Alimento,6,199
12275,2024-01-09 12:34:00,89,145,Alimento,3,234
12276,2024-01-09 12:35:00,72,62,Vestuário,6,134
12277,2024-01-09 12:36:00,80,123,Móvel,5,203
12278,2024-01-09 12:37:00,20,170,Alimento,4,190
12279,2024-01-09 12:38:00,44,13,Vestuário,6,57
12280,2024-01-09 12:39:00,99,51,Móvel,6,150
12281,2024-01-09 12:40:00,109,51,Alimento,2,160
12282,2024-01-09 12:41:00,69,108,Eletrônico,3,177
12283,2024-01-09 12:42:00,51,110,Vestuário,2,161
12284,2024-01-09 12:43:00,109,38,Eletrônico,2,147
12285,2024-01-09 12:44:00,39,131,Alimento,6,170
12286,2024-01-09 12:45:00,40,107,Alimento,6,147
12287,2024-01-09 12:46:00,80,91,Brinquedo,2,171
12288,2024-01-09 12:47:00,51,32,Eletrônico,2,83
12289,2024-01-09 12:48:00,56,40,Móvel,2,96
12290,2024-01-09 12:49:00,107,171,Alimento,1,278
12291,2024-01-09 12:50:00,101,25,Brinquedo,9,126
12292,2024-01-09 12:51:00,65,41,Brinquedo,4,106
12293,2024-01-09 12:52:00,23,132,Vestuário,8,155
12294,2024-01-09 12:53:00,111,174,Móvel,2,285
12295,2024-01-09 12:54:00,112,157,Alimento,7,269
12296,2024-01-09 12:55:00,61,102,Móvel,7,163
12297,2024-01-09 12:56:00,94,137,Eletrônico,5,231
12298,2024-01-09 12:57:00,95,56,Brinquedo,3,151
12299,2024-01-09 12:58:00,115,166,Alimento,9,281
12300,2024-01-09 12:59:00,97,56,Vestuário,7,153
12301,2024-01-09 13:00:00,46,89,Móvel,9,135
12302,2024-01-09 13:01:00,81,17,Alimento,2,98
12303,2024-01-09 13:02:00,77,136,Brinquedo,5,213
12304,2024-01-09 13:03:00,23,132,Vestuário,2,155
12305,2024-01-09 13:04:00,40,93,Brinquedo,7,133
12306,2024-01-09 13:05:00,47,17,Alimento,9,64
12307,2024-01-09 13:06:00,18,158,Alimento,5,176
12308,2024-01-09 13:07:00,107,120,Vestuário,2,227
12309,2024-01-09 13:08:00,106,159,Brinquedo,7,265
12310,2024-01-09 13:09:00,108,90,Vestuário,8,198
12311,2024-01-09 13:10:00,53,157,Vestuário,3,210
12312,2024-01-09 13:11:00,97,11,Brinquedo,7,108
12313,2024-01-09 13:12:00,89,134,Alimento,1,223
12314,2024-01-09 13:13:00,64,29,Alimento,7,93
12315,2024-01-09 13:14:00,58,49,Brinquedo,8,107
12316,2024-01-09 13:15:00,61,17,Alimento,5,78
12317,2024-01-09 13:16:00,70,138,Alimento,3,208
12318,2024-01-09 13:17:00,94,171,Vestuário,4,265
12319,2024-01-09 13:18:00,74,163,Eletrônico,3,237
12320,2024-01-09 13:19:00,109,38,Móvel,2,147
12321,2024-01-09 13:20:00,107,55,Móvel,6,162
12322,2024-01-09 13:21:00,86,143,Móvel,6,229
12323,2024-01-09 13:22:00,57,83,Vestuário,8,140
12324,2024-01-09 13:23:00,88,97,Alimento,3,185
12325,2024-01-09 13:24:00,37,43,Brinquedo,1,80
12326,2024-01-09 13:25:00,95,155,Vestuário,1,250
12327,2024-01-09 13:26:00,74,142,Brinquedo,9,216
12328,2024-01-09 13:27:00,73,152,Vestuário,3,225
12329,2024-01-09 13:28:00,112,56,Vestuário,7,168
12330,2024-01-09 13:29:00,73,179,Vestuário,9,252
12331,2024-01-09 13:30:00,41,125,Eletrônico,3,166
12332,2024-01-09 13:31:00,83,168,Móvel,8,251
12333,2024-01-09 13:32:00,25,68,Eletrônico,8,93
12334,2024-01-09 13:33:00,103,85,Brinquedo,2,188
12335,2024-01-09 13:34:00,84,55,Eletrônico,2,139
12336,2024-01-09 13:35:00,99,144,Móvel,8,243
12337,2024-01-09 13:36:00,23,130,Eletrônico,6,153
12338,2024-01-09 13:37:00,84,86,Vestuário,5,170
12339,2024-01-09 13:38:00,104,21,Eletrônico,5,125
12340,2024-01-09 13:39:00,83,80,Alimento,8,163
12341,2024-01-09 13:40:00,24,92,Eletrônico,9,116
12342,2024-01-09 13:41:00,85,131,Móvel,9,216
12343,2024-01-09 13:42:00,99,120,Brinquedo,1,219
12344,2024-01-09 13:43:00,27,49,Alimento,3,76
12345,2024-01-09 13:44:00,42,17,Eletrônico,4,59
12346,2024-01-09 13:45:00,80,56,Eletrônico,6,136
12347,2024-01-09 13:46:00,33,170,Alimento,6,203
12348,2024-01-09 13:47:00,32,121,Brinquedo,5,153
12349,2024-01-09 13:48:00,26,29,Brinquedo,3,55
12350,2024-01-09 13:49:00,10,39,Móvel,4,49
12351,2024-01-09 13:50:00,66,52,Vestuário,9,118
12352,2024-01-09 13:51:00,48,78,Vestuário,6,126
12353,2024-01-09 13:52:00,23,110,Vestuário,6,133
12354,2024-01-09 13:53:00,116,47,Eletrônico,5,163
12355,2024-01-09 13:54:00,12,65,Brinquedo,1,77
12356,2024-01-09 13:55:00,50,174,Brinquedo,1,224
12357,2024-01-09 13:56:00,73,153,Móvel,8,226
12358,2024-01-09 13:57:00,37,106,Móvel,4,143
12359,2024-01-09 13:58:00,84,160,Vestuário,3,244
12360,2024-01-09 13:59:00,118,146,Vestuário,4,264
12361,2024-01-09 14:00:00,42,94,Alimento,6,136
12362,2024-01-09 14:01:00,25,55,Vestuário,7,80
12363,2024-01-09 14:02:00,105,60,Móvel,1,165
12364,2024-01-09 14:03:00,47,35,Móvel,7,82
12365,2024-01-09 14:04:00,85,68,Eletrônico,8,153
12366,2024-01-09 14:05:00,14,52,Vestuário,7,66
12367,2024-01-09 14:06:00,41,137,Brinquedo,1,178
12368,2024-01-09 14:07:00,19,56,Móvel,8,75
12369,2024-01-09 14:08:00,23,102,Móvel,1,125
12370,2024-01-09 14:09:00,51,109,Móvel,7,160
12371,2024-01-09 14:10:00,12,119,Móvel,4,131
12372,2024-01-09 14:11:00,64,96,Brinquedo,6,160
12373,2024-01-09 14:12:00,37,147,Eletrônico,7,184
12374,2024-01-09 14:13:00,69,139,Eletrônico,5,208
12375,2024-01-09 14:14:00,60,82,Brinquedo,9,142
12376,2024-01-09 14:15:00,115,101,Vestuário,2,216
12377,2024-01-09 14:16:00,92,173,Móvel,2,265
12378,2024-01-09 14:17:00,71,35,Alimento,6,106
12379,2024-01-09 14:18:00,111,112,Eletrônico,4,223
12380,2024-01-09 14:19:00,69,18,Eletrônico,5,87
12381,2024-01-09 14:20:00,116,174,Eletrônico,5,290
12382,2024-01-09 14:21:00,71,147,Vestuário,3,218
12383,2024-01-09 14:22:00,82,17,Alimento,9,99
12384,2024-01-09 14:23:00,117,48,Móvel,5,165
12385,2024-01-09 14:24:00,89,46,Brinquedo,1,135
12386,2024-01-09 14:25:00,113,171,Brinquedo,9,284
12387,2024-01-09 14:26:00,63,163,Eletrônico,6,226
12388,2024-01-09 14:27:00,88,121,Eletrônico,7,209
12389,2024-01-09 14:28:00,78,130,Móvel,3,208
12390,2024-01-09 14:29:00,43,49,Móvel,4,92
12391,2024-01-09 14:30:00,34,75,Móvel,7,109
12392,2024-01-09 14:31:00,10,73,Alimento,1,83
12393,2024-01-09 14:32:00,33,13,Vestuário,5,46
12394,2024-01-09 14:33:00,52,36,Móvel,7,88
12395,2024-01-09 14:34:00,12,123,Vestuário,5,135
12396,2024-01-09 14:35:00,23,148,Brinquedo,6,171
12397,2024-01-09 14:36:00,98,175,Alimento,1,273
12398,2024-01-09 14:37:00,52,171,Eletrônico,8,223
12399,2024-01-09 14:38:00,95,25,Eletrônico,1,120
12400,2024-01-09 14:39:00,117,11,Vestuário,6,128
12401,2024-01-09 14:40:00,110,22,Eletrônico,6,132
12402,2024-01-09 14:41:00,107,46,Móvel,2,153
12403,2024-01-09 14:42:00,71,10,Vestuário,5,81
12404,2024-01-09 14:43:00,14,53,Alimento,4,67
12405,2024-01-09 14:44:00,86,169,Móvel,7,255
12406,2024-01-09 14:45:00,74,55,Alimento,6,129
12407,2024-01-09 14:46:00,40,109,Eletrônico,5,149
12408,2024-01-09 14:47:00,77,166,Móvel,8,243
12409,2024-01-09 14:48:00,102,165,Eletrônico,8,267
12410,2024-01-09 14:49:00,32,84,Móvel,4,116
12411,2024-01-09 14:50:00,53,44,Alimento,4,97
12412,2024-01-09 14:51:00,22,93,Vestuário,4,115
12413,2024-01-09 14:52:00,112,154,Móvel,3,266
12414,2024-01-09 14:53:00,62,147,Vestuário,7,209
12415,2024-01-09 14:54:00,45,58,Eletrônico,3,103
12416,2024-01-09 14:55:00,58,58,Brinquedo,5,116
12417,2024-01-09 14:56:00,12,130,Móvel,6,142
12418,2024-01-09 14:57:00,10,52,Eletrônico,3,62
12419,2024-01-09 14:58:00,28,30,Vestuário,2,58
12420,2024-01-09 14:59:00,13,96,Móvel,3,109
12421,2024-01-09 15:00:00,85,150,Eletrônico,3,235
12422,2024-01-09 15:01:00,77,41,Brinquedo,1,118
12423,2024-01-09 15:02:00,36,93,Móvel,8,129
12424,2024-01-09 15:03:00,10,66,Vestuário,5,76
12425,2024-01-09 15:04:00,106,172,Alimento,4,278
12426,2024-01-09 15:05:00,103,133,Móvel,9,236
12427,2024-01-09 15:06:00,112,81,Eletrônico,7,193
12428,2024-01-09 15:07:00,109,42,Eletrônico,1,151
12429,2024-01-09 15:08:00,58,175,Eletrônico,4,233
12430,2024-01-09 15:09:00,71,126,Vestuário,1,197
12431,2024-01-09 15:10:00,97,138,Vestuário,6,235
12432,2024-01-09 15:11:00,18,62,Móvel,8,80
12433,2024-01-09 15:12:00,10,88,Móvel,4,98
12434,2024-01-09 15:13:00,27,54,Eletrônico,4,81
12435,2024-01-09 15:14:00,55,158,Brinquedo,3,213
12436,2024-01-09 15:15:00,65,100,Brinquedo,7,165
12437,2024-01-09 15:16:00,48,32,Eletrônico,3,80
12438,2024-01-09 15:17:00,56,93,Eletrônico,1,149
12439,2024-01-09 15:18:00,32,97,Eletrônico,1,129
12440,2024-01-09 15:19:00,29,97,Alimento,3,126
12441,2024-01-09 15:20:00,29,119,Brinquedo,1,148
12442,2024-01-09 15:21:00,25,14,Brinquedo,4,39
12443,2024-01-09 15:22:00,75,69,Móvel,3,144
12444,2024-01-09 15:23:00,72,18,Brinquedo,4,90
12445,2024-01-09 15:24:00,17,110,Alimento,8,127
12446,2024-01-09 15:25:00,77,135,Vestuário,2,212
12447,2024-01-09 15:26:00,100,24,Móvel,5,124
12448,2024-01-09 15:27:00,14,166,Vestuário,8,180
12449,2024-01-09 15:28:00,94,85,Móvel,9,179
12450,2024-01-09 15:29:00,56,125,Eletrônico,6,181
12451,2024-01-09 15:30:00,63,71,Alimento,4,134
12452,2024-01-09 15:31:00,74,148,Eletrônico,2,222
12453,2024-01-09 15:32:00,35,141,Brinquedo,3,176
12454,2024-01-09 15:33:00,84,85,Eletrônico,9,169
12455,2024-01-09 15:34:00,56,61,Brinquedo,3,117
12456,2024-01-09 15:35:00,79,98,Vestuário,9,177
12457,2024-01-09 15:36:00,113,150,Eletrônico,4,263
12458,2024-01-09 15:37:00,87,53,Brinquedo,7,140
12459,2024-01-09 15:38:00,118,32,Vestuário,4,150
12460,2024-01-09 15:39:00,113,128,Alimento,3,241
12461,2024-01-09 15:40:00,70,11,Eletrônico,3,81
12462,2024-01-09 15:41:00,61,153,Alimento,6,214
12463,2024-01-09 15:42:00,98,48,Eletrônico,8,146
12464,2024-01-09 15:43:00,65,133,Vestuário,9,198
12465,2024-01-09 15:44:00,31,99,Vestuário,9,130
12466,2024-01-09 15:45:00,50,129,Eletrônico,7,179
12467,2024-01-09 15:46:00,77,107,Eletrônico,5,184
12468,2024-01-09 15:47:00,93,17,Móvel,1,110
12469,2024-01-09 15:48:00,62,29,Eletrônico,3,91
12470,2024-01-09 15:49:00,115,15,Vestuário,1,130
12471,2024-01-09 15:50:00,93,162,Móvel,2,255
12472,2024-01-09 15:51:00,61,17,Vestuário,1,78
12473,2024-01-09 15:52:00,38,38,Alimento,7,76
12474,2024-01-09 15:53:00,28,100,Vestuário,6,128
12475,2024-01-09 15:54:00,79,163,Móvel,4,242
12476,2024-01-09 15:55:00,33,67,Alimento,6,100
12477,2024-01-09 15:56:00,107,44,Móvel,9,151
12478,2024-01-09 15:57:00,35,160,Móvel,2,195
12479,2024-01-09 15:58:00,25,16,Alimento,3,41
12480,2024-01-09 15:59:00,112,83,Brinquedo,9,195
12481,2024-01-09 16:00:00,78,155,Brinquedo,3,233
12482,2024-01-09 16:01:00,60,150,Alimento,4,210
12483,2024-01-09 16:02:00,77,63,Vestuário,3,140
12484,2024-01-09 16:03:00,89,126,Eletrônico,2,215
12485,2024-01-09 16:04:00,82,123,Eletrônico,1,205
12486,2024-01-09 16:05:00,68,33,Alimento,4,101
12487,2024-01-09 16:06:00,93,10,Eletrônico,2,103
12488,2024-01-09 16:07:00,44,101,Alimento,9,145
12489,2024-01-09 16:08:00,110,62,Alimento,4,172
12490,2024-01-09 16:09:00,109,120,Móvel,7,229
12491,2024-01-09 16:10:00,110,41,Brinquedo,7,151
12492,2024-01-09 16:11:00,11,52,Brinquedo,9,63
12493,2024-01-09 16:12:00,118,87,Móvel,4,205
12494,2024-01-09 16:13:00,55,166,Vestuário,8,221
12495,2024-01-09 16:14:00,102,100,Alimento,6,202
12496,2024-01-09 16:15:00,106,38,Brinquedo,3,144
12497,2024-01-09 16:16:00,111,78,Brinquedo,2,189
12498,2024-01-09 16:17:00,63,133,Brinquedo,6,196
12499,2024-01-09 16:18:00,74,28,Brinquedo,9,102
12500,2024-01-09 16:19:00,19,76,Alimento,8,95
12501,2024-01-09 16:20:00,71,123,Brinquedo,5,194
12502,2024-01-09 16:21:00,50,67,Brinquedo,3,117
12503,2024-01-09 16:22:00,48,156,Alimento,7,204
12504,2024-01-09 16:23:00,14,32,Brinquedo,8,46
12505,2024-01-09 16:24:00,39,174,Vestuário,3,213
12506,2024-01-09 16:25:00,49,25,Brinquedo,7,74
12507,2024-01-09 16:26:00,87,150,Vestuário,6,237
12508,2024-01-09 16:27:00,76,139,Brinquedo,2,215
12509,2024-01-09 16:28:00,102,138,Brinquedo,1,240
12510,2024-01-09 16:29:00,53,70,Vestuário,4,123
12511,2024-01-09 16:30:00,96,144,Móvel,2,240
12512,2024-01-09 16:31:00,85,132,Brinquedo,6,217
12513,2024-01-09 16:32:00,17,179,Brinquedo,5,196
12514,2024-01-09 16:33:00,11,153,Eletrônico,4,164
12515,2024-01-09 16:34:00,117,28,Alimento,4,145
12516,2024-01-09 16:35:00,12,84,Brinquedo,8,96
12517,2024-01-09 16:36:00,60,89,Alimento,6,149
12518,2024-01-09 16:37:00,109,134,Eletrônico,7,243
12519,2024-01-09 16:38:00,92,118,Eletrônico,9,210
12520,2024-01-09 16:39:00,114,44,Alimento,1,158
12521,2024-01-09 16:40:00,26,148,Eletrônico,6,174
12522,2024-01-09 16:41:00,61,156,Móvel,3,217
12523,2024-01-09 16:42:00,34,68,Brinquedo,7,102
12524,2024-01-09 16:43:00,92,34,Vestuário,7,126
12525,2024-01-09 16:44:00,41,155,Alimento,6,196
12526,2024-01-09 16:45:00,24,141,Vestuário,8,165
12527,2024-01-09 16:46:00,42,168,Alimento,6,210
12528,2024-01-09 16:47:00,90,106,Vestuário,4,196
12529,2024-01-09 16:48:00,59,109,Alimento,8,168
12530,2024-01-09 16:49:00,110,160,Eletrônico,3,270
12531,2024-01-09 16:50:00,50,101,Móvel,8,151
12532,2024-01-09 16:51:00,39,131,Alimento,7,170
12533,2024-01-09 16:52:00,58,97,Eletrônico,9,155
12534,2024-01-09 16:53:00,22,175,Móvel,7,197
12535,2024-01-09 16:54:00,48,127,Móvel,6,175
12536,2024-01-09 16:55:00,56,116,Móvel,5,172
12537,2024-01-09 16:56:00,104,179,Brinquedo,2,283
12538,2024-01-09 16:57:00,21,45,Alimento,1,66
12539,2024-01-09 16:58:00,99,24,Móvel,9,123
12540,2024-01-09 16:59:00,16,179,Móvel,4,195
12541,2024-01-09 17:00:00,94,159,Alimento,8,253
12542,2024-01-09 17:01:00,86,89,Alimento,1,175
12543,2024-01-09 17:02:00,73,168,Brinquedo,7,241
12544,2024-01-09 17:03:00,34,146,Alimento,2,180
12545,2024-01-09 17:04:00,48,160,Alimento,1,208
12546,2024-01-09 17:05:00,119,89,Móvel,9,208
12547,2024-01-09 17:06:00,49,23,Eletrônico,9,72
12548,2024-01-09 17:07:00,111,93,Eletrônico,7,204
12549,2024-01-09 17:08:00,47,168,Vestuário,2,215
12550,2024-01-09 17:09:00,78,79,Alimento,6,157
12551,2024-01-09 17:10:00,14,96,Brinquedo,1,110
12552,2024-01-09 17:11:00,45,177,Alimento,9,222
12553,2024-01-09 17:12:00,117,15,Eletrônico,2,132
12554,2024-01-09 17:13:00,69,132,Móvel,7,201
12555,2024-01-09 17:14:00,98,150,Móvel,9,248
12556,2024-01-09 17:15:00,11,22,Móvel,4,33
12557,2024-01-09 17:16:00,91,127,Vestuário,4,218
12558,2024-01-09 17:17:00,79,166,Eletrônico,6,245
12559,2024-01-09 17:18:00,24,60,Eletrônico,5,84
12560,2024-01-09 17:19:00,81,75,Brinquedo,4,156
12561,2024-01-09 17:20:00,85,39,Alimento,5,124
12562,2024-01-09 17:21:00,35,68,Eletrônico,9,103
12563,2024-01-09 17:22:00,79,44,Móvel,2,123
12564,2024-01-09 17:23:00,85,146,Vestuário,3,231
12565,2024-01-09 17:24:00,77,125,Eletrônico,4,202
12566,2024-01-09 17:25:00,16,84,Alimento,9,100
12567,2024-01-09 17:26:00,81,57,Alimento,6,138
12568,2024-01-09 17:27:00,89,64,Brinquedo,7,153
12569,2024-01-09 17:28:00,57,116,Vestuário,4,173
12570,2024-01-09 17:29:00,112,62,Brinquedo,6,174
12571,2024-01-09 17:30:00,60,57,Móvel,3,117
12572,2024-01-09 17:31:00,41,60,Móvel,2,101
12573,2024-01-09 17:32:00,115,89,Brinquedo,8,204
12574,2024-01-09 17:33:00,73,159,Vestuário,8,232
12575,2024-01-09 17:34:00,12,146,Alimento,4,158
12576,2024-01-09 17:35:00,85,21,Brinquedo,2,106
12577,2024-01-09 17:36:00,35,118,Brinquedo,8,153
12578,2024-01-09 17:37:00,34,28,Alimento,8,62
12579,2024-01-09 17:38:00,23,48,Eletrônico,3,71
12580,2024-01-09 17:39:00,65,24,Alimento,3,89
12581,2024-01-09 17:40:00,89,13,Vestuário,9,102
12582,2024-01-09 17:41:00,116,26,Móvel,6,142
12583,2024-01-09 17:42:00,90,152,Eletrônico,2,242
12584,2024-01-09 17:43:00,35,176,Alimento,8,211
12585,2024-01-09 17:44:00,95,140,Alimento,9,235
12586,2024-01-09 17:45:00,114,150,Móvel,6,264
12587,2024-01-09 17:46:00,15,118,Móvel,5,133
12588,2024-01-09 17:47:00,61,157,Alimento,5,218
12589,2024-01-09 17:48:00,98,11,Eletrônico,2,109
12590,2024-01-09 17:49:00,107,87,Alimento,9,194
12591,2024-01-09 17:50:00,33,100,Eletrônico,8,133
12592,2024-01-09 17:51:00,13,11,Alimento,9,24
12593,2024-01-09 17:52:00,17,117,Eletrônico,3,134
12594,2024-01-09 17:53:00,78,148,Eletrônico,4,226
12595,2024-01-09 17:54:00,42,123,Vestuário,8,165
12596,2024-01-09 17:55:00,103,128,Alimento,3,231
12597,2024-01-09 17:56:00,57,101,Vestuário,6,158
12598,2024-01-09 17:57:00,28,83,Móvel,7,111
12599,2024-01-09 17:58:00,83,111,Eletrônico,6,194
12600,2024-01-09 17:59:00,80,170,Brinquedo,1,250
12601,2024-01-09 18:00:00,117,132,Móvel,5,249
12602,2024-01-09 18:01:00,118,143,Brinquedo,5,261
12603,2024-01-09 18:02:00,100,156,Alimento,8,256
12604,2024-01-09 18:03:00,30,59,Eletrônico,2,89
12605,2024-01-09 18:04:00,53,66,Brinquedo,6,119
12606,2024-01-09 18:05:00,71,57,Brinquedo,4,128
12607,2024-01-09 18:06:00,94,166,Brinquedo,9,260
12608,2024-01-09 18:07:00,31,47,Alimento,4,78
12609,2024-01-09 18:08:00,29,115,Eletrônico,3,144
12610,2024-01-09 18:09:00,76,67,Móvel,1,143
12611,2024-01-09 18:10:00,31,137,Brinquedo,6,168
12612,2024-01-09 18:11:00,21,43,Vestuário,4,64
12613,2024-01-09 18:12:00,12,56,Móvel,9,68
12614,2024-01-09 18:13:00,54,25,Vestuário,1,79
12615,2024-01-09 18:14:00,107,104,Móvel,8,211
12616,2024-01-09 18:15:00,94,18,Alimento,2,112
12617,2024-01-09 18:16:00,45,140,Alimento,9,185
12618,2024-01-09 18:17:00,114,48,Eletrônico,7,162
12619,2024-01-09 18:18:00,72,63,Móvel,7,135
12620,2024-01-09 18:19:00,18,77,Vestuário,7,95
12621,2024-01-09 18:20:00,17,83,Alimento,4,100
12622,2024-01-09 18:21:00,97,176,Móvel,8,273
12623,2024-01-09 18:22:00,62,72,Vestuário,5,134
12624,2024-01-09 18:23:00,10,53,Alimento,8,63
12625,2024-01-09 18:24:00,112,64,Brinquedo,1,176
12626,2024-01-09 18:25:00,118,172,Eletrônico,4,290
12627,2024-01-09 18:26:00,86,171,Eletrônico,6,257
12628,2024-01-09 18:27:00,119,38,Eletrônico,7,157
12629,2024-01-09 18:28:00,79,142,Alimento,4,221
12630,2024-01-09 18:29:00,78,57,Eletrônico,4,135
12631,2024-01-09 18:30:00,79,135,Brinquedo,9,214
12632,2024-01-09 18:31:00,31,150,Alimento,5,181
12633,2024-01-09 18:32:00,24,149,Brinquedo,4,173
12634,2024-01-09 18:33:00,42,41,Alimento,4,83
12635,2024-01-09 18:34:00,76,26,Brinquedo,3,102
12636,2024-01-09 18:35:00,54,80,Móvel,9,134
12637,2024-01-09 18:36:00,36,170,Brinquedo,4,206
12638,2024-01-09 18:37:00,42,92,Brinquedo,8,134
12639,2024-01-09 18:38:00,86,144,Vestuário,6,230
12640,2024-01-09 18:39:00,14,178,Vestuário,3,192
12641,2024-01-09 18:40:00,98,116,Eletrônico,3,214
12642,2024-01-09 18:41:00,29,141,Vestuário,8,170
12643,2024-01-09 18:42:00,59,120,Móvel,5,179
12644,2024-01-09 18:43:00,110,12,Eletrônico,2,122
12645,2024-01-09 18:44:00,80,135,Brinquedo,4,215
12646,2024-01-09 18:45:00,81,31,Vestuário,8,112
12647,2024-01-09 18:46:00,18,172,Alimento,5,190
12648,2024-01-09 18:47:00,52,148,Alimento,5,200
12649,2024-01-09 18:48:00,17,59,Vestuário,1,76
12650,2024-01-09 18:49:00,38,60,Móvel,7,98
12651,2024-01-09 18:50:00,33,92,Eletrônico,6,125
12652,2024-01-09 18:51:00,89,79,Vestuário,5,168
12653,2024-01-09 18:52:00,107,178,Eletrônico,6,285
12654,2024-01-09 18:53:00,67,115,Vestuário,2,182
12655,2024-01-09 18:54:00,55,155,Vestuário,1,210
12656,2024-01-09 18:55:00,113,134,Vestuário,2,247
12657,2024-01-09 18:56:00,47,77,Vestuário,9,124
12658,2024-01-09 18:57:00,10,95,Alimento,2,105
12659,2024-01-09 18:58:00,31,89,Brinquedo,9,120
12660,2024-01-09 18:59:00,17,178,Móvel,5,195
12661,2024-01-09 19:00:00,94,125,Móvel,3,219
12662,2024-01-09 19:01:00,44,87,Eletrônico,7,131
12663,2024-01-09 19:02:00,100,63,Brinquedo,5,163
12664,2024-01-09 19:03:00,32,173,Eletrônico,1,205
12665,2024-01-09 19:04:00,108,173,Alimento,2,281
12666,2024-01-09 19:05:00,94,114,Móvel,8,208
12667,2024-01-09 19:06:00,104,131,Alimento,9,235
12668,2024-01-09 19:07:00,85,43,Vestuário,4,128
12669,2024-01-09 19:08:00,58,178,Vestuário,2,236
12670,2024-01-09 19:09:00,113,146,Alimento,9,259
12671,2024-01-09 19:10:00,108,92,Vestuário,2,200
12672,2024-01-09 19:11:00,83,54,Vestuário,1,137
12673,2024-01-09 19:12:00,108,149,Vestuário,4,257
12674,2024-01-09 19:13:00,60,116,Alimento,2,176
12675,2024-01-09 19:14:00,111,82,Eletrônico,1,193
12676,2024-01-09 19:15:00,117,56,Eletrônico,5,173
12677,2024-01-09 19:16:00,86,132,Alimento,6,218
12678,2024-01-09 19:17:00,84,156,Brinquedo,7,240
12679,2024-01-09 19:18:00,16,123,Alimento,7,139
12680,2024-01-09 19:19:00,75,167,Vestuário,9,242
12681,2024-01-09 19:20:00,72,110,Alimento,4,182
12682,2024-01-09 19:21:00,56,51,Vestuário,2,107
12683,2024-01-09 19:22:00,75,80,Eletrônico,4,155
12684,2024-01-09 19:23:00,108,166,Alimento,7,274
12685,2024-01-09 19:24:00,40,126,Brinquedo,6,166
12686,2024-01-09 19:25:00,52,88,Brinquedo,2,140
12687,2024-01-09 19:26:00,49,122,Eletrônico,7,171
12688,2024-01-09 19:27:00,74,107,Vestuário,1,181
12689,2024-01-09 19:28:00,101,143,Vestuário,1,244
12690,2024-01-09 19:29:00,40,56,Eletrônico,8,96
12691,2024-01-09 19:30:00,24,137,Móvel,3,161
12692,2024-01-09 19:31:00,100,37,Brinquedo,7,137
12693,2024-01-09 19:32:00,18,80,Eletrônico,1,98
12694,2024-01-09 19:33:00,69,164,Móvel,5,233
12695,2024-01-09 19:34:00,40,109,Brinquedo,4,149
12696,2024-01-09 19:35:00,54,77,Alimento,6,131
12697,2024-01-09 19:36:00,103,137,Alimento,5,240
12698,2024-01-09 19:37:00,13,150,Vestuário,7,163
12699,2024-01-09 19:38:00,74,27,Vestuário,2,101
12700,2024-01-09 19:39:00,75,64,Móvel,6,139
12701,2024-01-09 19:40:00,82,151,Eletrônico,9,233
12702,2024-01-09 19:41:00,87,21,Alimento,6,108
12703,2024-01-09 19:42:00,102,51,Alimento,6,153
12704,2024-01-09 19:43:00,17,36,Eletrônico,9,53
12705,2024-01-09 19:44:00,91,67,Vestuário,6,158
12706,2024-01-09 19:45:00,85,36,Eletrônico,5,121
12707,2024-01-09 19:46:00,112,20,Móvel,8,132
12708,2024-01-09 19:47:00,52,61,Alimento,9,113
12709,2024-01-09 19:48:00,28,88,Alimento,8,116
12710,2024-01-09 19:49:00,76,140,Eletrônico,4,216
12711,2024-01-09 19:50:00,51,105,Vestuário,7,156
12712,2024-01-09 19:51:00,66,68,Alimento,7,134
12713,2024-01-09 19:52:00,118,46,Brinquedo,1,164
12714,2024-01-09 19:53:00,53,54,Brinquedo,4,107
12715,2024-01-09 19:54:00,115,15,Eletrônico,3,130
12716,2024-01-09 19:55:00,23,10,Brinquedo,1,33
12717,2024-01-09 19:56:00,53,65,Brinquedo,8,118
12718,2024-01-09 19:57:00,53,12,Alimento,2,65
12719,2024-01-09 19:58:00,49,111,Alimento,5,160
12720,2024-01-09 19:59:00,38,19,Alimento,8,57
12721,2024-01-09 20:00:00,14,172,Móvel,8,186
12722,2024-01-09 20:01:00,75,120,Móvel,5,195
12723,2024-01-09 20:02:00,101,47,Brinquedo,2,148
12724,2024-01-09 20:03:00,43,16,Eletrônico,3,59
12725,2024-01-09 20:04:00,96,119,Brinquedo,9,215
12726,2024-01-09 20:05:00,69,59,Alimento,6,128
12727,2024-01-09 20:06:00,88,49,Eletrônico,2,137
12728,2024-01-09 20:07:00,76,49,Vestuário,6,125
12729,2024-01-09 20:08:00,12,10,Eletrônico,3,22
12730,2024-01-09 20:09:00,100,103,Alimento,3,203
12731,2024-01-09 20:10:00,73,157,Vestuário,5,230
12732,2024-01-09 20:11:00,49,55,Móvel,5,104
12733,2024-01-09 20:12:00,34,127,Alimento,2,161
12734,2024-01-09 20:13:00,56,91,Eletrônico,1,147
12735,2024-01-09 20:14:00,95,178,Móvel,4,273
12736,2024-01-09 20:15:00,42,37,Alimento,9,79
12737,2024-01-09 20:16:00,74,154,Móvel,1,228
12738,2024-01-09 20:17:00,68,139,Eletrônico,3,207
12739,2024-01-09 20:18:00,12,107,Vestuário,7,119
12740,2024-01-09 20:19:00,30,41,Alimento,7,71
12741,2024-01-09 20:20:00,50,41,Brinquedo,9,91
12742,2024-01-09 20:21:00,43,83,Brinquedo,6,126
12743,2024-01-09 20:22:00,109,86,Eletrônico,9,195
12744,2024-01-09 20:23:00,13,153,Brinquedo,5,166
12745,2024-01-09 20:24:00,68,11,Eletrônico,8,79
12746,2024-01-09 20:25:00,95,56,Brinquedo,9,151
12747,2024-01-09 20:26:00,108,31,Alimento,8,139
12748,2024-01-09 20:27:00,69,161,Alimento,5,230
12749,2024-01-09 20:28:00,19,123,Eletrônico,3,142
12750,2024-01-09 20:29:00,34,119,Vestuário,1,153
12751,2024-01-09 20:30:00,23,160,Alimento,8,183
12752,2024-01-09 20:31:00,117,59,Alimento,4,176
12753,2024-01-09 20:32:00,37,87,Eletrônico,8,124
12754,2024-01-09 20:33:00,51,173,Alimento,2,224
12755,2024-01-09 20:34:00,44,172,Brinquedo,4,216
12756,2024-01-09 20:35:00,25,61,Brinquedo,2,86
12757,2024-01-09 20:36:00,66,65,Brinquedo,6,131
12758,2024-01-09 20:37:00,94,89,Eletrônico,1,183
12759,2024-01-09 20:38:00,78,140,Alimento,1,218
12760,2024-01-09 20:39:00,12,94,Móvel,4,106
12761,2024-01-09 20:40:00,105,43,Brinquedo,5,148
12762,2024-01-09 20:41:00,39,135,Alimento,6,174
12763,2024-01-09 20:42:00,28,176,Brinquedo,8,204
12764,2024-01-09 20:43:00,59,60,Alimento,9,119
12765,2024-01-09 20:44:00,14,42,Vestuário,1,56
12766,2024-01-09 20:45:00,13,123,Vestuário,9,136
12767,2024-01-09 20:46:00,47,48,Alimento,6,95
12768,2024-01-09 20:47:00,28,10,Brinquedo,4,38
12769,2024-01-09 20:48:00,46,42,Eletrônico,6,88
12770,2024-01-09 20:49:00,19,165,Eletrônico,8,184
12771,2024-01-09 20:50:00,54,26,Alimento,9,80
12772,2024-01-09 20:51:00,16,137,Alimento,3,153
12773,2024-01-09 20:52:00,98,134,Vestuário,1,232
12774,2024-01-09 20:53:00,41,59,Vestuário,1,100
12775,2024-01-09 20:54:00,39,110,Móvel,3,149
12776,2024-01-09 20:55:00,27,157,Brinquedo,7,184
12777,2024-01-09 20:56:00,13,70,Alimento,6,83
12778,2024-01-09 20:57:00,20,100,Móvel,5,120
12779,2024-01-09 20:58:00,51,63,Móvel,6,114
12780,2024-01-09 20:59:00,70,81,Alimento,9,151
12781,2024-01-09 21:00:00,52,36,Brinquedo,9,88
12782,2024-01-09 21:01:00,32,135,Móvel,3,167
12783,2024-01-09 21:02:00,42,88,Vestuário,8,130
12784,2024-01-09 21:03:00,98,131,Móvel,3,229
12785,2024-01-09 21:04:00,118,81,Brinquedo,5,199
12786,2024-01-09 21:05:00,110,92,Móvel,9,202
12787,2024-01-09 21:06:00,92,135,Vestuário,2,227
12788,2024-01-09 21:07:00,92,73,Vestuário,4,165
12789,2024-01-09 21:08:00,22,35,Brinquedo,2,57
12790,2024-01-09 21:09:00,82,138,Vestuário,9,220
12791,2024-01-09 21:10:00,101,55,Eletrônico,3,156
12792,2024-01-09 21:11:00,90,12,Alimento,4,102
12793,2024-01-09 21:12:00,99,18,Vestuário,9,117
12794,2024-01-09 21:13:00,56,22,Eletrônico,8,78
12795,2024-01-09 21:14:00,93,145,Móvel,2,238
12796,2024-01-09 21:15:00,90,73,Brinquedo,3,163
12797,2024-01-09 21:16:00,85,150,Vestuário,8,235
12798,2024-01-09 21:17:00,19,107,Móvel,5,126
12799,2024-01-09 21:18:00,33,10,Móvel,7,43
12800,2024-01-09 21:19:00,28,63,Vestuário,6,91
12801,2024-01-09 21:20:00,35,70,Eletrônico,1,105
12802,2024-01-09 21:21:00,109,95,Alimento,2,204
12803,2024-01-09 21:22:00,79,55,Vestuário,6,134
12804,2024-01-09 21:23:00,12,125,Alimento,7,137
12805,2024-01-09 21:24:00,93,79,Eletrônico,4,172
12806,2024-01-09 21:25:00,30,89,Vestuário,2,119
12807,2024-01-09 21:26:00,34,136,Brinquedo,5,170
12808,2024-01-09 21:27:00,74,138,Móvel,8,212
12809,2024-01-09 21:28:00,118,70,Brinquedo,6,188
12810,2024-01-09 21:29:00,84,126,Móvel,5,210
12811,2024-01-09 21:30:00,108,167,Eletrônico,1,275
12812,2024-01-09 21:31:00,15,80,Vestuário,7,95
12813,2024-01-09 21:32:00,60,176,Alimento,8,236
12814,2024-01-09 21:33:00,82,155,Brinquedo,1,237
12815,2024-01-09 21:34:00,69,80,Brinquedo,6,149
12816,2024-01-09 21:35:00,36,48,Alimento,8,84
12817,2024-01-09 21:36:00,14,33,Vestuário,3,47
12818,2024-01-09 21:37:00,78,77,Eletrônico,3,155
12819,2024-01-09 21:38:00,97,117,Móvel,8,214
12820,2024-01-09 21:39:00,118,95,Vestuário,9,213
12821,2024-01-09 21:40:00,72,15,Alimento,7,87
12822,2024-01-09 21:41:00,97,39,Vestuário,2,136
12823,2024-01-09 21:42:00,45,127,Alimento,9,172
12824,2024-01-09 21:43:00,106,120,Alimento,7,226
12825,2024-01-09 21:44:00,15,36,Vestuário,1,51
12826,2024-01-09 21:45:00,70,103,Brinquedo,8,173
12827,2024-01-09 21:46:00,98,154,Alimento,6,252
12828,2024-01-09 21:47:00,33,129,Eletrônico,2,162
12829,2024-01-09 21:48:00,39,83,Brinquedo,6,122
12830,2024-01-09 21:49:00,54,70,Brinquedo,2,124
12831,2024-01-09 21:50:00,28,104,Móvel,4,132
12832,2024-01-09 21:51:00,58,96,Alimento,1,154
12833,2024-01-09 21:52:00,31,26,Móvel,8,57
12834,2024-01-09 21:53:00,32,133,Brinquedo,6,165
12835,2024-01-09 21:54:00,60,21,Brinquedo,1,81
12836,2024-01-09 21:55:00,86,94,Eletrônico,8,180
12837,2024-01-09 21:56:00,67,49,Eletrônico,6,116
12838,2024-01-09 21:57:00,82,155,Alimento,8,237
12839,2024-01-09 21:58:00,46,48,Eletrônico,6,94
12840,2024-01-09 21:59:00,117,62,Alimento,6,179
12841,2024-01-09 22:00:00,51,51,Móvel,3,102
12842,2024-01-09 22:01:00,65,101,Brinquedo,9,166
12843,2024-01-09 22:02:00,46,98,Alimento,2,144
12844,2024-01-09 22:03:00,108,52,Vestuário,5,160
12845,2024-01-09 22:04:00,68,148,Eletrônico,6,216
12846,2024-01-09 22:05:00,100,14,Vestuário,3,114
12847,2024-01-09 22:06:00,65,11,Alimento,9,76
12848,2024-01-09 22:07:00,85,10,Brinquedo,2,95
12849,2024-01-09 22:08:00,54,13,Vestuário,4,67
12850,2024-01-09 22:09:00,80,70,Eletrônico,1,150
12851,2024-01-09 22:10:00,42,136,Móvel,2,178
12852,2024-01-09 22:11:00,52,95,Móvel,2,147
12853,2024-01-09 22:12:00,55,104,Alimento,9,159
12854,2024-01-09 22:13:00,29,107,Vestuário,9,136
12855,2024-01-09 22:14:00,75,90,Vestuário,1,165
12856,2024-01-09 22:15:00,57,171,Alimento,9,228
12857,2024-01-09 22:16:00,90,44,Brinquedo,9,134
12858,2024-01-09 22:17:00,100,49,Vestuário,1,149
12859,2024-01-09 22:18:00,80,99,Brinquedo,8,179
12860,2024-01-09 22:19:00,91,12,Alimento,7,103
12861,2024-01-09 22:20:00,86,105,Vestuário,1,191
12862,2024-01-09 22:21:00,35,57,Brinquedo,7,92
12863,2024-01-09 22:22:00,94,71,Móvel,4,165
12864,2024-01-09 22:23:00,63,57,Brinquedo,7,120
12865,2024-01-09 22:24:00,60,149,Brinquedo,8,209
12866,2024-01-09 22:25:00,11,78,Vestuário,9,89
12867,2024-01-09 22:26:00,76,133,Alimento,7,209
12868,2024-01-09 22:27:00,101,50,Brinquedo,3,151
12869,2024-01-09 22:28:00,104,134,Móvel,7,238
12870,2024-01-09 22:29:00,77,117,Vestuário,9,194
12871,2024-01-09 22:30:00,62,65,Alimento,9,127
12872,2024-01-09 22:31:00,104,40,Brinquedo,5,144
12873,2024-01-09 22:32:00,18,91,Vestuário,4,109
12874,2024-01-09 22:33:00,49,139,Vestuário,7,188
12875,2024-01-09 22:34:00,54,10,Móvel,1,64
12876,2024-01-09 22:35:00,22,151,Eletrônico,8,173
12877,2024-01-09 22:36:00,70,79,Móvel,2,149
12878,2024-01-09 22:37:00,13,100,Eletrônico,1,113
12879,2024-01-09 22:38:00,88,167,Eletrônico,1,255
12880,2024-01-09 22:39:00,12,145,Brinquedo,7,157
12881,2024-01-09 22:40:00,103,117,Móvel,5,220
12882,2024-01-09 22:41:00,38,162,Eletrônico,2,200
12883,2024-01-09 22:42:00,108,12,Brinquedo,3,120
12884,2024-01-09 22:43:00,77,116,Eletrônico,5,193
12885,2024-01-09 22:44:00,52,65,Móvel,7,117
12886,2024-01-09 22:45:00,49,21,Brinquedo,8,70
12887,2024-01-09 22:46:00,28,134,Eletrônico,5,162
12888,2024-01-09 22:47:00,52,98,Móvel,4,150
12889,2024-01-09 22:48:00,69,115,Móvel,8,184
12890,2024-01-09 22:49:00,43,47,Móvel,6,90
12891,2024-01-09 22:50:00,76,102,Móvel,4,178
12892,2024-01-09 22:51:00,57,40,Brinquedo,1,97
12893,2024-01-09 22:52:00,101,143,Vestuário,8,244
12894,2024-01-09 22:53:00,41,115,Móvel,4,156
12895,2024-01-09 22:54:00,33,72,Alimento,6,105
12896,2024-01-09 22:55:00,26,54,Móvel,8,80
12897,2024-01-09 22:56:00,15,97,Móvel,2,112
12898,2024-01-09 22:57:00,112,39,Alimento,8,151
12899,2024-01-09 22:58:00,43,34,Vestuário,4,77
12900,2024-01-09 22:59:00,56,106,Eletrônico,3,162
12901,2024-01-09 23:00:00,100,116,Vestuário,3,216
12902,2024-01-09 23:01:00,55,61,Vestuário,6,116
12903,2024-01-09 23:02:00,70,85,Alimento,7,155
12904,2024-01-09 23:03:00,60,120,Brinquedo,4,180
12905,2024-01-09 23:04:00,26,171,Eletrônico,2,197
12906,2024-01-09 23:05:00,68,127,Brinquedo,3,195
12907,2024-01-09 23:06:00,33,20,Móvel,9,53
12908,2024-01-09 23:07:00,34,91,Vestuário,5,125
12909,2024-01-09 23:08:00,15,91,Alimento,9,106
12910,2024-01-09 23:09:00,75,163,Eletrônico,9,238
12911,2024-01-09 23:10:00,84,83,Eletrônico,8,167
12912,2024-01-09 23:11:00,103,79,Eletrônico,6,182
12913,2024-01-09 23:12:00,24,146,Eletrônico,3,170
12914,2024-01-09 23:13:00,52,112,Vestuário,2,164
12915,2024-01-09 23:14:00,49,75,Vestuário,9,124
12916,2024-01-09 23:15:00,68,146,Alimento,5,214
12917,2024-01-09 23:16:00,101,168,Brinquedo,5,269
12918,2024-01-09 23:17:00,22,137,Vestuário,3,159
12919,2024-01-09 23:18:00,34,52,Brinquedo,1,86
12920,2024-01-09 23:19:00,58,51,Eletrônico,8,109
12921,2024-01-09 23:20:00,101,146,Vestuário,1,247
12922,2024-01-09 23:21:00,23,41,Alimento,7,64
12923,2024-01-09 23:22:00,67,95,Brinquedo,6,162
12924,2024-01-09 23:23:00,108,60,Alimento,9,168
12925,2024-01-09 23:24:00,82,102,Eletrônico,5,184
12926,2024-01-09 23:25:00,112,33,Alimento,8,145
12927,2024-01-09 23:26:00,64,93,Eletrônico,8,157
12928,2024-01-09 23:27:00,77,172,Brinquedo,8,249
12929,2024-01-09 23:28:00,68,41,Alimento,5,109
12930,2024-01-09 23:29:00,49,20,Vestuário,9,69
12931,2024-01-09 23:30:00,117,43,Móvel,1,160
12932,2024-01-09 23:31:00,33,37,Vestuário,3,70
12933,2024-01-09 23:32:00,41,106,Móvel,3,147
12934,2024-01-09 23:33:00,47,125,Brinquedo,8,172
12935,2024-01-09 23:34:00,90,94,Brinquedo,3,184
12936,2024-01-09 23:35:00,69,41,Vestuário,4,110
12937,2024-01-09 23:36:00,45,150,Alimento,2,195
12938,2024-01-09 23:37:00,94,65,Vestuário,8,159
12939,2024-01-09 23:38:00,90,113,Eletrônico,8,203
12940,2024-01-09 23:39:00,97,29,Eletrônico,1,126
12941,2024-01-09 23:40:00,28,28,Brinquedo,3,56
12942,2024-01-09 23:41:00,15,148,Eletrônico,4,163
12943,2024-01-09 23:42:00,53,101,Móvel,1,154
12944,2024-01-09 23:43:00,115,146,Eletrônico,8,261
12945,2024-01-09 23:44:00,78,83,Eletrônico,6,161
12946,2024-01-09 23:45:00,28,78,Vestuário,3,106
12947,2024-01-09 23:46:00,70,98,Brinquedo,5,168
12948,2024-01-09 23:47:00,105,174,Vestuário,6,279
12949,2024-01-09 23:48:00,54,121,Eletrônico,1,175
12950,2024-01-09 23:49:00,58,119,Móvel,3,177
12951,2024-01-09 23:50:00,111,21,Vestuário,5,132
12952,2024-01-09 23:51:00,95,37,Alimento,4,132
12953,2024-01-09 23:52:00,76,57,Vestuário,1,133
12954,2024-01-09 23:53:00,50,137,Alimento,3,187
12955,2024-01-09 23:54:00,21,144,Móvel,3,165
12956,2024-01-09 23:55:00,29,79,Alimento,3,108
12957,2024-01-09 23:56:00,21,91,Eletrônico,1,112
12958,2024-01-09 23:57:00,68,73,Vestuário,1,141
12959,2024-01-09 23:58:00,109,127,Móvel,3,236
12960,2024-01-09 23:59:00,66,145,Vestuário,1,211
12961,2024-01-10 00:00:00,13,57,Brinquedo,1,70
12962,2024-01-10 00:01:00,25,64,Móvel,6,89
12963,2024-01-10 00:02:00,30,41,Vestuário,9,71
12964,2024-01-10 00:03:00,32,13,Alimento,8,45
12965,2024-01-10 00:04:00,46,114,Móvel,1,160
12966,2024-01-10 00:05:00,53,74,Eletrônico,2,127
12967,2024-01-10 00:06:00,79,113,Alimento,9,192
12968,2024-01-10 00:07:00,65,100,Brinquedo,9,165
12969,2024-01-10 00:08:00,108,94,Eletrônico,6,202
12970,2024-01-10 00:09:00,29,34,Alimento,3,63
12971,2024-01-10 00:10:00,15,82,Alimento,1,97
12972,2024-01-10 00:11:00,89,103,Brinquedo,4,192
12973,2024-01-10 00:12:00,53,140,Alimento,3,193
12974,2024-01-10 00:13:00,30,136,Vestuário,1,166
12975,2024-01-10 00:14:00,93,111,Eletrônico,3,204
12976,2024-01-10 00:15:00,76,103,Alimento,7,179
12977,2024-01-10 00:16:00,56,80,Móvel,4,136
12978,2024-01-10 00:17:00,117,106,Brinquedo,4,223
12979,2024-01-10 00:18:00,75,161,Brinquedo,6,236
12980,2024-01-10 00:19:00,77,17,Brinquedo,7,94
12981,2024-01-10 00:20:00,28,110,Alimento,9,138
12982,2024-01-10 00:21:00,94,142,Eletrônico,3,236
12983,2024-01-10 00:22:00,104,11,Alimento,7,115
12984,2024-01-10 00:23:00,57,137,Vestuário,2,194
12985,2024-01-10 00:24:00,88,43,Vestuário,1,131
12986,2024-01-10 00:25:00,79,133,Brinquedo,8,212
12987,2024-01-10 00:26:00,67,59,Vestuário,6,126
12988,2024-01-10 00:27:00,61,100,Móvel,8,161
12989,2024-01-10 00:28:00,97,154,Brinquedo,2,251
12990,2024-01-10 00:29:00,57,153,Brinquedo,8,210
12991,2024-01-10 00:30:00,44,160,Brinquedo,3,204
12992,2024-01-10 00:31:00,44,167,Vestuário,5,211
12993,2024-01-10 00:32:00,118,83,Alimento,3,201
12994,2024-01-10 00:33:00,61,15,Brinquedo,2,76
12995,2024-01-10 00:34:00,95,64,Alimento,6,159
12996,2024-01-10 00:35:00,40,44,Vestuário,5,84
12997,2024-01-10 00:36:00,52,154,Móvel,3,206
12998,2024-01-10 00:37:00,82,89,Brinquedo,2,171
12999,2024-01-10 00:38:00,18,47,Móvel,7,65
13000,2024-01-10 00:39:00,27,147,Vestuário,5,174
13001,2024-01-10 00:40:00,33,131,Vestuário,9,164
13002,2024-01-10 00:41:00,100,16,Móvel,4,116
13003,2024-01-10 00:42:00,82,20,Brinquedo,5,102
13004,2024-01-10 00:43:00,94,113,Vestuário,8,207
13005,2024-01-10 00:44:00,28,161,Vestuário,6,189
13006,2024-01-10 00:45:00,85,115,Eletrônico,5,200
13007,2024-01-10 00:46:00,91,12,Móvel,8,103
13008,2024-01-10 00:47:00,108,84,Móvel,4,192
13009,2024-01-10 00:48:00,12,19,Móvel,9,31
13010,2024-01-10 00:49:00,35,166,Brinquedo,6,201
13011,2024-01-10 00:50:00,15,82,Brinquedo,9,97
13012,2024-01-10 00:51:00,34,60,Móvel,8,94
13013,2024-01-10 00:52:00,87,89,Vestuário,8,176
13014,2024-01-10 00:53:00,33,164,Eletrônico,3,197
13015,2024-01-10 00:54:00,42,44,Alimento,7,86
13016,2024-01-10 00:55:00,53,109,Móvel,4,162
13017,2024-01-10 00:56:00,13,15,Vestuário,5,28
13018,2024-01-10 00:57:00,27,174,Móvel,8,201
13019,2024-01-10 00:58:00,93,61,Vestuário,8,154
13020,2024-01-10 00:59:00,50,169,Brinquedo,6,219
13021,2024-01-10 01:00:00,80,59,Brinquedo,5,139
13022,2024-01-10 01:01:00,63,26,Alimento,7,89
13023,2024-01-10 01:02:00,103,22,Brinquedo,6,125
13024,2024-01-10 01:03:00,109,50,Eletrônico,5,159
13025,2024-01-10 01:04:00,72,162,Alimento,3,234
13026,2024-01-10 01:05:00,111,86,Alimento,9,197
13027,2024-01-10 01:06:00,78,76,Alimento,5,154
13028,2024-01-10 01:07:00,50,162,Eletrônico,4,212
13029,2024-01-10 01:08:00,75,30,Móvel,1,105
13030,2024-01-10 01:09:00,99,74,Vestuário,1,173
13031,2024-01-10 01:10:00,24,141,Brinquedo,4,165
13032,2024-01-10 01:11:00,98,50,Alimento,3,148
13033,2024-01-10 01:12:00,53,51,Alimento,3,104
13034,2024-01-10 01:13:00,71,21,Móvel,2,92
13035,2024-01-10 01:14:00,13,93,Eletrônico,5,106
13036,2024-01-10 01:15:00,38,138,Vestuário,9,176
13037,2024-01-10 01:16:00,76,83,Eletrônico,3,159
13038,2024-01-10 01:17:00,17,16,Eletrônico,8,33
13039,2024-01-10 01:18:00,30,122,Eletrônico,4,152
13040,2024-01-10 01:19:00,50,18,Vestuário,4,68
13041,2024-01-10 01:20:00,93,60,Eletrônico,2,153
13042,2024-01-10 01:21:00,65,126,Eletrônico,1,191
13043,2024-01-10 01:22:00,114,77,Móvel,1,191
13044,2024-01-10 01:23:00,111,45,Eletrônico,6,156
13045,2024-01-10 01:24:00,43,172,Móvel,5,215
13046,2024-01-10 01:25:00,25,23,Brinquedo,9,48
13047,2024-01-10 01:26:00,102,18,Brinquedo,6,120
13048,2024-01-10 01:27:00,69,141,Brinquedo,7,210
13049,2024-01-10 01:28:00,56,127,Móvel,4,183
13050,2024-01-10 01:29:00,73,57,Vestuário,9,130
13051,2024-01-10 01:30:00,40,173,Vestuário,1,213
13052,2024-01-10 01:31:00,37,155,Vestuário,6,192
13053,2024-01-10 01:32:00,35,126,Móvel,1,161
13054,2024-01-10 01:33:00,18,14,Brinquedo,1,32
13055,2024-01-10 01:34:00,88,100,Vestuário,7,188
13056,2024-01-10 01:35:00,110,169,Eletrônico,6,279
13057,2024-01-10 01:36:00,73,136,Brinquedo,6,209
13058,2024-01-10 01:37:00,51,85,Vestuário,2,136
13059,2024-01-10 01:38:00,95,11,Vestuário,4,106
13060,2024-01-10 01:39:00,119,80,Brinquedo,9,199
13061,2024-01-10 01:40:00,78,77,Eletrônico,5,155
13062,2024-01-10 01:41:00,13,67,Eletrônico,2,80
13063,2024-01-10 01:42:00,86,100,Móvel,9,186
13064,2024-01-10 01:43:00,112,48,Vestuário,3,160
13065,2024-01-10 01:44:00,112,164,Alimento,6,276
13066,2024-01-10 01:45:00,99,88,Móvel,2,187
13067,2024-01-10 01:46:00,36,111,Alimento,5,147
13068,2024-01-10 01:47:00,51,105,Móvel,4,156
13069,2024-01-10 01:48:00,84,58,Eletrônico,4,142
13070,2024-01-10 01:49:00,18,141,Eletrônico,4,159
13071,2024-01-10 01:50:00,48,128,Vestuário,9,176
13072,2024-01-10 01:51:00,81,65,Alimento,6,146
13073,2024-01-10 01:52:00,75,53,Vestuário,1,128
13074,2024-01-10 01:53:00,34,87,Móvel,5,121
13075,2024-01-10 01:54:00,110,63,Alimento,6,173
13076,2024-01-10 01:55:00,119,105,Alimento,9,224
13077,2024-01-10 01:56:00,20,162,Eletrônico,7,182
13078,2024-01-10 01:57:00,89,132,Móvel,3,221
13079,2024-01-10 01:58:00,32,15,Vestuário,2,47
13080,2024-01-10 01:59:00,23,48,Brinquedo,5,71
13081,2024-01-10 02:00:00,108,60,Brinquedo,5,168
13082,2024-01-10 02:01:00,56,29,Vestuário,9,85
13083,2024-01-10 02:02:00,115,61,Móvel,8,176
13084,2024-01-10 02:03:00,80,48,Brinquedo,9,128
13085,2024-01-10 02:04:00,46,12,Alimento,1,58
13086,2024-01-10 02:05:00,110,160,Brinquedo,5,270
13087,2024-01-10 02:06:00,58,79,Brinquedo,7,137
13088,2024-01-10 02:07:00,80,46,Brinquedo,2,126
13089,2024-01-10 02:08:00,33,83,Vestuário,2,116
13090,2024-01-10 02:09:00,102,47,Brinquedo,1,149
13091,2024-01-10 02:10:00,43,149,Brinquedo,4,192
13092,2024-01-10 02:11:00,38,169,Eletrônico,2,207
13093,2024-01-10 02:12:00,18,117,Alimento,8,135
13094,2024-01-10 02:13:00,23,80,Alimento,7,103
13095,2024-01-10 02:14:00,48,22,Vestuário,6,70
13096,2024-01-10 02:15:00,64,146,Eletrônico,5,210
13097,2024-01-10 02:16:00,29,137,Alimento,2,166
13098,2024-01-10 02:17:00,73,99,Brinquedo,8,172
13099,2024-01-10 02:18:00,22,14,Eletrônico,9,36
13100,2024-01-10 02:19:00,79,137,Brinquedo,2,216
13101,2024-01-10 02:20:00,13,51,Móvel,9,64
13102,2024-01-10 02:21:00,40,68,Brinquedo,9,108
13103,2024-01-10 02:22:00,31,81,Alimento,6,112
13104,2024-01-10 02:23:00,31,62,Vestuário,9,93
13105,2024-01-10 02:24:00,54,43,Vestuário,2,97
13106,2024-01-10 02:25:00,23,101,Alimento,5,124
13107,2024-01-10 02:26:00,88,146,Eletrônico,2,234
13108,2024-01-10 02:27:00,16,43,Vestuário,5,59
13109,2024-01-10 02:28:00,10,145,Vestuário,9,155
13110,2024-01-10 02:29:00,39,107,Vestuário,1,146
13111,2024-01-10 02:30:00,39,112,Eletrônico,5,151
13112,2024-01-10 02:31:00,100,103,Móvel,3,203
13113,2024-01-10 02:32:00,57,131,Alimento,9,188
13114,2024-01-10 02:33:00,100,112,Vestuário,2,212
13115,2024-01-10 02:34:00,57,112,Eletrônico,1,169
13116,2024-01-10 02:35:00,45,124,Vestuário,7,169
13117,2024-01-10 02:36:00,55,150,Alimento,6,205
13118,2024-01-10 02:37:00,110,118,Vestuário,8,228
13119,2024-01-10 02:38:00,83,64,Móvel,3,147
13120,2024-01-10 02:39:00,41,176,Vestuário,6,217
13121,2024-01-10 02:40:00,115,38,Vestuário,4,153
13122,2024-01-10 02:41:00,92,82,Móvel,1,174
13123,2024-01-10 02:42:00,53,151,Móvel,7,204
13124,2024-01-10 02:43:00,19,35,Alimento,2,54
13125,2024-01-10 02:44:00,105,81,Vestuário,7,186
13126,2024-01-10 02:45:00,118,32,Móvel,2,150
13127,2024-01-10 02:46:00,101,167,Brinquedo,6,268
13128,2024-01-10 02:47:00,115,81,Brinquedo,5,196
13129,2024-01-10 02:48:00,104,84,Eletrônico,9,188
13130,2024-01-10 02:49:00,115,35,Eletrônico,2,150
13131,2024-01-10 02:50:00,83,179,Vestuário,2,262
13132,2024-01-10 02:51:00,62,160,Eletrônico,2,222
13133,2024-01-10 02:52:00,83,26,Vestuário,2,109
13134,2024-01-10 02:53:00,70,94,Móvel,3,164
13135,2024-01-10 02:54:00,32,59,Brinquedo,3,91
13136,2024-01-10 02:55:00,57,116,Vestuário,3,173
13137,2024-01-10 02:56:00,112,148,Vestuário,5,260
13138,2024-01-10 02:57:00,16,174,Vestuário,9,190
13139,2024-01-10 02:58:00,23,38,Móvel,6,61
13140,2024-01-10 02:59:00,80,23,Alimento,3,103
13141,2024-01-10 03:00:00,45,161,Vestuário,5,206
13142,2024-01-10 03:01:00,112,85,Eletrônico,7,197
13143,2024-01-10 03:02:00,88,87,Móvel,8,175
13144,2024-01-10 03:03:00,59,117,Alimento,3,176
13145,2024-01-10 03:04:00,44,18,Alimento,8,62
13146,2024-01-10 03:05:00,71,107,Brinquedo,9,178
13147,2024-01-10 03:06:00,104,175,Vestuário,1,279
13148,2024-01-10 03:07:00,45,19,Eletrônico,9,64
13149,2024-01-10 03:08:00,35,110,Vestuário,4,145
13150,2024-01-10 03:09:00,60,20,Eletrônico,9,80
13151,2024-01-10 03:10:00,61,133,Alimento,8,194
13152,2024-01-10 03:11:00,105,163,Alimento,9,268
13153,2024-01-10 03:12:00,44,26,Eletrônico,7,70
13154,2024-01-10 03:13:00,84,100,Eletrônico,4,184
13155,2024-01-10 03:14:00,93,123,Eletrônico,9,216
13156,2024-01-10 03:15:00,59,149,Alimento,6,208
13157,2024-01-10 03:16:00,79,136,Vestuário,4,215
13158,2024-01-10 03:17:00,27,47,Brinquedo,9,74
13159,2024-01-10 03:18:00,116,80,Brinquedo,3,196
13160,2024-01-10 03:19:00,43,149,Vestuário,2,192
13161,2024-01-10 03:20:00,12,132,Móvel,8,144
13162,2024-01-10 03:21:00,102,100,Brinquedo,2,202
13163,2024-01-10 03:22:00,16,154,Vestuário,4,170
13164,2024-01-10 03:23:00,25,159,Alimento,7,184
13165,2024-01-10 03:24:00,23,149,Alimento,9,172
13166,2024-01-10 03:25:00,28,119,Brinquedo,6,147
13167,2024-01-10 03:26:00,14,147,Eletrônico,6,161
13168,2024-01-10 03:27:00,85,36,Móvel,9,121
13169,2024-01-10 03:28:00,68,174,Brinquedo,5,242
13170,2024-01-10 03:29:00,72,88,Vestuário,2,160
13171,2024-01-10 03:30:00,94,36,Alimento,6,130
13172,2024-01-10 03:31:00,44,14,Móvel,9,58
13173,2024-01-10 03:32:00,63,87,Eletrônico,6,150
13174,2024-01-10 03:33:00,13,169,Móvel,7,182
13175,2024-01-10 03:34:00,82,73,Alimento,1,155
13176,2024-01-10 03:35:00,26,67,Vestuário,7,93
13177,2024-01-10 03:36:00,112,99,Alimento,3,211
13178,2024-01-10 03:37:00,70,10,Vestuário,2,80
13179,2024-01-10 03:38:00,115,74,Alimento,4,189
13180,2024-01-10 03:39:00,73,59,Alimento,9,132
13181,2024-01-10 03:40:00,97,83,Vestuário,4,180
13182,2024-01-10 03:41:00,64,74,Brinquedo,2,138
13183,2024-01-10 03:42:00,84,27,Vestuário,1,111
13184,2024-01-10 03:43:00,39,80,Vestuário,4,119
13185,2024-01-10 03:44:00,80,156,Brinquedo,1,236
13186,2024-01-10 03:45:00,76,30,Vestuário,3,106
13187,2024-01-10 03:46:00,26,69,Alimento,4,95
13188,2024-01-10 03:47:00,30,100,Brinquedo,9,130
13189,2024-01-10 03:48:00,49,76,Eletrônico,9,125
13190,2024-01-10 03:49:00,60,152,Móvel,4,212
13191,2024-01-10 03:50:00,29,31,Alimento,3,60
13192,2024-01-10 03:51:00,96,16,Eletrônico,8,112
13193,2024-01-10 03:52:00,98,125,Vestuário,2,223
13194,2024-01-10 03:53:00,33,11,Alimento,1,44
13195,2024-01-10 03:54:00,65,115,Alimento,2,180
13196,2024-01-10 03:55:00,19,125,Vestuário,9,144
13197,2024-01-10 03:56:00,86,75,Brinquedo,7,161
13198,2024-01-10 03:57:00,98,97,Móvel,2,195
13199,2024-01-10 03:58:00,50,63,Brinquedo,2,113
13200,2024-01-10 03:59:00,83,153,Móvel,7,236
13201,2024-01-10 04:00:00,78,154,Móvel,7,232
13202,2024-01-10 04:01:00,45,90,Eletrônico,3,135
13203,2024-01-10 04:02:00,61,141,Móvel,4,202
13204,2024-01-10 04:03:00,117,163,Brinquedo,3,280
13205,2024-01-10 04:04:00,59,30,Alimento,3,89
13206,2024-01-10 04:05:00,26,142,Móvel,6,168
13207,2024-01-10 04:06:00,14,17,Brinquedo,2,31
13208,2024-01-10 04:07:00,79,146,Eletrônico,6,225
13209,2024-01-10 04:08:00,54,12,Brinquedo,3,66
13210,2024-01-10 04:09:00,32,31,Brinquedo,3,63
13211,2024-01-10 04:10:00,54,91,Alimento,8,145
13212,2024-01-10 04:11:00,109,62,Brinquedo,7,171
13213,2024-01-10 04:12:00,58,34,Brinquedo,5,92
13214,2024-01-10 04:13:00,88,64,Móvel,2,152
13215,2024-01-10 04:14:00,12,120,Vestuário,5,132
13216,2024-01-10 04:15:00,11,118,Brinquedo,4,129
13217,2024-01-10 04:16:00,113,14,Brinquedo,9,127
13218,2024-01-10 04:17:00,46,120,Vestuário,7,166
13219,2024-01-10 04:18:00,73,116,Móvel,1,189
13220,2024-01-10 04:19:00,16,28,Eletrônico,2,44
13221,2024-01-10 04:20:00,45,67,Móvel,6,112
13222,2024-01-10 04:21:00,90,175,Eletrônico,9,265
13223,2024-01-10 04:22:00,103,89,Móvel,9,192
13224,2024-01-10 04:23:00,58,125,Alimento,5,183
13225,2024-01-10 04:24:00,44,17,Alimento,2,61
13226,2024-01-10 04:25:00,28,81,Móvel,8,109
13227,2024-01-10 04:26:00,91,87,Alimento,6,178
13228,2024-01-10 04:27:00,64,88,Brinquedo,3,152
13229,2024-01-10 04:28:00,56,31,Eletrônico,6,87
13230,2024-01-10 04:29:00,22,137,Alimento,6,159
13231,2024-01-10 04:30:00,30,58,Brinquedo,6,88
13232,2024-01-10 04:31:00,13,23,Vestuário,4,36
13233,2024-01-10 04:32:00,21,158,Alimento,8,179
13234,2024-01-10 04:33:00,89,136,Vestuário,5,225
13235,2024-01-10 04:34:00,43,51,Eletrônico,9,94
13236,2024-01-10 04:35:00,39,116,Eletrônico,9,155
13237,2024-01-10 04:36:00,28,25,Brinquedo,1,53
13238,2024-01-10 04:37:00,40,159,Alimento,2,199
13239,2024-01-10 04:38:00,109,173,Eletrônico,7,282
13240,2024-01-10 04:39:00,111,173,Vestuário,8,284
13241,2024-01-10 04:40:00,86,33,Móvel,2,119
13242,2024-01-10 04:41:00,31,100,Vestuário,4,131
13243,2024-01-10 04:42:00,21,173,Móvel,7,194
13244,2024-01-10 04:43:00,112,178,Eletrônico,1,290
13245,2024-01-10 04:44:00,63,18,Alimento,9,81
13246,2024-01-10 04:45:00,96,21,Alimento,7,117
13247,2024-01-10 04:46:00,48,131,Eletrônico,2,179
13248,2024-01-10 04:47:00,12,162,Eletrônico,9,174
13249,2024-01-10 04:48:00,12,104,Vestuário,8,116
13250,2024-01-10 04:49:00,22,156,Alimento,2,178
13251,2024-01-10 04:50:00,110,63,Vestuário,2,173
13252,2024-01-10 04:51:00,24,10,Brinquedo,3,34
13253,2024-01-10 04:52:00,102,162,Móvel,5,264
13254,2024-01-10 04:53:00,28,26,Vestuário,6,54
13255,2024-01-10 04:54:00,100,35,Vestuário,9,135
13256,2024-01-10 04:55:00,22,95,Brinquedo,2,117
13257,2024-01-10 04:56:00,16,45,Alimento,4,61
13258,2024-01-10 04:57:00,108,25,Móvel,8,133
13259,2024-01-10 04:58:00,104,59,Brinquedo,2,163
13260,2024-01-10 04:59:00,54,69,Eletrônico,6,123
13261,2024-01-10 05:00:00,81,39,Eletrônico,5,120
13262,2024-01-10 05:01:00,15,166,Vestuário,3,181
13263,2024-01-10 05:02:00,42,73,Vestuário,7,115
13264,2024-01-10 05:03:00,84,69,Brinquedo,1,153
13265,2024-01-10 05:04:00,61,140,Brinquedo,4,201
13266,2024-01-10 05:05:00,117,116,Eletrônico,8,233
13267,2024-01-10 05:06:00,86,148,Alimento,9,234
13268,2024-01-10 05:07:00,58,71,Eletrônico,7,129
13269,2024-01-10 05:08:00,57,54,Móvel,4,111
13270,2024-01-10 05:09:00,20,78,Móvel,2,98
13271,2024-01-10 05:10:00,76,99,Eletrônico,4,175
13272,2024-01-10 05:11:00,103,34,Brinquedo,5,137
13273,2024-01-10 05:12:00,75,55,Brinquedo,4,130
13274,2024-01-10 05:13:00,19,156,Alimento,1,175
13275,2024-01-10 05:14:00,27,162,Eletrônico,7,189
13276,2024-01-10 05:15:00,54,23,Eletrônico,5,77
13277,2024-01-10 05:16:00,66,155,Vestuário,5,221
13278,2024-01-10 05:17:00,112,90,Brinquedo,1,202
13279,2024-01-10 05:18:00,110,35,Eletrônico,5,145
13280,2024-01-10 05:19:00,111,114,Móvel,9,225
13281,2024-01-10 05:20:00,25,65,Eletrônico,2,90
13282,2024-01-10 05:21:00,84,50,Brinquedo,9,134
13283,2024-01-10 05:22:00,30,122,Eletrônico,9,152
13284,2024-01-10 05:23:00,59,15,Brinquedo,9,74
13285,2024-01-10 05:24:00,35,163,Eletrônico,9,198
13286,2024-01-10 05:25:00,50,170,Alimento,9,220
13287,2024-01-10 05:26:00,68,85,Alimento,7,153
13288,2024-01-10 05:27:00,88,29,Brinquedo,6,117
13289,2024-01-10 05:28:00,14,113,Alimento,4,127
13290,2024-01-10 05:29:00,91,170,Brinquedo,7,261
13291,2024-01-10 05:30:00,109,91,Móvel,6,200
13292,2024-01-10 05:31:00,87,107,Alimento,9,194
13293,2024-01-10 05:32:00,92,106,Alimento,7,198
13294,2024-01-10 05:33:00,109,74,Brinquedo,1,183
13295,2024-01-10 05:34:00,77,160,Móvel,1,237
13296,2024-01-10 05:35:00,18,106,Alimento,2,124
13297,2024-01-10 05:36:00,30,68,Vestuário,8,98
13298,2024-01-10 05:37:00,35,163,Vestuário,8,198
13299,2024-01-10 05:38:00,61,89,Vestuário,4,150
13300,2024-01-10 05:39:00,68,156,Brinquedo,5,224
13301,2024-01-10 05:40:00,68,126,Brinquedo,3,194
13302,2024-01-10 05:41:00,32,114,Móvel,5,146
13303,2024-01-10 05:42:00,101,64,Móvel,9,165
13304,2024-01-10 05:43:00,65,137,Vestuário,4,202
13305,2024-01-10 05:44:00,70,48,Alimento,8,118
13306,2024-01-10 05:45:00,80,68,Eletrônico,7,148
13307,2024-01-10 05:46:00,16,52,Vestuário,8,68
13308,2024-01-10 05:47:00,58,139,Alimento,6,197
13309,2024-01-10 05:48:00,99,106,Alimento,4,205
13310,2024-01-10 05:49:00,103,46,Vestuário,7,149
13311,2024-01-10 05:50:00,81,122,Móvel,6,203
13312,2024-01-10 05:51:00,103,31,Alimento,1,134
13313,2024-01-10 05:52:00,42,165,Móvel,6,207
13314,2024-01-10 05:53:00,31,47,Eletrônico,5,78
13315,2024-01-10 05:54:00,27,76,Móvel,4,103
13316,2024-01-10 05:55:00,61,83,Brinquedo,5,144
13317,2024-01-10 05:56:00,20,173,Vestuário,6,193
13318,2024-01-10 05:57:00,114,175,Brinquedo,7,289
13319,2024-01-10 05:58:00,77,61,Móvel,3,138
13320,2024-01-10 05:59:00,86,28,Vestuário,8,114
13321,2024-01-10 06:00:00,111,166,Eletrônico,9,277
13322,2024-01-10 06:01:00,40,70,Móvel,8,110
13323,2024-01-10 06:02:00,83,109,Alimento,7,192
13324,2024-01-10 06:03:00,69,173,Vestuário,9,242
13325,2024-01-10 06:04:00,51,52,Alimento,7,103
13326,2024-01-10 06:05:00,75,38,Brinquedo,2,113
13327,2024-01-10 06:06:00,85,129,Vestuário,8,214
13328,2024-01-10 06:07:00,114,131,Eletrônico,1,245
13329,2024-01-10 06:08:00,48,39,Alimento,3,87
13330,2024-01-10 06:09:00,78,110,Móvel,6,188
13331,2024-01-10 06:10:00,104,127,Brinquedo,1,231
13332,2024-01-10 06:11:00,60,45,Brinquedo,9,105
13333,2024-01-10 06:12:00,80,49,Brinquedo,5,129
13334,2024-01-10 06:13:00,62,141,Vestuário,4,203
13335,2024-01-10 06:14:00,55,123,Vestuário,8,178
13336,2024-01-10 06:15:00,71,90,Vestuário,7,161
13337,2024-01-10 06:16:00,105,128,Brinquedo,3,233
13338,2024-01-10 06:17:00,47,84,Alimento,3,131
13339,2024-01-10 06:18:00,16,143,Alimento,5,159
13340,2024-01-10 06:19:00,118,51,Vestuário,2,169
13341,2024-01-10 06:20:00,53,119,Brinquedo,1,172
13342,2024-01-10 06:21:00,25,126,Brinquedo,6,151
13343,2024-01-10 06:22:00,25,103,Alimento,8,128
13344,2024-01-10 06:23:00,117,28,Eletrônico,1,145
13345,2024-01-10 06:24:00,12,81,Móvel,4,93
13346,2024-01-10 06:25:00,83,115,Vestuário,3,198
13347,2024-01-10 06:26:00,101,37,Vestuário,4,138
13348,2024-01-10 06:27:00,26,114,Vestuário,4,140
13349,2024-01-10 06:28:00,53,90,Móvel,5,143
13350,2024-01-10 06:29:00,83,132,Brinquedo,9,215
13351,2024-01-10 06:30:00,77,63,Brinquedo,2,140
13352,2024-01-10 06:31:00,99,11,Eletrônico,5,110
13353,2024-01-10 06:32:00,83,91,Brinquedo,4,174
13354,2024-01-10 06:33:00,115,119,Vestuário,5,234
13355,2024-01-10 06:34:00,17,124,Alimento,5,141
13356,2024-01-10 06:35:00,83,101,Móvel,4,184
13357,2024-01-10 06:36:00,32,28,Vestuário,2,60
13358,2024-01-10 06:37:00,18,156,Móvel,8,174
13359,2024-01-10 06:38:00,84,66,Móvel,5,150
13360,2024-01-10 06:39:00,27,58,Móvel,5,85
13361,2024-01-10 06:40:00,118,47,Vestuário,7,165
13362,2024-01-10 06:41:00,111,42,Brinquedo,2,153
13363,2024-01-10 06:42:00,52,36,Alimento,2,88
13364,2024-01-10 06:43:00,106,42,Vestuário,5,148
13365,2024-01-10 06:44:00,86,68,Móvel,2,154
13366,2024-01-10 06:45:00,95,165,Vestuário,4,260
13367,2024-01-10 06:46:00,84,118,Eletrônico,3,202
13368,2024-01-10 06:47:00,52,75,Móvel,4,127
13369,2024-01-10 06:48:00,89,81,Móvel,8,170
13370,2024-01-10 06:49:00,69,98,Vestuário,3,167
13371,2024-01-10 06:50:00,26,101,Vestuário,1,127
13372,2024-01-10 06:51:00,81,38,Alimento,3,119
13373,2024-01-10 06:52:00,117,173,Brinquedo,8,290
13374,2024-01-10 06:53:00,43,28,Eletrônico,4,71
13375,2024-01-10 06:54:00,38,175,Vestuário,7,213
13376,2024-01-10 06:55:00,63,114,Móvel,9,177
13377,2024-01-10 06:56:00,94,177,Eletrônico,5,271
13378,2024-01-10 06:57:00,43,111,Móvel,6,154
13379,2024-01-10 06:58:00,52,141,Vestuário,6,193
13380,2024-01-10 06:59:00,33,68,Vestuário,4,101
13381,2024-01-10 07:00:00,37,101,Eletrônico,3,138
13382,2024-01-10 07:01:00,93,54,Eletrônico,5,147
13383,2024-01-10 07:02:00,102,90,Móvel,7,192
13384,2024-01-10 07:03:00,23,26,Eletrônico,5,49
13385,2024-01-10 07:04:00,50,104,Alimento,9,154
13386,2024-01-10 07:05:00,49,105,Eletrônico,2,154
13387,2024-01-10 07:06:00,89,91,Eletrônico,1,180
13388,2024-01-10 07:07:00,45,177,Brinquedo,7,222
13389,2024-01-10 07:08:00,88,83,Móvel,2,171
13390,2024-01-10 07:09:00,68,132,Vestuário,8,200
13391,2024-01-10 07:10:00,25,107,Brinquedo,2,132
13392,2024-01-10 07:11:00,101,70,Alimento,9,171
13393,2024-01-10 07:12:00,55,23,Eletrônico,9,78
13394,2024-01-10 07:13:00,90,27,Alimento,9,117
13395,2024-01-10 07:14:00,22,42,Alimento,3,64
13396,2024-01-10 07:15:00,75,27,Móvel,3,102
13397,2024-01-10 07:16:00,85,175,Móvel,3,260
13398,2024-01-10 07:17:00,60,49,Brinquedo,8,109
13399,2024-01-10 07:18:00,117,177,Alimento,4,294
13400,2024-01-10 07:19:00,77,105,Móvel,5,182
13401,2024-01-10 07:20:00,104,161,Móvel,2,265
13402,2024-01-10 07:21:00,118,22,Vestuário,1,140
13403,2024-01-10 07:22:00,94,109,Eletrônico,1,203
13404,2024-01-10 07:23:00,83,34,Eletrônico,8,117
13405,2024-01-10 07:24:00,52,149,Eletrônico,7,201
13406,2024-01-10 07:25:00,68,162,Alimento,4,230
13407,2024-01-10 07:26:00,92,142,Vestuário,9,234
13408,2024-01-10 07:27:00,14,16,Móvel,4,30
13409,2024-01-10 07:28:00,115,113,Brinquedo,1,228
13410,2024-01-10 07:29:00,84,38,Eletrônico,7,122
13411,2024-01-10 07:30:00,69,133,Eletrônico,5,202
13412,2024-01-10 07:31:00,56,47,Brinquedo,1,103
13413,2024-01-10 07:32:00,107,37,Brinquedo,5,144
13414,2024-01-10 07:33:00,16,167,Alimento,5,183
13415,2024-01-10 07:34:00,50,43,Eletrônico,8,93
13416,2024-01-10 07:35:00,79,179,Brinquedo,4,258
13417,2024-01-10 07:36:00,73,144,Eletrônico,7,217
13418,2024-01-10 07:37:00,27,52,Vestuário,9,79
13419,2024-01-10 07:38:00,95,104,Eletrônico,8,199
13420,2024-01-10 07:39:00,61,32,Móvel,3,93
13421,2024-01-10 07:40:00,12,93,Eletrônico,4,105
13422,2024-01-10 07:41:00,35,144,Eletrônico,5,179
13423,2024-01-10 07:42:00,58,60,Brinquedo,2,118
13424,2024-01-10 07:43:00,27,92,Móvel,4,119
13425,2024-01-10 07:44:00,56,114,Móvel,5,170
13426,2024-01-10 07:45:00,70,92,Vestuário,6,162
13427,2024-01-10 07:46:00,83,94,Eletrônico,4,177
13428,2024-01-10 07:47:00,109,86,Brinquedo,3,195
13429,2024-01-10 07:48:00,95,10,Vestuário,3,105
13430,2024-01-10 07:49:00,56,22,Alimento,5,78
13431,2024-01-10 07:50:00,91,14,Eletrônico,9,105
13432,2024-01-10 07:51:00,55,87,Móvel,2,142
13433,2024-01-10 07:52:00,82,149,Móvel,7,231
13434,2024-01-10 07:53:00,15,113,Brinquedo,5,128
13435,2024-01-10 07:54:00,115,106,Alimento,6,221
13436,2024-01-10 07:55:00,106,138,Eletrônico,7,244
13437,2024-01-10 07:56:00,112,177,Eletrônico,4,289
13438,2024-01-10 07:57:00,18,150,Eletrônico,9,168
13439,2024-01-10 07:58:00,115,26,Alimento,1,141
13440,2024-01-10 07:59:00,65,155,Alimento,5,220
13441,2024-01-10 08:00:00,49,132,Alimento,1,181
13442,2024-01-10 08:01:00,104,153,Eletrônico,1,257
13443,2024-01-10 08:02:00,103,96,Alimento,1,199
13444,2024-01-10 08:03:00,51,165,Eletrônico,4,216
13445,2024-01-10 08:04:00,96,160,Alimento,4,256
13446,2024-01-10 08:05:00,80,68,Alimento,5,148
13447,2024-01-10 08:06:00,74,31,Alimento,3,105
13448,2024-01-10 08:07:00,105,136,Vestuário,3,241
13449,2024-01-10 08:08:00,33,165,Brinquedo,8,198
13450,2024-01-10 08:09:00,41,95,Alimento,6,136
13451,2024-01-10 08:10:00,71,167,Eletrônico,5,238
13452,2024-01-10 08:11:00,74,66,Alimento,9,140
13453,2024-01-10 08:12:00,118,41,Brinquedo,9,159
13454,2024-01-10 08:13:00,50,109,Móvel,8,159
13455,2024-01-10 08:14:00,49,46,Brinquedo,4,95
13456,2024-01-10 08:15:00,13,16,Brinquedo,6,29
13457,2024-01-10 08:16:00,24,50,Brinquedo,3,74
13458,2024-01-10 08:17:00,91,30,Alimento,8,121
13459,2024-01-10 08:18:00,98,138,Vestuário,6,236
13460,2024-01-10 08:19:00,74,150,Móvel,6,224
13461,2024-01-10 08:20:00,26,80,Móvel,2,106
13462,2024-01-10 08:21:00,20,140,Eletrônico,7,160
13463,2024-01-10 08:22:00,34,162,Brinquedo,9,196
13464,2024-01-10 08:23:00,42,97,Móvel,2,139
13465,2024-01-10 08:24:00,48,126,Móvel,4,174
13466,2024-01-10 08:25:00,87,43,Vestuário,2,130
13467,2024-01-10 08:26:00,78,26,Eletrônico,3,104
13468,2024-01-10 08:27:00,76,172,Alimento,5,248
13469,2024-01-10 08:28:00,83,173,Vestuário,2,256
13470,2024-01-10 08:29:00,103,169,Vestuário,8,272
13471,2024-01-10 08:30:00,15,57,Vestuário,7,72
13472,2024-01-10 08:31:00,32,161,Móvel,5,193
13473,2024-01-10 08:32:00,78,61,Eletrônico,7,139
13474,2024-01-10 08:33:00,48,53,Brinquedo,8,101
13475,2024-01-10 08:34:00,89,122,Móvel,9,211
13476,2024-01-10 08:35:00,63,73,Eletrônico,9,136
13477,2024-01-10 08:36:00,10,100,Eletrônico,4,110
13478,2024-01-10 08:37:00,41,106,Móvel,3,147
13479,2024-01-10 08:38:00,12,165,Brinquedo,4,177
13480,2024-01-10 08:39:00,107,15,Móvel,2,122
13481,2024-01-10 08:40:00,86,175,Brinquedo,6,261
13482,2024-01-10 08:41:00,105,70,Vestuário,6,175
13483,2024-01-10 08:42:00,93,42,Móvel,3,135
13484,2024-01-10 08:43:00,12,57,Alimento,7,69
13485,2024-01-10 08:44:00,99,96,Alimento,4,195
13486,2024-01-10 08:45:00,61,148,Eletrônico,1,209
13487,2024-01-10 08:46:00,118,156,Móvel,9,274
13488,2024-01-10 08:47:00,100,155,Brinquedo,4,255
13489,2024-01-10 08:48:00,48,48,Móvel,8,96
13490,2024-01-10 08:49:00,80,53,Alimento,9,133
13491,2024-01-10 08:50:00,81,11,Vestuário,3,92
13492,2024-01-10 08:51:00,66,46,Brinquedo,6,112
13493,2024-01-10 08:52:00,109,121,Eletrônico,5,230
13494,2024-01-10 08:53:00,118,35,Alimento,9,153
13495,2024-01-10 08:54:00,51,126,Alimento,6,177
13496,2024-01-10 08:55:00,41,121,Alimento,5,162
13497,2024-01-10 08:56:00,87,169,Eletrônico,5,256
13498,2024-01-10 08:57:00,110,131,Móvel,5,241
13499,2024-01-10 08:58:00,31,67,Alimento,4,98
13500,2024-01-10 08:59:00,16,108,Móvel,9,124
13501,2024-01-10 09:00:00,68,78,Eletrônico,7,146
13502,2024-01-10 09:01:00,25,52,Alimento,2,77
13503,2024-01-10 09:02:00,70,60,Móvel,2,130
13504,2024-01-10 09:03:00,25,47,Móvel,5,72
13505,2024-01-10 09:04:00,20,43,Eletrônico,7,63
13506,2024-01-10 09:05:00,47,68,Brinquedo,7,115
13507,2024-01-10 09:06:00,110,118,Brinquedo,2,228
13508,2024-01-10 09:07:00,111,36,Eletrônico,5,147
13509,2024-01-10 09:08:00,11,80,Móvel,2,91
13510,2024-01-10 09:09:00,79,104,Móvel,6,183
13511,2024-01-10 09:10:00,106,57,Brinquedo,2,163
13512,2024-01-10 09:11:00,64,149,Eletrônico,9,213
13513,2024-01-10 09:12:00,109,46,Brinquedo,4,155
13514,2024-01-10 09:13:00,53,92,Vestuário,6,145
13515,2024-01-10 09:14:00,110,38,Móvel,7,148
13516,2024-01-10 09:15:00,55,18,Eletrônico,2,73
13517,2024-01-10 09:16:00,100,62,Alimento,5,162
13518,2024-01-10 09:17:00,29,171,Brinquedo,5,200
13519,2024-01-10 09:18:00,77,101,Alimento,7,178
13520,2024-01-10 09:19:00,28,178,Eletrônico,6,206
13521,2024-01-10 09:20:00,97,47,Eletrônico,2,144
13522,2024-01-10 09:21:00,43,22,Brinquedo,2,65
13523,2024-01-10 09:22:00,83,91,Alimento,7,174
13524,2024-01-10 09:23:00,17,101,Alimento,5,118
13525,2024-01-10 09:24:00,35,174,Vestuário,2,209
13526,2024-01-10 09:25:00,103,162,Brinquedo,8,265
13527,2024-01-10 09:26:00,12,11,Eletrônico,5,23
13528,2024-01-10 09:27:00,94,123,Brinquedo,5,217
13529,2024-01-10 09:28:00,45,122,Alimento,6,167
13530,2024-01-10 09:29:00,59,124,Eletrônico,1,183
13531,2024-01-10 09:30:00,119,84,Móvel,7,203
13532,2024-01-10 09:31:00,81,122,Brinquedo,9,203
13533,2024-01-10 09:32:00,77,131,Móvel,6,208
13534,2024-01-10 09:33:00,58,16,Eletrônico,7,74
13535,2024-01-10 09:34:00,117,134,Brinquedo,4,251
13536,2024-01-10 09:35:00,55,35,Eletrônico,2,90
13537,2024-01-10 09:36:00,67,30,Vestuário,1,97
13538,2024-01-10 09:37:00,76,47,Vestuário,5,123
13539,2024-01-10 09:38:00,54,86,Brinquedo,8,140
13540,2024-01-10 09:39:00,65,164,Móvel,8,229
13541,2024-01-10 09:40:00,115,89,Alimento,3,204
13542,2024-01-10 09:41:00,62,167,Alimento,2,229
13543,2024-01-10 09:42:00,19,117,Eletrônico,6,136
13544,2024-01-10 09:43:00,107,128,Alimento,3,235
13545,2024-01-10 09:44:00,86,73,Móvel,9,159
13546,2024-01-10 09:45:00,16,43,Brinquedo,2,59
13547,2024-01-10 09:46:00,108,22,Alimento,8,130
13548,2024-01-10 09:47:00,22,146,Alimento,7,168
13549,2024-01-10 09:48:00,48,13,Vestuário,1,61
13550,2024-01-10 09:49:00,23,83,Alimento,7,106
13551,2024-01-10 09:50:00,74,76,Alimento,2,150
13552,2024-01-10 09:51:00,30,175,Eletrônico,9,205
13553,2024-01-10 09:52:00,49,55,Móvel,1,104
13554,2024-01-10 09:53:00,77,81,Eletrônico,9,158
13555,2024-01-10 09:54:00,100,131,Eletrônico,4,231
13556,2024-01-10 09:55:00,19,161,Eletrônico,1,180
13557,2024-01-10 09:56:00,64,36,Eletrônico,1,100
13558,2024-01-10 09:57:00,67,78,Alimento,3,145
13559,2024-01-10 09:58:00,24,65,Móvel,5,89
13560,2024-01-10 09:59:00,88,44,Eletrônico,8,132
13561,2024-01-10 10:00:00,68,23,Móvel,4,91
13562,2024-01-10 10:01:00,118,122,Eletrônico,5,240
13563,2024-01-10 10:02:00,67,173,Vestuário,9,240
13564,2024-01-10 10:03:00,11,148,Vestuário,5,159
13565,2024-01-10 10:04:00,59,28,Vestuário,5,87
13566,2024-01-10 10:05:00,33,122,Brinquedo,1,155
13567,2024-01-10 10:06:00,59,132,Móvel,9,191
13568,2024-01-10 10:07:00,60,104,Brinquedo,3,164
13569,2024-01-10 10:08:00,29,148,Móvel,9,177
13570,2024-01-10 10:09:00,96,106,Alimento,5,202
13571,2024-01-10 10:10:00,28,133,Móvel,2,161
13572,2024-01-10 10:11:00,19,169,Alimento,1,188
13573,2024-01-10 10:12:00,22,49,Brinquedo,8,71
13574,2024-01-10 10:13:00,59,164,Vestuário,6,223
13575,2024-01-10 10:14:00,75,11,Brinquedo,9,86
13576,2024-01-10 10:15:00,85,151,Móvel,7,236
13577,2024-01-10 10:16:00,69,87,Eletrônico,4,156
13578,2024-01-10 10:17:00,119,115,Alimento,1,234
13579,2024-01-10 10:18:00,92,86,Móvel,3,178
13580,2024-01-10 10:19:00,26,149,Vestuário,1,175
13581,2024-01-10 10:20:00,25,78,Alimento,6,103
13582,2024-01-10 10:21:00,27,167,Vestuário,5,194
13583,2024-01-10 10:22:00,93,55,Eletrônico,2,148
13584,2024-01-10 10:23:00,103,37,Brinquedo,9,140
13585,2024-01-10 10:24:00,16,124,Vestuário,2,140
13586,2024-01-10 10:25:00,81,122,Vestuário,2,203
13587,2024-01-10 10:26:00,19,86,Móvel,9,105
13588,2024-01-10 10:27:00,53,99,Brinquedo,4,152
13589,2024-01-10 10:28:00,64,54,Vestuário,7,118
13590,2024-01-10 10:29:00,97,109,Móvel,6,206
13591,2024-01-10 10:30:00,23,72,Vestuário,8,95
13592,2024-01-10 10:31:00,108,36,Móvel,9,144
13593,2024-01-10 10:32:00,38,146,Eletrônico,9,184
13594,2024-01-10 10:33:00,19,155,Brinquedo,1,174
13595,2024-01-10 10:34:00,53,174,Alimento,5,227
13596,2024-01-10 10:35:00,50,102,Vestuário,4,152
13597,2024-01-10 10:36:00,29,36,Móvel,1,65
13598,2024-01-10 10:37:00,14,61,Brinquedo,9,75
13599,2024-01-10 10:38:00,34,80,Brinquedo,6,114
13600,2024-01-10 10:39:00,80,122,Brinquedo,2,202
13601,2024-01-10 10:40:00,91,38,Vestuário,3,129
13602,2024-01-10 10:41:00,20,138,Alimento,2,158
13603,2024-01-10 10:42:00,80,91,Vestuário,6,171
13604,2024-01-10 10:43:00,24,71,Eletrônico,2,95
13605,2024-01-10 10:44:00,55,51,Alimento,3,106
13606,2024-01-10 10:45:00,117,68,Alimento,8,185
13607,2024-01-10 10:46:00,66,66,Vestuário,4,132
13608,2024-01-10 10:47:00,39,52,Móvel,4,91
13609,2024-01-10 10:48:00,85,152,Alimento,7,237
13610,2024-01-10 10:49:00,50,22,Móvel,3,72
13611,2024-01-10 10:50:00,40,66,Brinquedo,3,106
13612,2024-01-10 10:51:00,25,81,Brinquedo,9,106
13613,2024-01-10 10:52:00,61,71,Vestuário,9,132
13614,2024-01-10 10:53:00,108,20,Brinquedo,8,128
13615,2024-01-10 10:54:00,18,94,Eletrônico,1,112
13616,2024-01-10 10:55:00,109,18,Alimento,3,127
13617,2024-01-10 10:56:00,59,88,Brinquedo,1,147
13618,2024-01-10 10:57:00,114,133,Eletrônico,6,247
13619,2024-01-10 10:58:00,81,44,Eletrônico,9,125
13620,2024-01-10 10:59:00,80,44,Brinquedo,9,124
13621,2024-01-10 11:00:00,91,51,Eletrônico,9,142
13622,2024-01-10 11:01:00,20,108,Brinquedo,6,128
13623,2024-01-10 11:02:00,94,102,Alimento,6,196
13624,2024-01-10 11:03:00,43,155,Alimento,3,198
13625,2024-01-10 11:04:00,51,125,Alimento,8,176
13626,2024-01-10 11:05:00,27,75,Eletrônico,5,102
13627,2024-01-10 11:06:00,100,51,Móvel,7,151
13628,2024-01-10 11:07:00,40,119,Móvel,7,159
13629,2024-01-10 11:08:00,100,173,Eletrônico,7,273
13630,2024-01-10 11:09:00,93,126,Vestuário,7,219
13631,2024-01-10 11:10:00,53,171,Eletrônico,3,224
13632,2024-01-10 11:11:00,44,168,Alimento,1,212
13633,2024-01-10 11:12:00,59,25,Alimento,5,84
13634,2024-01-10 11:13:00,30,46,Móvel,2,76
13635,2024-01-10 11:14:00,97,141,Vestuário,9,238
13636,2024-01-10 11:15:00,108,49,Vestuário,4,157
13637,2024-01-10 11:16:00,41,147,Brinquedo,5,188
13638,2024-01-10 11:17:00,51,14,Vestuário,8,65
13639,2024-01-10 11:18:00,86,122,Vestuário,8,208
13640,2024-01-10 11:19:00,38,37,Eletrônico,7,75
13641,2024-01-10 11:20:00,28,28,Alimento,3,56
13642,2024-01-10 11:21:00,80,155,Móvel,6,235
13643,2024-01-10 11:22:00,29,41,Vestuário,2,70
13644,2024-01-10 11:23:00,60,102,Vestuário,3,162
13645,2024-01-10 11:24:00,66,38,Móvel,3,104
13646,2024-01-10 11:25:00,97,170,Alimento,9,267
13647,2024-01-10 11:26:00,13,113,Eletrônico,9,126
13648,2024-01-10 11:27:00,78,76,Brinquedo,1,154
13649,2024-01-10 11:28:00,100,34,Brinquedo,9,134
13650,2024-01-10 11:29:00,98,31,Brinquedo,9,129
13651,2024-01-10 11:30:00,106,91,Alimento,7,197
13652,2024-01-10 11:31:00,73,31,Brinquedo,9,104
13653,2024-01-10 11:32:00,54,129,Alimento,3,183
13654,2024-01-10 11:33:00,40,14,Alimento,2,54
13655,2024-01-10 11:34:00,72,93,Vestuário,5,165
13656,2024-01-10 11:35:00,86,57,Vestuário,4,143
13657,2024-01-10 11:36:00,40,162,Móvel,6,202
13658,2024-01-10 11:37:00,37,22,Móvel,7,59
13659,2024-01-10 11:38:00,31,104,Móvel,6,135
13660,2024-01-10 11:39:00,63,176,Vestuário,5,239
13661,2024-01-10 11:40:00,107,152,Eletrônico,3,259
13662,2024-01-10 11:41:00,67,72,Brinquedo,2,139
13663,2024-01-10 11:42:00,110,25,Brinquedo,2,135
13664,2024-01-10 11:43:00,56,25,Brinquedo,2,81
13665,2024-01-10 11:44:00,57,14,Vestuário,9,71
13666,2024-01-10 11:45:00,105,102,Alimento,6,207
13667,2024-01-10 11:46:00,116,13,Vestuário,8,129
13668,2024-01-10 11:47:00,90,12,Vestuário,5,102
13669,2024-01-10 11:48:00,114,111,Eletrônico,2,225
13670,2024-01-10 11:49:00,20,93,Eletrônico,5,113
13671,2024-01-10 11:50:00,95,122,Vestuário,8,217
13672,2024-01-10 11:51:00,81,41,Móvel,4,122
13673,2024-01-10 11:52:00,115,26,Alimento,5,141
13674,2024-01-10 11:53:00,31,156,Brinquedo,1,187
13675,2024-01-10 11:54:00,74,133,Móvel,2,207
13676,2024-01-10 11:55:00,109,29,Alimento,8,138
13677,2024-01-10 11:56:00,52,156,Alimento,8,208
13678,2024-01-10 11:57:00,61,80,Vestuário,5,141
13679,2024-01-10 11:58:00,53,121,Eletrônico,8,174
13680,2024-01-10 11:59:00,36,29,Móvel,3,65
13681,2024-01-10 12:00:00,83,101,Móvel,3,184
13682,2024-01-10 12:01:00,98,63,Vestuário,7,161
13683,2024-01-10 12:02:00,101,76,Vestuário,4,177
13684,2024-01-10 12:03:00,82,73,Vestuário,1,155
13685,2024-01-10 12:04:00,22,165,Alimento,1,187
13686,2024-01-10 12:05:00,85,112,Móvel,2,197
13687,2024-01-10 12:06:00,101,168,Eletrônico,8,269
13688,2024-01-10 12:07:00,108,70,Vestuário,4,178
13689,2024-01-10 12:08:00,76,25,Vestuário,1,101
13690,2024-01-10 12:09:00,30,131,Vestuário,4,161
13691,2024-01-10 12:10:00,55,22,Alimento,5,77
13692,2024-01-10 12:11:00,97,176,Alimento,3,273
13693,2024-01-10 12:12:00,23,161,Vestuário,1,184
13694,2024-01-10 12:13:00,19,126,Brinquedo,4,145
13695,2024-01-10 12:14:00,79,103,Brinquedo,5,182
13696,2024-01-10 12:15:00,103,114,Brinquedo,2,217
13697,2024-01-10 12:16:00,20,169,Vestuário,6,189
13698,2024-01-10 12:17:00,57,72,Brinquedo,3,129
13699,2024-01-10 12:18:00,49,102,Eletrônico,8,151
13700,2024-01-10 12:19:00,34,111,Móvel,7,145
13701,2024-01-10 12:20:00,10,137,Brinquedo,8,147
13702,2024-01-10 12:21:00,105,169,Eletrônico,3,274
13703,2024-01-10 12:22:00,17,98,Brinquedo,9,115
13704,2024-01-10 12:23:00,15,161,Alimento,6,176
13705,2024-01-10 12:24:00,95,18,Eletrônico,9,113
13706,2024-01-10 12:25:00,91,102,Eletrônico,1,193
13707,2024-01-10 12:26:00,82,21,Eletrônico,9,103
13708,2024-01-10 12:27:00,119,164,Alimento,8,283
13709,2024-01-10 12:28:00,35,74,Brinquedo,3,109
13710,2024-01-10 12:29:00,27,10,Vestuário,4,37
13711,2024-01-10 12:30:00,114,162,Alimento,9,276
13712,2024-01-10 12:31:00,106,114,Alimento,9,220
13713,2024-01-10 12:32:00,108,49,Brinquedo,1,157
13714,2024-01-10 12:33:00,46,134,Vestuário,5,180
13715,2024-01-10 12:34:00,26,177,Brinquedo,5,203
13716,2024-01-10 12:35:00,46,148,Vestuário,7,194
13717,2024-01-10 12:36:00,111,128,Eletrônico,4,239
13718,2024-01-10 12:37:00,33,46,Móvel,3,79
13719,2024-01-10 12:38:00,39,69,Vestuário,8,108
13720,2024-01-10 12:39:00,48,56,Móvel,9,104
13721,2024-01-10 12:40:00,100,129,Eletrônico,6,229
13722,2024-01-10 12:41:00,70,110,Brinquedo,8,180
13723,2024-01-10 12:42:00,116,46,Brinquedo,1,162
13724,2024-01-10 12:43:00,32,152,Móvel,5,184
13725,2024-01-10 12:44:00,113,101,Eletrônico,1,214
13726,2024-01-10 12:45:00,46,140,Eletrônico,7,186
13727,2024-01-10 12:46:00,81,94,Eletrônico,5,175
13728,2024-01-10 12:47:00,110,65,Alimento,9,175
13729,2024-01-10 12:48:00,88,88,Alimento,7,176
13730,2024-01-10 12:49:00,14,68,Eletrônico,1,82
13731,2024-01-10 12:50:00,14,138,Móvel,3,152
13732,2024-01-10 12:51:00,23,92,Alimento,5,115
13733,2024-01-10 12:52:00,112,62,Alimento,6,174
13734,2024-01-10 12:53:00,13,55,Vestuário,2,68
13735,2024-01-10 12:54:00,12,18,Alimento,8,30
13736,2024-01-10 12:55:00,43,95,Móvel,5,138
13737,2024-01-10 12:56:00,78,23,Vestuário,6,101
13738,2024-01-10 12:57:00,108,113,Vestuário,1,221
13739,2024-01-10 12:58:00,80,154,Alimento,2,234
13740,2024-01-10 12:59:00,13,125,Móvel,7,138
13741,2024-01-10 13:00:00,96,155,Alimento,2,251
13742,2024-01-10 13:01:00,117,138,Vestuário,4,255
13743,2024-01-10 13:02:00,86,109,Móvel,5,195
13744,2024-01-10 13:03:00,105,10,Eletrônico,3,115
13745,2024-01-10 13:04:00,41,43,Móvel,8,84
13746,2024-01-10 13:05:00,56,70,Vestuário,8,126
13747,2024-01-10 13:06:00,36,39,Brinquedo,9,75
13748,2024-01-10 13:07:00,36,146,Vestuário,9,182
13749,2024-01-10 13:08:00,42,45,Brinquedo,6,87
13750,2024-01-10 13:09:00,36,48,Eletrônico,9,84
13751,2024-01-10 13:10:00,55,75,Móvel,9,130
13752,2024-01-10 13:11:00,75,61,Alimento,3,136
13753,2024-01-10 13:12:00,113,115,Alimento,4,228
13754,2024-01-10 13:13:00,53,33,Brinquedo,6,86
13755,2024-01-10 13:14:00,10,99,Móvel,1,109
13756,2024-01-10 13:15:00,98,120,Vestuário,8,218
13757,2024-01-10 13:16:00,40,45,Vestuário,7,85
13758,2024-01-10 13:17:00,79,91,Vestuário,6,170
13759,2024-01-10 13:18:00,46,73,Móvel,8,119
13760,2024-01-10 13:19:00,16,59,Vestuário,2,75
13761,2024-01-10 13:20:00,34,48,Móvel,1,82
13762,2024-01-10 13:21:00,116,61,Eletrônico,8,177
13763,2024-01-10 13:22:00,100,172,Móvel,7,272
13764,2024-01-10 13:23:00,63,137,Vestuário,9,200
13765,2024-01-10 13:24:00,31,118,Eletrônico,2,149
13766,2024-01-10 13:25:00,44,55,Eletrônico,9,99
13767,2024-01-10 13:26:00,54,172,Móvel,2,226
13768,2024-01-10 13:27:00,28,133,Vestuário,2,161
13769,2024-01-10 13:28:00,78,50,Móvel,7,128
13770,2024-01-10 13:29:00,14,137,Eletrônico,8,151
13771,2024-01-10 13:30:00,90,159,Brinquedo,9,249
13772,2024-01-10 13:31:00,66,115,Móvel,8,181
13773,2024-01-10 13:32:00,104,76,Brinquedo,6,180
13774,2024-01-10 13:33:00,63,148,Alimento,1,211
13775,2024-01-10 13:34:00,77,11,Brinquedo,4,88
13776,2024-01-10 13:35:00,14,119,Vestuário,6,133
13777,2024-01-10 13:36:00,47,28,Brinquedo,5,75
13778,2024-01-10 13:37:00,119,124,Móvel,1,243
13779,2024-01-10 13:38:00,20,64,Eletrônico,7,84
13780,2024-01-10 13:39:00,67,140,Vestuário,7,207
13781,2024-01-10 13:40:00,49,67,Brinquedo,1,116
13782,2024-01-10 13:41:00,37,28,Móvel,3,65
13783,2024-01-10 13:42:00,62,84,Alimento,7,146
13784,2024-01-10 13:43:00,45,146,Eletrônico,9,191
13785,2024-01-10 13:44:00,94,179,Móvel,5,273
13786,2024-01-10 13:45:00,117,43,Brinquedo,9,160
13787,2024-01-10 13:46:00,89,18,Móvel,3,107
13788,2024-01-10 13:47:00,51,112,Brinquedo,9,163
13789,2024-01-10 13:48:00,31,52,Móvel,9,83
13790,2024-01-10 13:49:00,88,69,Vestuário,3,157
13791,2024-01-10 13:50:00,49,54,Alimento,4,103
13792,2024-01-10 13:51:00,99,49,Eletrônico,9,148
13793,2024-01-10 13:52:00,76,125,Vestuário,7,201
13794,2024-01-10 13:53:00,72,170,Alimento,6,242
13795,2024-01-10 13:54:00,54,146,Móvel,1,200
13796,2024-01-10 13:55:00,37,16,Alimento,1,53
13797,2024-01-10 13:56:00,56,29,Móvel,1,85
13798,2024-01-10 13:57:00,87,12,Móvel,1,99
13799,2024-01-10 13:58:00,115,133,Alimento,5,248
13800,2024-01-10 13:59:00,42,25,Brinquedo,6,67
13801,2024-01-10 14:00:00,65,170,Móvel,8,235
13802,2024-01-10 14:01:00,43,133,Vestuário,3,176
13803,2024-01-10 14:02:00,107,170,Eletrônico,8,277
13804,2024-01-10 14:03:00,60,61,Alimento,5,121
13805,2024-01-10 14:04:00,19,54,Vestuário,9,73
13806,2024-01-10 14:05:00,71,107,Vestuário,7,178
13807,2024-01-10 14:06:00,77,129,Vestuário,3,206
13808,2024-01-10 14:07:00,34,22,Móvel,6,56
13809,2024-01-10 14:08:00,119,20,Móvel,2,139
13810,2024-01-10 14:09:00,100,159,Alimento,4,259
13811,2024-01-10 14:10:00,12,152,Eletrônico,2,164
13812,2024-01-10 14:11:00,35,100,Brinquedo,4,135
13813,2024-01-10 14:12:00,65,93,Alimento,3,158
13814,2024-01-10 14:13:00,100,96,Móvel,7,196
13815,2024-01-10 14:14:00,26,159,Brinquedo,1,185
13816,2024-01-10 14:15:00,20,158,Vestuário,3,178
13817,2024-01-10 14:16:00,101,23,Brinquedo,6,124
13818,2024-01-10 14:17:00,80,110,Eletrônico,8,190
13819,2024-01-10 14:18:00,60,61,Vestuário,1,121
13820,2024-01-10 14:19:00,18,161,Móvel,1,179
13821,2024-01-10 14:20:00,99,26,Brinquedo,2,125
13822,2024-01-10 14:21:00,26,175,Brinquedo,1,201
13823,2024-01-10 14:22:00,114,170,Alimento,7,284
13824,2024-01-10 14:23:00,84,107,Vestuário,8,191
13825,2024-01-10 14:24:00,43,114,Brinquedo,6,157
13826,2024-01-10 14:25:00,101,83,Móvel,4,184
13827,2024-01-10 14:26:00,87,171,Brinquedo,1,258
13828,2024-01-10 14:27:00,67,42,Alimento,3,109
13829,2024-01-10 14:28:00,42,110,Alimento,3,152
13830,2024-01-10 14:29:00,117,72,Eletrônico,5,189
13831,2024-01-10 14:30:00,110,34,Vestuário,5,144
13832,2024-01-10 14:31:00,108,40,Brinquedo,2,148
13833,2024-01-10 14:32:00,65,125,Móvel,3,190
13834,2024-01-10 14:33:00,14,102,Móvel,1,116
13835,2024-01-10 14:34:00,72,24,Eletrônico,4,96
13836,2024-01-10 14:35:00,33,29,Eletrônico,7,62
13837,2024-01-10 14:36:00,72,83,Vestuário,5,155
13838,2024-01-10 14:37:00,79,28,Eletrônico,7,107
13839,2024-01-10 14:38:00,40,155,Alimento,9,195
13840,2024-01-10 14:39:00,24,124,Brinquedo,2,148
13841,2024-01-10 14:40:00,59,19,Eletrônico,4,78
13842,2024-01-10 14:41:00,88,121,Eletrônico,8,209
13843,2024-01-10 14:42:00,95,110,Brinquedo,5,205
13844,2024-01-10 14:43:00,41,10,Vestuário,1,51
13845,2024-01-10 14:44:00,21,21,Brinquedo,3,42
13846,2024-01-10 14:45:00,17,13,Vestuário,2,30
13847,2024-01-10 14:46:00,114,111,Móvel,3,225
13848,2024-01-10 14:47:00,42,172,Eletrônico,7,214
13849,2024-01-10 14:48:00,73,46,Vestuário,4,119
13850,2024-01-10 14:49:00,22,126,Móvel,7,148
13851,2024-01-10 14:50:00,71,46,Eletrônico,9,117
13852,2024-01-10 14:51:00,34,169,Alimento,6,203
13853,2024-01-10 14:52:00,81,130,Eletrônico,3,211
13854,2024-01-10 14:53:00,85,87,Alimento,2,172
13855,2024-01-10 14:54:00,31,163,Alimento,3,194
13856,2024-01-10 14:55:00,111,107,Móvel,4,218
13857,2024-01-10 14:56:00,34,17,Brinquedo,1,51
13858,2024-01-10 14:57:00,107,62,Móvel,2,169
13859,2024-01-10 14:58:00,59,68,Móvel,4,127
13860,2024-01-10 14:59:00,12,171,Vestuário,9,183
13861,2024-01-10 15:00:00,66,18,Móvel,1,84
13862,2024-01-10 15:01:00,87,88,Móvel,6,175
13863,2024-01-10 15:02:00,65,28,Móvel,1,93
13864,2024-01-10 15:03:00,54,32,Vestuário,3,86
13865,2024-01-10 15:04:00,92,39,Alimento,6,131
13866,2024-01-10 15:05:00,113,21,Brinquedo,3,134
13867,2024-01-10 15:06:00,19,78,Móvel,7,97
13868,2024-01-10 15:07:00,93,116,Eletrônico,9,209
13869,2024-01-10 15:08:00,87,82,Vestuário,2,169
13870,2024-01-10 15:09:00,62,144,Eletrônico,4,206
13871,2024-01-10 15:10:00,21,94,Móvel,1,115
13872,2024-01-10 15:11:00,84,34,Vestuário,9,118
13873,2024-01-10 15:12:00,83,143,Vestuário,9,226
13874,2024-01-10 15:13:00,19,39,Eletrônico,3,58
13875,2024-01-10 15:14:00,46,60,Brinquedo,5,106
13876,2024-01-10 15:15:00,76,95,Alimento,6,171
13877,2024-01-10 15:16:00,57,42,Vestuário,5,99
13878,2024-01-10 15:17:00,47,55,Brinquedo,4,102
13879,2024-01-10 15:18:00,20,31,Vestuário,1,51
13880,2024-01-10 15:19:00,92,11,Alimento,9,103
13881,2024-01-10 15:20:00,44,103,Vestuário,8,147
13882,2024-01-10 15:21:00,54,128,Móvel,1,182
13883,2024-01-10 15:22:00,69,66,Brinquedo,6,135
13884,2024-01-10 15:23:00,76,56,Eletrônico,7,132
13885,2024-01-10 15:24:00,35,157,Vestuário,2,192
13886,2024-01-10 15:25:00,53,107,Vestuário,3,160
13887,2024-01-10 15:26:00,18,94,Brinquedo,1,112
13888,2024-01-10 15:27:00,20,173,Eletrônico,1,193
13889,2024-01-10 15:28:00,77,77,Alimento,1,154
13890,2024-01-10 15:29:00,39,115,Eletrônico,1,154
13891,2024-01-10 15:30:00,56,141,Móvel,1,197
13892,2024-01-10 15:31:00,14,126,Brinquedo,8,140
13893,2024-01-10 15:32:00,11,83,Alimento,1,94
13894,2024-01-10 15:33:00,117,110,Eletrônico,4,227
13895,2024-01-10 15:34:00,56,177,Brinquedo,4,233
13896,2024-01-10 15:35:00,28,55,Vestuário,6,83
13897,2024-01-10 15:36:00,68,65,Alimento,6,133
13898,2024-01-10 15:37:00,26,143,Eletrônico,7,169
13899,2024-01-10 15:38:00,91,128,Alimento,5,219
13900,2024-01-10 15:39:00,69,76,Alimento,4,145
13901,2024-01-10 15:40:00,53,166,Alimento,2,219
13902,2024-01-10 15:41:00,73,60,Móvel,6,133
13903,2024-01-10 15:42:00,79,43,Alimento,2,122
13904,2024-01-10 15:43:00,79,24,Vestuário,4,103
13905,2024-01-10 15:44:00,22,64,Brinquedo,4,86
13906,2024-01-10 15:45:00,107,93,Vestuário,1,200
13907,2024-01-10 15:46:00,21,15,Móvel,8,36
13908,2024-01-10 15:47:00,18,53,Eletrônico,1,71
13909,2024-01-10 15:48:00,43,96,Móvel,2,139
13910,2024-01-10 15:49:00,18,178,Móvel,6,196
13911,2024-01-10 15:50:00,74,177,Brinquedo,9,251
13912,2024-01-10 15:51:00,12,93,Eletrônico,1,105
13913,2024-01-10 15:52:00,36,29,Eletrônico,3,65
13914,2024-01-10 15:53:00,16,37,Alimento,8,53
13915,2024-01-10 15:54:00,108,90,Móvel,3,198
13916,2024-01-10 15:55:00,11,138,Alimento,1,149
13917,2024-01-10 15:56:00,53,172,Eletrônico,8,225
13918,2024-01-10 15:57:00,69,70,Brinquedo,3,139
13919,2024-01-10 15:58:00,106,50,Eletrônico,3,156
13920,2024-01-10 15:59:00,28,62,Brinquedo,2,90
13921,2024-01-10 16:00:00,91,55,Eletrônico,3,146
13922,2024-01-10 16:01:00,22,67,Vestuário,8,89
13923,2024-01-10 16:02:00,90,169,Eletrônico,8,259
13924,2024-01-10 16:03:00,57,143,Vestuário,7,200
13925,2024-01-10 16:04:00,46,138,Vestuário,7,184
13926,2024-01-10 16:05:00,84,156,Móvel,2,240
13927,2024-01-10 16:06:00,17,86,Alimento,8,103
13928,2024-01-10 16:07:00,51,108,Alimento,9,159
13929,2024-01-10 16:08:00,87,104,Móvel,5,191
13930,2024-01-10 16:09:00,117,59,Vestuário,1,176
13931,2024-01-10 16:10:00,26,146,Vestuário,8,172
13932,2024-01-10 16:11:00,79,142,Vestuário,5,221
13933,2024-01-10 16:12:00,60,71,Alimento,4,131
13934,2024-01-10 16:13:00,24,154,Vestuário,1,178
13935,2024-01-10 16:14:00,57,116,Vestuário,1,173
13936,2024-01-10 16:15:00,101,163,Vestuário,1,264
13937,2024-01-10 16:16:00,82,101,Móvel,8,183
13938,2024-01-10 16:17:00,11,159,Móvel,9,170
13939,2024-01-10 16:18:00,70,72,Móvel,7,142
13940,2024-01-10 16:19:00,79,59,Alimento,8,138
13941,2024-01-10 16:20:00,37,157,Móvel,6,194
13942,2024-01-10 16:21:00,101,81,Eletrônico,7,182
13943,2024-01-10 16:22:00,118,14,Vestuário,3,132
13944,2024-01-10 16:23:00,86,105,Brinquedo,7,191
13945,2024-01-10 16:24:00,118,13,Eletrônico,7,131
13946,2024-01-10 16:25:00,23,17,Eletrônico,7,40
13947,2024-01-10 16:26:00,61,167,Vestuário,5,228
13948,2024-01-10 16:27:00,104,58,Móvel,4,162
13949,2024-01-10 16:28:00,34,132,Brinquedo,6,166
13950,2024-01-10 16:29:00,16,141,Brinquedo,4,157
13951,2024-01-10 16:30:00,90,96,Eletrônico,1,186
13952,2024-01-10 16:31:00,18,176,Eletrônico,3,194
13953,2024-01-10 16:32:00,87,87,Móvel,9,174
13954,2024-01-10 16:33:00,12,74,Brinquedo,6,86
13955,2024-01-10 16:34:00,106,38,Brinquedo,1,144
13956,2024-01-10 16:35:00,31,75,Eletrônico,9,106
13957,2024-01-10 16:36:00,81,153,Móvel,8,234
13958,2024-01-10 16:37:00,34,32,Eletrônico,9,66
13959,2024-01-10 16:38:00,115,81,Móvel,2,196
13960,2024-01-10 16:39:00,22,142,Eletrônico,3,164
13961,2024-01-10 16:40:00,48,55,Alimento,5,103
13962,2024-01-10 16:41:00,119,161,Eletrônico,7,280
13963,2024-01-10 16:42:00,12,123,Brinquedo,9,135
13964,2024-01-10 16:43:00,90,34,Alimento,5,124
13965,2024-01-10 16:44:00,114,36,Móvel,7,150
13966,2024-01-10 16:45:00,44,13,Brinquedo,5,57
13967,2024-01-10 16:46:00,29,135,Eletrônico,6,164
13968,2024-01-10 16:47:00,50,166,Móvel,8,216
13969,2024-01-10 16:48:00,37,115,Vestuário,2,152
13970,2024-01-10 16:49:00,71,152,Brinquedo,1,223
13971,2024-01-10 16:50:00,92,121,Vestuário,2,213
13972,2024-01-10 16:51:00,109,20,Eletrônico,9,129
13973,2024-01-10 16:52:00,10,21,Eletrônico,8,31
13974,2024-01-10 16:53:00,96,27,Vestuário,6,123
13975,2024-01-10 16:54:00,29,148,Móvel,6,177
13976,2024-01-10 16:55:00,119,141,Vestuário,7,260
13977,2024-01-10 16:56:00,61,26,Móvel,5,87
13978,2024-01-10 16:57:00,42,174,Vestuário,7,216
13979,2024-01-10 16:58:00,31,38,Móvel,9,69
13980,2024-01-10 16:59:00,67,17,Vestuário,3,84
13981,2024-01-10 17:00:00,115,112,Móvel,2,227
13982,2024-01-10 17:01:00,101,128,Eletrônico,3,229
13983,2024-01-10 17:02:00,50,169,Alimento,5,219
13984,2024-01-10 17:03:00,54,10,Eletrônico,7,64
13985,2024-01-10 17:04:00,88,44,Alimento,4,132
13986,2024-01-10 17:05:00,13,110,Vestuário,1,123
13987,2024-01-10 17:06:00,112,28,Eletrônico,2,140
13988,2024-01-10 17:07:00,11,124,Móvel,9,135
13989,2024-01-10 17:08:00,29,147,Alimento,2,176
13990,2024-01-10 17:09:00,13,13,Alimento,5,26
13991,2024-01-10 17:10:00,23,114,Eletrônico,9,137
13992,2024-01-10 17:11:00,32,78,Móvel,2,110
13993,2024-01-10 17:12:00,109,70,Eletrônico,3,179
13994,2024-01-10 17:13:00,39,103,Brinquedo,7,142
13995,2024-01-10 17:14:00,72,48,Alimento,9,120
13996,2024-01-10 17:15:00,77,86,Móvel,3,163
13997,2024-01-10 17:16:00,98,46,Eletrônico,3,144
13998,2024-01-10 17:17:00,115,63,Vestuário,7,178
13999,2024-01-10 17:18:00,65,128,Alimento,3,193
14000,2024-01-10 17:19:00,10,148,Brinquedo,2,158
14001,2024-01-10 17:20:00,31,131,Alimento,2,162
14002,2024-01-10 17:21:00,109,163,Eletrônico,9,272
14003,2024-01-10 17:22:00,70,49,Eletrônico,1,119
14004,2024-01-10 17:23:00,79,73,Vestuário,1,152
14005,2024-01-10 17:24:00,13,68,Brinquedo,5,81
14006,2024-01-10 17:25:00,111,50,Eletrônico,8,161
14007,2024-01-10 17:26:00,64,119,Brinquedo,8,183
14008,2024-01-10 17:27:00,81,130,Vestuário,4,211
14009,2024-01-10 17:28:00,113,49,Vestuário,3,162
14010,2024-01-10 17:29:00,56,41,Brinquedo,9,97
14011,2024-01-10 17:30:00,79,83,Brinquedo,2,162
14012,2024-01-10 17:31:00,40,97,Alimento,2,137
14013,2024-01-10 17:32:00,78,103,Brinquedo,4,181
14014,2024-01-10 17:33:00,72,142,Móvel,9,214
14015,2024-01-10 17:34:00,48,48,Eletrônico,9,96
14016,2024-01-10 17:35:00,102,135,Vestuário,2,237
14017,2024-01-10 17:36:00,58,25,Móvel,2,83
14018,2024-01-10 17:37:00,100,86,Eletrônico,8,186
14019,2024-01-10 17:38:00,111,172,Vestuário,7,283
14020,2024-01-10 17:39:00,23,86,Móvel,9,109
14021,2024-01-10 17:40:00,78,81,Brinquedo,4,159
14022,2024-01-10 17:41:00,72,111,Brinquedo,9,183
14023,2024-01-10 17:42:00,35,43,Eletrônico,6,78
14024,2024-01-10 17:43:00,66,73,Vestuário,5,139
14025,2024-01-10 17:44:00,28,173,Vestuário,6,201
14026,2024-01-10 17:45:00,49,143,Vestuário,4,192
14027,2024-01-10 17:46:00,79,107,Brinquedo,1,186
14028,2024-01-10 17:47:00,98,106,Alimento,3,204
14029,2024-01-10 17:48:00,67,124,Vestuário,8,191
14030,2024-01-10 17:49:00,10,121,Móvel,8,131
14031,2024-01-10 17:50:00,40,139,Alimento,7,179
14032,2024-01-10 17:51:00,103,31,Alimento,9,134
14033,2024-01-10 17:52:00,96,100,Eletrônico,8,196
14034,2024-01-10 17:53:00,38,105,Alimento,7,143
14035,2024-01-10 17:54:00,28,161,Alimento,2,189
14036,2024-01-10 17:55:00,106,130,Alimento,9,236
14037,2024-01-10 17:56:00,24,119,Alimento,6,143
14038,2024-01-10 17:57:00,52,30,Vestuário,2,82
14039,2024-01-10 17:58:00,77,130,Móvel,4,207
14040,2024-01-10 17:59:00,25,69,Alimento,1,94
14041,2024-01-10 18:00:00,92,176,Alimento,4,268
14042,2024-01-10 18:01:00,40,26,Eletrônico,7,66
14043,2024-01-10 18:02:00,71,143,Eletrônico,2,214
14044,2024-01-10 18:03:00,97,64,Eletrônico,7,161
14045,2024-01-10 18:04:00,51,178,Móvel,4,229
14046,2024-01-10 18:05:00,100,70,Alimento,5,170
14047,2024-01-10 18:06:00,23,33,Eletrônico,5,56
14048,2024-01-10 18:07:00,29,19,Eletrônico,9,48
14049,2024-01-10 18:08:00,54,159,Vestuário,6,213
14050,2024-01-10 18:09:00,80,21,Móvel,2,101
14051,2024-01-10 18:10:00,60,58,Móvel,2,118
14052,2024-01-10 18:11:00,93,72,Alimento,4,165
14053,2024-01-10 18:12:00,62,129,Vestuário,1,191
14054,2024-01-10 18:13:00,81,150,Vestuário,6,231
14055,2024-01-10 18:14:00,35,75,Móvel,7,110
14056,2024-01-10 18:15:00,43,23,Eletrônico,1,66
14057,2024-01-10 18:16:00,47,70,Eletrônico,3,117
14058,2024-01-10 18:17:00,60,110,Eletrônico,9,170
14059,2024-01-10 18:18:00,38,90,Vestuário,5,128
14060,2024-01-10 18:19:00,68,90,Eletrônico,5,158
14061,2024-01-10 18:20:00,93,174,Vestuário,2,267
14062,2024-01-10 18:21:00,110,135,Vestuário,1,245
14063,2024-01-10 18:22:00,22,132,Móvel,7,154
14064,2024-01-10 18:23:00,59,157,Vestuário,5,216
14065,2024-01-10 18:24:00,15,60,Móvel,3,75
14066,2024-01-10 18:25:00,29,61,Vestuário,7,90
14067,2024-01-10 18:26:00,44,150,Vestuário,9,194
14068,2024-01-10 18:27:00,16,136,Alimento,1,152
14069,2024-01-10 18:28:00,84,55,Alimento,5,139
14070,2024-01-10 18:29:00,39,162,Móvel,3,201
14071,2024-01-10 18:30:00,49,56,Brinquedo,4,105
14072,2024-01-10 18:31:00,69,144,Brinquedo,2,213
14073,2024-01-10 18:32:00,109,73,Alimento,5,182
14074,2024-01-10 18:33:00,27,104,Vestuário,7,131
14075,2024-01-10 18:34:00,26,108,Vestuário,2,134
14076,2024-01-10 18:35:00,15,77,Brinquedo,3,92
14077,2024-01-10 18:36:00,18,134,Brinquedo,6,152
14078,2024-01-10 18:37:00,118,86,Alimento,1,204
14079,2024-01-10 18:38:00,105,52,Eletrônico,7,157
14080,2024-01-10 18:39:00,66,173,Móvel,6,239
14081,2024-01-10 18:40:00,67,39,Vestuário,7,106
14082,2024-01-10 18:41:00,76,134,Eletrônico,6,210
14083,2024-01-10 18:42:00,68,78,Alimento,6,146
14084,2024-01-10 18:43:00,77,15,Eletrônico,4,92
14085,2024-01-10 18:44:00,13,176,Vestuário,4,189
14086,2024-01-10 18:45:00,24,26,Brinquedo,7,50
14087,2024-01-10 18:46:00,43,66,Alimento,3,109
14088,2024-01-10 18:47:00,70,170,Alimento,3,240
14089,2024-01-10 18:48:00,114,76,Brinquedo,2,190
14090,2024-01-10 18:49:00,18,126,Móvel,2,144
14091,2024-01-10 18:50:00,33,107,Eletrônico,8,140
14092,2024-01-10 18:51:00,106,35,Alimento,4,141
14093,2024-01-10 18:52:00,76,30,Alimento,6,106
14094,2024-01-10 18:53:00,22,140,Vestuário,6,162
14095,2024-01-10 18:54:00,25,33,Eletrônico,1,58
14096,2024-01-10 18:55:00,60,137,Brinquedo,2,197
14097,2024-01-10 18:56:00,75,60,Eletrônico,4,135
14098,2024-01-10 18:57:00,80,114,Alimento,1,194
14099,2024-01-10 18:58:00,81,152,Vestuário,2,233
14100,2024-01-10 18:59:00,95,146,Vestuário,1,241
14101,2024-01-10 19:00:00,105,31,Brinquedo,9,136
14102,2024-01-10 19:01:00,79,93,Alimento,8,172
14103,2024-01-10 19:02:00,91,74,Vestuário,3,165
14104,2024-01-10 19:03:00,85,177,Alimento,8,262
14105,2024-01-10 19:04:00,93,24,Brinquedo,5,117
14106,2024-01-10 19:05:00,40,100,Alimento,4,140
14107,2024-01-10 19:06:00,107,33,Eletrônico,6,140
14108,2024-01-10 19:07:00,43,59,Alimento,1,102
14109,2024-01-10 19:08:00,24,18,Brinquedo,8,42
14110,2024-01-10 19:09:00,57,111,Alimento,8,168
14111,2024-01-10 19:10:00,24,176,Vestuário,3,200
14112,2024-01-10 19:11:00,112,22,Vestuário,9,134
14113,2024-01-10 19:12:00,28,86,Móvel,6,114
14114,2024-01-10 19:13:00,52,80,Móvel,4,132
14115,2024-01-10 19:14:00,52,139,Brinquedo,7,191
14116,2024-01-10 19:15:00,46,150,Brinquedo,5,196
14117,2024-01-10 19:16:00,61,41,Eletrônico,5,102
14118,2024-01-10 19:17:00,11,106,Eletrônico,5,117
14119,2024-01-10 19:18:00,78,105,Eletrônico,9,183
14120,2024-01-10 19:19:00,42,85,Vestuário,9,127
14121,2024-01-10 19:20:00,15,76,Alimento,7,91
14122,2024-01-10 19:21:00,87,127,Brinquedo,5,214
14123,2024-01-10 19:22:00,15,98,Brinquedo,7,113
14124,2024-01-10 19:23:00,113,62,Vestuário,1,175
14125,2024-01-10 19:24:00,24,25,Vestuário,6,49
14126,2024-01-10 19:25:00,40,17,Vestuário,1,57
14127,2024-01-10 19:26:00,103,146,Alimento,1,249
14128,2024-01-10 19:27:00,90,19,Brinquedo,1,109
14129,2024-01-10 19:28:00,40,42,Eletrônico,5,82
14130,2024-01-10 19:29:00,53,164,Móvel,5,217
14131,2024-01-10 19:30:00,25,109,Móvel,4,134
14132,2024-01-10 19:31:00,34,14,Eletrônico,8,48
14133,2024-01-10 19:32:00,12,176,Brinquedo,5,188
14134,2024-01-10 19:33:00,58,83,Brinquedo,8,141
14135,2024-01-10 19:34:00,60,93,Alimento,2,153
14136,2024-01-10 19:35:00,29,54,Alimento,5,83
14137,2024-01-10 19:36:00,26,88,Eletrônico,2,114
14138,2024-01-10 19:37:00,80,161,Brinquedo,3,241
14139,2024-01-10 19:38:00,19,73,Alimento,8,92
14140,2024-01-10 19:39:00,103,136,Alimento,1,239
14141,2024-01-10 19:40:00,10,68,Brinquedo,6,78
14142,2024-01-10 19:41:00,12,137,Alimento,8,149
14143,2024-01-10 19:42:00,73,168,Eletrônico,4,241
14144,2024-01-10 19:43:00,107,156,Vestuário,9,263
14145,2024-01-10 19:44:00,19,71,Móvel,1,90
14146,2024-01-10 19:45:00,61,162,Alimento,4,223
14147,2024-01-10 19:46:00,75,164,Alimento,4,239
14148,2024-01-10 19:47:00,111,54,Eletrônico,1,165
14149,2024-01-10 19:48:00,111,128,Vestuário,5,239
14150,2024-01-10 19:49:00,116,115,Móvel,2,231
14151,2024-01-10 19:50:00,98,170,Eletrônico,2,268
14152,2024-01-10 19:51:00,83,85,Eletrônico,6,168
14153,2024-01-10 19:52:00,110,118,Alimento,8,228
14154,2024-01-10 19:53:00,30,54,Móvel,4,84
14155,2024-01-10 19:54:00,36,46,Brinquedo,2,82
14156,2024-01-10 19:55:00,60,39,Móvel,7,99
14157,2024-01-10 19:56:00,83,172,Alimento,9,255
14158,2024-01-10 19:57:00,47,94,Vestuário,5,141
14159,2024-01-10 19:58:00,67,107,Alimento,4,174
14160,2024-01-10 19:59:00,28,91,Brinquedo,8,119
14161,2024-01-10 20:00:00,91,137,Vestuário,3,228
14162,2024-01-10 20:01:00,90,28,Brinquedo,3,118
14163,2024-01-10 20:02:00,54,146,Eletrônico,6,200
14164,2024-01-10 20:03:00,65,175,Vestuário,3,240
14165,2024-01-10 20:04:00,13,38,Eletrônico,9,51
14166,2024-01-10 20:05:00,87,37,Vestuário,9,124
14167,2024-01-10 20:06:00,47,58,Vestuário,9,105
14168,2024-01-10 20:07:00,25,118,Alimento,5,143
14169,2024-01-10 20:08:00,87,37,Alimento,8,124
14170,2024-01-10 20:09:00,51,145,Vestuário,2,196
14171,2024-01-10 20:10:00,74,167,Móvel,2,241
14172,2024-01-10 20:11:00,100,84,Vestuário,2,184
14173,2024-01-10 20:12:00,16,133,Alimento,7,149
14174,2024-01-10 20:13:00,89,39,Vestuário,7,128
14175,2024-01-10 20:14:00,83,44,Brinquedo,8,127
14176,2024-01-10 20:15:00,79,161,Eletrônico,8,240
14177,2024-01-10 20:16:00,41,167,Eletrônico,9,208
14178,2024-01-10 20:17:00,59,45,Eletrônico,4,104
14179,2024-01-10 20:18:00,18,62,Eletrônico,5,80
14180,2024-01-10 20:19:00,66,151,Móvel,3,217
14181,2024-01-10 20:20:00,13,43,Brinquedo,3,56
14182,2024-01-10 20:21:00,41,23,Alimento,5,64
14183,2024-01-10 20:22:00,42,63,Vestuário,4,105
14184,2024-01-10 20:23:00,95,129,Móvel,7,224
14185,2024-01-10 20:24:00,27,56,Brinquedo,9,83
14186,2024-01-10 20:25:00,118,31,Eletrônico,5,149
14187,2024-01-10 20:26:00,44,24,Alimento,8,68
14188,2024-01-10 20:27:00,58,135,Móvel,7,193
14189,2024-01-10 20:28:00,76,121,Eletrônico,9,197
14190,2024-01-10 20:29:00,104,57,Eletrônico,8,161
14191,2024-01-10 20:30:00,11,160,Alimento,4,171
14192,2024-01-10 20:31:00,107,54,Eletrônico,9,161
14193,2024-01-10 20:32:00,91,97,Vestuário,4,188
14194,2024-01-10 20:33:00,44,48,Móvel,5,92
14195,2024-01-10 20:34:00,25,105,Brinquedo,8,130
14196,2024-01-10 20:35:00,30,122,Móvel,6,152
14197,2024-01-10 20:36:00,85,102,Móvel,8,187
14198,2024-01-10 20:37:00,98,74,Brinquedo,9,172
14199,2024-01-10 20:38:00,55,38,Vestuário,5,93
14200,2024-01-10 20:39:00,66,134,Alimento,6,200
14201,2024-01-10 20:40:00,79,99,Vestuário,3,178
14202,2024-01-10 20:41:00,61,107,Eletrônico,9,168
14203,2024-01-10 20:42:00,29,169,Eletrônico,5,198
14204,2024-01-10 20:43:00,49,10,Móvel,7,59
14205,2024-01-10 20:44:00,62,156,Eletrônico,7,218
14206,2024-01-10 20:45:00,28,101,Alimento,4,129
14207,2024-01-10 20:46:00,66,121,Brinquedo,7,187
14208,2024-01-10 20:47:00,56,178,Móvel,4,234
14209,2024-01-10 20:48:00,47,136,Eletrônico,5,183
14210,2024-01-10 20:49:00,68,163,Vestuário,6,231
14211,2024-01-10 20:50:00,29,109,Móvel,9,138
14212,2024-01-10 20:51:00,71,12,Eletrônico,5,83
14213,2024-01-10 20:52:00,84,35,Móvel,7,119
14214,2024-01-10 20:53:00,90,153,Móvel,9,243
14215,2024-01-10 20:54:00,23,27,Eletrônico,8,50
14216,2024-01-10 20:55:00,70,178,Móvel,1,248
14217,2024-01-10 20:56:00,89,75,Eletrônico,2,164
14218,2024-01-10 20:57:00,88,26,Móvel,6,114
14219,2024-01-10 20:58:00,42,69,Eletrônico,3,111
14220,2024-01-10 20:59:00,60,79,Vestuário,5,139
14221,2024-01-10 21:00:00,41,121,Brinquedo,1,162
14222,2024-01-10 21:01:00,78,99,Brinquedo,4,177
14223,2024-01-10 21:02:00,20,50,Móvel,5,70
14224,2024-01-10 21:03:00,36,34,Alimento,5,70
14225,2024-01-10 21:04:00,18,118,Alimento,2,136
14226,2024-01-10 21:05:00,95,116,Móvel,5,211
14227,2024-01-10 21:06:00,78,34,Vestuário,6,112
14228,2024-01-10 21:07:00,72,143,Eletrônico,8,215
14229,2024-01-10 21:08:00,110,125,Alimento,8,235
14230,2024-01-10 21:09:00,114,150,Brinquedo,9,264
14231,2024-01-10 21:10:00,96,84,Alimento,6,180
14232,2024-01-10 21:11:00,45,146,Eletrônico,3,191
14233,2024-01-10 21:12:00,71,89,Eletrônico,7,160
14234,2024-01-10 21:13:00,97,35,Brinquedo,1,132
14235,2024-01-10 21:14:00,32,59,Vestuário,1,91
14236,2024-01-10 21:15:00,75,57,Alimento,1,132
14237,2024-01-10 21:16:00,29,151,Alimento,6,180
14238,2024-01-10 21:17:00,43,177,Brinquedo,2,220
14239,2024-01-10 21:18:00,44,67,Alimento,2,111
14240,2024-01-10 21:19:00,49,116,Vestuário,8,165
14241,2024-01-10 21:20:00,95,133,Alimento,4,228
14242,2024-01-10 21:21:00,60,89,Móvel,2,149
14243,2024-01-10 21:22:00,117,98,Vestuário,1,215
14244,2024-01-10 21:23:00,69,169,Alimento,1,238
14245,2024-01-10 21:24:00,19,53,Brinquedo,1,72
14246,2024-01-10 21:25:00,27,158,Vestuário,3,185
14247,2024-01-10 21:26:00,28,73,Vestuário,6,101
14248,2024-01-10 21:27:00,10,133,Eletrônico,3,143
14249,2024-01-10 21:28:00,42,78,Móvel,3,120
14250,2024-01-10 21:29:00,88,137,Eletrônico,6,225
14251,2024-01-10 21:30:00,51,67,Brinquedo,9,118
14252,2024-01-10 21:31:00,26,124,Alimento,4,150
14253,2024-01-10 21:32:00,20,53,Vestuário,8,73
14254,2024-01-10 21:33:00,73,154,Eletrônico,4,227
14255,2024-01-10 21:34:00,99,120,Eletrônico,2,219
14256,2024-01-10 21:35:00,96,29,Vestuário,7,125
14257,2024-01-10 21:36:00,43,60,Vestuário,9,103
14258,2024-01-10 21:37:00,45,158,Alimento,3,203
14259,2024-01-10 21:38:00,12,121,Brinquedo,7,133
14260,2024-01-10 21:39:00,20,95,Eletrônico,6,115
14261,2024-01-10 21:40:00,86,57,Brinquedo,7,143
14262,2024-01-10 21:41:00,22,32,Alimento,2,54
14263,2024-01-10 21:42:00,71,17,Eletrônico,7,88
14264,2024-01-10 21:43:00,93,89,Eletrônico,8,182
14265,2024-01-10 21:44:00,48,168,Brinquedo,3,216
14266,2024-01-10 21:45:00,86,66,Móvel,6,152
14267,2024-01-10 21:46:00,36,147,Móvel,7,183
14268,2024-01-10 21:47:00,36,15,Eletrônico,4,51
14269,2024-01-10 21:48:00,87,105,Alimento,9,192
14270,2024-01-10 21:49:00,80,162,Brinquedo,6,242
14271,2024-01-10 21:50:00,66,63,Brinquedo,4,129
14272,2024-01-10 21:51:00,100,105,Vestuário,9,205
14273,2024-01-10 21:52:00,119,25,Brinquedo,3,144
14274,2024-01-10 21:53:00,49,51,Alimento,1,100
14275,2024-01-10 21:54:00,72,62,Alimento,9,134
14276,2024-01-10 21:55:00,110,121,Alimento,1,231
14277,2024-01-10 21:56:00,104,36,Eletrônico,8,140
14278,2024-01-10 21:57:00,89,138,Eletrônico,7,227
14279,2024-01-10 21:58:00,96,178,Alimento,1,274
14280,2024-01-10 21:59:00,11,49,Móvel,4,60
14281,2024-01-10 22:00:00,57,104,Móvel,6,161
14282,2024-01-10 22:01:00,99,69,Brinquedo,3,168
14283,2024-01-10 22:02:00,65,159,Móvel,5,224
14284,2024-01-10 22:03:00,86,82,Vestuário,7,168
14285,2024-01-10 22:04:00,80,175,Brinquedo,5,255
14286,2024-01-10 22:05:00,57,88,Vestuário,7,145
14287,2024-01-10 22:06:00,62,135,Alimento,2,197
14288,2024-01-10 22:07:00,10,94,Eletrônico,6,104
14289,2024-01-10 22:08:00,71,111,Eletrônico,7,182
14290,2024-01-10 22:09:00,76,34,Alimento,9,110
14291,2024-01-10 22:10:00,101,38,Brinquedo,3,139
14292,2024-01-10 22:11:00,87,129,Eletrônico,3,216
14293,2024-01-10 22:12:00,35,60,Vestuário,2,95
14294,2024-01-10 22:13:00,74,47,Móvel,9,121
14295,2024-01-10 22:14:00,114,69,Alimento,7,183
14296,2024-01-10 22:15:00,62,123,Brinquedo,1,185
14297,2024-01-10 22:16:00,66,91,Móvel,2,157
14298,2024-01-10 22:17:00,73,43,Móvel,1,116
14299,2024-01-10 22:18:00,59,14,Brinquedo,3,73
14300,2024-01-10 22:19:00,83,70,Eletrônico,1,153
14301,2024-01-10 22:20:00,113,100,Alimento,2,213
14302,2024-01-10 22:21:00,39,63,Móvel,2,102
14303,2024-01-10 22:22:00,49,99,Alimento,9,148
14304,2024-01-10 22:23:00,64,29,Vestuário,6,93
14305,2024-01-10 22:24:00,86,124,Móvel,9,210
14306,2024-01-10 22:25:00,14,62,Brinquedo,8,76
14307,2024-01-10 22:26:00,77,43,Vestuário,3,120
14308,2024-01-10 22:27:00,62,23,Móvel,1,85
14309,2024-01-10 22:28:00,66,78,Móvel,8,144
14310,2024-01-10 22:29:00,25,44,Eletrônico,1,69
14311,2024-01-10 22:30:00,62,24,Eletrônico,1,86
14312,2024-01-10 22:31:00,78,156,Brinquedo,1,234
14313,2024-01-10 22:32:00,70,107,Alimento,3,177
14314,2024-01-10 22:33:00,63,118,Vestuário,9,181
14315,2024-01-10 22:34:00,38,89,Alimento,6,127
14316,2024-01-10 22:35:00,37,167,Vestuário,5,204
14317,2024-01-10 22:36:00,70,117,Eletrônico,8,187
14318,2024-01-10 22:37:00,48,32,Vestuário,9,80
14319,2024-01-10 22:38:00,100,95,Vestuário,5,195
14320,2024-01-10 22:39:00,57,28,Alimento,2,85
14321,2024-01-10 22:40:00,67,158,Eletrônico,2,225
14322,2024-01-10 22:41:00,80,16,Móvel,8,96
14323,2024-01-10 22:42:00,108,11,Brinquedo,4,119
14324,2024-01-10 22:43:00,59,13,Vestuário,5,72
14325,2024-01-10 22:44:00,113,88,Eletrônico,6,201
14326,2024-01-10 22:45:00,65,150,Brinquedo,1,215
14327,2024-01-10 22:46:00,100,49,Móvel,1,149
14328,2024-01-10 22:47:00,81,65,Alimento,5,146
14329,2024-01-10 22:48:00,76,127,Vestuário,2,203
14330,2024-01-10 22:49:00,29,121,Alimento,3,150
14331,2024-01-10 22:50:00,23,57,Eletrônico,6,80
14332,2024-01-10 22:51:00,88,48,Alimento,4,136
14333,2024-01-10 22:52:00,17,21,Brinquedo,1,38
14334,2024-01-10 22:53:00,35,59,Móvel,1,94
14335,2024-01-10 22:54:00,103,130,Vestuário,6,233
14336,2024-01-10 22:55:00,106,55,Móvel,3,161
14337,2024-01-10 22:56:00,109,141,Brinquedo,4,250
14338,2024-01-10 22:57:00,113,162,Alimento,6,275
14339,2024-01-10 22:58:00,40,36,Móvel,3,76
14340,2024-01-10 22:59:00,42,75,Alimento,7,117
14341,2024-01-10 23:00:00,36,122,Alimento,3,158
14342,2024-01-10 23:01:00,39,91,Eletrônico,2,130
14343,2024-01-10 23:02:00,13,30,Vestuário,2,43
14344,2024-01-10 23:03:00,64,24,Móvel,4,88
14345,2024-01-10 23:04:00,68,12,Vestuário,1,80
14346,2024-01-10 23:05:00,91,41,Vestuário,9,132
14347,2024-01-10 23:06:00,19,53,Eletrônico,8,72
14348,2024-01-10 23:07:00,69,43,Eletrônico,3,112
14349,2024-01-10 23:08:00,27,55,Alimento,5,82
14350,2024-01-10 23:09:00,78,137,Eletrônico,8,215
14351,2024-01-10 23:10:00,15,111,Alimento,2,126
14352,2024-01-10 23:11:00,88,72,Vestuário,9,160
14353,2024-01-10 23:12:00,39,66,Móvel,6,105
14354,2024-01-10 23:13:00,45,152,Móvel,4,197
14355,2024-01-10 23:14:00,89,34,Vestuário,6,123
14356,2024-01-10 23:15:00,72,158,Brinquedo,4,230
14357,2024-01-10 23:16:00,35,22,Eletrônico,7,57
14358,2024-01-10 23:17:00,85,134,Eletrônico,2,219
14359,2024-01-10 23:18:00,40,174,Vestuário,3,214
14360,2024-01-10 23:19:00,79,50,Móvel,3,129
14361,2024-01-10 23:20:00,32,66,Vestuário,2,98
14362,2024-01-10 23:21:00,10,107,Vestuário,3,117
14363,2024-01-10 23:22:00,111,23,Móvel,3,134
14364,2024-01-10 23:23:00,82,114,Eletrônico,5,196
14365,2024-01-10 23:24:00,72,13,Eletrônico,7,85
14366,2024-01-10 23:25:00,32,48,Alimento,4,80
14367,2024-01-10 23:26:00,74,121,Eletrônico,7,195
14368,2024-01-10 23:27:00,69,139,Vestuário,2,208
14369,2024-01-10 23:28:00,32,134,Eletrônico,4,166
14370,2024-01-10 23:29:00,95,112,Vestuário,1,207
14371,2024-01-10 23:30:00,47,176,Vestuário,4,223
14372,2024-01-10 23:31:00,105,53,Eletrônico,7,158
14373,2024-01-10 23:32:00,77,13,Brinquedo,8,90
14374,2024-01-10 23:33:00,21,156,Brinquedo,7,177
14375,2024-01-10 23:34:00,31,106,Móvel,3,137
14376,2024-01-10 23:35:00,112,132,Alimento,3,244
14377,2024-01-10 23:36:00,34,47,Brinquedo,5,81
14378,2024-01-10 23:37:00,99,101,Móvel,5,200
14379,2024-01-10 23:38:00,84,119,Vestuário,6,203
14380,2024-01-10 23:39:00,53,44,Vestuário,9,97
14381,2024-01-10 23:40:00,41,119,Eletrônico,3,160
14382,2024-01-10 23:41:00,109,34,Eletrônico,9,143
14383,2024-01-10 23:42:00,69,34,Vestuário,7,103
14384,2024-01-10 23:43:00,105,30,Eletrônico,5,135
14385,2024-01-10 23:44:00,110,59,Eletrônico,7,169
14386,2024-01-10 23:45:00,44,126,Vestuário,6,170
14387,2024-01-10 23:46:00,46,174,Brinquedo,1,220
14388,2024-01-10 23:47:00,94,13,Brinquedo,2,107
14389,2024-01-10 23:48:00,14,163,Brinquedo,3,177
14390,2024-01-10 23:49:00,22,131,Vestuário,5,153
14391,2024-01-10 23:50:00,77,27,Móvel,2,104
14392,2024-01-10 23:51:00,34,19,Alimento,8,53
14393,2024-01-10 23:52:00,65,64,Brinquedo,4,129
14394,2024-01-10 23:53:00,72,24,Alimento,1,96
14395,2024-01-10 23:54:00,42,48,Brinquedo,5,90
14396,2024-01-10 23:55:00,42,63,Eletrônico,6,105
14397,2024-01-10 23:56:00,46,89,Alimento,3,135
14398,2024-01-10 23:57:00,69,30,Alimento,6,99
14399,2024-01-10 23:58:00,93,160,Eletrônico,9,253
14400,2024-01-10 23:59:00,80,92,Brinquedo,3,172
14401,2024-01-11 00:00:00,113,132,Eletrônico,4,245
14402,2024-01-11 00:01:00,41,141,Eletrônico,9,182
14403,2024-01-11 00:02:00,82,160,Vestuário,6,242
14404,2024-01-11 00:03:00,61,165,Eletrônico,3,226
14405,2024-01-11 00:04:00,68,23,Vestuário,9,91
14406,2024-01-11 00:05:00,58,140,Alimento,3,198
14407,2024-01-11 00:06:00,75,145,Eletrônico,7,220
14408,2024-01-11 00:07:00,45,115,Vestuário,6,160
14409,2024-01-11 00:08:00,102,113,Brinquedo,4,215
14410,2024-01-11 00:09:00,27,113,Brinquedo,5,140
14411,2024-01-11 00:10:00,75,139,Alimento,1,214
14412,2024-01-11 00:11:00,68,149,Vestuário,8,217
14413,2024-01-11 00:12:00,26,15,Vestuário,1,41
14414,2024-01-11 00:13:00,12,88,Vestuário,5,100
14415,2024-01-11 00:14:00,103,172,Móvel,5,275
14416,2024-01-11 00:15:00,73,149,Vestuário,8,222
14417,2024-01-11 00:16:00,92,70,Eletrônico,5,162
14418,2024-01-11 00:17:00,80,52,Vestuário,3,132
14419,2024-01-11 00:18:00,88,36,Móvel,6,124
14420,2024-01-11 00:19:00,37,88,Alimento,8,125
14421,2024-01-11 00:20:00,57,44,Vestuário,5,101
14422,2024-01-11 00:21:00,55,19,Eletrônico,9,74
14423,2024-01-11 00:22:00,13,166,Brinquedo,4,179
14424,2024-01-11 00:23:00,75,20,Móvel,8,95
14425,2024-01-11 00:24:00,40,75,Eletrônico,7,115
14426,2024-01-11 00:25:00,11,159,Eletrônico,5,170
14427,2024-01-11 00:26:00,61,29,Brinquedo,7,90
14428,2024-01-11 00:27:00,92,66,Eletrônico,6,158
14429,2024-01-11 00:28:00,21,67,Alimento,8,88
14430,2024-01-11 00:29:00,78,82,Brinquedo,8,160
14431,2024-01-11 00:30:00,30,113,Eletrônico,1,143
14432,2024-01-11 00:31:00,11,55,Móvel,4,66
14433,2024-01-11 00:32:00,60,85,Alimento,1,145
14434,2024-01-11 00:33:00,54,152,Alimento,1,206
14435,2024-01-11 00:34:00,57,40,Eletrônico,3,97
14436,2024-01-11 00:35:00,58,30,Eletrônico,3,88
14437,2024-01-11 00:36:00,47,10,Móvel,5,57
14438,2024-01-11 00:37:00,51,167,Móvel,1,218
14439,2024-01-11 00:38:00,40,144,Alimento,2,184
14440,2024-01-11 00:39:00,53,123,Brinquedo,2,176
14441,2024-01-11 00:40:00,82,154,Vestuário,7,236
14442,2024-01-11 00:41:00,47,94,Eletrônico,3,141
14443,2024-01-11 00:42:00,37,121,Vestuário,7,158
14444,2024-01-11 00:43:00,91,82,Vestuário,9,173
14445,2024-01-11 00:44:00,20,84,Brinquedo,8,104
14446,2024-01-11 00:45:00,113,117,Móvel,5,230
14447,2024-01-11 00:46:00,103,55,Eletrônico,1,158
14448,2024-01-11 00:47:00,44,145,Vestuário,6,189
14449,2024-01-11 00:48:00,51,162,Vestuário,7,213
14450,2024-01-11 00:49:00,93,66,Brinquedo,1,159
14451,2024-01-11 00:50:00,57,35,Vestuário,5,92
14452,2024-01-11 00:51:00,61,11,Móvel,9,72
14453,2024-01-11 00:52:00,68,49,Alimento,6,117
14454,2024-01-11 00:53:00,79,154,Vestuário,7,233
14455,2024-01-11 00:54:00,85,59,Alimento,2,144
14456,2024-01-11 00:55:00,108,128,Vestuário,7,236
14457,2024-01-11 00:56:00,11,41,Eletrônico,7,52
14458,2024-01-11 00:57:00,80,157,Vestuário,9,237
14459,2024-01-11 00:58:00,93,155,Alimento,6,248
14460,2024-01-11 00:59:00,27,94,Eletrônico,6,121
14461,2024-01-11 01:00:00,25,96,Móvel,7,121
14462,2024-01-11 01:01:00,62,137,Alimento,2,199
14463,2024-01-11 01:02:00,52,14,Móvel,8,66
14464,2024-01-11 01:03:00,53,32,Alimento,2,85
14465,2024-01-11 01:04:00,88,137,Brinquedo,6,225
14466,2024-01-11 01:05:00,82,24,Alimento,7,106
14467,2024-01-11 01:06:00,55,75,Brinquedo,4,130
14468,2024-01-11 01:07:00,46,146,Brinquedo,4,192
14469,2024-01-11 01:08:00,14,116,Eletrônico,5,130
14470,2024-01-11 01:09:00,64,13,Alimento,7,77
14471,2024-01-11 01:10:00,95,68,Brinquedo,1,163
14472,2024-01-11 01:11:00,113,173,Móvel,6,286
14473,2024-01-11 01:12:00,78,59,Brinquedo,8,137
14474,2024-01-11 01:13:00,106,159,Móvel,5,265
14475,2024-01-11 01:14:00,39,51,Alimento,6,90
14476,2024-01-11 01:15:00,114,110,Brinquedo,3,224
14477,2024-01-11 01:16:00,80,12,Brinquedo,1,92
14478,2024-01-11 01:17:00,11,17,Eletrônico,1,28
14479,2024-01-11 01:18:00,29,151,Brinquedo,4,180
14480,2024-01-11 01:19:00,100,139,Alimento,8,239
14481,2024-01-11 01:20:00,47,116,Eletrônico,6,163
14482,2024-01-11 01:21:00,17,65,Eletrônico,4,82
14483,2024-01-11 01:22:00,39,104,Brinquedo,3,143
14484,2024-01-11 01:23:00,24,124,Alimento,1,148
14485,2024-01-11 01:24:00,92,61,Vestuário,5,153
14486,2024-01-11 01:25:00,11,176,Móvel,4,187
14487,2024-01-11 01:26:00,69,179,Vestuário,1,248
14488,2024-01-11 01:27:00,112,95,Eletrônico,7,207
14489,2024-01-11 01:28:00,102,89,Alimento,2,191
14490,2024-01-11 01:29:00,25,26,Vestuário,5,51
14491,2024-01-11 01:30:00,92,72,Brinquedo,5,164
14492,2024-01-11 01:31:00,32,127,Vestuário,5,159
14493,2024-01-11 01:32:00,102,115,Móvel,2,217
14494,2024-01-11 01:33:00,14,45,Móvel,7,59
14495,2024-01-11 01:34:00,32,35,Alimento,3,67
14496,2024-01-11 01:35:00,30,105,Brinquedo,1,135
14497,2024-01-11 01:36:00,114,138,Alimento,4,252
14498,2024-01-11 01:37:00,86,59,Brinquedo,6,145
14499,2024-01-11 01:38:00,14,159,Brinquedo,4,173
14500,2024-01-11 01:39:00,61,138,Eletrônico,3,199
14501,2024-01-11 01:40:00,91,43,Vestuário,3,134
14502,2024-01-11 01:41:00,83,59,Alimento,2,142
14503,2024-01-11 01:42:00,84,67,Alimento,6,151
14504,2024-01-11 01:43:00,101,80,Móvel,8,181
14505,2024-01-11 01:44:00,87,134,Alimento,1,221
14506,2024-01-11 01:45:00,35,25,Alimento,7,60
14507,2024-01-11 01:46:00,66,169,Vestuário,5,235
14508,2024-01-11 01:47:00,40,165,Vestuário,4,205
14509,2024-01-11 01:48:00,60,59,Vestuário,3,119
14510,2024-01-11 01:49:00,51,146,Vestuário,6,197
14511,2024-01-11 01:50:00,24,116,Brinquedo,3,140
14512,2024-01-11 01:51:00,23,32,Móvel,2,55
14513,2024-01-11 01:52:00,118,112,Brinquedo,4,230
14514,2024-01-11 01:53:00,35,97,Brinquedo,9,132
14515,2024-01-11 01:54:00,29,30,Alimento,7,59
14516,2024-01-11 01:55:00,103,136,Vestuário,3,239
14517,2024-01-11 01:56:00,14,26,Alimento,8,40
14518,2024-01-11 01:57:00,68,84,Brinquedo,4,152
14519,2024-01-11 01:58:00,30,77,Alimento,8,107
14520,2024-01-11 01:59:00,88,179,Eletrônico,3,267
14521,2024-01-11 02:00:00,33,51,Móvel,6,84
14522,2024-01-11 02:01:00,100,162,Eletrônico,6,262
14523,2024-01-11 02:02:00,102,43,Eletrônico,4,145
14524,2024-01-11 02:03:00,49,17,Móvel,3,66
14525,2024-01-11 02:04:00,30,141,Alimento,1,171
14526,2024-01-11 02:05:00,99,125,Móvel,1,224
14527,2024-01-11 02:06:00,46,93,Brinquedo,6,139
14528,2024-01-11 02:07:00,30,83,Vestuário,1,113
14529,2024-01-11 02:08:00,105,12,Móvel,7,117
14530,2024-01-11 02:09:00,16,138,Alimento,7,154
14531,2024-01-11 02:10:00,30,160,Brinquedo,4,190
14532,2024-01-11 02:11:00,110,83,Brinquedo,7,193
14533,2024-01-11 02:12:00,65,32,Eletrônico,4,97
14534,2024-01-11 02:13:00,18,122,Alimento,9,140
14535,2024-01-11 02:14:00,64,10,Brinquedo,4,74
14536,2024-01-11 02:15:00,24,178,Vestuário,3,202
14537,2024-01-11 02:16:00,78,139,Brinquedo,5,217
14538,2024-01-11 02:17:00,105,14,Alimento,3,119
14539,2024-01-11 02:18:00,79,97,Móvel,7,176
14540,2024-01-11 02:19:00,99,17,Vestuário,8,116
14541,2024-01-11 02:20:00,104,97,Alimento,3,201
14542,2024-01-11 02:21:00,78,10,Alimento,8,88
14543,2024-01-11 02:22:00,100,22,Brinquedo,6,122
14544,2024-01-11 02:23:00,17,145,Móvel,6,162
14545,2024-01-11 02:24:00,19,139,Brinquedo,1,158
14546,2024-01-11 02:25:00,116,137,Brinquedo,6,253
14547,2024-01-11 02:26:00,26,141,Brinquedo,8,167
14548,2024-01-11 02:27:00,10,28,Móvel,3,38
14549,2024-01-11 02:28:00,85,129,Eletrônico,6,214
14550,2024-01-11 02:29:00,86,64,Alimento,9,150
14551,2024-01-11 02:30:00,49,41,Brinquedo,6,90
14552,2024-01-11 02:31:00,41,29,Eletrônico,6,70
14553,2024-01-11 02:32:00,41,11,Vestuário,9,52
14554,2024-01-11 02:33:00,50,42,Brinquedo,6,92
14555,2024-01-11 02:34:00,34,39,Vestuário,4,73
14556,2024-01-11 02:35:00,28,59,Móvel,5,87
14557,2024-01-11 02:36:00,86,83,Vestuário,2,169
14558,2024-01-11 02:37:00,48,44,Eletrônico,7,92
14559,2024-01-11 02:38:00,58,155,Vestuário,9,213
14560,2024-01-11 02:39:00,39,53,Brinquedo,5,92
14561,2024-01-11 02:40:00,56,134,Brinquedo,9,190
14562,2024-01-11 02:41:00,10,127,Eletrônico,7,137
14563,2024-01-11 02:42:00,37,102,Vestuário,1,139
14564,2024-01-11 02:43:00,47,175,Eletrônico,3,222
14565,2024-01-11 02:44:00,102,86,Alimento,8,188
14566,2024-01-11 02:45:00,49,137,Eletrônico,2,186
14567,2024-01-11 02:46:00,86,121,Alimento,9,207
14568,2024-01-11 02:47:00,44,129,Móvel,6,173
14569,2024-01-11 02:48:00,36,96,Brinquedo,2,132
14570,2024-01-11 02:49:00,24,91,Alimento,4,115
14571,2024-01-11 02:50:00,28,52,Eletrônico,5,80
14572,2024-01-11 02:51:00,72,143,Alimento,9,215
14573,2024-01-11 02:52:00,18,46,Brinquedo,9,64
14574,2024-01-11 02:53:00,84,25,Brinquedo,3,109
14575,2024-01-11 02:54:00,114,152,Eletrônico,7,266
14576,2024-01-11 02:55:00,115,32,Eletrônico,1,147
14577,2024-01-11 02:56:00,87,60,Brinquedo,2,147
14578,2024-01-11 02:57:00,16,124,Vestuário,7,140
14579,2024-01-11 02:58:00,44,68,Alimento,8,112
14580,2024-01-11 02:59:00,37,107,Vestuário,4,144
14581,2024-01-11 03:00:00,102,24,Vestuário,2,126
14582,2024-01-11 03:01:00,31,163,Eletrônico,9,194
14583,2024-01-11 03:02:00,87,139,Eletrônico,9,226
14584,2024-01-11 03:03:00,118,71,Eletrônico,5,189
14585,2024-01-11 03:04:00,50,45,Brinquedo,1,95
14586,2024-01-11 03:05:00,59,118,Brinquedo,8,177
14587,2024-01-11 03:06:00,95,150,Alimento,9,245
14588,2024-01-11 03:07:00,43,72,Eletrônico,4,115
14589,2024-01-11 03:08:00,105,71,Móvel,1,176
14590,2024-01-11 03:09:00,115,22,Brinquedo,1,137
14591,2024-01-11 03:10:00,18,41,Móvel,4,59
14592,2024-01-11 03:11:00,24,106,Eletrônico,6,130
14593,2024-01-11 03:12:00,43,47,Brinquedo,7,90
14594,2024-01-11 03:13:00,64,168,Alimento,9,232
14595,2024-01-11 03:14:00,82,136,Móvel,8,218
14596,2024-01-11 03:15:00,100,111,Brinquedo,9,211
14597,2024-01-11 03:16:00,97,137,Vestuário,9,234
14598,2024-01-11 03:17:00,105,73,Móvel,8,178
14599,2024-01-11 03:18:00,75,29,Brinquedo,6,104
14600,2024-01-11 03:19:00,109,58,Alimento,5,167
14601,2024-01-11 03:20:00,91,29,Móvel,8,120
14602,2024-01-11 03:21:00,42,46,Brinquedo,6,88
14603,2024-01-11 03:22:00,51,23,Eletrônico,2,74
14604,2024-01-11 03:23:00,54,162,Brinquedo,4,216
14605,2024-01-11 03:24:00,92,97,Móvel,5,189
14606,2024-01-11 03:25:00,119,54,Móvel,3,173
14607,2024-01-11 03:26:00,82,170,Eletrônico,2,252
14608,2024-01-11 03:27:00,74,96,Eletrônico,6,170
14609,2024-01-11 03:28:00,74,168,Alimento,9,242
14610,2024-01-11 03:29:00,30,122,Móvel,4,152
14611,2024-01-11 03:30:00,29,14,Alimento,2,43
14612,2024-01-11 03:31:00,88,111,Vestuário,4,199
14613,2024-01-11 03:32:00,86,80,Brinquedo,8,166
14614,2024-01-11 03:33:00,114,93,Móvel,3,207
14615,2024-01-11 03:34:00,26,47,Alimento,9,73
14616,2024-01-11 03:35:00,80,81,Brinquedo,7,161
14617,2024-01-11 03:36:00,94,89,Eletrônico,8,183
14618,2024-01-11 03:37:00,91,71,Móvel,6,162
14619,2024-01-11 03:38:00,22,22,Brinquedo,1,44
14620,2024-01-11 03:39:00,73,110,Vestuário,3,183
14621,2024-01-11 03:40:00,108,114,Alimento,7,222
14622,2024-01-11 03:41:00,35,83,Brinquedo,9,118
14623,2024-01-11 03:42:00,101,38,Alimento,7,139
14624,2024-01-11 03:43:00,85,34,Eletrônico,7,119
14625,2024-01-11 03:44:00,58,96,Vestuário,8,154
14626,2024-01-11 03:45:00,34,77,Móvel,1,111
14627,2024-01-11 03:46:00,62,139,Eletrônico,8,201
14628,2024-01-11 03:47:00,13,41,Eletrônico,1,54
14629,2024-01-11 03:48:00,116,143,Alimento,5,259
14630,2024-01-11 03:49:00,47,64,Alimento,9,111
14631,2024-01-11 03:50:00,85,168,Eletrônico,1,253
14632,2024-01-11 03:51:00,14,166,Móvel,3,180
14633,2024-01-11 03:52:00,58,153,Móvel,7,211
14634,2024-01-11 03:53:00,50,58,Alimento,3,108
14635,2024-01-11 03:54:00,117,161,Vestuário,6,278
14636,2024-01-11 03:55:00,92,86,Móvel,6,178
14637,2024-01-11 03:56:00,20,157,Móvel,9,177
14638,2024-01-11 03:57:00,49,15,Alimento,4,64
14639,2024-01-11 03:58:00,88,65,Móvel,2,153
14640,2024-01-11 03:59:00,57,109,Vestuário,9,166
14641,2024-01-11 04:00:00,34,45,Alimento,3,79
14642,2024-01-11 04:01:00,14,37,Vestuário,4,51
14643,2024-01-11 04:02:00,63,66,Brinquedo,7,129
14644,2024-01-11 04:03:00,78,159,Brinquedo,5,237
14645,2024-01-11 04:04:00,14,42,Móvel,3,56
14646,2024-01-11 04:05:00,95,41,Móvel,1,136
14647,2024-01-11 04:06:00,23,52,Alimento,8,75
14648,2024-01-11 04:07:00,63,43,Eletrônico,1,106
14649,2024-01-11 04:08:00,71,24,Eletrônico,3,95
14650,2024-01-11 04:09:00,114,24,Eletrônico,6,138
14651,2024-01-11 04:10:00,32,39,Vestuário,9,71
14652,2024-01-11 04:11:00,68,25,Vestuário,4,93
14653,2024-01-11 04:12:00,53,68,Alimento,8,121
14654,2024-01-11 04:13:00,50,169,Vestuário,1,219
14655,2024-01-11 04:14:00,87,133,Vestuário,9,220
14656,2024-01-11 04:15:00,109,41,Móvel,8,150
14657,2024-01-11 04:16:00,76,20,Vestuário,8,96
14658,2024-01-11 04:17:00,70,15,Brinquedo,2,85
14659,2024-01-11 04:18:00,110,172,Vestuário,7,282
14660,2024-01-11 04:19:00,51,149,Vestuário,9,200
14661,2024-01-11 04:20:00,60,95,Móvel,1,155
14662,2024-01-11 04:21:00,37,37,Móvel,2,74
14663,2024-01-11 04:22:00,94,123,Brinquedo,9,217
14664,2024-01-11 04:23:00,89,76,Eletrônico,7,165
14665,2024-01-11 04:24:00,119,67,Alimento,1,186
14666,2024-01-11 04:25:00,70,154,Alimento,4,224
14667,2024-01-11 04:26:00,40,19,Móvel,7,59
14668,2024-01-11 04:27:00,22,25,Vestuário,9,47
14669,2024-01-11 04:28:00,29,130,Vestuário,3,159
14670,2024-01-11 04:29:00,106,121,Alimento,1,227
14671,2024-01-11 04:30:00,90,16,Móvel,1,106
14672,2024-01-11 04:31:00,87,22,Alimento,7,109
14673,2024-01-11 04:32:00,42,113,Eletrônico,2,155
14674,2024-01-11 04:33:00,116,106,Brinquedo,4,222
14675,2024-01-11 04:34:00,82,64,Alimento,9,146
14676,2024-01-11 04:35:00,28,60,Brinquedo,4,88
14677,2024-01-11 04:36:00,105,97,Alimento,7,202
14678,2024-01-11 04:37:00,17,59,Alimento,3,76
14679,2024-01-11 04:38:00,105,46,Alimento,1,151
14680,2024-01-11 04:39:00,118,177,Móvel,7,295
14681,2024-01-11 04:40:00,78,153,Brinquedo,2,231
14682,2024-01-11 04:41:00,102,69,Vestuário,7,171
14683,2024-01-11 04:42:00,83,89,Eletrônico,6,172
14684,2024-01-11 04:43:00,66,173,Brinquedo,8,239
14685,2024-01-11 04:44:00,103,48,Vestuário,8,151
14686,2024-01-11 04:45:00,76,92,Brinquedo,4,168
14687,2024-01-11 04:46:00,53,101,Alimento,9,154
14688,2024-01-11 04:47:00,56,137,Vestuário,3,193
14689,2024-01-11 04:48:00,102,35,Móvel,2,137
14690,2024-01-11 04:49:00,50,102,Alimento,8,152
14691,2024-01-11 04:50:00,73,149,Eletrônico,3,222
14692,2024-01-11 04:51:00,39,52,Eletrônico,1,91
14693,2024-01-11 04:52:00,53,177,Móvel,9,230
14694,2024-01-11 04:53:00,39,119,Eletrônico,3,158
14695,2024-01-11 04:54:00,90,14,Alimento,6,104
14696,2024-01-11 04:55:00,23,138,Móvel,4,161
14697,2024-01-11 04:56:00,110,106,Eletrônico,3,216
14698,2024-01-11 04:57:00,79,64,Alimento,2,143
14699,2024-01-11 04:58:00,12,113,Vestuário,8,125
14700,2024-01-11 04:59:00,100,156,Vestuário,6,256
14701,2024-01-11 05:00:00,43,42,Eletrônico,9,85
14702,2024-01-11 05:01:00,86,28,Vestuário,7,114
14703,2024-01-11 05:02:00,107,140,Alimento,9,247
14704,2024-01-11 05:03:00,48,89,Brinquedo,7,137
14705,2024-01-11 05:04:00,17,20,Vestuário,7,37
14706,2024-01-11 05:05:00,49,44,Eletrônico,7,93
14707,2024-01-11 05:06:00,24,100,Eletrônico,6,124
14708,2024-01-11 05:07:00,85,108,Eletrônico,3,193
14709,2024-01-11 05:08:00,69,41,Vestuário,5,110
14710,2024-01-11 05:09:00,107,68,Móvel,2,175
14711,2024-01-11 05:10:00,28,163,Brinquedo,7,191
14712,2024-01-11 05:11:00,69,49,Eletrônico,9,118
14713,2024-01-11 05:12:00,104,171,Eletrônico,3,275
14714,2024-01-11 05:13:00,110,46,Eletrônico,2,156
14715,2024-01-11 05:14:00,119,118,Vestuário,1,237
14716,2024-01-11 05:15:00,105,54,Vestuário,9,159
14717,2024-01-11 05:16:00,59,136,Vestuário,3,195
14718,2024-01-11 05:17:00,82,132,Eletrônico,9,214
14719,2024-01-11 05:18:00,24,31,Vestuário,1,55
14720,2024-01-11 05:19:00,113,81,Alimento,6,194
14721,2024-01-11 05:20:00,108,132,Alimento,2,240
14722,2024-01-11 05:21:00,16,55,Eletrônico,9,71
14723,2024-01-11 05:22:00,58,93,Alimento,7,151
14724,2024-01-11 05:23:00,87,166,Vestuário,4,253
14725,2024-01-11 05:24:00,107,109,Eletrônico,5,216
14726,2024-01-11 05:25:00,63,105,Brinquedo,7,168
14727,2024-01-11 05:26:00,26,108,Alimento,3,134
14728,2024-01-11 05:27:00,26,93,Eletrônico,6,119
14729,2024-01-11 05:28:00,80,35,Móvel,8,115
14730,2024-01-11 05:29:00,69,83,Móvel,4,152
14731,2024-01-11 05:30:00,36,116,Eletrônico,6,152
14732,2024-01-11 05:31:00,119,66,Móvel,1,185
14733,2024-01-11 05:32:00,90,155,Vestuário,3,245
14734,2024-01-11 05:33:00,17,79,Eletrônico,3,96
14735,2024-01-11 05:34:00,58,150,Eletrônico,6,208
14736,2024-01-11 05:35:00,65,65,Eletrônico,2,130
14737,2024-01-11 05:36:00,117,38,Eletrônico,9,155
14738,2024-01-11 05:37:00,45,174,Brinquedo,3,219
14739,2024-01-11 05:38:00,75,168,Móvel,4,243
14740,2024-01-11 05:39:00,37,11,Eletrônico,8,48
14741,2024-01-11 05:40:00,41,130,Vestuário,3,171
14742,2024-01-11 05:41:00,11,145,Móvel,6,156
14743,2024-01-11 05:42:00,64,104,Eletrônico,6,168
14744,2024-01-11 05:43:00,90,55,Brinquedo,8,145
14745,2024-01-11 05:44:00,86,47,Vestuário,7,133
14746,2024-01-11 05:45:00,21,26,Móvel,2,47
14747,2024-01-11 05:46:00,14,38,Vestuário,8,52
14748,2024-01-11 05:47:00,50,68,Brinquedo,3,118
14749,2024-01-11 05:48:00,100,115,Eletrônico,9,215
14750,2024-01-11 05:49:00,14,18,Brinquedo,4,32
14751,2024-01-11 05:50:00,11,39,Alimento,9,50
14752,2024-01-11 05:51:00,36,17,Brinquedo,8,53
14753,2024-01-11 05:52:00,86,37,Vestuário,4,123
14754,2024-01-11 05:53:00,86,50,Móvel,2,136
14755,2024-01-11 05:54:00,80,50,Vestuário,2,130
14756,2024-01-11 05:55:00,110,100,Eletrônico,8,210
14757,2024-01-11 05:56:00,62,157,Brinquedo,4,219
14758,2024-01-11 05:57:00,26,176,Brinquedo,1,202
14759,2024-01-11 05:58:00,98,27,Móvel,1,125
14760,2024-01-11 05:59:00,73,116,Móvel,8,189
14761,2024-01-11 06:00:00,90,144,Eletrônico,8,234
14762,2024-01-11 06:01:00,73,166,Alimento,5,239
14763,2024-01-11 06:02:00,46,54,Móvel,4,100
14764,2024-01-11 06:03:00,119,116,Eletrônico,1,235
14765,2024-01-11 06:04:00,113,170,Móvel,7,283
14766,2024-01-11 06:05:00,30,98,Vestuário,4,128
14767,2024-01-11 06:06:00,73,52,Eletrônico,1,125
14768,2024-01-11 06:07:00,26,51,Móvel,1,77
14769,2024-01-11 06:08:00,55,119,Eletrônico,3,174
14770,2024-01-11 06:09:00,11,30,Brinquedo,8,41
14771,2024-01-11 06:10:00,117,71,Móvel,9,188
14772,2024-01-11 06:11:00,62,150,Alimento,5,212
14773,2024-01-11 06:12:00,16,106,Alimento,1,122
14774,2024-01-11 06:13:00,83,149,Eletrônico,4,232
14775,2024-01-11 06:14:00,31,100,Vestuário,1,131
14776,2024-01-11 06:15:00,87,69,Eletrônico,3,156
14777,2024-01-11 06:16:00,47,168,Eletrônico,3,215
14778,2024-01-11 06:17:00,80,94,Alimento,1,174
14779,2024-01-11 06:18:00,94,76,Alimento,8,170
14780,2024-01-11 06:19:00,83,121,Vestuário,5,204
14781,2024-01-11 06:20:00,106,66,Móvel,1,172
14782,2024-01-11 06:21:00,86,155,Vestuário,6,241
14783,2024-01-11 06:22:00,84,121,Brinquedo,1,205
14784,2024-01-11 06:23:00,50,166,Vestuário,7,216
14785,2024-01-11 06:24:00,18,164,Móvel,5,182
14786,2024-01-11 06:25:00,29,132,Vestuário,6,161
14787,2024-01-11 06:26:00,115,22,Vestuário,9,137
14788,2024-01-11 06:27:00,34,80,Móvel,6,114
14789,2024-01-11 06:28:00,112,172,Vestuário,7,284
14790,2024-01-11 06:29:00,106,103,Brinquedo,8,209
14791,2024-01-11 06:30:00,82,138,Eletrônico,6,220
14792,2024-01-11 06:31:00,55,15,Eletrônico,1,70
14793,2024-01-11 06:32:00,40,163,Vestuário,5,203
14794,2024-01-11 06:33:00,19,114,Brinquedo,6,133
14795,2024-01-11 06:34:00,95,105,Móvel,2,200
14796,2024-01-11 06:35:00,70,137,Alimento,8,207
14797,2024-01-11 06:36:00,45,166,Alimento,7,211
14798,2024-01-11 06:37:00,34,25,Eletrônico,6,59
14799,2024-01-11 06:38:00,54,160,Móvel,4,214
14800,2024-01-11 06:39:00,13,148,Vestuário,8,161
14801,2024-01-11 06:40:00,105,93,Vestuário,8,198
14802,2024-01-11 06:41:00,81,86,Vestuário,8,167
14803,2024-01-11 06:42:00,22,45,Alimento,9,67
14804,2024-01-11 06:43:00,91,50,Móvel,8,141
14805,2024-01-11 06:44:00,10,43,Alimento,6,53
14806,2024-01-11 06:45:00,60,79,Brinquedo,7,139
14807,2024-01-11 06:46:00,65,163,Móvel,5,228
14808,2024-01-11 06:47:00,74,51,Brinquedo,5,125
14809,2024-01-11 06:48:00,76,68,Vestuário,6,144
14810,2024-01-11 06:49:00,36,79,Vestuário,1,115
14811,2024-01-11 06:50:00,28,73,Eletrônico,2,101
14812,2024-01-11 06:51:00,114,32,Eletrônico,4,146
14813,2024-01-11 06:52:00,91,96,Brinquedo,6,187
14814,2024-01-11 06:53:00,32,74,Alimento,8,106
14815,2024-01-11 06:54:00,58,27,Alimento,7,85
14816,2024-01-11 06:55:00,54,41,Brinquedo,4,95
14817,2024-01-11 06:56:00,30,147,Alimento,7,177
14818,2024-01-11 06:57:00,74,106,Vestuário,4,180
14819,2024-01-11 06:58:00,75,53,Eletrônico,4,128
14820,2024-01-11 06:59:00,39,100,Vestuário,4,139
14821,2024-01-11 07:00:00,105,125,Móvel,2,230
14822,2024-01-11 07:01:00,87,14,Vestuário,5,101
14823,2024-01-11 07:02:00,101,73,Móvel,6,174
14824,2024-01-11 07:03:00,47,98,Vestuário,2,145
14825,2024-01-11 07:04:00,18,162,Vestuário,7,180
14826,2024-01-11 07:05:00,19,18,Alimento,8,37
14827,2024-01-11 07:06:00,57,90,Alimento,6,147
14828,2024-01-11 07:07:00,35,178,Eletrônico,5,213
14829,2024-01-11 07:08:00,49,96,Eletrônico,4,145
14830,2024-01-11 07:09:00,92,46,Brinquedo,1,138
14831,2024-01-11 07:10:00,37,146,Brinquedo,8,183
14832,2024-01-11 07:11:00,80,120,Eletrônico,3,200
14833,2024-01-11 07:12:00,75,94,Eletrônico,1,169
14834,2024-01-11 07:13:00,42,12,Alimento,5,54
14835,2024-01-11 07:14:00,58,31,Móvel,6,89
14836,2024-01-11 07:15:00,80,130,Brinquedo,4,210
14837,2024-01-11 07:16:00,28,117,Vestuário,3,145
14838,2024-01-11 07:17:00,14,173,Brinquedo,8,187
14839,2024-01-11 07:18:00,104,133,Vestuário,2,237
14840,2024-01-11 07:19:00,55,126,Alimento,8,181
14841,2024-01-11 07:20:00,99,108,Móvel,6,207
14842,2024-01-11 07:21:00,110,87,Brinquedo,8,197
14843,2024-01-11 07:22:00,56,102,Móvel,1,158
14844,2024-01-11 07:23:00,47,29,Brinquedo,9,76
14845,2024-01-11 07:24:00,119,94,Vestuário,8,213
14846,2024-01-11 07:25:00,54,61,Vestuário,7,115
14847,2024-01-11 07:26:00,15,40,Eletrônico,9,55
14848,2024-01-11 07:27:00,76,171,Brinquedo,7,247
14849,2024-01-11 07:28:00,17,124,Móvel,4,141
14850,2024-01-11 07:29:00,10,171,Eletrônico,9,181
14851,2024-01-11 07:30:00,64,98,Brinquedo,5,162
14852,2024-01-11 07:31:00,76,42,Móvel,9,118
14853,2024-01-11 07:32:00,80,111,Alimento,3,191
14854,2024-01-11 07:33:00,91,30,Eletrônico,8,121
14855,2024-01-11 07:34:00,29,109,Móvel,5,138
14856,2024-01-11 07:35:00,66,109,Brinquedo,1,175
14857,2024-01-11 07:36:00,99,69,Móvel,5,168
14858,2024-01-11 07:37:00,21,129,Eletrônico,9,150
14859,2024-01-11 07:38:00,74,103,Vestuário,7,177
14860,2024-01-11 07:39:00,43,161,Móvel,1,204
14861,2024-01-11 07:40:00,95,149,Alimento,4,244
14862,2024-01-11 07:41:00,10,82,Vestuário,6,92
14863,2024-01-11 07:42:00,107,161,Alimento,8,268
14864,2024-01-11 07:43:00,58,21,Brinquedo,6,79
14865,2024-01-11 07:44:00,89,29,Brinquedo,1,118
14866,2024-01-11 07:45:00,14,136,Eletrônico,6,150
14867,2024-01-11 07:46:00,44,16,Móvel,2,60
14868,2024-01-11 07:47:00,107,172,Eletrônico,2,279
14869,2024-01-11 07:48:00,19,35,Alimento,5,54
14870,2024-01-11 07:49:00,93,40,Móvel,3,133
14871,2024-01-11 07:50:00,64,101,Vestuário,6,165
14872,2024-01-11 07:51:00,102,43,Móvel,7,145
14873,2024-01-11 07:52:00,86,74,Brinquedo,8,160
14874,2024-01-11 07:53:00,89,120,Vestuário,8,209
14875,2024-01-11 07:54:00,69,155,Alimento,8,224
14876,2024-01-11 07:55:00,85,45,Móvel,5,130
14877,2024-01-11 07:56:00,51,127,Vestuário,5,178
14878,2024-01-11 07:57:00,111,13,Vestuário,4,124
14879,2024-01-11 07:58:00,22,28,Móvel,2,50
14880,2024-01-11 07:59:00,20,109,Alimento,9,129
14881,2024-01-11 08:00:00,46,66,Alimento,6,112
14882,2024-01-11 08:01:00,73,10,Vestuário,7,83
14883,2024-01-11 08:02:00,24,37,Móvel,5,61
14884,2024-01-11 08:03:00,20,12,Móvel,6,32
14885,2024-01-11 08:04:00,26,61,Eletrônico,8,87
14886,2024-01-11 08:05:00,91,34,Eletrônico,9,125
14887,2024-01-11 08:06:00,107,93,Vestuário,2,200
14888,2024-01-11 08:07:00,84,46,Alimento,8,130
14889,2024-01-11 08:08:00,61,11,Vestuário,6,72
14890,2024-01-11 08:09:00,43,24,Alimento,4,67
14891,2024-01-11 08:10:00,57,128,Vestuário,2,185
14892,2024-01-11 08:11:00,88,136,Eletrônico,7,224
14893,2024-01-11 08:12:00,86,109,Vestuário,5,195
14894,2024-01-11 08:13:00,35,129,Brinquedo,5,164
14895,2024-01-11 08:14:00,63,46,Alimento,6,109
14896,2024-01-11 08:15:00,10,120,Vestuário,8,130
14897,2024-01-11 08:16:00,81,17,Brinquedo,8,98
14898,2024-01-11 08:17:00,93,50,Eletrônico,3,143
14899,2024-01-11 08:18:00,77,130,Alimento,5,207
14900,2024-01-11 08:19:00,20,75,Brinquedo,2,95
14901,2024-01-11 08:20:00,101,108,Vestuário,2,209
14902,2024-01-11 08:21:00,89,20,Eletrônico,5,109
14903,2024-01-11 08:22:00,78,43,Brinquedo,8,121
14904,2024-01-11 08:23:00,73,177,Móvel,8,250
14905,2024-01-11 08:24:00,63,32,Eletrônico,5,95
14906,2024-01-11 08:25:00,69,170,Alimento,6,239
14907,2024-01-11 08:26:00,77,178,Móvel,5,255
14908,2024-01-11 08:27:00,41,118,Alimento,1,159
14909,2024-01-11 08:28:00,75,14,Brinquedo,4,89
14910,2024-01-11 08:29:00,35,117,Eletrônico,2,152
14911,2024-01-11 08:30:00,52,101,Eletrônico,5,153
14912,2024-01-11 08:31:00,65,73,Alimento,3,138
14913,2024-01-11 08:32:00,111,160,Móvel,6,271
14914,2024-01-11 08:33:00,41,56,Móvel,7,97
14915,2024-01-11 08:34:00,86,61,Móvel,5,147
14916,2024-01-11 08:35:00,48,42,Eletrônico,1,90
14917,2024-01-11 08:36:00,71,44,Móvel,9,115
14918,2024-01-11 08:37:00,26,67,Eletrônico,8,93
14919,2024-01-11 08:38:00,75,127,Alimento,5,202
14920,2024-01-11 08:39:00,38,108,Móvel,3,146
14921,2024-01-11 08:40:00,37,104,Alimento,3,141
14922,2024-01-11 08:41:00,92,155,Alimento,3,247
14923,2024-01-11 08:42:00,77,100,Vestuário,6,177
14924,2024-01-11 08:43:00,62,118,Alimento,7,180
14925,2024-01-11 08:44:00,39,113,Brinquedo,9,152
14926,2024-01-11 08:45:00,46,115,Móvel,4,161
14927,2024-01-11 08:46:00,64,152,Alimento,4,216
14928,2024-01-11 08:47:00,37,76,Brinquedo,7,113
14929,2024-01-11 08:48:00,73,109,Alimento,7,182
14930,2024-01-11 08:49:00,80,65,Brinquedo,4,145
14931,2024-01-11 08:50:00,21,156,Brinquedo,6,177
14932,2024-01-11 08:51:00,89,50,Alimento,4,139
14933,2024-01-11 08:52:00,47,160,Brinquedo,6,207
14934,2024-01-11 08:53:00,111,79,Vestuário,8,190
14935,2024-01-11 08:54:00,100,87,Eletrônico,7,187
14936,2024-01-11 08:55:00,64,17,Móvel,1,81
14937,2024-01-11 08:56:00,35,76,Brinquedo,2,111
14938,2024-01-11 08:57:00,76,147,Vestuário,5,223
14939,2024-01-11 08:58:00,93,33,Alimento,5,126
14940,2024-01-11 08:59:00,12,179,Brinquedo,3,191
14941,2024-01-11 09:00:00,19,15,Móvel,1,34
14942,2024-01-11 09:01:00,10,115,Eletrônico,9,125
14943,2024-01-11 09:02:00,49,94,Brinquedo,2,143
14944,2024-01-11 09:03:00,46,178,Alimento,3,224
14945,2024-01-11 09:04:00,77,94,Alimento,7,171
14946,2024-01-11 09:05:00,57,36,Brinquedo,1,93
14947,2024-01-11 09:06:00,82,70,Vestuário,3,152
14948,2024-01-11 09:07:00,100,14,Vestuário,8,114
14949,2024-01-11 09:08:00,81,55,Brinquedo,8,136
14950,2024-01-11 09:09:00,108,122,Brinquedo,2,230
14951,2024-01-11 09:10:00,102,136,Móvel,4,238
14952,2024-01-11 09:11:00,16,49,Alimento,2,65
14953,2024-01-11 09:12:00,114,35,Móvel,8,149
14954,2024-01-11 09:13:00,93,164,Vestuário,6,257
14955,2024-01-11 09:14:00,72,112,Vestuário,7,184
14956,2024-01-11 09:15:00,35,148,Vestuário,1,183
14957,2024-01-11 09:16:00,37,120,Alimento,7,157
14958,2024-01-11 09:17:00,60,135,Alimento,1,195
14959,2024-01-11 09:18:00,59,149,Eletrônico,6,208
14960,2024-01-11 09:19:00,59,74,Alimento,1,133
14961,2024-01-11 09:20:00,71,79,Alimento,6,150
14962,2024-01-11 09:21:00,101,147,Móvel,2,248
14963,2024-01-11 09:22:00,39,173,Eletrônico,5,212
14964,2024-01-11 09:23:00,23,91,Móvel,6,114
14965,2024-01-11 09:24:00,52,12,Vestuário,9,64
14966,2024-01-11 09:25:00,81,90,Brinquedo,2,171
14967,2024-01-11 09:26:00,54,130,Brinquedo,2,184
14968,2024-01-11 09:27:00,111,81,Vestuário,4,192
14969,2024-01-11 09:28:00,116,14,Alimento,5,130
14970,2024-01-11 09:29:00,87,39,Brinquedo,8,126
14971,2024-01-11 09:30:00,70,160,Alimento,8,230
14972,2024-01-11 09:31:00,70,175,Alimento,9,245
14973,2024-01-11 09:32:00,14,69,Vestuário,7,83
14974,2024-01-11 09:33:00,105,84,Vestuário,9,189
14975,2024-01-11 09:34:00,88,33,Vestuário,3,121
14976,2024-01-11 09:35:00,98,82,Alimento,7,180
14977,2024-01-11 09:36:00,13,172,Brinquedo,9,185
14978,2024-01-11 09:37:00,114,130,Eletrônico,3,244
14979,2024-01-11 09:38:00,88,119,Brinquedo,2,207
14980,2024-01-11 09:39:00,21,134,Eletrônico,3,155
14981,2024-01-11 09:40:00,33,40,Móvel,5,73
14982,2024-01-11 09:41:00,74,72,Alimento,2,146
14983,2024-01-11 09:42:00,33,85,Brinquedo,3,118
14984,2024-01-11 09:43:00,80,31,Eletrônico,7,111
14985,2024-01-11 09:44:00,46,27,Móvel,3,73
14986,2024-01-11 09:45:00,114,172,Alimento,2,286
14987,2024-01-11 09:46:00,112,99,Brinquedo,9,211
14988,2024-01-11 09:47:00,66,159,Brinquedo,6,225
14989,2024-01-11 09:48:00,35,14,Eletrônico,1,49
14990,2024-01-11 09:49:00,40,118,Vestuário,3,158
14991,2024-01-11 09:50:00,70,47,Vestuário,8,117
14992,2024-01-11 09:51:00,55,93,Alimento,8,148
14993,2024-01-11 09:52:00,41,80,Alimento,6,121
14994,2024-01-11 09:53:00,92,129,Brinquedo,1,221
14995,2024-01-11 09:54:00,40,33,Brinquedo,8,73
14996,2024-01-11 09:55:00,51,38,Brinquedo,3,89
14997,2024-01-11 09:56:00,31,45,Alimento,4,76
14998,2024-01-11 09:57:00,42,79,Alimento,8,121
14999,2024-01-11 09:58:00,85,77,Alimento,4,162
15000,2024-01-11 09:59:00,101,80,Brinquedo,3,181
15001,2024-01-11 10:00:00,105,133,Vestuário,8,238
15002,2024-01-11 10:01:00,10,93,Brinquedo,5,103
15003,2024-01-11 10:02:00,75,22,Móvel,4,97
15004,2024-01-11 10:03:00,96,166,Vestuário,4,262
15005,2024-01-11 10:04:00,116,124,Alimento,1,240
15006,2024-01-11 10:05:00,32,153,Eletrônico,6,185
15007,2024-01-11 10:06:00,31,54,Brinquedo,8,85
15008,2024-01-11 10:07:00,98,108,Brinquedo,6,206
15009,2024-01-11 10:08:00,116,100,Móvel,3,216
15010,2024-01-11 10:09:00,79,89,Móvel,3,168
15011,2024-01-11 10:10:00,27,172,Vestuário,2,199
15012,2024-01-11 10:11:00,99,42,Vestuário,4,141
15013,2024-01-11 10:12:00,25,85,Brinquedo,7,110
15014,2024-01-11 10:13:00,74,90,Alimento,1,164
15015,2024-01-11 10:14:00,22,127,Brinquedo,6,149
15016,2024-01-11 10:15:00,47,134,Eletrônico,5,181
15017,2024-01-11 10:16:00,49,116,Eletrônico,3,165
15018,2024-01-11 10:17:00,27,79,Móvel,3,106
15019,2024-01-11 10:18:00,46,84,Brinquedo,7,130
15020,2024-01-11 10:19:00,113,41,Alimento,6,154
15021,2024-01-11 10:20:00,28,129,Vestuário,5,157
15022,2024-01-11 10:21:00,45,108,Vestuário,1,153
15023,2024-01-11 10:22:00,106,96,Brinquedo,9,202
15024,2024-01-11 10:23:00,99,50,Vestuário,1,149
15025,2024-01-11 10:24:00,62,174,Alimento,9,236
15026,2024-01-11 10:25:00,19,74,Eletrônico,3,93
15027,2024-01-11 10:26:00,20,67,Vestuário,9,87
15028,2024-01-11 10:27:00,91,79,Brinquedo,1,170
15029,2024-01-11 10:28:00,58,67,Eletrônico,7,125
15030,2024-01-11 10:29:00,15,79,Alimento,3,94
15031,2024-01-11 10:30:00,59,112,Vestuário,3,171
15032,2024-01-11 10:31:00,89,45,Móvel,5,134
15033,2024-01-11 10:32:00,77,34,Alimento,7,111
15034,2024-01-11 10:33:00,110,35,Eletrônico,2,145
15035,2024-01-11 10:34:00,55,56,Vestuário,3,111
15036,2024-01-11 10:35:00,93,44,Eletrônico,8,137
15037,2024-01-11 10:36:00,103,105,Eletrônico,5,208
15038,2024-01-11 10:37:00,63,37,Vestuário,7,100
15039,2024-01-11 10:38:00,109,103,Vestuário,3,212
15040,2024-01-11 10:39:00,26,74,Móvel,7,100
15041,2024-01-11 10:40:00,84,24,Brinquedo,5,108
15042,2024-01-11 10:41:00,114,128,Vestuário,9,242
15043,2024-01-11 10:42:00,112,33,Alimento,6,145
15044,2024-01-11 10:43:00,40,102,Móvel,6,142
15045,2024-01-11 10:44:00,87,138,Móvel,6,225
15046,2024-01-11 10:45:00,85,24,Brinquedo,2,109
15047,2024-01-11 10:46:00,40,148,Móvel,8,188
15048,2024-01-11 10:47:00,46,157,Eletrônico,8,203
15049,2024-01-11 10:48:00,19,108,Móvel,9,127
15050,2024-01-11 10:49:00,52,82,Brinquedo,4,134
15051,2024-01-11 10:50:00,65,130,Móvel,9,195
15052,2024-01-11 10:51:00,114,126,Vestuário,9,240
15053,2024-01-11 10:52:00,30,102,Brinquedo,9,132
15054,2024-01-11 10:53:00,106,21,Vestuário,1,127
15055,2024-01-11 10:54:00,117,152,Eletrônico,4,269
15056,2024-01-11 10:55:00,58,111,Vestuário,7,169
15057,2024-01-11 10:56:00,57,125,Móvel,7,182
15058,2024-01-11 10:57:00,40,91,Brinquedo,1,131
15059,2024-01-11 10:58:00,98,54,Móvel,4,152
15060,2024-01-11 10:59:00,32,61,Eletrônico,3,93
15061,2024-01-11 11:00:00,17,92,Alimento,8,109
15062,2024-01-11 11:01:00,107,104,Móvel,1,211
15063,2024-01-11 11:02:00,55,165,Móvel,4,220
15064,2024-01-11 11:03:00,114,139,Móvel,9,253
15065,2024-01-11 11:04:00,80,125,Vestuário,3,205
15066,2024-01-11 11:05:00,114,80,Eletrônico,6,194
15067,2024-01-11 11:06:00,31,15,Eletrônico,3,46
15068,2024-01-11 11:07:00,12,37,Alimento,8,49
15069,2024-01-11 11:08:00,80,110,Vestuário,5,190
15070,2024-01-11 11:09:00,50,141,Alimento,6,191
15071,2024-01-11 11:10:00,93,115,Alimento,2,208
15072,2024-01-11 11:11:00,11,13,Brinquedo,5,24
15073,2024-01-11 11:12:00,63,103,Eletrônico,2,166
15074,2024-01-11 11:13:00,20,102,Brinquedo,6,122
15075,2024-01-11 11:14:00,83,87,Eletrônico,8,170
15076,2024-01-11 11:15:00,112,36,Brinquedo,9,148
15077,2024-01-11 11:16:00,83,160,Brinquedo,7,243
15078,2024-01-11 11:17:00,63,43,Vestuário,9,106
15079,2024-01-11 11:18:00,16,15,Alimento,3,31
15080,2024-01-11 11:19:00,19,58,Alimento,2,77
15081,2024-01-11 11:20:00,116,165,Brinquedo,2,281
15082,2024-01-11 11:21:00,82,120,Alimento,9,202
15083,2024-01-11 11:22:00,23,145,Brinquedo,5,168
15084,2024-01-11 11:23:00,39,93,Vestuário,9,132
15085,2024-01-11 11:24:00,45,142,Brinquedo,3,187
15086,2024-01-11 11:25:00,63,70,Alimento,6,133
15087,2024-01-11 11:26:00,34,50,Móvel,8,84
15088,2024-01-11 11:27:00,104,177,Vestuário,4,281
15089,2024-01-11 11:28:00,37,107,Vestuário,7,144
15090,2024-01-11 11:29:00,84,107,Móvel,4,191
15091,2024-01-11 11:30:00,112,169,Eletrônico,6,281
15092,2024-01-11 11:31:00,71,22,Brinquedo,1,93
15093,2024-01-11 11:32:00,91,162,Vestuário,6,253
15094,2024-01-11 11:33:00,85,11,Móvel,5,96
15095,2024-01-11 11:34:00,38,143,Alimento,5,181
15096,2024-01-11 11:35:00,99,83,Alimento,8,182
15097,2024-01-11 11:36:00,65,167,Vestuário,9,232
15098,2024-01-11 11:37:00,107,167,Alimento,1,274
15099,2024-01-11 11:38:00,63,120,Móvel,6,183
15100,2024-01-11 11:39:00,30,153,Brinquedo,8,183
15101,2024-01-11 11:40:00,96,17,Vestuário,8,113
15102,2024-01-11 11:41:00,86,75,Vestuário,7,161
15103,2024-01-11 11:42:00,93,155,Alimento,8,248
15104,2024-01-11 11:43:00,63,145,Alimento,2,208
15105,2024-01-11 11:44:00,99,171,Alimento,2,270
15106,2024-01-11 11:45:00,115,62,Móvel,5,177
15107,2024-01-11 11:46:00,68,174,Alimento,7,242
15108,2024-01-11 11:47:00,67,52,Alimento,7,119
15109,2024-01-11 11:48:00,53,161,Brinquedo,7,214
15110,2024-01-11 11:49:00,103,144,Móvel,3,247
15111,2024-01-11 11:50:00,60,32,Alimento,6,92
15112,2024-01-11 11:51:00,10,18,Móvel,1,28
15113,2024-01-11 11:52:00,56,118,Brinquedo,9,174
15114,2024-01-11 11:53:00,37,65,Vestuário,2,102
15115,2024-01-11 11:54:00,102,101,Eletrônico,3,203
15116,2024-01-11 11:55:00,16,46,Móvel,6,62
15117,2024-01-11 11:56:00,103,154,Móvel,7,257
15118,2024-01-11 11:57:00,20,149,Brinquedo,7,169
15119,2024-01-11 11:58:00,81,104,Móvel,3,185
15120,2024-01-11 11:59:00,81,157,Móvel,3,238
15121,2024-01-11 12:00:00,27,54,Eletrônico,6,81
15122,2024-01-11 12:01:00,58,20,Eletrônico,7,78
15123,2024-01-11 12:02:00,96,138,Vestuário,5,234
15124,2024-01-11 12:03:00,47,88,Brinquedo,1,135
15125,2024-01-11 12:04:00,99,41,Móvel,2,140
15126,2024-01-11 12:05:00,50,25,Móvel,1,75
15127,2024-01-11 12:06:00,37,49,Brinquedo,8,86
15128,2024-01-11 12:07:00,57,129,Móvel,3,186
15129,2024-01-11 12:08:00,118,28,Alimento,1,146
15130,2024-01-11 12:09:00,115,167,Alimento,1,282
15131,2024-01-11 12:10:00,109,136,Eletrônico,3,245
15132,2024-01-11 12:11:00,31,160,Eletrônico,3,191
15133,2024-01-11 12:12:00,58,14,Móvel,6,72
15134,2024-01-11 12:13:00,32,72,Móvel,9,104
15135,2024-01-11 12:14:00,44,158,Móvel,1,202
15136,2024-01-11 12:15:00,108,144,Móvel,5,252
15137,2024-01-11 12:16:00,95,35,Alimento,4,130
15138,2024-01-11 12:17:00,92,75,Alimento,1,167
15139,2024-01-11 12:18:00,16,109,Vestuário,2,125
15140,2024-01-11 12:19:00,16,149,Vestuário,9,165
15141,2024-01-11 12:20:00,93,156,Móvel,2,249
15142,2024-01-11 12:21:00,57,96,Vestuário,5,153
15143,2024-01-11 12:22:00,63,133,Eletrônico,5,196
15144,2024-01-11 12:23:00,73,26,Brinquedo,2,99
15145,2024-01-11 12:24:00,69,98,Alimento,5,167
15146,2024-01-11 12:25:00,61,16,Eletrônico,1,77
15147,2024-01-11 12:26:00,98,94,Alimento,9,192
15148,2024-01-11 12:27:00,65,100,Eletrônico,1,165
15149,2024-01-11 12:28:00,67,121,Móvel,1,188
15150,2024-01-11 12:29:00,113,159,Eletrônico,1,272
15151,2024-01-11 12:30:00,111,110,Móvel,1,221
15152,2024-01-11 12:31:00,41,174,Eletrônico,2,215
15153,2024-01-11 12:32:00,73,47,Móvel,1,120
15154,2024-01-11 12:33:00,16,47,Eletrônico,1,63
15155,2024-01-11 12:34:00,78,87,Brinquedo,6,165
15156,2024-01-11 12:35:00,40,36,Alimento,6,76
15157,2024-01-11 12:36:00,77,111,Móvel,3,188
15158,2024-01-11 12:37:00,55,89,Brinquedo,2,144
15159,2024-01-11 12:38:00,114,32,Brinquedo,8,146
15160,2024-01-11 12:39:00,72,100,Alimento,5,172
15161,2024-01-11 12:40:00,40,113,Móvel,1,153
15162,2024-01-11 12:41:00,95,88,Vestuário,9,183
15163,2024-01-11 12:42:00,79,72,Brinquedo,5,151
15164,2024-01-11 12:43:00,30,29,Móvel,2,59
15165,2024-01-11 12:44:00,83,170,Móvel,3,253
15166,2024-01-11 12:45:00,73,171,Brinquedo,1,244
15167,2024-01-11 12:46:00,12,11,Vestuário,4,23
15168,2024-01-11 12:47:00,46,51,Brinquedo,6,97
15169,2024-01-11 12:48:00,29,30,Vestuário,7,59
15170,2024-01-11 12:49:00,16,93,Vestuário,7,109
15171,2024-01-11 12:50:00,104,153,Móvel,2,257
15172,2024-01-11 12:51:00,33,93,Eletrônico,2,126
15173,2024-01-11 12:52:00,105,80,Eletrônico,5,185
15174,2024-01-11 12:53:00,11,47,Brinquedo,2,58
15175,2024-01-11 12:54:00,26,178,Eletrônico,8,204
15176,2024-01-11 12:55:00,26,167,Móvel,6,193
15177,2024-01-11 12:56:00,49,100,Móvel,7,149
15178,2024-01-11 12:57:00,28,109,Alimento,8,137
15179,2024-01-11 12:58:00,45,11,Brinquedo,8,56
15180,2024-01-11 12:59:00,34,129,Eletrônico,4,163
15181,2024-01-11 13:00:00,94,35,Alimento,8,129
15182,2024-01-11 13:01:00,95,70,Alimento,5,165
15183,2024-01-11 13:02:00,22,96,Eletrônico,2,118
15184,2024-01-11 13:03:00,45,75,Eletrônico,9,120
15185,2024-01-11 13:04:00,109,14,Eletrônico,5,123
15186,2024-01-11 13:05:00,87,55,Alimento,8,142
15187,2024-01-11 13:06:00,98,39,Eletrônico,2,137
15188,2024-01-11 13:07:00,23,61,Brinquedo,4,84
15189,2024-01-11 13:08:00,40,40,Vestuário,5,80
15190,2024-01-11 13:09:00,30,40,Brinquedo,8,70
15191,2024-01-11 13:10:00,92,38,Móvel,5,130
15192,2024-01-11 13:11:00,119,150,Alimento,6,269
15193,2024-01-11 13:12:00,68,41,Móvel,7,109
15194,2024-01-11 13:13:00,57,114,Eletrônico,8,171
15195,2024-01-11 13:14:00,22,71,Eletrônico,1,93
15196,2024-01-11 13:15:00,110,32,Brinquedo,4,142
15197,2024-01-11 13:16:00,20,122,Alimento,1,142
15198,2024-01-11 13:17:00,47,151,Alimento,2,198
15199,2024-01-11 13:18:00,86,86,Eletrônico,1,172
15200,2024-01-11 13:19:00,54,25,Eletrônico,2,79
15201,2024-01-11 13:20:00,59,174,Móvel,5,233
15202,2024-01-11 13:21:00,36,39,Vestuário,5,75
15203,2024-01-11 13:22:00,87,98,Alimento,2,185
15204,2024-01-11 13:23:00,17,139,Brinquedo,8,156
15205,2024-01-11 13:24:00,98,34,Móvel,8,132
15206,2024-01-11 13:25:00,109,153,Móvel,2,262
15207,2024-01-11 13:26:00,21,153,Eletrônico,2,174
15208,2024-01-11 13:27:00,89,22,Vestuário,6,111
15209,2024-01-11 13:28:00,89,23,Vestuário,4,112
15210,2024-01-11 13:29:00,65,55,Alimento,2,120
15211,2024-01-11 13:30:00,26,163,Alimento,3,189
15212,2024-01-11 13:31:00,112,107,Brinquedo,5,219
15213,2024-01-11 13:32:00,104,145,Vestuário,6,249
15214,2024-01-11 13:33:00,92,43,Móvel,2,135
15215,2024-01-11 13:34:00,59,29,Brinquedo,8,88
15216,2024-01-11 13:35:00,15,25,Brinquedo,8,40
15217,2024-01-11 13:36:00,108,40,Vestuário,5,148
15218,2024-01-11 13:37:00,105,53,Alimento,2,158
15219,2024-01-11 13:38:00,75,13,Vestuário,8,88
15220,2024-01-11 13:39:00,37,149,Alimento,5,186
15221,2024-01-11 13:40:00,19,58,Vestuário,7,77
15222,2024-01-11 13:41:00,39,76,Móvel,1,115
15223,2024-01-11 13:42:00,109,162,Eletrônico,6,271
15224,2024-01-11 13:43:00,22,29,Brinquedo,6,51
15225,2024-01-11 13:44:00,57,98,Alimento,1,155
15226,2024-01-11 13:45:00,18,80,Vestuário,5,98
15227,2024-01-11 13:46:00,50,152,Brinquedo,1,202
15228,2024-01-11 13:47:00,46,163,Eletrônico,9,209
15229,2024-01-11 13:48:00,58,158,Alimento,1,216
15230,2024-01-11 13:49:00,69,169,Brinquedo,5,238
15231,2024-01-11 13:50:00,13,84,Móvel,8,97
15232,2024-01-11 13:51:00,76,169,Brinquedo,4,245
15233,2024-01-11 13:52:00,30,73,Brinquedo,9,103
15234,2024-01-11 13:53:00,59,154,Brinquedo,8,213
15235,2024-01-11 13:54:00,22,107,Brinquedo,7,129
15236,2024-01-11 13:55:00,87,179,Brinquedo,8,266
15237,2024-01-11 13:56:00,92,147,Brinquedo,2,239
15238,2024-01-11 13:57:00,47,96,Vestuário,3,143
15239,2024-01-11 13:58:00,62,78,Eletrônico,2,140
15240,2024-01-11 13:59:00,42,48,Móvel,2,90
15241,2024-01-11 14:00:00,59,14,Brinquedo,9,73
15242,2024-01-11 14:01:00,13,12,Alimento,4,25
15243,2024-01-11 14:02:00,31,23,Eletrônico,9,54
15244,2024-01-11 14:03:00,57,13,Alimento,1,70
15245,2024-01-11 14:04:00,84,99,Alimento,8,183
15246,2024-01-11 14:05:00,55,140,Vestuário,4,195
15247,2024-01-11 14:06:00,108,101,Brinquedo,1,209
15248,2024-01-11 14:07:00,106,92,Vestuário,9,198
15249,2024-01-11 14:08:00,27,153,Alimento,5,180
15250,2024-01-11 14:09:00,102,128,Alimento,1,230
15251,2024-01-11 14:10:00,97,88,Eletrônico,7,185
15252,2024-01-11 14:11:00,33,95,Alimento,6,128
15253,2024-01-11 14:12:00,112,16,Móvel,2,128
15254,2024-01-11 14:13:00,109,80,Eletrônico,6,189
15255,2024-01-11 14:14:00,45,149,Móvel,4,194
15256,2024-01-11 14:15:00,101,34,Eletrônico,4,135
15257,2024-01-11 14:16:00,79,175,Eletrônico,7,254
15258,2024-01-11 14:17:00,21,28,Brinquedo,4,49
15259,2024-01-11 14:18:00,72,42,Alimento,5,114
15260,2024-01-11 14:19:00,92,163,Alimento,4,255
15261,2024-01-11 14:20:00,103,41,Brinquedo,5,144
15262,2024-01-11 14:21:00,87,160,Móvel,1,247
15263,2024-01-11 14:22:00,50,164,Brinquedo,4,214
15264,2024-01-11 14:23:00,99,131,Eletrônico,2,230
15265,2024-01-11 14:24:00,102,93,Alimento,7,195
15266,2024-01-11 14:25:00,79,24,Brinquedo,6,103
15267,2024-01-11 14:26:00,22,72,Eletrônico,1,94
15268,2024-01-11 14:27:00,46,73,Alimento,6,119
15269,2024-01-11 14:28:00,116,56,Móvel,8,172
15270,2024-01-11 14:29:00,109,127,Brinquedo,6,236
15271,2024-01-11 14:30:00,16,136,Vestuário,7,152
15272,2024-01-11 14:31:00,30,26,Eletrônico,5,56
15273,2024-01-11 14:32:00,51,54,Brinquedo,8,105
15274,2024-01-11 14:33:00,108,108,Brinquedo,6,216
15275,2024-01-11 14:34:00,35,159,Vestuário,2,194
15276,2024-01-11 14:35:00,65,11,Vestuário,9,76
15277,2024-01-11 14:36:00,97,72,Vestuário,7,169
15278,2024-01-11 14:37:00,13,12,Eletrônico,6,25
15279,2024-01-11 14:38:00,20,150,Alimento,9,170
15280,2024-01-11 14:39:00,100,127,Vestuário,7,227
15281,2024-01-11 14:40:00,28,23,Alimento,2,51
15282,2024-01-11 14:41:00,38,94,Móvel,2,132
15283,2024-01-11 14:42:00,90,64,Eletrônico,3,154
15284,2024-01-11 14:43:00,17,93,Brinquedo,8,110
15285,2024-01-11 14:44:00,24,97,Eletrônico,8,121
15286,2024-01-11 14:45:00,13,55,Brinquedo,5,68
15287,2024-01-11 14:46:00,79,73,Vestuário,8,152
15288,2024-01-11 14:47:00,63,25,Vestuário,1,88
15289,2024-01-11 14:48:00,72,134,Alimento,6,206
15290,2024-01-11 14:49:00,58,83,Vestuário,1,141
15291,2024-01-11 14:50:00,116,15,Brinquedo,6,131
15292,2024-01-11 14:51:00,61,47,Vestuário,4,108
15293,2024-01-11 14:52:00,111,48,Alimento,7,159
15294,2024-01-11 14:53:00,95,97,Vestuário,4,192
15295,2024-01-11 14:54:00,59,65,Móvel,6,124
15296,2024-01-11 14:55:00,118,20,Móvel,6,138
15297,2024-01-11 14:56:00,39,47,Móvel,5,86
15298,2024-01-11 14:57:00,15,59,Vestuário,1,74
15299,2024-01-11 14:58:00,117,38,Alimento,5,155
15300,2024-01-11 14:59:00,95,41,Vestuário,3,136
15301,2024-01-11 15:00:00,26,44,Vestuário,9,70
15302,2024-01-11 15:01:00,16,162,Brinquedo,9,178
15303,2024-01-11 15:02:00,86,113,Vestuário,2,199
15304,2024-01-11 15:03:00,117,27,Móvel,3,144
15305,2024-01-11 15:04:00,42,60,Vestuário,2,102
15306,2024-01-11 15:05:00,42,149,Eletrônico,5,191
15307,2024-01-11 15:06:00,32,14,Vestuário,2,46
15308,2024-01-11 15:07:00,77,35,Vestuário,2,112
15309,2024-01-11 15:08:00,106,26,Alimento,8,132
15310,2024-01-11 15:09:00,114,37,Brinquedo,7,151
15311,2024-01-11 15:10:00,45,174,Eletrônico,9,219
15312,2024-01-11 15:11:00,23,171,Eletrônico,1,194
15313,2024-01-11 15:12:00,60,153,Brinquedo,2,213
15314,2024-01-11 15:13:00,34,29,Eletrônico,8,63
15315,2024-01-11 15:14:00,65,38,Alimento,8,103
15316,2024-01-11 15:15:00,87,129,Móvel,9,216
15317,2024-01-11 15:16:00,100,15,Vestuário,6,115
15318,2024-01-11 15:17:00,75,148,Eletrônico,2,223
15319,2024-01-11 15:18:00,105,144,Vestuário,4,249
15320,2024-01-11 15:19:00,78,10,Eletrônico,9,88
15321,2024-01-11 15:20:00,51,157,Vestuário,8,208
15322,2024-01-11 15:21:00,119,19,Vestuário,7,138
15323,2024-01-11 15:22:00,84,94,Móvel,3,178
15324,2024-01-11 15:23:00,84,48,Eletrônico,8,132
15325,2024-01-11 15:24:00,99,13,Móvel,8,112
15326,2024-01-11 15:25:00,119,158,Alimento,5,277
15327,2024-01-11 15:26:00,74,72,Alimento,9,146
15328,2024-01-11 15:27:00,101,123,Brinquedo,9,224
15329,2024-01-11 15:28:00,48,98,Eletrônico,3,146
15330,2024-01-11 15:29:00,37,92,Vestuário,3,129
15331,2024-01-11 15:30:00,26,58,Vestuário,8,84
15332,2024-01-11 15:31:00,113,151,Alimento,8,264
15333,2024-01-11 15:32:00,114,142,Alimento,3,256
15334,2024-01-11 15:33:00,110,167,Vestuário,4,277
15335,2024-01-11 15:34:00,12,133,Eletrônico,3,145
15336,2024-01-11 15:35:00,105,117,Alimento,8,222
15337,2024-01-11 15:36:00,61,110,Vestuário,2,171
15338,2024-01-11 15:37:00,92,131,Eletrônico,7,223
15339,2024-01-11 15:38:00,11,164,Eletrônico,3,175
15340,2024-01-11 15:39:00,35,164,Alimento,2,199
15341,2024-01-11 15:40:00,95,93,Móvel,3,188
15342,2024-01-11 15:41:00,66,89,Móvel,7,155
15343,2024-01-11 15:42:00,23,163,Vestuário,3,186
15344,2024-01-11 15:43:00,12,55,Móvel,3,67
15345,2024-01-11 15:44:00,24,149,Móvel,8,173
15346,2024-01-11 15:45:00,54,104,Móvel,3,158
15347,2024-01-11 15:46:00,36,99,Eletrônico,3,135
15348,2024-01-11 15:47:00,69,108,Vestuário,3,177
15349,2024-01-11 15:48:00,85,83,Alimento,2,168
15350,2024-01-11 15:49:00,69,124,Brinquedo,9,193
15351,2024-01-11 15:50:00,88,75,Eletrônico,9,163
15352,2024-01-11 15:51:00,110,107,Móvel,6,217
15353,2024-01-11 15:52:00,118,145,Móvel,8,263
15354,2024-01-11 15:53:00,64,77,Alimento,9,141
15355,2024-01-11 15:54:00,83,126,Móvel,8,209
15356,2024-01-11 15:55:00,51,45,Eletrônico,2,96
15357,2024-01-11 15:56:00,59,67,Brinquedo,5,126
15358,2024-01-11 15:57:00,85,91,Móvel,4,176
15359,2024-01-11 15:58:00,75,39,Brinquedo,7,114
15360,2024-01-11 15:59:00,72,54,Eletrônico,8,126
15361,2024-01-11 16:00:00,98,120,Brinquedo,8,218
15362,2024-01-11 16:01:00,48,88,Alimento,2,136
15363,2024-01-11 16:02:00,19,176,Alimento,9,195
15364,2024-01-11 16:03:00,80,167,Alimento,4,247
15365,2024-01-11 16:04:00,44,146,Eletrônico,3,190
15366,2024-01-11 16:05:00,39,48,Móvel,6,87
15367,2024-01-11 16:06:00,72,41,Vestuário,2,113
15368,2024-01-11 16:07:00,109,169,Eletrônico,8,278
15369,2024-01-11 16:08:00,91,129,Alimento,1,220
15370,2024-01-11 16:09:00,38,120,Alimento,1,158
15371,2024-01-11 16:10:00,48,176,Vestuário,1,224
15372,2024-01-11 16:11:00,38,172,Móvel,7,210
15373,2024-01-11 16:12:00,94,104,Alimento,5,198
15374,2024-01-11 16:13:00,49,128,Móvel,1,177
15375,2024-01-11 16:14:00,52,139,Eletrônico,9,191
15376,2024-01-11 16:15:00,49,77,Móvel,3,126
15377,2024-01-11 16:16:00,119,50,Eletrônico,6,169
15378,2024-01-11 16:17:00,109,120,Móvel,6,229
15379,2024-01-11 16:18:00,40,64,Vestuário,4,104
15380,2024-01-11 16:19:00,19,99,Móvel,8,118
15381,2024-01-11 16:20:00,90,115,Vestuário,1,205
15382,2024-01-11 16:21:00,55,143,Móvel,5,198
15383,2024-01-11 16:22:00,100,167,Móvel,5,267
15384,2024-01-11 16:23:00,103,12,Móvel,7,115
15385,2024-01-11 16:24:00,13,81,Brinquedo,5,94
15386,2024-01-11 16:25:00,72,52,Brinquedo,6,124
15387,2024-01-11 16:26:00,98,52,Móvel,6,150
15388,2024-01-11 16:27:00,84,160,Eletrônico,6,244
15389,2024-01-11 16:28:00,112,109,Brinquedo,1,221
15390,2024-01-11 16:29:00,70,63,Eletrônico,6,133
15391,2024-01-11 16:30:00,58,99,Eletrônico,6,157
15392,2024-01-11 16:31:00,100,93,Alimento,1,193
15393,2024-01-11 16:32:00,43,144,Alimento,5,187
15394,2024-01-11 16:33:00,55,138,Móvel,4,193
15395,2024-01-11 16:34:00,40,93,Alimento,3,133
15396,2024-01-11 16:35:00,69,85,Vestuário,3,154
15397,2024-01-11 16:36:00,58,176,Móvel,7,234
15398,2024-01-11 16:37:00,41,166,Vestuário,5,207
15399,2024-01-11 16:38:00,95,85,Eletrônico,7,180
15400,2024-01-11 16:39:00,53,139,Alimento,5,192
15401,2024-01-11 16:40:00,68,138,Eletrônico,7,206
15402,2024-01-11 16:41:00,63,87,Vestuário,9,150
15403,2024-01-11 16:42:00,76,103,Alimento,7,179
15404,2024-01-11 16:43:00,51,173,Brinquedo,9,224
15405,2024-01-11 16:44:00,27,40,Móvel,7,67
15406,2024-01-11 16:45:00,28,117,Vestuário,5,145
15407,2024-01-11 16:46:00,108,139,Vestuário,9,247
15408,2024-01-11 16:47:00,68,15,Eletrônico,9,83
15409,2024-01-11 16:48:00,105,65,Eletrônico,6,170
15410,2024-01-11 16:49:00,10,64,Brinquedo,1,74
15411,2024-01-11 16:50:00,84,159,Eletrônico,5,243
15412,2024-01-11 16:51:00,63,133,Eletrônico,8,196
15413,2024-01-11 16:52:00,22,74,Eletrônico,4,96
15414,2024-01-11 16:53:00,106,148,Alimento,9,254
15415,2024-01-11 16:54:00,13,23,Brinquedo,9,36
15416,2024-01-11 16:55:00,93,50,Eletrônico,4,143
15417,2024-01-11 16:56:00,100,101,Eletrônico,4,201
15418,2024-01-11 16:57:00,79,148,Eletrônico,2,227
15419,2024-01-11 16:58:00,15,154,Alimento,2,169
15420,2024-01-11 16:59:00,33,26,Móvel,7,59
15421,2024-01-11 17:00:00,85,123,Brinquedo,2,208
15422,2024-01-11 17:01:00,100,154,Eletrônico,5,254
15423,2024-01-11 17:02:00,44,150,Alimento,6,194
15424,2024-01-11 17:03:00,31,115,Eletrônico,2,146
15425,2024-01-11 17:04:00,27,111,Móvel,4,138
15426,2024-01-11 17:05:00,105,80,Brinquedo,2,185
15427,2024-01-11 17:06:00,109,23,Brinquedo,7,132
15428,2024-01-11 17:07:00,50,155,Brinquedo,1,205
15429,2024-01-11 17:08:00,101,84,Alimento,7,185
15430,2024-01-11 17:09:00,46,32,Vestuário,8,78
15431,2024-01-11 17:10:00,107,159,Móvel,4,266
15432,2024-01-11 17:11:00,68,49,Vestuário,5,117
15433,2024-01-11 17:12:00,110,157,Brinquedo,6,267
15434,2024-01-11 17:13:00,12,48,Brinquedo,5,60
15435,2024-01-11 17:14:00,92,63,Brinquedo,9,155
15436,2024-01-11 17:15:00,32,124,Alimento,7,156
15437,2024-01-11 17:16:00,80,157,Brinquedo,3,237
15438,2024-01-11 17:17:00,32,160,Eletrônico,7,192
15439,2024-01-11 17:18:00,105,166,Móvel,9,271
15440,2024-01-11 17:19:00,78,79,Alimento,5,157
15441,2024-01-11 17:20:00,53,156,Brinquedo,1,209
15442,2024-01-11 17:21:00,60,153,Alimento,6,213
15443,2024-01-11 17:22:00,74,178,Vestuário,2,252
15444,2024-01-11 17:23:00,68,85,Móvel,6,153
15445,2024-01-11 17:24:00,101,86,Alimento,6,187
15446,2024-01-11 17:25:00,25,24,Móvel,5,49
15447,2024-01-11 17:26:00,33,111,Eletrônico,5,144
15448,2024-01-11 17:27:00,45,147,Vestuário,6,192
15449,2024-01-11 17:28:00,87,111,Eletrônico,2,198
15450,2024-01-11 17:29:00,80,48,Brinquedo,6,128
15451,2024-01-11 17:30:00,87,132,Alimento,5,219
15452,2024-01-11 17:31:00,20,119,Alimento,3,139
15453,2024-01-11 17:32:00,68,164,Eletrônico,6,232
15454,2024-01-11 17:33:00,119,168,Vestuário,8,287
15455,2024-01-11 17:34:00,33,18,Brinquedo,7,51
15456,2024-01-11 17:35:00,45,55,Móvel,8,100
15457,2024-01-11 17:36:00,78,153,Alimento,1,231
15458,2024-01-11 17:37:00,103,60,Eletrônico,5,163
15459,2024-01-11 17:38:00,59,110,Brinquedo,9,169
15460,2024-01-11 17:39:00,109,150,Alimento,7,259
15461,2024-01-11 17:40:00,102,163,Brinquedo,1,265
15462,2024-01-11 17:41:00,71,139,Móvel,6,210
15463,2024-01-11 17:42:00,20,171,Alimento,3,191
15464,2024-01-11 17:43:00,106,87,Eletrônico,6,193
15465,2024-01-11 17:44:00,47,171,Alimento,2,218
15466,2024-01-11 17:45:00,96,165,Brinquedo,4,261
15467,2024-01-11 17:46:00,92,31,Vestuário,3,123
15468,2024-01-11 17:47:00,51,28,Brinquedo,2,79
15469,2024-01-11 17:48:00,74,37,Móvel,5,111
15470,2024-01-11 17:49:00,47,90,Alimento,7,137
15471,2024-01-11 17:50:00,97,115,Brinquedo,8,212
15472,2024-01-11 17:51:00,115,86,Vestuário,7,201
15473,2024-01-11 17:52:00,72,122,Vestuário,9,194
15474,2024-01-11 17:53:00,65,127,Vestuário,3,192
15475,2024-01-11 17:54:00,104,156,Alimento,7,260
15476,2024-01-11 17:55:00,65,116,Vestuário,1,181
15477,2024-01-11 17:56:00,112,113,Vestuário,6,225
15478,2024-01-11 17:57:00,41,63,Brinquedo,8,104
15479,2024-01-11 17:58:00,60,36,Alimento,5,96
15480,2024-01-11 17:59:00,107,38,Móvel,6,145
15481,2024-01-11 18:00:00,72,35,Alimento,8,107
15482,2024-01-11 18:01:00,17,26,Alimento,4,43
15483,2024-01-11 18:02:00,40,48,Brinquedo,1,88
15484,2024-01-11 18:03:00,67,157,Alimento,5,224
15485,2024-01-11 18:04:00,75,113,Eletrônico,6,188
15486,2024-01-11 18:05:00,80,156,Alimento,6,236
15487,2024-01-11 18:06:00,41,171,Eletrônico,2,212
15488,2024-01-11 18:07:00,38,78,Móvel,7,116
15489,2024-01-11 18:08:00,83,109,Eletrônico,1,192
15490,2024-01-11 18:09:00,104,29,Eletrônico,4,133
15491,2024-01-11 18:10:00,36,138,Móvel,2,174
15492,2024-01-11 18:11:00,81,89,Eletrônico,8,170
15493,2024-01-11 18:12:00,61,78,Brinquedo,6,139
15494,2024-01-11 18:13:00,55,83,Móvel,2,138
15495,2024-01-11 18:14:00,29,141,Brinquedo,3,170
15496,2024-01-11 18:15:00,80,45,Brinquedo,1,125
15497,2024-01-11 18:16:00,101,44,Brinquedo,5,145
15498,2024-01-11 18:17:00,13,27,Vestuário,9,40
15499,2024-01-11 18:18:00,80,127,Eletrônico,5,207
15500,2024-01-11 18:19:00,55,24,Vestuário,6,79
15501,2024-01-11 18:20:00,81,148,Móvel,3,229
15502,2024-01-11 18:21:00,13,166,Vestuário,7,179
15503,2024-01-11 18:22:00,51,33,Vestuário,6,84
15504,2024-01-11 18:23:00,98,142,Eletrônico,9,240
15505,2024-01-11 18:24:00,10,13,Vestuário,5,23
15506,2024-01-11 18:25:00,112,175,Alimento,4,287
15507,2024-01-11 18:26:00,40,98,Eletrônico,5,138
15508,2024-01-11 18:27:00,68,22,Móvel,6,90
15509,2024-01-11 18:28:00,31,136,Eletrônico,3,167
15510,2024-01-11 18:29:00,108,61,Vestuário,9,169
15511,2024-01-11 18:30:00,78,71,Eletrônico,1,149
15512,2024-01-11 18:31:00,116,69,Vestuário,2,185
15513,2024-01-11 18:32:00,77,96,Brinquedo,1,173
15514,2024-01-11 18:33:00,77,27,Eletrônico,9,104
15515,2024-01-11 18:34:00,60,48,Móvel,4,108
15516,2024-01-11 18:35:00,95,55,Brinquedo,1,150
15517,2024-01-11 18:36:00,56,101,Eletrônico,9,157
15518,2024-01-11 18:37:00,11,129,Alimento,6,140
15519,2024-01-11 18:38:00,29,75,Vestuário,8,104
15520,2024-01-11 18:39:00,111,157,Móvel,1,268
15521,2024-01-11 18:40:00,53,70,Alimento,7,123
15522,2024-01-11 18:41:00,71,175,Eletrônico,4,246
15523,2024-01-11 18:42:00,89,176,Vestuário,4,265
15524,2024-01-11 18:43:00,37,116,Eletrônico,6,153
15525,2024-01-11 18:44:00,26,53,Alimento,2,79
15526,2024-01-11 18:45:00,29,16,Vestuário,2,45
15527,2024-01-11 18:46:00,112,71,Móvel,8,183
15528,2024-01-11 18:47:00,54,179,Vestuário,6,233
15529,2024-01-11 18:48:00,69,67,Eletrônico,6,136
15530,2024-01-11 18:49:00,32,28,Alimento,2,60
15531,2024-01-11 18:50:00,76,179,Brinquedo,1,255
15532,2024-01-11 18:51:00,84,167,Brinquedo,5,251
15533,2024-01-11 18:52:00,71,70,Vestuário,5,141
15534,2024-01-11 18:53:00,90,142,Brinquedo,8,232
15535,2024-01-11 18:54:00,118,41,Móvel,8,159
15536,2024-01-11 18:55:00,50,72,Vestuário,8,122
15537,2024-01-11 18:56:00,19,119,Móvel,9,138
15538,2024-01-11 18:57:00,102,34,Móvel,1,136
15539,2024-01-11 18:58:00,104,138,Eletrônico,7,242
15540,2024-01-11 18:59:00,11,153,Móvel,1,164
15541,2024-01-11 19:00:00,43,146,Brinquedo,4,189
15542,2024-01-11 19:01:00,63,46,Alimento,8,109
15543,2024-01-11 19:02:00,85,72,Eletrônico,1,157
15544,2024-01-11 19:03:00,48,31,Vestuário,1,79
15545,2024-01-11 19:04:00,77,119,Móvel,7,196
15546,2024-01-11 19:05:00,35,107,Brinquedo,1,142
15547,2024-01-11 19:06:00,33,66,Vestuário,9,99
15548,2024-01-11 19:07:00,48,34,Brinquedo,9,82
15549,2024-01-11 19:08:00,25,159,Móvel,5,184
15550,2024-01-11 19:09:00,34,151,Brinquedo,6,185
15551,2024-01-11 19:10:00,86,136,Alimento,5,222
15552,2024-01-11 19:11:00,71,58,Móvel,5,129
15553,2024-01-11 19:12:00,52,150,Alimento,4,202
15554,2024-01-11 19:13:00,21,122,Eletrônico,2,143
15555,2024-01-11 19:14:00,68,176,Alimento,6,244
15556,2024-01-11 19:15:00,70,116,Móvel,7,186
15557,2024-01-11 19:16:00,20,20,Vestuário,5,40
15558,2024-01-11 19:17:00,111,130,Eletrônico,1,241
15559,2024-01-11 19:18:00,62,52,Alimento,4,114
15560,2024-01-11 19:19:00,15,177,Brinquedo,8,192
15561,2024-01-11 19:20:00,73,137,Alimento,1,210
15562,2024-01-11 19:21:00,114,104,Móvel,6,218
15563,2024-01-11 19:22:00,87,97,Vestuário,1,184
15564,2024-01-11 19:23:00,56,56,Eletrônico,8,112
15565,2024-01-11 19:24:00,53,121,Eletrônico,9,174
15566,2024-01-11 19:25:00,67,85,Alimento,5,152
15567,2024-01-11 19:26:00,28,14,Eletrônico,7,42
15568,2024-01-11 19:27:00,33,150,Eletrônico,3,183
15569,2024-01-11 19:28:00,31,157,Móvel,2,188
15570,2024-01-11 19:29:00,20,78,Eletrônico,4,98
15571,2024-01-11 19:30:00,112,67,Alimento,4,179
15572,2024-01-11 19:31:00,76,15,Eletrônico,2,91
15573,2024-01-11 19:32:00,61,94,Vestuário,2,155
15574,2024-01-11 19:33:00,39,165,Alimento,7,204
15575,2024-01-11 19:34:00,23,108,Vestuário,7,131
15576,2024-01-11 19:35:00,21,171,Móvel,5,192
15577,2024-01-11 19:36:00,28,130,Eletrônico,8,158
15578,2024-01-11 19:37:00,40,40,Brinquedo,4,80
15579,2024-01-11 19:38:00,81,131,Brinquedo,5,212
15580,2024-01-11 19:39:00,93,19,Vestuário,2,112
15581,2024-01-11 19:40:00,84,64,Eletrônico,5,148
15582,2024-01-11 19:41:00,11,36,Vestuário,5,47
15583,2024-01-11 19:42:00,61,88,Vestuário,8,149
15584,2024-01-11 19:43:00,55,62,Vestuário,3,117
15585,2024-01-11 19:44:00,33,106,Vestuário,2,139
15586,2024-01-11 19:45:00,39,20,Móvel,4,59
15587,2024-01-11 19:46:00,55,110,Alimento,1,165
15588,2024-01-11 19:47:00,77,69,Vestuário,8,146
15589,2024-01-11 19:48:00,119,62,Alimento,2,181
15590,2024-01-11 19:49:00,97,177,Móvel,6,274
15591,2024-01-11 19:50:00,38,31,Brinquedo,5,69
15592,2024-01-11 19:51:00,40,111,Móvel,6,151
15593,2024-01-11 19:52:00,101,134,Alimento,2,235
15594,2024-01-11 19:53:00,86,49,Alimento,3,135
15595,2024-01-11 19:54:00,22,44,Vestuário,1,66
15596,2024-01-11 19:55:00,79,67,Eletrônico,1,146
15597,2024-01-11 19:56:00,62,137,Vestuário,2,199
15598,2024-01-11 19:57:00,110,116,Vestuário,4,226
15599,2024-01-11 19:58:00,67,143,Alimento,9,210
15600,2024-01-11 19:59:00,64,111,Brinquedo,8,175
15601,2024-01-11 20:00:00,92,67,Eletrônico,6,159
15602,2024-01-11 20:01:00,46,164,Móvel,6,210
15603,2024-01-11 20:02:00,82,14,Eletrônico,2,96
15604,2024-01-11 20:03:00,49,26,Vestuário,9,75
15605,2024-01-11 20:04:00,87,118,Móvel,9,205
15606,2024-01-11 20:05:00,111,113,Alimento,5,224
15607,2024-01-11 20:06:00,77,125,Eletrônico,5,202
15608,2024-01-11 20:07:00,72,26,Vestuário,1,98
15609,2024-01-11 20:08:00,84,46,Brinquedo,4,130
15610,2024-01-11 20:09:00,116,170,Móvel,1,286
15611,2024-01-11 20:10:00,30,77,Eletrônico,8,107
15612,2024-01-11 20:11:00,79,133,Alimento,3,212
15613,2024-01-11 20:12:00,23,79,Vestuário,9,102
15614,2024-01-11 20:13:00,29,117,Eletrônico,6,146
15615,2024-01-11 20:14:00,64,111,Brinquedo,4,175
15616,2024-01-11 20:15:00,101,179,Eletrônico,2,280
15617,2024-01-11 20:16:00,112,131,Vestuário,6,243
15618,2024-01-11 20:17:00,71,106,Eletrônico,2,177
15619,2024-01-11 20:18:00,110,18,Móvel,8,128
15620,2024-01-11 20:19:00,47,97,Vestuário,6,144
15621,2024-01-11 20:20:00,103,135,Alimento,8,238
15622,2024-01-11 20:21:00,103,26,Brinquedo,5,129
15623,2024-01-11 20:22:00,65,142,Eletrônico,7,207
15624,2024-01-11 20:23:00,26,136,Brinquedo,3,162
15625,2024-01-11 20:24:00,104,38,Brinquedo,5,142
15626,2024-01-11 20:25:00,45,164,Vestuário,8,209
15627,2024-01-11 20:26:00,106,88,Brinquedo,8,194
15628,2024-01-11 20:27:00,102,153,Brinquedo,1,255
15629,2024-01-11 20:28:00,51,62,Vestuário,4,113
15630,2024-01-11 20:29:00,19,117,Móvel,4,136
15631,2024-01-11 20:30:00,78,134,Vestuário,2,212
15632,2024-01-11 20:31:00,85,120,Móvel,1,205
15633,2024-01-11 20:32:00,107,161,Móvel,5,268
15634,2024-01-11 20:33:00,103,102,Alimento,6,205
15635,2024-01-11 20:34:00,18,58,Móvel,3,76
15636,2024-01-11 20:35:00,106,111,Vestuário,1,217
15637,2024-01-11 20:36:00,91,22,Móvel,9,113
15638,2024-01-11 20:37:00,85,122,Vestuário,6,207
15639,2024-01-11 20:38:00,91,78,Móvel,4,169
15640,2024-01-11 20:39:00,44,98,Eletrônico,3,142
15641,2024-01-11 20:40:00,73,23,Eletrônico,8,96
15642,2024-01-11 20:41:00,32,127,Brinquedo,8,159
15643,2024-01-11 20:42:00,116,173,Vestuário,3,289
15644,2024-01-11 20:43:00,88,149,Brinquedo,4,237
15645,2024-01-11 20:44:00,28,173,Eletrônico,7,201
15646,2024-01-11 20:45:00,108,79,Alimento,2,187
15647,2024-01-11 20:46:00,90,110,Eletrônico,5,200
15648,2024-01-11 20:47:00,16,45,Vestuário,1,61
15649,2024-01-11 20:48:00,48,75,Eletrônico,2,123
15650,2024-01-11 20:49:00,23,40,Vestuário,2,63
15651,2024-01-11 20:50:00,31,71,Alimento,4,102
15652,2024-01-11 20:51:00,104,42,Vestuário,2,146
15653,2024-01-11 20:52:00,51,103,Móvel,2,154
15654,2024-01-11 20:53:00,32,161,Brinquedo,5,193
15655,2024-01-11 20:54:00,41,171,Alimento,2,212
15656,2024-01-11 20:55:00,119,92,Móvel,7,211
15657,2024-01-11 20:56:00,67,60,Móvel,7,127
15658,2024-01-11 20:57:00,22,34,Brinquedo,1,56
15659,2024-01-11 20:58:00,98,120,Vestuário,4,218
15660,2024-01-11 20:59:00,37,81,Brinquedo,8,118
15661,2024-01-11 21:00:00,105,151,Eletrônico,8,256
15662,2024-01-11 21:01:00,59,27,Alimento,3,86
15663,2024-01-11 21:02:00,15,89,Móvel,7,104
15664,2024-01-11 21:03:00,28,159,Alimento,1,187
15665,2024-01-11 21:04:00,90,79,Eletrônico,9,169
15666,2024-01-11 21:05:00,59,107,Vestuário,1,166
15667,2024-01-11 21:06:00,93,60,Vestuário,4,153
15668,2024-01-11 21:07:00,95,148,Eletrônico,1,243
15669,2024-01-11 21:08:00,34,176,Eletrônico,4,210
15670,2024-01-11 21:09:00,34,78,Móvel,6,112
15671,2024-01-11 21:10:00,52,13,Brinquedo,4,65
15672,2024-01-11 21:11:00,96,108,Eletrônico,1,204
15673,2024-01-11 21:12:00,70,99,Eletrônico,3,169
15674,2024-01-11 21:13:00,32,137,Brinquedo,5,169
15675,2024-01-11 21:14:00,102,37,Alimento,8,139
15676,2024-01-11 21:15:00,94,85,Móvel,4,179
15677,2024-01-11 21:16:00,29,102,Vestuário,7,131
15678,2024-01-11 21:17:00,80,59,Móvel,6,139
15679,2024-01-11 21:18:00,67,170,Eletrônico,5,237
15680,2024-01-11 21:19:00,85,85,Vestuário,3,170
15681,2024-01-11 21:20:00,96,52,Alimento,4,148
15682,2024-01-11 21:21:00,106,177,Brinquedo,4,283
15683,2024-01-11 21:22:00,95,78,Móvel,6,173
15684,2024-01-11 21:23:00,21,76,Móvel,6,97
15685,2024-01-11 21:24:00,20,44,Móvel,4,64
15686,2024-01-11 21:25:00,63,43,Eletrônico,5,106
15687,2024-01-11 21:26:00,85,150,Brinquedo,2,235
15688,2024-01-11 21:27:00,85,20,Vestuário,4,105
15689,2024-01-11 21:28:00,50,63,Alimento,1,113
15690,2024-01-11 21:29:00,56,97,Móvel,3,153
15691,2024-01-11 21:30:00,57,76,Eletrônico,7,133
15692,2024-01-11 21:31:00,108,63,Móvel,3,171
15693,2024-01-11 21:32:00,53,50,Brinquedo,4,103
15694,2024-01-11 21:33:00,88,79,Brinquedo,2,167
15695,2024-01-11 21:34:00,18,57,Eletrônico,2,75
15696,2024-01-11 21:35:00,100,50,Brinquedo,1,150
15697,2024-01-11 21:36:00,52,115,Brinquedo,8,167
15698,2024-01-11 21:37:00,77,33,Móvel,4,110
15699,2024-01-11 21:38:00,68,130,Vestuário,8,198
15700,2024-01-11 21:39:00,62,161,Móvel,9,223
15701,2024-01-11 21:40:00,41,106,Eletrônico,8,147
15702,2024-01-11 21:41:00,114,72,Alimento,1,186
15703,2024-01-11 21:42:00,98,153,Móvel,2,251
15704,2024-01-11 21:43:00,91,114,Eletrônico,5,205
15705,2024-01-11 21:44:00,102,78,Brinquedo,6,180
15706,2024-01-11 21:45:00,107,107,Móvel,6,214
15707,2024-01-11 21:46:00,28,91,Vestuário,7,119
15708,2024-01-11 21:47:00,40,110,Vestuário,2,150
15709,2024-01-11 21:48:00,84,104,Brinquedo,3,188
15710,2024-01-11 21:49:00,61,116,Brinquedo,3,177
15711,2024-01-11 21:50:00,19,142,Eletrônico,6,161
15712,2024-01-11 21:51:00,96,171,Eletrônico,1,267
15713,2024-01-11 21:52:00,36,52,Eletrônico,8,88
15714,2024-01-11 21:53:00,119,47,Alimento,1,166
15715,2024-01-11 21:54:00,46,140,Móvel,3,186
15716,2024-01-11 21:55:00,53,18,Eletrônico,7,71
15717,2024-01-11 21:56:00,39,107,Brinquedo,4,146
15718,2024-01-11 21:57:00,115,17,Móvel,7,132
15719,2024-01-11 21:58:00,69,173,Móvel,8,242
15720,2024-01-11 21:59:00,105,175,Alimento,8,280
15721,2024-01-11 22:00:00,64,30,Alimento,8,94
15722,2024-01-11 22:01:00,20,88,Móvel,3,108
15723,2024-01-11 22:02:00,60,75,Vestuário,6,135
15724,2024-01-11 22:03:00,113,163,Móvel,4,276
15725,2024-01-11 22:04:00,109,95,Móvel,5,204
15726,2024-01-11 22:05:00,30,75,Eletrônico,9,105
15727,2024-01-11 22:06:00,60,117,Vestuário,7,177
15728,2024-01-11 22:07:00,74,151,Alimento,6,225
15729,2024-01-11 22:08:00,17,98,Brinquedo,8,115
15730,2024-01-11 22:09:00,77,96,Móvel,1,173
15731,2024-01-11 22:10:00,30,131,Brinquedo,3,161
15732,2024-01-11 22:11:00,48,140,Vestuário,9,188
15733,2024-01-11 22:12:00,119,81,Eletrônico,8,200
15734,2024-01-11 22:13:00,113,75,Vestuário,5,188
15735,2024-01-11 22:14:00,92,123,Brinquedo,4,215
15736,2024-01-11 22:15:00,35,165,Móvel,9,200
15737,2024-01-11 22:16:00,108,35,Vestuário,5,143
15738,2024-01-11 22:17:00,101,89,Eletrônico,6,190
15739,2024-01-11 22:18:00,92,89,Móvel,9,181
15740,2024-01-11 22:19:00,67,161,Alimento,2,228
15741,2024-01-11 22:20:00,75,92,Alimento,1,167
15742,2024-01-11 22:21:00,65,162,Alimento,7,227
15743,2024-01-11 22:22:00,21,130,Eletrônico,3,151
15744,2024-01-11 22:23:00,47,128,Eletrônico,1,175
15745,2024-01-11 22:24:00,28,156,Alimento,3,184
15746,2024-01-11 22:25:00,41,107,Brinquedo,9,148
15747,2024-01-11 22:26:00,10,76,Alimento,7,86
15748,2024-01-11 22:27:00,21,113,Móvel,8,134
15749,2024-01-11 22:28:00,39,110,Móvel,8,149
15750,2024-01-11 22:29:00,101,31,Alimento,2,132
15751,2024-01-11 22:30:00,101,57,Alimento,1,158
15752,2024-01-11 22:31:00,97,140,Brinquedo,8,237
15753,2024-01-11 22:32:00,114,55,Brinquedo,2,169
15754,2024-01-11 22:33:00,45,15,Alimento,7,60
15755,2024-01-11 22:34:00,68,81,Brinquedo,5,149
15756,2024-01-11 22:35:00,57,110,Brinquedo,3,167
15757,2024-01-11 22:36:00,15,87,Brinquedo,4,102
15758,2024-01-11 22:37:00,36,120,Eletrônico,6,156
15759,2024-01-11 22:38:00,67,136,Eletrônico,4,203
15760,2024-01-11 22:39:00,28,13,Vestuário,8,41
15761,2024-01-11 22:40:00,22,91,Eletrônico,7,113
15762,2024-01-11 22:41:00,78,64,Brinquedo,9,142
15763,2024-01-11 22:42:00,78,152,Móvel,1,230
15764,2024-01-11 22:43:00,91,95,Móvel,8,186
15765,2024-01-11 22:44:00,22,40,Brinquedo,1,62
15766,2024-01-11 22:45:00,118,65,Brinquedo,7,183
15767,2024-01-11 22:46:00,20,85,Alimento,4,105
15768,2024-01-11 22:47:00,85,28,Móvel,3,113
15769,2024-01-11 22:48:00,79,62,Alimento,6,141
15770,2024-01-11 22:49:00,48,41,Móvel,1,89
15771,2024-01-11 22:50:00,69,98,Brinquedo,2,167
15772,2024-01-11 22:51:00,61,89,Vestuário,8,150
15773,2024-01-11 22:52:00,76,37,Eletrônico,7,113
15774,2024-01-11 22:53:00,79,174,Vestuário,2,253
15775,2024-01-11 22:54:00,29,119,Móvel,8,148
15776,2024-01-11 22:55:00,34,123,Vestuário,4,157
15777,2024-01-11 22:56:00,48,89,Eletrônico,3,137
15778,2024-01-11 22:57:00,42,160,Móvel,2,202
15779,2024-01-11 22:58:00,34,30,Móvel,8,64
15780,2024-01-11 22:59:00,95,46,Alimento,6,141
15781,2024-01-11 23:00:00,77,13,Alimento,9,90
15782,2024-01-11 23:01:00,82,175,Brinquedo,2,257
15783,2024-01-11 23:02:00,77,15,Brinquedo,8,92
15784,2024-01-11 23:03:00,52,69,Brinquedo,6,121
15785,2024-01-11 23:04:00,28,129,Brinquedo,7,157
15786,2024-01-11 23:05:00,55,98,Móvel,2,153
15787,2024-01-11 23:06:00,50,53,Alimento,6,103
15788,2024-01-11 23:07:00,71,163,Eletrônico,7,234
15789,2024-01-11 23:08:00,116,92,Alimento,8,208
15790,2024-01-11 23:09:00,96,118,Eletrônico,5,214
15791,2024-01-11 23:10:00,116,19,Eletrônico,7,135
15792,2024-01-11 23:11:00,33,11,Alimento,6,44
15793,2024-01-11 23:12:00,60,145,Alimento,9,205
15794,2024-01-11 23:13:00,68,177,Móvel,3,245
15795,2024-01-11 23:14:00,99,94,Brinquedo,4,193
15796,2024-01-11 23:15:00,82,15,Brinquedo,4,97
15797,2024-01-11 23:16:00,74,91,Vestuário,2,165
15798,2024-01-11 23:17:00,35,55,Eletrônico,8,90
15799,2024-01-11 23:18:00,84,108,Alimento,1,192
15800,2024-01-11 23:19:00,103,51,Eletrônico,6,154
15801,2024-01-11 23:20:00,61,24,Móvel,3,85
15802,2024-01-11 23:21:00,59,32,Alimento,4,91
15803,2024-01-11 23:22:00,112,127,Alimento,4,239
15804,2024-01-11 23:23:00,27,175,Móvel,2,202
15805,2024-01-11 23:24:00,70,141,Vestuário,4,211
15806,2024-01-11 23:25:00,103,92,Vestuário,5,195
15807,2024-01-11 23:26:00,59,144,Brinquedo,2,203
15808,2024-01-11 23:27:00,92,138,Vestuário,7,230
15809,2024-01-11 23:28:00,103,119,Eletrônico,6,222
15810,2024-01-11 23:29:00,83,115,Vestuário,6,198
15811,2024-01-11 23:30:00,68,65,Móvel,5,133
15812,2024-01-11 23:31:00,86,100,Vestuário,2,186
15813,2024-01-11 23:32:00,98,158,Vestuário,6,256
15814,2024-01-11 23:33:00,77,163,Eletrônico,7,240
15815,2024-01-11 23:34:00,19,150,Brinquedo,8,169
15816,2024-01-11 23:35:00,93,140,Eletrônico,5,233
15817,2024-01-11 23:36:00,20,85,Alimento,2,105
15818,2024-01-11 23:37:00,45,25,Alimento,6,70
15819,2024-01-11 23:38:00,30,26,Vestuário,6,56
15820,2024-01-11 23:39:00,52,160,Brinquedo,6,212
15821,2024-01-11 23:40:00,14,102,Brinquedo,4,116
15822,2024-01-11 23:41:00,52,115,Eletrônico,6,167
15823,2024-01-11 23:42:00,102,146,Brinquedo,5,248
15824,2024-01-11 23:43:00,76,26,Móvel,3,102
15825,2024-01-11 23:44:00,115,144,Brinquedo,2,259
15826,2024-01-11 23:45:00,89,10,Brinquedo,9,99
15827,2024-01-11 23:46:00,103,35,Eletrônico,5,138
15828,2024-01-11 23:47:00,46,129,Móvel,4,175
15829,2024-01-11 23:48:00,93,166,Móvel,2,259
15830,2024-01-11 23:49:00,61,163,Vestuário,3,224
15831,2024-01-11 23:50:00,82,65,Vestuário,5,147
15832,2024-01-11 23:51:00,108,169,Móvel,5,277
15833,2024-01-11 23:52:00,56,37,Alimento,6,93
15834,2024-01-11 23:53:00,74,31,Brinquedo,9,105
15835,2024-01-11 23:54:00,87,158,Alimento,4,245
15836,2024-01-11 23:55:00,51,84,Alimento,9,135
15837,2024-01-11 23:56:00,11,163,Vestuário,5,174
15838,2024-01-11 23:57:00,107,10,Vestuário,6,117
15839,2024-01-11 23:58:00,111,134,Brinquedo,2,245
15840,2024-01-11 23:59:00,55,136,Vestuário,5,191
15841,2024-01-12 00:00:00,37,81,Brinquedo,1,118
15842,2024-01-12 00:01:00,83,147,Vestuário,8,230
15843,2024-01-12 00:02:00,118,47,Eletrônico,4,165
15844,2024-01-12 00:03:00,41,68,Alimento,8,109
15845,2024-01-12 00:04:00,84,81,Brinquedo,9,165
15846,2024-01-12 00:05:00,29,174,Móvel,2,203
15847,2024-01-12 00:06:00,116,105,Móvel,3,221
15848,2024-01-12 00:07:00,30,140,Móvel,4,170
15849,2024-01-12 00:08:00,91,12,Brinquedo,9,103
15850,2024-01-12 00:09:00,45,51,Vestuário,7,96
15851,2024-01-12 00:10:00,56,11,Brinquedo,9,67
15852,2024-01-12 00:11:00,57,65,Móvel,5,122
15853,2024-01-12 00:12:00,113,155,Móvel,8,268
15854,2024-01-12 00:13:00,113,101,Vestuário,4,214
15855,2024-01-12 00:14:00,79,40,Brinquedo,7,119
15856,2024-01-12 00:15:00,118,10,Alimento,8,128
15857,2024-01-12 00:16:00,66,107,Móvel,6,173
15858,2024-01-12 00:17:00,56,161,Móvel,7,217
15859,2024-01-12 00:18:00,48,82,Brinquedo,1,130
15860,2024-01-12 00:19:00,116,136,Móvel,5,252
15861,2024-01-12 00:20:00,111,132,Móvel,3,243
15862,2024-01-12 00:21:00,60,175,Móvel,6,235
15863,2024-01-12 00:22:00,35,166,Alimento,9,201
15864,2024-01-12 00:23:00,51,113,Eletrônico,5,164
15865,2024-01-12 00:24:00,98,119,Vestuário,8,217
15866,2024-01-12 00:25:00,107,44,Brinquedo,3,151
15867,2024-01-12 00:26:00,56,101,Eletrônico,4,157
15868,2024-01-12 00:27:00,64,179,Móvel,8,243
15869,2024-01-12 00:28:00,83,57,Vestuário,2,140
15870,2024-01-12 00:29:00,106,35,Vestuário,4,141
15871,2024-01-12 00:30:00,49,56,Móvel,7,105
15872,2024-01-12 00:31:00,41,143,Brinquedo,1,184
15873,2024-01-12 00:32:00,36,179,Eletrônico,1,215
15874,2024-01-12 00:33:00,91,65,Vestuário,7,156
15875,2024-01-12 00:34:00,38,78,Vestuário,6,116
15876,2024-01-12 00:35:00,19,24,Eletrônico,1,43
15877,2024-01-12 00:36:00,58,34,Brinquedo,2,92
15878,2024-01-12 00:37:00,76,165,Alimento,7,241
15879,2024-01-12 00:38:00,48,179,Vestuário,1,227
15880,2024-01-12 00:39:00,20,127,Eletrônico,5,147
15881,2024-01-12 00:40:00,51,86,Vestuário,9,137
15882,2024-01-12 00:41:00,78,96,Eletrônico,7,174
15883,2024-01-12 00:42:00,69,169,Móvel,7,238
15884,2024-01-12 00:43:00,90,169,Móvel,2,259
15885,2024-01-12 00:44:00,75,111,Vestuário,3,186
15886,2024-01-12 00:45:00,97,170,Móvel,1,267
15887,2024-01-12 00:46:00,57,59,Eletrônico,7,116
15888,2024-01-12 00:47:00,41,39,Alimento,6,80
15889,2024-01-12 00:48:00,17,136,Brinquedo,6,153
15890,2024-01-12 00:49:00,81,85,Brinquedo,3,166
15891,2024-01-12 00:50:00,80,167,Alimento,5,247
15892,2024-01-12 00:51:00,109,166,Brinquedo,7,275
15893,2024-01-12 00:52:00,105,19,Vestuário,7,124
15894,2024-01-12 00:53:00,34,99,Brinquedo,7,133
15895,2024-01-12 00:54:00,109,45,Brinquedo,1,154
15896,2024-01-12 00:55:00,118,92,Móvel,5,210
15897,2024-01-12 00:56:00,96,172,Eletrônico,2,268
15898,2024-01-12 00:57:00,81,99,Brinquedo,1,180
15899,2024-01-12 00:58:00,51,154,Eletrônico,9,205
15900,2024-01-12 00:59:00,36,71,Eletrônico,4,107
15901,2024-01-12 01:00:00,48,156,Vestuário,4,204
15902,2024-01-12 01:01:00,94,23,Brinquedo,3,117
15903,2024-01-12 01:02:00,38,174,Vestuário,5,212
15904,2024-01-12 01:03:00,37,102,Eletrônico,7,139
15905,2024-01-12 01:04:00,87,32,Vestuário,4,119
15906,2024-01-12 01:05:00,113,39,Brinquedo,5,152
15907,2024-01-12 01:06:00,33,141,Brinquedo,1,174
15908,2024-01-12 01:07:00,11,130,Vestuário,9,141
15909,2024-01-12 01:08:00,75,154,Móvel,9,229
15910,2024-01-12 01:09:00,108,99,Vestuário,2,207
15911,2024-01-12 01:10:00,110,20,Brinquedo,8,130
15912,2024-01-12 01:11:00,42,85,Vestuário,3,127
15913,2024-01-12 01:12:00,110,127,Vestuário,3,237
15914,2024-01-12 01:13:00,32,105,Móvel,3,137
15915,2024-01-12 01:14:00,111,143,Brinquedo,2,254
15916,2024-01-12 01:15:00,80,97,Eletrônico,4,177
15917,2024-01-12 01:16:00,46,110,Alimento,5,156
15918,2024-01-12 01:17:00,85,26,Vestuário,2,111
15919,2024-01-12 01:18:00,34,32,Brinquedo,2,66
15920,2024-01-12 01:19:00,111,97,Alimento,4,208
15921,2024-01-12 01:20:00,104,99,Alimento,2,203
15922,2024-01-12 01:21:00,38,91,Móvel,7,129
15923,2024-01-12 01:22:00,91,122,Brinquedo,4,213
15924,2024-01-12 01:23:00,38,149,Vestuário,7,187
15925,2024-01-12 01:24:00,101,156,Móvel,2,257
15926,2024-01-12 01:25:00,100,75,Móvel,5,175
15927,2024-01-12 01:26:00,102,52,Brinquedo,5,154
15928,2024-01-12 01:27:00,49,177,Alimento,1,226
15929,2024-01-12 01:28:00,38,78,Móvel,2,116
15930,2024-01-12 01:29:00,67,97,Eletrônico,9,164
15931,2024-01-12 01:30:00,102,80,Eletrônico,6,182
15932,2024-01-12 01:31:00,73,72,Alimento,4,145
15933,2024-01-12 01:32:00,80,31,Alimento,3,111
15934,2024-01-12 01:33:00,90,72,Brinquedo,6,162
15935,2024-01-12 01:34:00,16,83,Brinquedo,2,99
15936,2024-01-12 01:35:00,118,64,Alimento,2,182
15937,2024-01-12 01:36:00,33,11,Vestuário,6,44
15938,2024-01-12 01:37:00,19,49,Alimento,6,68
15939,2024-01-12 01:38:00,34,34,Móvel,7,68
15940,2024-01-12 01:39:00,104,71,Alimento,3,175
15941,2024-01-12 01:40:00,76,112,Brinquedo,9,188
15942,2024-01-12 01:41:00,21,97,Móvel,7,118
15943,2024-01-12 01:42:00,23,104,Vestuário,7,127
15944,2024-01-12 01:43:00,72,134,Alimento,2,206
15945,2024-01-12 01:44:00,58,91,Vestuário,8,149
15946,2024-01-12 01:45:00,16,124,Vestuário,1,140
15947,2024-01-12 01:46:00,81,100,Brinquedo,8,181
15948,2024-01-12 01:47:00,116,118,Eletrônico,4,234
15949,2024-01-12 01:48:00,49,97,Móvel,5,146
15950,2024-01-12 01:49:00,119,60,Eletrônico,9,179
15951,2024-01-12 01:50:00,27,129,Alimento,3,156
15952,2024-01-12 01:51:00,86,89,Eletrônico,2,175
15953,2024-01-12 01:52:00,86,155,Móvel,9,241
15954,2024-01-12 01:53:00,118,169,Eletrônico,1,287
15955,2024-01-12 01:54:00,70,53,Alimento,9,123
15956,2024-01-12 01:55:00,60,156,Vestuário,9,216
15957,2024-01-12 01:56:00,91,39,Alimento,2,130
15958,2024-01-12 01:57:00,42,178,Eletrônico,3,220
15959,2024-01-12 01:58:00,81,66,Alimento,9,147
15960,2024-01-12 01:59:00,111,156,Vestuário,8,267
15961,2024-01-12 02:00:00,78,108,Alimento,3,186
15962,2024-01-12 02:01:00,73,141,Vestuário,1,214
15963,2024-01-12 02:02:00,84,35,Brinquedo,9,119
15964,2024-01-12 02:03:00,117,119,Vestuário,8,236
15965,2024-01-12 02:04:00,23,142,Brinquedo,1,165
15966,2024-01-12 02:05:00,78,103,Brinquedo,2,181
15967,2024-01-12 02:06:00,110,17,Móvel,2,127
15968,2024-01-12 02:07:00,31,17,Brinquedo,8,48
15969,2024-01-12 02:08:00,79,70,Eletrônico,8,149
15970,2024-01-12 02:09:00,116,27,Brinquedo,3,143
15971,2024-01-12 02:10:00,91,52,Alimento,5,143
15972,2024-01-12 02:11:00,92,149,Brinquedo,2,241
15973,2024-01-12 02:12:00,13,44,Móvel,1,57
15974,2024-01-12 02:13:00,91,44,Eletrônico,7,135
15975,2024-01-12 02:14:00,114,140,Vestuário,8,254
15976,2024-01-12 02:15:00,102,117,Alimento,8,219
15977,2024-01-12 02:16:00,35,76,Brinquedo,3,111
15978,2024-01-12 02:17:00,88,22,Brinquedo,7,110
15979,2024-01-12 02:18:00,108,100,Móvel,5,208
15980,2024-01-12 02:19:00,53,90,Eletrônico,9,143
15981,2024-01-12 02:20:00,32,81,Vestuário,2,113
15982,2024-01-12 02:21:00,98,32,Eletrônico,4,130
15983,2024-01-12 02:22:00,29,179,Alimento,1,208
15984,2024-01-12 02:23:00,46,28,Brinquedo,1,74
15985,2024-01-12 02:24:00,11,173,Vestuário,2,184
15986,2024-01-12 02:25:00,65,147,Alimento,6,212
15987,2024-01-12 02:26:00,17,145,Brinquedo,6,162
15988,2024-01-12 02:27:00,27,58,Alimento,9,85
15989,2024-01-12 02:28:00,47,126,Vestuário,6,173
15990,2024-01-12 02:29:00,115,55,Móvel,4,170
15991,2024-01-12 02:30:00,22,100,Eletrônico,3,122
15992,2024-01-12 02:31:00,14,18,Brinquedo,7,32
15993,2024-01-12 02:32:00,99,113,Eletrônico,8,212
15994,2024-01-12 02:33:00,35,108,Eletrônico,6,143
15995,2024-01-12 02:34:00,63,25,Vestuário,3,88
15996,2024-01-12 02:35:00,55,73,Eletrônico,4,128
15997,2024-01-12 02:36:00,76,166,Brinquedo,5,242
15998,2024-01-12 02:37:00,63,56,Alimento,6,119
15999,2024-01-12 02:38:00,29,118,Eletrônico,1,147
16000,2024-01-12 02:39:00,40,63,Brinquedo,6,103
16001,2024-01-12 02:40:00,107,134,Eletrônico,8,241
16002,2024-01-12 02:41:00,116,83,Móvel,1,199
16003,2024-01-12 02:42:00,43,77,Móvel,5,120
16004,2024-01-12 02:43:00,59,164,Eletrônico,6,223
16005,2024-01-12 02:44:00,71,68,Brinquedo,2,139
16006,2024-01-12 02:45:00,47,127,Brinquedo,9,174
16007,2024-01-12 02:46:00,30,168,Alimento,6,198
16008,2024-01-12 02:47:00,28,17,Móvel,7,45
16009,2024-01-12 02:48:00,43,50,Móvel,5,93
16010,2024-01-12 02:49:00,75,31,Móvel,7,106
16011,2024-01-12 02:50:00,11,128,Eletrônico,6,139
16012,2024-01-12 02:51:00,45,123,Alimento,8,168
16013,2024-01-12 02:52:00,23,128,Eletrônico,6,151
16014,2024-01-12 02:53:00,85,162,Vestuário,2,247
16015,2024-01-12 02:54:00,105,109,Brinquedo,3,214
16016,2024-01-12 02:55:00,90,39,Móvel,6,129
16017,2024-01-12 02:56:00,39,113,Eletrônico,7,152
16018,2024-01-12 02:57:00,56,16,Brinquedo,3,72
16019,2024-01-12 02:58:00,105,93,Vestuário,3,198
16020,2024-01-12 02:59:00,18,80,Alimento,6,98
16021,2024-01-12 03:00:00,23,143,Brinquedo,4,166
16022,2024-01-12 03:01:00,31,16,Móvel,2,47
16023,2024-01-12 03:02:00,32,137,Vestuário,5,169
16024,2024-01-12 03:03:00,67,68,Brinquedo,3,135
16025,2024-01-12 03:04:00,21,115,Móvel,8,136
16026,2024-01-12 03:05:00,66,102,Brinquedo,9,168
16027,2024-01-12 03:06:00,106,147,Vestuário,7,253
16028,2024-01-12 03:07:00,102,39,Móvel,4,141
16029,2024-01-12 03:08:00,115,162,Móvel,1,277
16030,2024-01-12 03:09:00,38,154,Vestuário,3,192
16031,2024-01-12 03:10:00,81,47,Vestuário,3,128
16032,2024-01-12 03:11:00,87,66,Alimento,5,153
16033,2024-01-12 03:12:00,86,163,Alimento,8,249
16034,2024-01-12 03:13:00,97,69,Alimento,6,166
16035,2024-01-12 03:14:00,49,135,Vestuário,8,184
16036,2024-01-12 03:15:00,35,94,Móvel,5,129
16037,2024-01-12 03:16:00,35,48,Móvel,6,83
16038,2024-01-12 03:17:00,70,161,Móvel,1,231
16039,2024-01-12 03:18:00,109,24,Brinquedo,5,133
16040,2024-01-12 03:19:00,52,101,Alimento,2,153
16041,2024-01-12 03:20:00,100,56,Brinquedo,4,156
16042,2024-01-12 03:21:00,18,37,Móvel,7,55
16043,2024-01-12 03:22:00,86,34,Alimento,5,120
16044,2024-01-12 03:23:00,11,32,Alimento,2,43
16045,2024-01-12 03:24:00,58,145,Móvel,3,203
16046,2024-01-12 03:25:00,81,33,Brinquedo,1,114
16047,2024-01-12 03:26:00,54,136,Móvel,2,190
16048,2024-01-12 03:27:00,48,104,Brinquedo,4,152
16049,2024-01-12 03:28:00,33,21,Alimento,7,54
16050,2024-01-12 03:29:00,17,102,Vestuário,7,119
16051,2024-01-12 03:30:00,74,158,Móvel,7,232
16052,2024-01-12 03:31:00,16,179,Eletrônico,8,195
16053,2024-01-12 03:32:00,118,39,Brinquedo,8,157
16054,2024-01-12 03:33:00,102,134,Eletrônico,9,236
16055,2024-01-12 03:34:00,68,158,Eletrônico,6,226
16056,2024-01-12 03:35:00,60,23,Móvel,5,83
16057,2024-01-12 03:36:00,24,36,Móvel,9,60
16058,2024-01-12 03:37:00,46,110,Móvel,5,156
16059,2024-01-12 03:38:00,102,168,Vestuário,9,270
16060,2024-01-12 03:39:00,60,138,Eletrônico,7,198
16061,2024-01-12 03:40:00,21,139,Alimento,3,160
16062,2024-01-12 03:41:00,80,99,Brinquedo,2,179
16063,2024-01-12 03:42:00,74,12,Móvel,7,86
16064,2024-01-12 03:43:00,74,11,Móvel,1,85
16065,2024-01-12 03:44:00,93,11,Eletrônico,4,104
16066,2024-01-12 03:45:00,74,135,Eletrônico,4,209
16067,2024-01-12 03:46:00,58,38,Brinquedo,5,96
16068,2024-01-12 03:47:00,35,40,Brinquedo,4,75
16069,2024-01-12 03:48:00,102,40,Vestuário,6,142
16070,2024-01-12 03:49:00,86,139,Vestuário,6,225
16071,2024-01-12 03:50:00,49,77,Vestuário,3,126
16072,2024-01-12 03:51:00,56,94,Eletrônico,7,150
16073,2024-01-12 03:52:00,33,74,Eletrônico,5,107
16074,2024-01-12 03:53:00,110,159,Eletrônico,5,269
16075,2024-01-12 03:54:00,112,80,Eletrônico,8,192
16076,2024-01-12 03:55:00,49,102,Brinquedo,2,151
16077,2024-01-12 03:56:00,101,179,Alimento,9,280
16078,2024-01-12 03:57:00,113,171,Vestuário,7,284
16079,2024-01-12 03:58:00,109,48,Móvel,4,157
16080,2024-01-12 03:59:00,86,25,Brinquedo,2,111
16081,2024-01-12 04:00:00,13,43,Alimento,1,56
16082,2024-01-12 04:01:00,31,130,Eletrônico,1,161
16083,2024-01-12 04:02:00,103,179,Móvel,4,282
16084,2024-01-12 04:03:00,89,124,Eletrônico,5,213
16085,2024-01-12 04:04:00,95,72,Brinquedo,6,167
16086,2024-01-12 04:05:00,39,93,Eletrônico,3,132
16087,2024-01-12 04:06:00,101,85,Móvel,4,186
16088,2024-01-12 04:07:00,93,86,Eletrônico,4,179
16089,2024-01-12 04:08:00,37,173,Eletrônico,3,210
16090,2024-01-12 04:09:00,78,95,Brinquedo,6,173
16091,2024-01-12 04:10:00,46,34,Alimento,1,80
16092,2024-01-12 04:11:00,86,155,Brinquedo,5,241
16093,2024-01-12 04:12:00,19,89,Móvel,9,108
16094,2024-01-12 04:13:00,114,116,Brinquedo,1,230
16095,2024-01-12 04:14:00,117,67,Alimento,9,184
16096,2024-01-12 04:15:00,58,56,Vestuário,7,114
16097,2024-01-12 04:16:00,45,31,Eletrônico,1,76
16098,2024-01-12 04:17:00,80,123,Móvel,8,203
16099,2024-01-12 04:18:00,48,34,Alimento,6,82
16100,2024-01-12 04:19:00,57,10,Brinquedo,6,67
16101,2024-01-12 04:20:00,43,92,Brinquedo,5,135
16102,2024-01-12 04:21:00,98,129,Móvel,2,227
16103,2024-01-12 04:22:00,63,156,Eletrônico,2,219
16104,2024-01-12 04:23:00,45,86,Móvel,4,131
16105,2024-01-12 04:24:00,76,143,Alimento,7,219
16106,2024-01-12 04:25:00,99,99,Eletrônico,3,198
16107,2024-01-12 04:26:00,58,150,Alimento,7,208
16108,2024-01-12 04:27:00,64,141,Alimento,8,205
16109,2024-01-12 04:28:00,116,129,Brinquedo,2,245
16110,2024-01-12 04:29:00,36,125,Eletrônico,8,161
16111,2024-01-12 04:30:00,85,133,Eletrônico,3,218
16112,2024-01-12 04:31:00,98,127,Brinquedo,5,225
16113,2024-01-12 04:32:00,116,146,Eletrônico,7,262
16114,2024-01-12 04:33:00,86,26,Brinquedo,1,112
16115,2024-01-12 04:34:00,96,80,Alimento,3,176
16116,2024-01-12 04:35:00,86,107,Eletrônico,5,193
16117,2024-01-12 04:36:00,41,110,Vestuário,6,151
16118,2024-01-12 04:37:00,100,146,Vestuário,6,246
16119,2024-01-12 04:38:00,119,62,Brinquedo,7,181
16120,2024-01-12 04:39:00,106,97,Móvel,9,203
16121,2024-01-12 04:40:00,109,24,Móvel,5,133
16122,2024-01-12 04:41:00,62,64,Brinquedo,1,126
16123,2024-01-12 04:42:00,70,140,Brinquedo,3,210
16124,2024-01-12 04:43:00,94,138,Brinquedo,6,232
16125,2024-01-12 04:44:00,30,80,Móvel,2,110
16126,2024-01-12 04:45:00,35,137,Eletrônico,9,172
16127,2024-01-12 04:46:00,85,82,Brinquedo,6,167
16128,2024-01-12 04:47:00,74,150,Móvel,9,224
16129,2024-01-12 04:48:00,44,44,Móvel,9,88
16130,2024-01-12 04:49:00,48,47,Alimento,1,95
16131,2024-01-12 04:50:00,29,118,Brinquedo,7,147
16132,2024-01-12 04:51:00,73,95,Eletrônico,7,168
16133,2024-01-12 04:52:00,43,43,Móvel,5,86
16134,2024-01-12 04:53:00,47,97,Móvel,2,144
16135,2024-01-12 04:54:00,96,63,Móvel,5,159
16136,2024-01-12 04:55:00,97,178,Alimento,4,275
16137,2024-01-12 04:56:00,29,103,Eletrônico,9,132
16138,2024-01-12 04:57:00,35,30,Eletrônico,7,65
16139,2024-01-12 04:58:00,95,15,Vestuário,9,110
16140,2024-01-12 04:59:00,55,52,Vestuário,4,107
16141,2024-01-12 05:00:00,14,79,Brinquedo,8,93
16142,2024-01-12 05:01:00,13,37,Vestuário,7,50
16143,2024-01-12 05:02:00,110,14,Vestuário,3,124
16144,2024-01-12 05:03:00,56,167,Eletrônico,5,223
16145,2024-01-12 05:04:00,33,49,Alimento,2,82
16146,2024-01-12 05:05:00,96,132,Brinquedo,5,228
16147,2024-01-12 05:06:00,10,135,Móvel,3,145
16148,2024-01-12 05:07:00,42,101,Móvel,8,143
16149,2024-01-12 05:08:00,23,46,Alimento,3,69
16150,2024-01-12 05:09:00,19,64,Vestuário,6,83
16151,2024-01-12 05:10:00,42,85,Móvel,6,127
16152,2024-01-12 05:11:00,76,16,Alimento,4,92
16153,2024-01-12 05:12:00,24,139,Vestuário,4,163
16154,2024-01-12 05:13:00,94,99,Móvel,2,193
16155,2024-01-12 05:14:00,66,126,Alimento,3,192
16156,2024-01-12 05:15:00,116,45,Alimento,3,161
16157,2024-01-12 05:16:00,41,89,Vestuário,9,130
16158,2024-01-12 05:17:00,32,70,Brinquedo,2,102
16159,2024-01-12 05:18:00,46,58,Móvel,5,104
16160,2024-01-12 05:19:00,52,89,Brinquedo,8,141
16161,2024-01-12 05:20:00,90,117,Brinquedo,7,207
16162,2024-01-12 05:21:00,74,100,Brinquedo,5,174
16163,2024-01-12 05:22:00,38,175,Eletrônico,5,213
16164,2024-01-12 05:23:00,99,168,Alimento,5,267
16165,2024-01-12 05:24:00,114,92,Móvel,1,206
16166,2024-01-12 05:25:00,83,105,Móvel,5,188
16167,2024-01-12 05:26:00,92,19,Móvel,7,111
16168,2024-01-12 05:27:00,84,40,Móvel,3,124
16169,2024-01-12 05:28:00,57,35,Brinquedo,2,92
16170,2024-01-12 05:29:00,89,162,Móvel,3,251
16171,2024-01-12 05:30:00,110,90,Móvel,5,200
16172,2024-01-12 05:31:00,90,163,Eletrônico,5,253
16173,2024-01-12 05:32:00,67,13,Brinquedo,3,80
16174,2024-01-12 05:33:00,118,86,Vestuário,1,204
16175,2024-01-12 05:34:00,75,142,Móvel,7,217
16176,2024-01-12 05:35:00,22,113,Brinquedo,5,135
16177,2024-01-12 05:36:00,82,82,Móvel,2,164
16178,2024-01-12 05:37:00,27,174,Eletrônico,5,201
16179,2024-01-12 05:38:00,19,97,Eletrônico,8,116
16180,2024-01-12 05:39:00,81,10,Brinquedo,8,91
16181,2024-01-12 05:40:00,83,81,Brinquedo,4,164
16182,2024-01-12 05:41:00,36,169,Brinquedo,7,205
16183,2024-01-12 05:42:00,91,90,Alimento,9,181
16184,2024-01-12 05:43:00,82,104,Alimento,5,186
16185,2024-01-12 05:44:00,16,112,Eletrônico,6,128
16186,2024-01-12 05:45:00,56,105,Eletrônico,7,161
16187,2024-01-12 05:46:00,68,145,Alimento,2,213
16188,2024-01-12 05:47:00,17,53,Móvel,8,70
16189,2024-01-12 05:48:00,31,75,Vestuário,5,106
16190,2024-01-12 05:49:00,66,56,Móvel,9,122
16191,2024-01-12 05:50:00,51,107,Eletrônico,3,158
16192,2024-01-12 05:51:00,91,103,Eletrônico,8,194
16193,2024-01-12 05:52:00,60,56,Vestuário,3,116
16194,2024-01-12 05:53:00,11,35,Brinquedo,1,46
16195,2024-01-12 05:54:00,116,88,Brinquedo,2,204
16196,2024-01-12 05:55:00,23,174,Eletrônico,2,197
16197,2024-01-12 05:56:00,117,29,Móvel,4,146
16198,2024-01-12 05:57:00,65,128,Vestuário,8,193
16199,2024-01-12 05:58:00,27,68,Brinquedo,5,95
16200,2024-01-12 05:59:00,93,19,Móvel,7,112
16201,2024-01-12 06:00:00,10,13,Alimento,2,23
16202,2024-01-12 06:01:00,94,173,Brinquedo,8,267
16203,2024-01-12 06:02:00,33,160,Alimento,7,193
16204,2024-01-12 06:03:00,36,96,Vestuário,3,132
16205,2024-01-12 06:04:00,10,74,Eletrônico,2,84
16206,2024-01-12 06:05:00,89,152,Móvel,4,241
16207,2024-01-12 06:06:00,117,103,Móvel,4,220
16208,2024-01-12 06:07:00,13,58,Brinquedo,4,71
16209,2024-01-12 06:08:00,11,152,Vestuário,5,163
16210,2024-01-12 06:09:00,20,91,Vestuário,5,111
16211,2024-01-12 06:10:00,113,77,Eletrônico,1,190
16212,2024-01-12 06:11:00,111,49,Alimento,8,160
16213,2024-01-12 06:12:00,85,149,Vestuário,1,234
16214,2024-01-12 06:13:00,56,85,Vestuário,9,141
16215,2024-01-12 06:14:00,82,122,Brinquedo,5,204
16216,2024-01-12 06:15:00,41,119,Alimento,1,160
16217,2024-01-12 06:16:00,26,41,Brinquedo,5,67
16218,2024-01-12 06:17:00,83,99,Alimento,2,182
16219,2024-01-12 06:18:00,33,54,Móvel,8,87
16220,2024-01-12 06:19:00,52,163,Alimento,6,215
16221,2024-01-12 06:20:00,90,81,Vestuário,1,171
16222,2024-01-12 06:21:00,109,98,Eletrônico,3,207
16223,2024-01-12 06:22:00,105,34,Alimento,7,139
16224,2024-01-12 06:23:00,109,172,Móvel,7,281
16225,2024-01-12 06:24:00,70,54,Brinquedo,4,124
16226,2024-01-12 06:25:00,16,65,Brinquedo,1,81
16227,2024-01-12 06:26:00,83,38,Móvel,3,121
16228,2024-01-12 06:27:00,117,151,Brinquedo,3,268
16229,2024-01-12 06:28:00,97,169,Brinquedo,6,266
16230,2024-01-12 06:29:00,97,154,Móvel,8,251
16231,2024-01-12 06:30:00,78,85,Móvel,9,163
16232,2024-01-12 06:31:00,117,59,Brinquedo,8,176
16233,2024-01-12 06:32:00,41,54,Vestuário,3,95
16234,2024-01-12 06:33:00,33,55,Vestuário,6,88
16235,2024-01-12 06:34:00,73,162,Eletrônico,3,235
16236,2024-01-12 06:35:00,47,46,Móvel,7,93
16237,2024-01-12 06:36:00,60,16,Brinquedo,6,76
16238,2024-01-12 06:37:00,111,151,Vestuário,9,262
16239,2024-01-12 06:38:00,13,64,Eletrônico,1,77
16240,2024-01-12 06:39:00,50,46,Vestuário,4,96
16241,2024-01-12 06:40:00,119,108,Alimento,7,227
16242,2024-01-12 06:41:00,23,101,Móvel,8,124
16243,2024-01-12 06:42:00,62,147,Alimento,7,209
16244,2024-01-12 06:43:00,63,15,Alimento,3,78
16245,2024-01-12 06:44:00,20,61,Móvel,4,81
16246,2024-01-12 06:45:00,114,154,Eletrônico,1,268
16247,2024-01-12 06:46:00,26,56,Brinquedo,8,82
16248,2024-01-12 06:47:00,13,45,Alimento,6,58
16249,2024-01-12 06:48:00,13,83,Brinquedo,2,96
16250,2024-01-12 06:49:00,15,149,Vestuário,6,164
16251,2024-01-12 06:50:00,104,143,Móvel,2,247
16252,2024-01-12 06:51:00,34,103,Móvel,1,137
16253,2024-01-12 06:52:00,72,75,Alimento,4,147
16254,2024-01-12 06:53:00,112,142,Vestuário,9,254
16255,2024-01-12 06:54:00,22,13,Brinquedo,2,35
16256,2024-01-12 06:55:00,64,31,Vestuário,1,95
16257,2024-01-12 06:56:00,104,155,Móvel,7,259
16258,2024-01-12 06:57:00,37,164,Alimento,8,201
16259,2024-01-12 06:58:00,82,152,Eletrônico,2,234
16260,2024-01-12 06:59:00,111,78,Vestuário,9,189
16261,2024-01-12 07:00:00,43,88,Móvel,3,131
16262,2024-01-12 07:01:00,70,15,Móvel,5,85
16263,2024-01-12 07:02:00,33,19,Móvel,5,52
16264,2024-01-12 07:03:00,11,140,Alimento,2,151
16265,2024-01-12 07:04:00,51,93,Eletrônico,1,144
16266,2024-01-12 07:05:00,100,88,Vestuário,7,188
16267,2024-01-12 07:06:00,117,138,Eletrônico,2,255
16268,2024-01-12 07:07:00,29,44,Móvel,6,73
16269,2024-01-12 07:08:00,50,173,Brinquedo,9,223
16270,2024-01-12 07:09:00,92,102,Vestuário,5,194
16271,2024-01-12 07:10:00,111,21,Brinquedo,5,132
16272,2024-01-12 07:11:00,107,35,Móvel,3,142
16273,2024-01-12 07:12:00,108,73,Eletrônico,6,181
16274,2024-01-12 07:13:00,111,82,Móvel,6,193
16275,2024-01-12 07:14:00,53,170,Alimento,3,223
16276,2024-01-12 07:15:00,65,102,Alimento,4,167
16277,2024-01-12 07:16:00,103,167,Móvel,9,270
16278,2024-01-12 07:17:00,100,159,Móvel,7,259
16279,2024-01-12 07:18:00,45,122,Móvel,4,167
16280,2024-01-12 07:19:00,110,19,Móvel,3,129
16281,2024-01-12 07:20:00,50,67,Alimento,6,117
16282,2024-01-12 07:21:00,94,123,Vestuário,8,217
16283,2024-01-12 07:22:00,40,156,Eletrônico,6,196
16284,2024-01-12 07:23:00,88,138,Alimento,3,226
16285,2024-01-12 07:24:00,35,82,Móvel,4,117
16286,2024-01-12 07:25:00,76,23,Alimento,5,99
16287,2024-01-12 07:26:00,37,27,Móvel,1,64
16288,2024-01-12 07:27:00,118,101,Eletrônico,6,219
16289,2024-01-12 07:28:00,59,134,Eletrônico,8,193
16290,2024-01-12 07:29:00,77,79,Vestuário,8,156
16291,2024-01-12 07:30:00,53,156,Móvel,5,209
16292,2024-01-12 07:31:00,30,151,Alimento,6,181
16293,2024-01-12 07:32:00,109,24,Brinquedo,1,133
16294,2024-01-12 07:33:00,47,27,Móvel,2,74
16295,2024-01-12 07:34:00,52,89,Móvel,4,141
16296,2024-01-12 07:35:00,68,63,Brinquedo,4,131
16297,2024-01-12 07:36:00,110,159,Vestuário,1,269
16298,2024-01-12 07:37:00,46,138,Móvel,4,184
16299,2024-01-12 07:38:00,48,119,Brinquedo,2,167
16300,2024-01-12 07:39:00,12,178,Móvel,9,190
16301,2024-01-12 07:40:00,79,18,Móvel,5,97
16302,2024-01-12 07:41:00,111,161,Alimento,2,272
16303,2024-01-12 07:42:00,59,160,Brinquedo,6,219
16304,2024-01-12 07:43:00,78,124,Alimento,4,202
16305,2024-01-12 07:44:00,113,36,Alimento,2,149
16306,2024-01-12 07:45:00,49,61,Brinquedo,9,110
16307,2024-01-12 07:46:00,68,122,Eletrônico,6,190
16308,2024-01-12 07:47:00,30,49,Brinquedo,3,79
16309,2024-01-12 07:48:00,100,166,Alimento,7,266
16310,2024-01-12 07:49:00,118,166,Brinquedo,3,284
16311,2024-01-12 07:50:00,100,115,Móvel,6,215
16312,2024-01-12 07:51:00,51,40,Móvel,9,91
16313,2024-01-12 07:52:00,43,141,Móvel,7,184
16314,2024-01-12 07:53:00,81,134,Vestuário,3,215
16315,2024-01-12 07:54:00,86,134,Móvel,8,220
16316,2024-01-12 07:55:00,87,74,Alimento,1,161
16317,2024-01-12 07:56:00,83,101,Brinquedo,5,184
16318,2024-01-12 07:57:00,94,24,Eletrônico,1,118
16319,2024-01-12 07:58:00,62,52,Alimento,4,114
16320,2024-01-12 07:59:00,33,44,Vestuário,5,77
16321,2024-01-12 08:00:00,56,170,Alimento,8,226
16322,2024-01-12 08:01:00,60,77,Móvel,6,137
16323,2024-01-12 08:02:00,42,136,Vestuário,4,178
16324,2024-01-12 08:03:00,60,60,Brinquedo,4,120
16325,2024-01-12 08:04:00,20,80,Vestuário,9,100
16326,2024-01-12 08:05:00,36,91,Móvel,8,127
16327,2024-01-12 08:06:00,14,136,Brinquedo,5,150
16328,2024-01-12 08:07:00,99,47,Móvel,4,146
16329,2024-01-12 08:08:00,24,146,Eletrônico,4,170
16330,2024-01-12 08:09:00,86,19,Alimento,3,105
16331,2024-01-12 08:10:00,94,26,Eletrônico,7,120
16332,2024-01-12 08:11:00,64,137,Alimento,5,201
16333,2024-01-12 08:12:00,47,123,Móvel,3,170
16334,2024-01-12 08:13:00,45,94,Brinquedo,7,139
16335,2024-01-12 08:14:00,48,51,Eletrônico,3,99
16336,2024-01-12 08:15:00,89,130,Móvel,6,219
16337,2024-01-12 08:16:00,19,74,Brinquedo,9,93
16338,2024-01-12 08:17:00,67,55,Alimento,9,122
16339,2024-01-12 08:18:00,117,174,Alimento,2,291
16340,2024-01-12 08:19:00,98,68,Vestuário,3,166
16341,2024-01-12 08:20:00,16,158,Eletrônico,5,174
16342,2024-01-12 08:21:00,73,14,Vestuário,8,87
16343,2024-01-12 08:22:00,74,87,Vestuário,8,161
16344,2024-01-12 08:23:00,66,129,Móvel,1,195
16345,2024-01-12 08:24:00,69,24,Eletrônico,1,93
16346,2024-01-12 08:25:00,79,132,Alimento,1,211
16347,2024-01-12 08:26:00,85,91,Vestuário,1,176
16348,2024-01-12 08:27:00,116,84,Brinquedo,4,200
16349,2024-01-12 08:28:00,109,129,Eletrônico,8,238
16350,2024-01-12 08:29:00,64,81,Móvel,4,145
16351,2024-01-12 08:30:00,38,86,Brinquedo,1,124
16352,2024-01-12 08:31:00,80,73,Eletrônico,6,153
16353,2024-01-12 08:32:00,103,118,Alimento,1,221
16354,2024-01-12 08:33:00,12,157,Móvel,7,169
16355,2024-01-12 08:34:00,86,129,Eletrônico,9,215
16356,2024-01-12 08:35:00,100,94,Móvel,9,194
16357,2024-01-12 08:36:00,46,157,Móvel,9,203
16358,2024-01-12 08:37:00,81,123,Vestuário,3,204
16359,2024-01-12 08:38:00,48,76,Vestuário,6,124
16360,2024-01-12 08:39:00,72,161,Brinquedo,6,233
16361,2024-01-12 08:40:00,33,80,Vestuário,8,113
16362,2024-01-12 08:41:00,32,170,Brinquedo,8,202
16363,2024-01-12 08:42:00,114,86,Brinquedo,5,200
16364,2024-01-12 08:43:00,116,42,Vestuário,4,158
16365,2024-01-12 08:44:00,91,136,Móvel,2,227
16366,2024-01-12 08:45:00,76,162,Móvel,1,238
16367,2024-01-12 08:46:00,29,50,Vestuário,5,79
16368,2024-01-12 08:47:00,88,61,Eletrônico,8,149
16369,2024-01-12 08:48:00,21,138,Alimento,6,159
16370,2024-01-12 08:49:00,50,20,Alimento,5,70
16371,2024-01-12 08:50:00,17,129,Brinquedo,2,146
16372,2024-01-12 08:51:00,55,107,Vestuário,7,162
16373,2024-01-12 08:52:00,85,140,Eletrônico,8,225
16374,2024-01-12 08:53:00,35,40,Móvel,2,75
16375,2024-01-12 08:54:00,118,130,Móvel,3,248
16376,2024-01-12 08:55:00,10,117,Móvel,7,127
16377,2024-01-12 08:56:00,38,144,Móvel,9,182
16378,2024-01-12 08:57:00,92,104,Brinquedo,1,196
16379,2024-01-12 08:58:00,96,65,Brinquedo,3,161
16380,2024-01-12 08:59:00,85,116,Alimento,6,201
16381,2024-01-12 09:00:00,66,178,Alimento,4,244
16382,2024-01-12 09:01:00,87,107,Móvel,1,194
16383,2024-01-12 09:02:00,89,153,Móvel,6,242
16384,2024-01-12 09:03:00,33,165,Alimento,2,198
16385,2024-01-12 09:04:00,33,24,Alimento,5,57
16386,2024-01-12 09:05:00,79,120,Eletrônico,4,199
16387,2024-01-12 09:06:00,13,75,Eletrônico,2,88
16388,2024-01-12 09:07:00,42,34,Brinquedo,6,76
16389,2024-01-12 09:08:00,51,114,Vestuário,8,165
16390,2024-01-12 09:09:00,97,28,Brinquedo,9,125
16391,2024-01-12 09:10:00,77,74,Móvel,8,151
16392,2024-01-12 09:11:00,106,89,Vestuário,6,195
16393,2024-01-12 09:12:00,59,53,Eletrônico,4,112
16394,2024-01-12 09:13:00,12,130,Vestuário,3,142
16395,2024-01-12 09:14:00,39,171,Eletrônico,7,210
16396,2024-01-12 09:15:00,50,28,Alimento,2,78
16397,2024-01-12 09:16:00,64,91,Vestuário,9,155
16398,2024-01-12 09:17:00,91,16,Alimento,5,107
16399,2024-01-12 09:18:00,17,81,Eletrônico,3,98
16400,2024-01-12 09:19:00,12,31,Brinquedo,3,43
16401,2024-01-12 09:20:00,64,174,Vestuário,1,238
16402,2024-01-12 09:21:00,75,149,Vestuário,6,224
16403,2024-01-12 09:22:00,85,45,Alimento,6,130
16404,2024-01-12 09:23:00,24,65,Eletrônico,6,89
16405,2024-01-12 09:24:00,70,83,Móvel,8,153
16406,2024-01-12 09:25:00,103,166,Brinquedo,8,269
16407,2024-01-12 09:26:00,99,49,Brinquedo,3,148
16408,2024-01-12 09:27:00,49,123,Alimento,6,172
16409,2024-01-12 09:28:00,102,116,Alimento,9,218
16410,2024-01-12 09:29:00,67,138,Eletrônico,5,205
16411,2024-01-12 09:30:00,93,82,Vestuário,4,175
16412,2024-01-12 09:31:00,83,87,Móvel,5,170
16413,2024-01-12 09:32:00,72,62,Alimento,4,134
16414,2024-01-12 09:33:00,55,115,Móvel,8,170
16415,2024-01-12 09:34:00,11,127,Móvel,5,138
16416,2024-01-12 09:35:00,77,11,Vestuário,7,88
16417,2024-01-12 09:36:00,85,49,Móvel,4,134
16418,2024-01-12 09:37:00,31,73,Eletrônico,4,104
16419,2024-01-12 09:38:00,94,32,Vestuário,5,126
16420,2024-01-12 09:39:00,13,67,Eletrônico,4,80
16421,2024-01-12 09:40:00,38,76,Móvel,3,114
16422,2024-01-12 09:41:00,116,166,Móvel,4,282
16423,2024-01-12 09:42:00,83,10,Alimento,3,93
16424,2024-01-12 09:43:00,13,50,Eletrônico,6,63
16425,2024-01-12 09:44:00,56,130,Vestuário,5,186
16426,2024-01-12 09:45:00,112,12,Alimento,8,124
16427,2024-01-12 09:46:00,39,147,Alimento,5,186
16428,2024-01-12 09:47:00,31,124,Brinquedo,1,155
16429,2024-01-12 09:48:00,114,126,Vestuário,2,240
16430,2024-01-12 09:49:00,57,157,Brinquedo,5,214
16431,2024-01-12 09:50:00,99,68,Móvel,5,167
16432,2024-01-12 09:51:00,33,88,Vestuário,9,121
16433,2024-01-12 09:52:00,114,105,Alimento,7,219
16434,2024-01-12 09:53:00,72,79,Eletrônico,6,151
16435,2024-01-12 09:54:00,20,120,Alimento,5,140
16436,2024-01-12 09:55:00,102,166,Móvel,2,268
16437,2024-01-12 09:56:00,84,51,Brinquedo,6,135
16438,2024-01-12 09:57:00,30,55,Eletrônico,7,85
16439,2024-01-12 09:58:00,77,23,Brinquedo,5,100
16440,2024-01-12 09:59:00,105,70,Móvel,7,175
16441,2024-01-12 10:00:00,93,149,Eletrônico,4,242
16442,2024-01-12 10:01:00,78,33,Vestuário,8,111
16443,2024-01-12 10:02:00,15,71,Brinquedo,3,86
16444,2024-01-12 10:03:00,36,71,Vestuário,9,107
16445,2024-01-12 10:04:00,64,176,Móvel,7,240
16446,2024-01-12 10:05:00,14,154,Eletrônico,7,168
16447,2024-01-12 10:06:00,101,30,Vestuário,6,131
16448,2024-01-12 10:07:00,82,161,Brinquedo,2,243
16449,2024-01-12 10:08:00,106,136,Brinquedo,8,242
16450,2024-01-12 10:09:00,15,69,Alimento,1,84
16451,2024-01-12 10:10:00,19,152,Brinquedo,9,171
16452,2024-01-12 10:11:00,18,39,Eletrônico,1,57
16453,2024-01-12 10:12:00,60,135,Móvel,3,195
16454,2024-01-12 10:13:00,21,168,Móvel,4,189
16455,2024-01-12 10:14:00,12,161,Eletrônico,8,173
16456,2024-01-12 10:15:00,107,38,Vestuário,6,145
16457,2024-01-12 10:16:00,30,51,Eletrônico,6,81
16458,2024-01-12 10:17:00,40,149,Vestuário,2,189
16459,2024-01-12 10:18:00,56,155,Eletrônico,6,211
16460,2024-01-12 10:19:00,99,54,Eletrônico,6,153
16461,2024-01-12 10:20:00,77,123,Brinquedo,9,200
16462,2024-01-12 10:21:00,93,152,Móvel,1,245
16463,2024-01-12 10:22:00,112,36,Móvel,3,148
16464,2024-01-12 10:23:00,113,86,Eletrônico,9,199
16465,2024-01-12 10:24:00,27,118,Vestuário,7,145
16466,2024-01-12 10:25:00,111,146,Eletrônico,7,257
16467,2024-01-12 10:26:00,18,27,Móvel,7,45
16468,2024-01-12 10:27:00,18,149,Brinquedo,5,167
16469,2024-01-12 10:28:00,88,71,Brinquedo,7,159
16470,2024-01-12 10:29:00,49,62,Móvel,1,111
16471,2024-01-12 10:30:00,27,90,Alimento,6,117
16472,2024-01-12 10:31:00,83,176,Vestuário,6,259
16473,2024-01-12 10:32:00,67,178,Móvel,3,245
16474,2024-01-12 10:33:00,66,111,Eletrônico,8,177
16475,2024-01-12 10:34:00,64,42,Alimento,4,106
16476,2024-01-12 10:35:00,59,87,Brinquedo,3,146
16477,2024-01-12 10:36:00,23,151,Brinquedo,9,174
16478,2024-01-12 10:37:00,61,29,Móvel,3,90
16479,2024-01-12 10:38:00,97,33,Alimento,8,130
16480,2024-01-12 10:39:00,40,166,Alimento,7,206
16481,2024-01-12 10:40:00,58,125,Brinquedo,7,183
16482,2024-01-12 10:41:00,108,143,Alimento,1,251
16483,2024-01-12 10:42:00,92,24,Alimento,5,116
16484,2024-01-12 10:43:00,24,69,Móvel,6,93
16485,2024-01-12 10:44:00,59,60,Brinquedo,4,119
16486,2024-01-12 10:45:00,65,47,Móvel,8,112
16487,2024-01-12 10:46:00,12,31,Eletrônico,8,43
16488,2024-01-12 10:47:00,88,72,Eletrônico,4,160
16489,2024-01-12 10:48:00,21,155,Alimento,1,176
16490,2024-01-12 10:49:00,117,41,Vestuário,2,158
16491,2024-01-12 10:50:00,37,142,Brinquedo,2,179
16492,2024-01-12 10:51:00,31,133,Eletrônico,5,164
16493,2024-01-12 10:52:00,91,58,Eletrônico,6,149
16494,2024-01-12 10:53:00,32,62,Alimento,6,94
16495,2024-01-12 10:54:00,98,28,Vestuário,5,126
16496,2024-01-12 10:55:00,38,168,Móvel,8,206
16497,2024-01-12 10:56:00,22,52,Vestuário,6,74
16498,2024-01-12 10:57:00,60,160,Brinquedo,8,220
16499,2024-01-12 10:58:00,62,126,Alimento,8,188
16500,2024-01-12 10:59:00,44,126,Alimento,8,170
16501,2024-01-12 11:00:00,59,13,Alimento,4,72
16502,2024-01-12 11:01:00,119,14,Alimento,8,133
16503,2024-01-12 11:02:00,51,141,Móvel,3,192
16504,2024-01-12 11:03:00,53,113,Brinquedo,5,166
16505,2024-01-12 11:04:00,60,150,Brinquedo,8,210
16506,2024-01-12 11:05:00,107,40,Alimento,6,147
16507,2024-01-12 11:06:00,55,28,Brinquedo,2,83
16508,2024-01-12 11:07:00,28,77,Móvel,9,105
16509,2024-01-12 11:08:00,36,57,Vestuário,8,93
16510,2024-01-12 11:09:00,65,94,Móvel,9,159
16511,2024-01-12 11:10:00,58,75,Vestuário,4,133
16512,2024-01-12 11:11:00,98,67,Móvel,5,165
16513,2024-01-12 11:12:00,12,79,Alimento,8,91
16514,2024-01-12 11:13:00,108,129,Móvel,3,237
16515,2024-01-12 11:14:00,63,158,Alimento,9,221
16516,2024-01-12 11:15:00,84,20,Alimento,8,104
16517,2024-01-12 11:16:00,53,138,Brinquedo,5,191
16518,2024-01-12 11:17:00,103,131,Brinquedo,9,234
16519,2024-01-12 11:18:00,92,14,Eletrônico,8,106
16520,2024-01-12 11:19:00,86,115,Brinquedo,2,201
16521,2024-01-12 11:20:00,61,178,Alimento,4,239
16522,2024-01-12 11:21:00,48,137,Vestuário,6,185
16523,2024-01-12 11:22:00,98,100,Eletrônico,9,198
16524,2024-01-12 11:23:00,94,120,Brinquedo,4,214
16525,2024-01-12 11:24:00,25,27,Alimento,4,52
16526,2024-01-12 11:25:00,99,80,Brinquedo,9,179
16527,2024-01-12 11:26:00,50,149,Vestuário,5,199
16528,2024-01-12 11:27:00,36,94,Móvel,4,130
16529,2024-01-12 11:28:00,10,156,Brinquedo,7,166
16530,2024-01-12 11:29:00,111,16,Eletrônico,5,127
16531,2024-01-12 11:30:00,115,36,Vestuário,4,151
16532,2024-01-12 11:31:00,35,32,Móvel,3,67
16533,2024-01-12 11:32:00,91,97,Alimento,9,188
16534,2024-01-12 11:33:00,99,30,Eletrônico,4,129
16535,2024-01-12 11:34:00,113,83,Vestuário,5,196
16536,2024-01-12 11:35:00,35,31,Brinquedo,9,66
16537,2024-01-12 11:36:00,107,173,Vestuário,6,280
16538,2024-01-12 11:37:00,12,89,Móvel,1,101
16539,2024-01-12 11:38:00,25,172,Eletrônico,5,197
16540,2024-01-12 11:39:00,41,102,Brinquedo,7,143
16541,2024-01-12 11:40:00,65,165,Vestuário,4,230
16542,2024-01-12 11:41:00,43,92,Eletrônico,5,135
16543,2024-01-12 11:42:00,98,170,Alimento,1,268
16544,2024-01-12 11:43:00,89,166,Vestuário,4,255
16545,2024-01-12 11:44:00,97,98,Alimento,4,195
16546,2024-01-12 11:45:00,28,138,Vestuário,6,166
16547,2024-01-12 11:46:00,35,80,Móvel,2,115
16548,2024-01-12 11:47:00,52,135,Vestuário,6,187
16549,2024-01-12 11:48:00,29,40,Alimento,8,69
16550,2024-01-12 11:49:00,46,37,Alimento,2,83
16551,2024-01-12 11:50:00,68,48,Brinquedo,8,116
16552,2024-01-12 11:51:00,77,51,Móvel,6,128
16553,2024-01-12 11:52:00,96,154,Eletrônico,6,250
16554,2024-01-12 11:53:00,25,69,Móvel,8,94
16555,2024-01-12 11:54:00,45,91,Vestuário,5,136
16556,2024-01-12 11:55:00,27,146,Eletrônico,6,173
16557,2024-01-12 11:56:00,40,147,Móvel,1,187
16558,2024-01-12 11:57:00,117,46,Eletrônico,3,163
16559,2024-01-12 11:58:00,14,139,Eletrônico,3,153
16560,2024-01-12 11:59:00,96,52,Alimento,6,148
16561,2024-01-12 12:00:00,38,160,Brinquedo,8,198
16562,2024-01-12 12:01:00,51,48,Vestuário,7,99
16563,2024-01-12 12:02:00,77,19,Vestuário,6,96
16564,2024-01-12 12:03:00,42,134,Vestuário,6,176
16565,2024-01-12 12:04:00,54,119,Alimento,2,173
16566,2024-01-12 12:05:00,36,72,Eletrônico,3,108
16567,2024-01-12 12:06:00,40,55,Móvel,4,95
16568,2024-01-12 12:07:00,10,174,Brinquedo,8,184
16569,2024-01-12 12:08:00,76,36,Vestuário,7,112
16570,2024-01-12 12:09:00,103,158,Vestuário,7,261
16571,2024-01-12 12:10:00,77,122,Vestuário,3,199
16572,2024-01-12 12:11:00,50,179,Brinquedo,2,229
16573,2024-01-12 12:12:00,29,42,Alimento,2,71
16574,2024-01-12 12:13:00,106,117,Alimento,7,223
16575,2024-01-12 12:14:00,56,158,Vestuário,9,214
16576,2024-01-12 12:15:00,87,101,Vestuário,3,188
16577,2024-01-12 12:16:00,101,124,Vestuário,6,225
16578,2024-01-12 12:17:00,25,13,Alimento,8,38
16579,2024-01-12 12:18:00,32,139,Alimento,6,171
16580,2024-01-12 12:19:00,39,39,Alimento,8,78
16581,2024-01-12 12:20:00,20,104,Brinquedo,6,124
16582,2024-01-12 12:21:00,90,128,Móvel,6,218
16583,2024-01-12 12:22:00,118,155,Vestuário,4,273
16584,2024-01-12 12:23:00,40,56,Móvel,6,96
16585,2024-01-12 12:24:00,53,141,Alimento,5,194
16586,2024-01-12 12:25:00,21,38,Eletrônico,1,59
16587,2024-01-12 12:26:00,42,76,Vestuário,6,118
16588,2024-01-12 12:27:00,71,22,Brinquedo,7,93
16589,2024-01-12 12:28:00,18,122,Móvel,7,140
16590,2024-01-12 12:29:00,35,174,Brinquedo,1,209
16591,2024-01-12 12:30:00,67,94,Eletrônico,1,161
16592,2024-01-12 12:31:00,119,37,Eletrônico,8,156
16593,2024-01-12 12:32:00,10,177,Móvel,1,187
16594,2024-01-12 12:33:00,71,144,Vestuário,9,215
16595,2024-01-12 12:34:00,89,147,Alimento,2,236
16596,2024-01-12 12:35:00,70,145,Vestuário,7,215
16597,2024-01-12 12:36:00,38,161,Alimento,9,199
16598,2024-01-12 12:37:00,83,101,Alimento,6,184
16599,2024-01-12 12:38:00,46,90,Móvel,2,136
16600,2024-01-12 12:39:00,53,65,Brinquedo,1,118
16601,2024-01-12 12:40:00,56,74,Móvel,9,130
16602,2024-01-12 12:41:00,77,156,Alimento,2,233
16603,2024-01-12 12:42:00,47,143,Eletrônico,4,190
16604,2024-01-12 12:43:00,73,63,Brinquedo,4,136
16605,2024-01-12 12:44:00,67,39,Móvel,1,106
16606,2024-01-12 12:45:00,32,73,Brinquedo,7,105
16607,2024-01-12 12:46:00,44,113,Vestuário,2,157
16608,2024-01-12 12:47:00,26,62,Móvel,6,88
16609,2024-01-12 12:48:00,30,23,Brinquedo,1,53
16610,2024-01-12 12:49:00,92,153,Móvel,5,245
16611,2024-01-12 12:50:00,115,47,Brinquedo,2,162
16612,2024-01-12 12:51:00,106,169,Vestuário,5,275
16613,2024-01-12 12:52:00,86,66,Alimento,7,152
16614,2024-01-12 12:53:00,72,71,Eletrônico,7,143
16615,2024-01-12 12:54:00,43,16,Móvel,9,59
16616,2024-01-12 12:55:00,21,73,Eletrônico,5,94
16617,2024-01-12 12:56:00,82,161,Móvel,2,243
16618,2024-01-12 12:57:00,119,71,Brinquedo,4,190
16619,2024-01-12 12:58:00,106,81,Brinquedo,6,187
16620,2024-01-12 12:59:00,69,53,Vestuário,4,122
16621,2024-01-12 13:00:00,107,25,Alimento,8,132
16622,2024-01-12 13:01:00,93,141,Alimento,9,234
16623,2024-01-12 13:02:00,36,42,Brinquedo,2,78
16624,2024-01-12 13:03:00,99,110,Brinquedo,1,209
16625,2024-01-12 13:04:00,109,109,Vestuário,1,218
16626,2024-01-12 13:05:00,119,36,Brinquedo,1,155
16627,2024-01-12 13:06:00,38,63,Alimento,1,101
16628,2024-01-12 13:07:00,111,90,Brinquedo,7,201
16629,2024-01-12 13:08:00,45,87,Móvel,6,132
16630,2024-01-12 13:09:00,115,83,Vestuário,2,198
16631,2024-01-12 13:10:00,77,67,Brinquedo,3,144
16632,2024-01-12 13:11:00,55,32,Móvel,1,87
16633,2024-01-12 13:12:00,35,60,Vestuário,8,95
16634,2024-01-12 13:13:00,107,74,Brinquedo,9,181
16635,2024-01-12 13:14:00,76,32,Eletrônico,8,108
16636,2024-01-12 13:15:00,36,51,Vestuário,4,87
16637,2024-01-12 13:16:00,71,91,Vestuário,7,162
16638,2024-01-12 13:17:00,86,166,Móvel,7,252
16639,2024-01-12 13:18:00,64,132,Alimento,6,196
16640,2024-01-12 13:19:00,51,31,Alimento,9,82
16641,2024-01-12 13:20:00,107,124,Brinquedo,5,231
16642,2024-01-12 13:21:00,41,30,Brinquedo,2,71
16643,2024-01-12 13:22:00,37,40,Alimento,4,77
16644,2024-01-12 13:23:00,50,112,Eletrônico,9,162
16645,2024-01-12 13:24:00,107,53,Móvel,4,160
16646,2024-01-12 13:25:00,96,137,Móvel,9,233
16647,2024-01-12 13:26:00,96,66,Eletrônico,6,162
16648,2024-01-12 13:27:00,18,75,Móvel,2,93
16649,2024-01-12 13:28:00,90,80,Vestuário,4,170
16650,2024-01-12 13:29:00,48,75,Brinquedo,7,123
16651,2024-01-12 13:30:00,55,31,Brinquedo,7,86
16652,2024-01-12 13:31:00,49,160,Alimento,2,209
16653,2024-01-12 13:32:00,45,169,Móvel,5,214
16654,2024-01-12 13:33:00,34,22,Eletrônico,9,56
16655,2024-01-12 13:34:00,106,92,Móvel,5,198
16656,2024-01-12 13:35:00,71,158,Brinquedo,5,229
16657,2024-01-12 13:36:00,112,35,Vestuário,5,147
16658,2024-01-12 13:37:00,34,123,Vestuário,4,157
16659,2024-01-12 13:38:00,89,127,Móvel,7,216
16660,2024-01-12 13:39:00,90,49,Vestuário,7,139
16661,2024-01-12 13:40:00,53,160,Eletrônico,8,213
16662,2024-01-12 13:41:00,84,63,Alimento,7,147
16663,2024-01-12 13:42:00,14,25,Brinquedo,6,39
16664,2024-01-12 13:43:00,95,93,Móvel,1,188
16665,2024-01-12 13:44:00,28,16,Eletrônico,1,44
16666,2024-01-12 13:45:00,93,107,Eletrônico,7,200
16667,2024-01-12 13:46:00,67,37,Alimento,2,104
16668,2024-01-12 13:47:00,111,21,Móvel,2,132
16669,2024-01-12 13:48:00,69,158,Móvel,7,227
16670,2024-01-12 13:49:00,31,162,Vestuário,3,193
16671,2024-01-12 13:50:00,30,39,Alimento,3,69
16672,2024-01-12 13:51:00,61,167,Eletrônico,7,228
16673,2024-01-12 13:52:00,58,18,Alimento,5,76
16674,2024-01-12 13:53:00,47,164,Eletrônico,9,211
16675,2024-01-12 13:54:00,71,99,Vestuário,1,170
16676,2024-01-12 13:55:00,112,29,Móvel,6,141
16677,2024-01-12 13:56:00,105,65,Móvel,5,170
16678,2024-01-12 13:57:00,49,44,Alimento,4,93
16679,2024-01-12 13:58:00,36,128,Móvel,6,164
16680,2024-01-12 13:59:00,117,173,Brinquedo,1,290
16681,2024-01-12 14:00:00,112,74,Brinquedo,2,186
16682,2024-01-12 14:01:00,77,35,Eletrônico,9,112
16683,2024-01-12 14:02:00,29,27,Eletrônico,8,56
16684,2024-01-12 14:03:00,39,101,Brinquedo,8,140
16685,2024-01-12 14:04:00,63,142,Brinquedo,2,205
16686,2024-01-12 14:05:00,22,48,Brinquedo,6,70
16687,2024-01-12 14:06:00,28,58,Móvel,1,86
16688,2024-01-12 14:07:00,16,99,Brinquedo,9,115
16689,2024-01-12 14:08:00,77,124,Brinquedo,2,201
16690,2024-01-12 14:09:00,93,157,Alimento,1,250
16691,2024-01-12 14:10:00,93,14,Eletrônico,3,107
16692,2024-01-12 14:11:00,21,115,Eletrônico,6,136
16693,2024-01-12 14:12:00,78,92,Brinquedo,9,170
16694,2024-01-12 14:13:00,10,79,Móvel,3,89
16695,2024-01-12 14:14:00,44,47,Móvel,6,91
16696,2024-01-12 14:15:00,28,144,Brinquedo,4,172
16697,2024-01-12 14:16:00,65,87,Brinquedo,3,152
16698,2024-01-12 14:17:00,57,39,Móvel,3,96
16699,2024-01-12 14:18:00,44,99,Alimento,9,143
16700,2024-01-12 14:19:00,89,42,Eletrônico,5,131
16701,2024-01-12 14:20:00,97,94,Móvel,8,191
16702,2024-01-12 14:21:00,119,174,Vestuário,3,293
16703,2024-01-12 14:22:00,114,142,Móvel,7,256
16704,2024-01-12 14:23:00,27,128,Brinquedo,6,155
16705,2024-01-12 14:24:00,43,74,Alimento,7,117
16706,2024-01-12 14:25:00,35,54,Móvel,3,89
16707,2024-01-12 14:26:00,104,137,Móvel,7,241
16708,2024-01-12 14:27:00,77,150,Alimento,3,227
16709,2024-01-12 14:28:00,31,129,Alimento,8,160
16710,2024-01-12 14:29:00,97,105,Vestuário,1,202
16711,2024-01-12 14:30:00,15,14,Brinquedo,1,29
16712,2024-01-12 14:31:00,10,167,Brinquedo,5,177
16713,2024-01-12 14:32:00,43,122,Brinquedo,3,165
16714,2024-01-12 14:33:00,36,104,Vestuário,5,140
16715,2024-01-12 14:34:00,74,55,Móvel,1,129
16716,2024-01-12 14:35:00,106,172,Brinquedo,7,278
16717,2024-01-12 14:36:00,73,173,Móvel,4,246
16718,2024-01-12 14:37:00,109,39,Vestuário,3,148
16719,2024-01-12 14:38:00,27,121,Eletrônico,4,148
16720,2024-01-12 14:39:00,50,82,Alimento,6,132
16721,2024-01-12 14:40:00,80,29,Vestuário,8,109
16722,2024-01-12 14:41:00,76,35,Móvel,5,111
16723,2024-01-12 14:42:00,75,91,Vestuário,3,166
16724,2024-01-12 14:43:00,28,100,Móvel,2,128
16725,2024-01-12 14:44:00,80,127,Alimento,4,207
16726,2024-01-12 14:45:00,52,31,Brinquedo,7,83
16727,2024-01-12 14:46:00,105,149,Móvel,7,254
16728,2024-01-12 14:47:00,59,76,Alimento,2,135
16729,2024-01-12 14:48:00,61,119,Eletrônico,4,180
16730,2024-01-12 14:49:00,68,60,Brinquedo,6,128
16731,2024-01-12 14:50:00,68,26,Eletrônico,4,94
16732,2024-01-12 14:51:00,24,81,Móvel,6,105
16733,2024-01-12 14:52:00,52,48,Vestuário,9,100
16734,2024-01-12 14:53:00,76,46,Vestuário,5,122
16735,2024-01-12 14:54:00,32,118,Vestuário,3,150
16736,2024-01-12 14:55:00,84,68,Vestuário,7,152
16737,2024-01-12 14:56:00,80,119,Móvel,9,199
16738,2024-01-12 14:57:00,85,101,Vestuário,1,186
16739,2024-01-12 14:58:00,39,16,Móvel,2,55
16740,2024-01-12 14:59:00,42,78,Eletrônico,6,120
16741,2024-01-12 15:00:00,29,39,Móvel,7,68
16742,2024-01-12 15:01:00,10,57,Móvel,7,67
16743,2024-01-12 15:02:00,62,173,Vestuário,5,235
16744,2024-01-12 15:03:00,67,16,Móvel,8,83
16745,2024-01-12 15:04:00,18,141,Brinquedo,9,159
16746,2024-01-12 15:05:00,20,56,Brinquedo,4,76
16747,2024-01-12 15:06:00,52,17,Alimento,6,69
16748,2024-01-12 15:07:00,102,48,Eletrônico,8,150
16749,2024-01-12 15:08:00,85,148,Móvel,7,233
16750,2024-01-12 15:09:00,24,155,Alimento,3,179
16751,2024-01-12 15:10:00,113,10,Eletrônico,5,123
16752,2024-01-12 15:11:00,56,20,Vestuário,2,76
16753,2024-01-12 15:12:00,20,89,Alimento,1,109
16754,2024-01-12 15:13:00,11,123,Eletrônico,8,134
16755,2024-01-12 15:14:00,100,116,Vestuário,7,216
16756,2024-01-12 15:15:00,89,50,Brinquedo,8,139
16757,2024-01-12 15:16:00,90,22,Brinquedo,9,112
16758,2024-01-12 15:17:00,101,69,Móvel,7,170
16759,2024-01-12 15:18:00,14,103,Vestuário,8,117
16760,2024-01-12 15:19:00,109,71,Eletrônico,5,180
16761,2024-01-12 15:20:00,10,144,Brinquedo,7,154
16762,2024-01-12 15:21:00,57,172,Móvel,5,229
16763,2024-01-12 15:22:00,63,132,Alimento,6,195
16764,2024-01-12 15:23:00,58,15,Brinquedo,4,73
16765,2024-01-12 15:24:00,31,12,Vestuário,5,43
16766,2024-01-12 15:25:00,99,13,Brinquedo,1,112
16767,2024-01-12 15:26:00,106,109,Móvel,6,215
16768,2024-01-12 15:27:00,92,140,Eletrônico,4,232
16769,2024-01-12 15:28:00,43,51,Móvel,7,94
16770,2024-01-12 15:29:00,115,69,Móvel,4,184
16771,2024-01-12 15:30:00,118,128,Vestuário,4,246
16772,2024-01-12 15:31:00,21,136,Vestuário,6,157
16773,2024-01-12 15:32:00,98,132,Alimento,5,230
16774,2024-01-12 15:33:00,77,98,Brinquedo,6,175
16775,2024-01-12 15:34:00,116,129,Móvel,5,245
16776,2024-01-12 15:35:00,93,110,Vestuário,4,203
16777,2024-01-12 15:36:00,43,159,Brinquedo,4,202
16778,2024-01-12 15:37:00,70,83,Móvel,9,153
16779,2024-01-12 15:38:00,83,52,Brinquedo,8,135
16780,2024-01-12 15:39:00,85,22,Vestuário,8,107
16781,2024-01-12 15:40:00,11,77,Eletrônico,5,88
16782,2024-01-12 15:41:00,70,87,Brinquedo,1,157
16783,2024-01-12 15:42:00,13,126,Móvel,2,139
16784,2024-01-12 15:43:00,72,40,Alimento,9,112
16785,2024-01-12 15:44:00,22,56,Alimento,8,78
16786,2024-01-12 15:45:00,22,70,Eletrônico,7,92
16787,2024-01-12 15:46:00,90,151,Eletrônico,3,241
16788,2024-01-12 15:47:00,51,175,Alimento,8,226
16789,2024-01-12 15:48:00,23,83,Vestuário,9,106
16790,2024-01-12 15:49:00,16,43,Alimento,9,59
16791,2024-01-12 15:50:00,67,43,Alimento,7,110
16792,2024-01-12 15:51:00,21,126,Móvel,5,147
16793,2024-01-12 15:52:00,46,151,Vestuário,7,197
16794,2024-01-12 15:53:00,45,49,Vestuário,3,94
16795,2024-01-12 15:54:00,19,106,Vestuário,2,125
16796,2024-01-12 15:55:00,109,110,Móvel,4,219
16797,2024-01-12 15:56:00,80,29,Vestuário,7,109
16798,2024-01-12 15:57:00,115,110,Eletrônico,1,225
16799,2024-01-12 15:58:00,81,21,Brinquedo,9,102
16800,2024-01-12 15:59:00,23,44,Móvel,3,67
16801,2024-01-12 16:00:00,89,133,Vestuário,6,222
16802,2024-01-12 16:01:00,50,56,Alimento,1,106
16803,2024-01-12 16:02:00,75,84,Brinquedo,6,159
16804,2024-01-12 16:03:00,50,132,Móvel,3,182
16805,2024-01-12 16:04:00,115,49,Vestuário,9,164
16806,2024-01-12 16:05:00,91,176,Brinquedo,3,267
16807,2024-01-12 16:06:00,40,171,Alimento,8,211
16808,2024-01-12 16:07:00,80,102,Eletrônico,2,182
16809,2024-01-12 16:08:00,118,154,Brinquedo,6,272
16810,2024-01-12 16:09:00,49,26,Eletrônico,2,75
16811,2024-01-12 16:10:00,22,81,Alimento,9,103
16812,2024-01-12 16:11:00,114,172,Eletrônico,7,286
16813,2024-01-12 16:12:00,57,142,Alimento,7,199
16814,2024-01-12 16:13:00,41,68,Eletrônico,9,109
16815,2024-01-12 16:14:00,51,92,Alimento,6,143
16816,2024-01-12 16:15:00,79,142,Alimento,7,221
16817,2024-01-12 16:16:00,63,129,Móvel,4,192
16818,2024-01-12 16:17:00,113,38,Alimento,9,151
16819,2024-01-12 16:18:00,93,31,Vestuário,4,124
16820,2024-01-12 16:19:00,21,156,Eletrônico,5,177
16821,2024-01-12 16:20:00,113,29,Brinquedo,6,142
16822,2024-01-12 16:21:00,21,114,Brinquedo,8,135
16823,2024-01-12 16:22:00,81,45,Alimento,8,126
16824,2024-01-12 16:23:00,35,58,Eletrônico,6,93
16825,2024-01-12 16:24:00,117,127,Móvel,4,244
16826,2024-01-12 16:25:00,119,170,Eletrônico,2,289
16827,2024-01-12 16:26:00,118,162,Brinquedo,3,280
16828,2024-01-12 16:27:00,80,148,Alimento,8,228
16829,2024-01-12 16:28:00,18,66,Alimento,9,84
16830,2024-01-12 16:29:00,90,166,Móvel,5,256
16831,2024-01-12 16:30:00,63,81,Vestuário,7,144
16832,2024-01-12 16:31:00,21,135,Eletrônico,8,156
16833,2024-01-12 16:32:00,85,169,Brinquedo,8,254
16834,2024-01-12 16:33:00,117,103,Eletrônico,9,220
16835,2024-01-12 16:34:00,85,167,Alimento,5,252
16836,2024-01-12 16:35:00,97,144,Eletrônico,6,241
16837,2024-01-12 16:36:00,97,154,Eletrônico,1,251
16838,2024-01-12 16:37:00,92,56,Vestuário,5,148
16839,2024-01-12 16:38:00,76,27,Vestuário,3,103
16840,2024-01-12 16:39:00,100,121,Eletrônico,9,221
16841,2024-01-12 16:40:00,40,102,Eletrônico,9,142
16842,2024-01-12 16:41:00,89,50,Vestuário,1,139
16843,2024-01-12 16:42:00,94,134,Alimento,2,228
16844,2024-01-12 16:43:00,56,43,Eletrônico,3,99
16845,2024-01-12 16:44:00,81,176,Alimento,3,257
16846,2024-01-12 16:45:00,82,75,Móvel,4,157
16847,2024-01-12 16:46:00,50,83,Eletrônico,2,133
16848,2024-01-12 16:47:00,32,144,Brinquedo,6,176
16849,2024-01-12 16:48:00,73,49,Brinquedo,2,122
16850,2024-01-12 16:49:00,42,58,Alimento,4,100
16851,2024-01-12 16:50:00,80,59,Eletrônico,9,139
16852,2024-01-12 16:51:00,28,84,Móvel,4,112
16853,2024-01-12 16:52:00,42,30,Vestuário,9,72
16854,2024-01-12 16:53:00,61,24,Eletrônico,9,85
16855,2024-01-12 16:54:00,103,105,Eletrônico,8,208
16856,2024-01-12 16:55:00,68,168,Alimento,7,236
16857,2024-01-12 16:56:00,51,30,Brinquedo,2,81
16858,2024-01-12 16:57:00,93,50,Alimento,1,143
16859,2024-01-12 16:58:00,79,173,Alimento,9,252
16860,2024-01-12 16:59:00,48,35,Eletrônico,3,83
16861,2024-01-12 17:00:00,104,159,Eletrônico,1,263
16862,2024-01-12 17:01:00,53,103,Brinquedo,7,156
16863,2024-01-12 17:02:00,75,58,Vestuário,3,133
16864,2024-01-12 17:03:00,76,92,Móvel,6,168
16865,2024-01-12 17:04:00,112,139,Vestuário,6,251
16866,2024-01-12 17:05:00,110,160,Alimento,6,270
16867,2024-01-12 17:06:00,107,37,Brinquedo,7,144
16868,2024-01-12 17:07:00,97,28,Móvel,5,125
16869,2024-01-12 17:08:00,15,55,Vestuário,3,70
16870,2024-01-12 17:09:00,103,68,Móvel,4,171
16871,2024-01-12 17:10:00,11,17,Móvel,7,28
16872,2024-01-12 17:11:00,84,96,Eletrônico,5,180
16873,2024-01-12 17:12:00,44,50,Brinquedo,9,94
16874,2024-01-12 17:13:00,52,87,Eletrônico,3,139
16875,2024-01-12 17:14:00,57,64,Vestuário,3,121
16876,2024-01-12 17:15:00,110,77,Vestuário,4,187
16877,2024-01-12 17:16:00,67,177,Brinquedo,4,244
16878,2024-01-12 17:17:00,35,80,Móvel,4,115
16879,2024-01-12 17:18:00,114,61,Brinquedo,6,175
16880,2024-01-12 17:19:00,39,78,Brinquedo,5,117
16881,2024-01-12 17:20:00,118,135,Alimento,1,253
16882,2024-01-12 17:21:00,31,75,Alimento,5,106
16883,2024-01-12 17:22:00,106,138,Eletrônico,7,244
16884,2024-01-12 17:23:00,113,48,Móvel,5,161
16885,2024-01-12 17:24:00,17,60,Vestuário,8,77
16886,2024-01-12 17:25:00,84,71,Alimento,5,155
16887,2024-01-12 17:26:00,42,150,Alimento,3,192
16888,2024-01-12 17:27:00,24,28,Vestuário,6,52
16889,2024-01-12 17:28:00,17,146,Eletrônico,5,163
16890,2024-01-12 17:29:00,43,168,Alimento,9,211
16891,2024-01-12 17:30:00,92,67,Móvel,5,159
16892,2024-01-12 17:31:00,89,118,Alimento,3,207
16893,2024-01-12 17:32:00,21,105,Alimento,7,126
16894,2024-01-12 17:33:00,13,58,Móvel,9,71
16895,2024-01-12 17:34:00,10,138,Móvel,9,148
16896,2024-01-12 17:35:00,40,95,Brinquedo,7,135
16897,2024-01-12 17:36:00,47,120,Vestuário,3,167
16898,2024-01-12 17:37:00,42,113,Alimento,4,155
16899,2024-01-12 17:38:00,22,163,Alimento,8,185
16900,2024-01-12 17:39:00,82,99,Vestuário,9,181
16901,2024-01-12 17:40:00,78,88,Eletrônico,2,166
16902,2024-01-12 17:41:00,80,90,Brinquedo,5,170
16903,2024-01-12 17:42:00,80,88,Alimento,5,168
16904,2024-01-12 17:43:00,29,177,Vestuário,3,206
16905,2024-01-12 17:44:00,21,72,Eletrônico,2,93
16906,2024-01-12 17:45:00,15,153,Brinquedo,7,168
16907,2024-01-12 17:46:00,94,120,Eletrônico,8,214
16908,2024-01-12 17:47:00,31,115,Móvel,6,146
16909,2024-01-12 17:48:00,76,78,Móvel,3,154
16910,2024-01-12 17:49:00,41,141,Móvel,9,182
16911,2024-01-12 17:50:00,15,132,Eletrônico,3,147
16912,2024-01-12 17:51:00,49,95,Vestuário,6,144
16913,2024-01-12 17:52:00,47,25,Eletrônico,2,72
16914,2024-01-12 17:53:00,51,43,Móvel,6,94
16915,2024-01-12 17:54:00,99,56,Brinquedo,7,155
16916,2024-01-12 17:55:00,22,91,Vestuário,5,113
16917,2024-01-12 17:56:00,21,83,Móvel,8,104
16918,2024-01-12 17:57:00,107,72,Eletrônico,1,179
16919,2024-01-12 17:58:00,102,82,Brinquedo,6,184
16920,2024-01-12 17:59:00,44,19,Móvel,8,63
16921,2024-01-12 18:00:00,78,48,Brinquedo,2,126
16922,2024-01-12 18:01:00,26,26,Eletrônico,6,52
16923,2024-01-12 18:02:00,57,42,Vestuário,3,99
16924,2024-01-12 18:03:00,42,166,Brinquedo,1,208
16925,2024-01-12 18:04:00,76,163,Móvel,7,239
16926,2024-01-12 18:05:00,111,38,Vestuário,8,149
16927,2024-01-12 18:06:00,107,53,Alimento,2,160
16928,2024-01-12 18:07:00,83,92,Móvel,9,175
16929,2024-01-12 18:08:00,26,159,Vestuário,1,185
16930,2024-01-12 18:09:00,63,26,Alimento,4,89
16931,2024-01-12 18:10:00,72,20,Eletrônico,6,92
16932,2024-01-12 18:11:00,45,111,Alimento,9,156
16933,2024-01-12 18:12:00,72,95,Alimento,4,167
16934,2024-01-12 18:13:00,13,105,Vestuário,8,118
16935,2024-01-12 18:14:00,80,167,Brinquedo,3,247
16936,2024-01-12 18:15:00,46,167,Móvel,4,213
16937,2024-01-12 18:16:00,87,53,Eletrônico,4,140
16938,2024-01-12 18:17:00,112,133,Eletrônico,8,245
16939,2024-01-12 18:18:00,114,45,Vestuário,7,159
16940,2024-01-12 18:19:00,28,51,Brinquedo,5,79
16941,2024-01-12 18:20:00,19,64,Vestuário,2,83
16942,2024-01-12 18:21:00,40,170,Eletrônico,1,210
16943,2024-01-12 18:22:00,16,143,Móvel,1,159
16944,2024-01-12 18:23:00,91,69,Vestuário,4,160
16945,2024-01-12 18:24:00,44,100,Alimento,4,144
16946,2024-01-12 18:25:00,69,99,Móvel,3,168
16947,2024-01-12 18:26:00,95,11,Vestuário,3,106
16948,2024-01-12 18:27:00,90,89,Móvel,6,179
16949,2024-01-12 18:28:00,17,108,Eletrônico,2,125
16950,2024-01-12 18:29:00,14,104,Eletrônico,9,118
16951,2024-01-12 18:30:00,56,91,Móvel,9,147
16952,2024-01-12 18:31:00,84,77,Alimento,1,161
16953,2024-01-12 18:32:00,40,61,Eletrônico,2,101
16954,2024-01-12 18:33:00,50,132,Vestuário,3,182
16955,2024-01-12 18:34:00,15,88,Brinquedo,7,103
16956,2024-01-12 18:35:00,28,101,Vestuário,4,129
16957,2024-01-12 18:36:00,108,176,Brinquedo,1,284
16958,2024-01-12 18:37:00,55,93,Alimento,2,148
16959,2024-01-12 18:38:00,41,41,Móvel,3,82
16960,2024-01-12 18:39:00,109,119,Móvel,4,228
16961,2024-01-12 18:40:00,114,44,Móvel,8,158
16962,2024-01-12 18:41:00,23,52,Eletrônico,7,75
16963,2024-01-12 18:42:00,34,145,Vestuário,9,179
16964,2024-01-12 18:43:00,60,110,Alimento,5,170
16965,2024-01-12 18:44:00,83,133,Brinquedo,7,216
16966,2024-01-12 18:45:00,57,160,Brinquedo,2,217
16967,2024-01-12 18:46:00,47,111,Vestuário,3,158
16968,2024-01-12 18:47:00,75,13,Eletrônico,4,88
16969,2024-01-12 18:48:00,107,88,Móvel,8,195
16970,2024-01-12 18:49:00,21,34,Brinquedo,6,55
16971,2024-01-12 18:50:00,46,166,Alimento,9,212
16972,2024-01-12 18:51:00,34,132,Eletrônico,2,166
16973,2024-01-12 18:52:00,68,37,Móvel,1,105
16974,2024-01-12 18:53:00,75,139,Móvel,1,214
16975,2024-01-12 18:54:00,68,161,Brinquedo,5,229
16976,2024-01-12 18:55:00,33,131,Eletrônico,4,164
16977,2024-01-12 18:56:00,112,99,Móvel,3,211
16978,2024-01-12 18:57:00,101,142,Eletrônico,3,243
16979,2024-01-12 18:58:00,42,64,Móvel,7,106
16980,2024-01-12 18:59:00,103,156,Brinquedo,4,259
16981,2024-01-12 19:00:00,101,53,Brinquedo,5,154
16982,2024-01-12 19:01:00,57,40,Eletrônico,2,97
16983,2024-01-12 19:02:00,93,153,Alimento,5,246
16984,2024-01-12 19:03:00,37,13,Brinquedo,2,50
16985,2024-01-12 19:04:00,63,178,Brinquedo,3,241
16986,2024-01-12 19:05:00,26,99,Brinquedo,9,125
16987,2024-01-12 19:06:00,72,140,Eletrônico,1,212
16988,2024-01-12 19:07:00,39,126,Móvel,1,165
16989,2024-01-12 19:08:00,117,40,Alimento,8,157
16990,2024-01-12 19:09:00,97,64,Vestuário,1,161
16991,2024-01-12 19:10:00,51,129,Vestuário,9,180
16992,2024-01-12 19:11:00,85,106,Vestuário,7,191
16993,2024-01-12 19:12:00,61,88,Brinquedo,9,149
16994,2024-01-12 19:13:00,68,143,Móvel,3,211
16995,2024-01-12 19:14:00,27,96,Brinquedo,5,123
16996,2024-01-12 19:15:00,94,16,Alimento,7,110
16997,2024-01-12 19:16:00,83,140,Brinquedo,5,223
16998,2024-01-12 19:17:00,38,44,Eletrônico,6,82
16999,2024-01-12 19:18:00,35,43,Alimento,4,78
17000,2024-01-12 19:19:00,89,78,Alimento,1,167
17001,2024-01-12 19:20:00,42,172,Brinquedo,3,214
17002,2024-01-12 19:21:00,110,28,Vestuário,2,138
17003,2024-01-12 19:22:00,20,115,Móvel,4,135
17004,2024-01-12 19:23:00,74,62,Brinquedo,1,136
17005,2024-01-12 19:24:00,34,124,Eletrônico,6,158
17006,2024-01-12 19:25:00,69,19,Eletrônico,4,88
17007,2024-01-12 19:26:00,96,76,Brinquedo,8,172
17008,2024-01-12 19:27:00,111,107,Vestuário,1,218
17009,2024-01-12 19:28:00,14,22,Vestuário,6,36
17010,2024-01-12 19:29:00,92,141,Brinquedo,4,233
17011,2024-01-12 19:30:00,82,32,Brinquedo,6,114
17012,2024-01-12 19:31:00,55,25,Móvel,1,80
17013,2024-01-12 19:32:00,80,84,Alimento,4,164
17014,2024-01-12 19:33:00,43,141,Móvel,6,184
17015,2024-01-12 19:34:00,37,144,Vestuário,3,181
17016,2024-01-12 19:35:00,12,32,Vestuário,8,44
17017,2024-01-12 19:36:00,68,137,Móvel,6,205
17018,2024-01-12 19:37:00,69,66,Eletrônico,2,135
17019,2024-01-12 19:38:00,107,109,Vestuário,1,216
17020,2024-01-12 19:39:00,84,101,Vestuário,2,185
17021,2024-01-12 19:40:00,98,45,Móvel,3,143
17022,2024-01-12 19:41:00,67,162,Alimento,3,229
17023,2024-01-12 19:42:00,69,109,Alimento,2,178
17024,2024-01-12 19:43:00,107,98,Móvel,3,205
17025,2024-01-12 19:44:00,50,54,Brinquedo,3,104
17026,2024-01-12 19:45:00,23,71,Móvel,5,94
17027,2024-01-12 19:46:00,13,131,Alimento,1,144
17028,2024-01-12 19:47:00,72,173,Brinquedo,2,245
17029,2024-01-12 19:48:00,113,142,Eletrônico,9,255
17030,2024-01-12 19:49:00,37,152,Eletrônico,2,189
17031,2024-01-12 19:50:00,89,78,Eletrônico,4,167
17032,2024-01-12 19:51:00,50,31,Brinquedo,1,81
17033,2024-01-12 19:52:00,49,80,Móvel,7,129
17034,2024-01-12 19:53:00,110,54,Móvel,6,164
17035,2024-01-12 19:54:00,23,105,Vestuário,4,128
17036,2024-01-12 19:55:00,60,108,Brinquedo,6,168
17037,2024-01-12 19:56:00,40,175,Eletrônico,5,215
17038,2024-01-12 19:57:00,49,24,Brinquedo,9,73
17039,2024-01-12 19:58:00,10,122,Eletrônico,8,132
17040,2024-01-12 19:59:00,77,92,Vestuário,6,169
17041,2024-01-12 20:00:00,113,33,Móvel,5,146
17042,2024-01-12 20:01:00,30,28,Eletrônico,2,58
17043,2024-01-12 20:02:00,49,151,Móvel,5,200
17044,2024-01-12 20:03:00,13,125,Alimento,7,138
17045,2024-01-12 20:04:00,41,27,Móvel,4,68
17046,2024-01-12 20:05:00,84,36,Alimento,1,120
17047,2024-01-12 20:06:00,48,124,Vestuário,9,172
17048,2024-01-12 20:07:00,39,123,Alimento,8,162
17049,2024-01-12 20:08:00,93,149,Vestuário,1,242
17050,2024-01-12 20:09:00,63,90,Móvel,6,153
17051,2024-01-12 20:10:00,48,134,Eletrônico,3,182
17052,2024-01-12 20:11:00,110,38,Vestuário,7,148
17053,2024-01-12 20:12:00,95,49,Eletrônico,5,144
17054,2024-01-12 20:13:00,58,62,Alimento,5,120
17055,2024-01-12 20:14:00,42,176,Vestuário,1,218
17056,2024-01-12 20:15:00,90,169,Brinquedo,4,259
17057,2024-01-12 20:16:00,67,52,Alimento,3,119
17058,2024-01-12 20:17:00,12,21,Eletrônico,2,33
17059,2024-01-12 20:18:00,111,79,Móvel,6,190
17060,2024-01-12 20:19:00,102,21,Móvel,4,123
17061,2024-01-12 20:20:00,27,105,Vestuário,7,132
17062,2024-01-12 20:21:00,44,135,Alimento,6,179
17063,2024-01-12 20:22:00,96,111,Alimento,8,207
17064,2024-01-12 20:23:00,107,117,Vestuário,7,224
17065,2024-01-12 20:24:00,117,38,Brinquedo,4,155
17066,2024-01-12 20:25:00,59,89,Brinquedo,4,148
17067,2024-01-12 20:26:00,116,74,Vestuário,1,190
17068,2024-01-12 20:27:00,31,67,Eletrônico,8,98
17069,2024-01-12 20:28:00,89,98,Eletrônico,6,187
17070,2024-01-12 20:29:00,66,66,Vestuário,7,132
17071,2024-01-12 20:30:00,71,106,Eletrônico,9,177
17072,2024-01-12 20:31:00,114,130,Eletrônico,5,244
17073,2024-01-12 20:32:00,112,27,Vestuário,1,139
17074,2024-01-12 20:33:00,48,119,Alimento,2,167
17075,2024-01-12 20:34:00,22,70,Alimento,3,92
17076,2024-01-12 20:35:00,51,150,Alimento,7,201
17077,2024-01-12 20:36:00,76,62,Vestuário,1,138
17078,2024-01-12 20:37:00,114,138,Brinquedo,5,252
17079,2024-01-12 20:38:00,39,91,Eletrônico,7,130
17080,2024-01-12 20:39:00,70,173,Móvel,5,243
17081,2024-01-12 20:40:00,76,115,Alimento,1,191
17082,2024-01-12 20:41:00,98,23,Brinquedo,6,121
17083,2024-01-12 20:42:00,79,144,Vestuário,7,223
17084,2024-01-12 20:43:00,77,152,Eletrônico,6,229
17085,2024-01-12 20:44:00,95,73,Móvel,1,168
17086,2024-01-12 20:45:00,58,51,Eletrônico,5,109
17087,2024-01-12 20:46:00,18,90,Móvel,8,108
17088,2024-01-12 20:47:00,73,81,Eletrônico,7,154
17089,2024-01-12 20:48:00,29,40,Móvel,7,69
17090,2024-01-12 20:49:00,42,136,Eletrônico,5,178
17091,2024-01-12 20:50:00,116,101,Alimento,4,217
17092,2024-01-12 20:51:00,84,73,Vestuário,1,157
17093,2024-01-12 20:52:00,106,79,Móvel,7,185
17094,2024-01-12 20:53:00,28,159,Vestuário,8,187
17095,2024-01-12 20:54:00,88,140,Vestuário,5,228
17096,2024-01-12 20:55:00,12,88,Brinquedo,1,100
17097,2024-01-12 20:56:00,44,51,Alimento,5,95
17098,2024-01-12 20:57:00,26,68,Brinquedo,6,94
17099,2024-01-12 20:58:00,40,25,Vestuário,9,65
17100,2024-01-12 20:59:00,80,135,Móvel,1,215
17101,2024-01-12 21:00:00,80,13,Brinquedo,6,93
17102,2024-01-12 21:01:00,61,98,Móvel,6,159
17103,2024-01-12 21:02:00,64,16,Brinquedo,3,80
17104,2024-01-12 21:03:00,114,13,Brinquedo,2,127
17105,2024-01-12 21:04:00,11,92,Alimento,2,103
17106,2024-01-12 21:05:00,33,71,Móvel,9,104
17107,2024-01-12 21:06:00,34,163,Vestuário,6,197
17108,2024-01-12 21:07:00,27,140,Alimento,5,167
17109,2024-01-12 21:08:00,42,23,Eletrônico,9,65
17110,2024-01-12 21:09:00,98,143,Alimento,2,241
17111,2024-01-12 21:10:00,96,107,Alimento,5,203
17112,2024-01-12 21:11:00,22,100,Móvel,7,122
17113,2024-01-12 21:12:00,45,88,Brinquedo,2,133
17114,2024-01-12 21:13:00,113,139,Móvel,1,252
17115,2024-01-12 21:14:00,92,22,Brinquedo,3,114
17116,2024-01-12 21:15:00,29,170,Móvel,1,199
17117,2024-01-12 21:16:00,41,153,Eletrônico,6,194
17118,2024-01-12 21:17:00,35,128,Brinquedo,7,163
17119,2024-01-12 21:18:00,61,45,Alimento,9,106
17120,2024-01-12 21:19:00,93,67,Vestuário,1,160
17121,2024-01-12 21:20:00,102,170,Brinquedo,5,272
17122,2024-01-12 21:21:00,89,153,Eletrônico,8,242
17123,2024-01-12 21:22:00,44,73,Móvel,1,117
17124,2024-01-12 21:23:00,106,178,Alimento,3,284
17125,2024-01-12 21:24:00,84,121,Alimento,7,205
17126,2024-01-12 21:25:00,116,167,Vestuário,7,283
17127,2024-01-12 21:26:00,33,162,Eletrônico,8,195
17128,2024-01-12 21:27:00,46,72,Alimento,3,118
17129,2024-01-12 21:28:00,40,27,Brinquedo,5,67
17130,2024-01-12 21:29:00,38,48,Eletrônico,9,86
17131,2024-01-12 21:30:00,77,91,Brinquedo,1,168
17132,2024-01-12 21:31:00,26,171,Móvel,4,197
17133,2024-01-12 21:32:00,28,79,Móvel,7,107
17134,2024-01-12 21:33:00,83,52,Alimento,3,135
17135,2024-01-12 21:34:00,76,158,Brinquedo,6,234
17136,2024-01-12 21:35:00,95,128,Brinquedo,7,223
17137,2024-01-12 21:36:00,101,61,Vestuário,9,162
17138,2024-01-12 21:37:00,78,144,Eletrônico,6,222
17139,2024-01-12 21:38:00,103,66,Vestuário,7,169
17140,2024-01-12 21:39:00,58,84,Brinquedo,6,142
17141,2024-01-12 21:40:00,74,44,Móvel,8,118
17142,2024-01-12 21:41:00,20,90,Brinquedo,2,110
17143,2024-01-12 21:42:00,49,39,Alimento,1,88
17144,2024-01-12 21:43:00,61,16,Vestuário,2,77
17145,2024-01-12 21:44:00,116,152,Eletrônico,6,268
17146,2024-01-12 21:45:00,101,173,Móvel,1,274
17147,2024-01-12 21:46:00,45,22,Brinquedo,4,67
17148,2024-01-12 21:47:00,97,41,Vestuário,4,138
17149,2024-01-12 21:48:00,72,27,Alimento,3,99
17150,2024-01-12 21:49:00,19,58,Móvel,2,77
17151,2024-01-12 21:50:00,71,51,Eletrônico,6,122
17152,2024-01-12 21:51:00,25,68,Eletrônico,2,93
17153,2024-01-12 21:52:00,77,155,Eletrônico,5,232
17154,2024-01-12 21:53:00,105,97,Brinquedo,9,202
17155,2024-01-12 21:54:00,78,114,Eletrônico,5,192
17156,2024-01-12 21:55:00,49,107,Brinquedo,5,156
17157,2024-01-12 21:56:00,13,149,Vestuário,7,162
17158,2024-01-12 21:57:00,27,67,Móvel,2,94
17159,2024-01-12 21:58:00,77,77,Vestuário,9,154
17160,2024-01-12 21:59:00,108,154,Alimento,2,262
17161,2024-01-12 22:00:00,26,28,Brinquedo,7,54
17162,2024-01-12 22:01:00,26,59,Eletrônico,3,85
17163,2024-01-12 22:02:00,51,177,Alimento,2,228
17164,2024-01-12 22:03:00,73,54,Eletrônico,3,127
17165,2024-01-12 22:04:00,78,38,Alimento,2,116
17166,2024-01-12 22:05:00,77,136,Móvel,9,213
17167,2024-01-12 22:06:00,33,64,Brinquedo,8,97
17168,2024-01-12 22:07:00,28,179,Brinquedo,9,207
17169,2024-01-12 22:08:00,73,27,Alimento,4,100
17170,2024-01-12 22:09:00,96,41,Móvel,9,137
17171,2024-01-12 22:10:00,92,131,Eletrônico,1,223
17172,2024-01-12 22:11:00,52,154,Vestuário,2,206
17173,2024-01-12 22:12:00,118,122,Vestuário,2,240
17174,2024-01-12 22:13:00,84,52,Brinquedo,8,136
17175,2024-01-12 22:14:00,32,132,Alimento,3,164
17176,2024-01-12 22:15:00,37,132,Vestuário,9,169
17177,2024-01-12 22:16:00,55,18,Brinquedo,8,73
17178,2024-01-12 22:17:00,26,103,Eletrônico,4,129
17179,2024-01-12 22:18:00,85,178,Alimento,4,263
17180,2024-01-12 22:19:00,34,32,Brinquedo,3,66
17181,2024-01-12 22:20:00,13,47,Vestuário,4,60
17182,2024-01-12 22:21:00,94,25,Vestuário,9,119
17183,2024-01-12 22:22:00,23,128,Eletrônico,8,151
17184,2024-01-12 22:23:00,25,131,Brinquedo,7,156
17185,2024-01-12 22:24:00,33,148,Eletrônico,1,181
17186,2024-01-12 22:25:00,56,146,Móvel,6,202
17187,2024-01-12 22:26:00,12,122,Vestuário,7,134
17188,2024-01-12 22:27:00,75,62,Móvel,5,137
17189,2024-01-12 22:28:00,65,119,Brinquedo,8,184
17190,2024-01-12 22:29:00,23,30,Móvel,4,53
17191,2024-01-12 22:30:00,81,99,Alimento,4,180
17192,2024-01-12 22:31:00,98,162,Alimento,6,260
17193,2024-01-12 22:32:00,74,85,Móvel,6,159
17194,2024-01-12 22:33:00,24,76,Alimento,4,100
17195,2024-01-12 22:34:00,59,49,Móvel,4,108
17196,2024-01-12 22:35:00,77,43,Vestuário,2,120
17197,2024-01-12 22:36:00,66,23,Brinquedo,8,89
17198,2024-01-12 22:37:00,96,145,Móvel,5,241
17199,2024-01-12 22:38:00,28,127,Vestuário,2,155
17200,2024-01-12 22:39:00,78,59,Vestuário,7,137
17201,2024-01-12 22:40:00,36,129,Eletrônico,3,165
17202,2024-01-12 22:41:00,115,122,Móvel,7,237
17203,2024-01-12 22:42:00,101,42,Alimento,2,143
17204,2024-01-12 22:43:00,36,118,Brinquedo,6,154
17205,2024-01-12 22:44:00,84,22,Alimento,4,106
17206,2024-01-12 22:45:00,81,145,Alimento,2,226
17207,2024-01-12 22:46:00,65,66,Móvel,6,131
17208,2024-01-12 22:47:00,75,41,Alimento,3,116
17209,2024-01-12 22:48:00,74,63,Móvel,8,137
17210,2024-01-12 22:49:00,99,156,Vestuário,8,255
17211,2024-01-12 22:50:00,29,70,Alimento,9,99
17212,2024-01-12 22:51:00,17,139,Vestuário,9,156
17213,2024-01-12 22:52:00,80,55,Vestuário,9,135
17214,2024-01-12 22:53:00,15,121,Móvel,7,136
17215,2024-01-12 22:54:00,39,142,Vestuário,1,181
17216,2024-01-12 22:55:00,100,75,Vestuário,5,175
17217,2024-01-12 22:56:00,103,89,Eletrônico,1,192
17218,2024-01-12 22:57:00,84,47,Eletrônico,8,131
17219,2024-01-12 22:58:00,110,13,Brinquedo,5,123
17220,2024-01-12 22:59:00,20,99,Brinquedo,1,119
17221,2024-01-12 23:00:00,41,88,Eletrônico,2,129
17222,2024-01-12 23:01:00,94,36,Eletrônico,8,130
17223,2024-01-12 23:02:00,25,34,Alimento,8,59
17224,2024-01-12 23:03:00,54,149,Vestuário,9,203
17225,2024-01-12 23:04:00,23,88,Móvel,3,111
17226,2024-01-12 23:05:00,65,161,Alimento,1,226
17227,2024-01-12 23:06:00,100,19,Eletrônico,2,119
17228,2024-01-12 23:07:00,69,54,Móvel,5,123
17229,2024-01-12 23:08:00,19,163,Vestuário,7,182
17230,2024-01-12 23:09:00,66,130,Brinquedo,9,196
17231,2024-01-12 23:10:00,34,20,Eletrônico,9,54
17232,2024-01-12 23:11:00,39,87,Alimento,5,126
17233,2024-01-12 23:12:00,113,36,Brinquedo,4,149
17234,2024-01-12 23:13:00,84,24,Alimento,1,108
17235,2024-01-12 23:14:00,25,85,Alimento,6,110
17236,2024-01-12 23:15:00,19,123,Móvel,2,142
17237,2024-01-12 23:16:00,46,13,Móvel,9,59
17238,2024-01-12 23:17:00,21,71,Alimento,6,92
17239,2024-01-12 23:18:00,101,129,Alimento,9,230
17240,2024-01-12 23:19:00,62,36,Alimento,2,98
17241,2024-01-12 23:20:00,90,72,Eletrônico,7,162
17242,2024-01-12 23:21:00,115,112,Vestuário,5,227
17243,2024-01-12 23:22:00,39,28,Móvel,6,67
17244,2024-01-12 23:23:00,52,20,Brinquedo,8,72
17245,2024-01-12 23:24:00,16,142,Brinquedo,3,158
17246,2024-01-12 23:25:00,66,122,Vestuário,5,188
17247,2024-01-12 23:26:00,86,57,Brinquedo,6,143
17248,2024-01-12 23:27:00,78,48,Alimento,7,126
17249,2024-01-12 23:28:00,116,17,Eletrônico,3,133
17250,2024-01-12 23:29:00,20,49,Eletrônico,7,69
17251,2024-01-12 23:30:00,27,161,Móvel,1,188
17252,2024-01-12 23:31:00,61,45,Móvel,1,106
17253,2024-01-12 23:32:00,105,17,Móvel,7,122
17254,2024-01-12 23:33:00,76,58,Brinquedo,2,134
17255,2024-01-12 23:34:00,33,179,Móvel,6,212
17256,2024-01-12 23:35:00,97,71,Alimento,1,168
17257,2024-01-12 23:36:00,42,23,Brinquedo,5,65
17258,2024-01-12 23:37:00,74,45,Móvel,4,119
17259,2024-01-12 23:38:00,92,15,Móvel,9,107
17260,2024-01-12 23:39:00,106,178,Móvel,9,284
17261,2024-01-12 23:40:00,64,115,Vestuário,1,179
17262,2024-01-12 23:41:00,78,38,Vestuário,8,116
17263,2024-01-12 23:42:00,48,160,Eletrônico,8,208
17264,2024-01-12 23:43:00,54,21,Alimento,8,75
17265,2024-01-12 23:44:00,103,124,Vestuário,4,227
17266,2024-01-12 23:45:00,119,14,Vestuário,2,133
17267,2024-01-12 23:46:00,96,159,Brinquedo,9,255
17268,2024-01-12 23:47:00,118,179,Alimento,9,297
17269,2024-01-12 23:48:00,25,125,Eletrônico,2,150
17270,2024-01-12 23:49:00,71,136,Alimento,6,207
17271,2024-01-12 23:50:00,53,155,Alimento,3,208
17272,2024-01-12 23:51:00,30,174,Móvel,3,204
17273,2024-01-12 23:52:00,19,74,Eletrônico,5,93
17274,2024-01-12 23:53:00,59,99,Vestuário,2,158
17275,2024-01-12 23:54:00,101,156,Eletrônico,2,257
17276,2024-01-12 23:55:00,72,24,Vestuário,6,96
17277,2024-01-12 23:56:00,88,179,Móvel,6,267
17278,2024-01-12 23:57:00,105,145,Alimento,2,250
17279,2024-01-12 23:58:00,99,121,Alimento,6,220
17280,2024-01-12 23:59:00,52,56,Alimento,3,108
17281,2024-01-13 00:00:00,14,57,Eletrônico,1,71
17282,2024-01-13 00:01:00,36,179,Móvel,2,215
17283,2024-01-13 00:02:00,93,93,Brinquedo,6,186
17284,2024-01-13 00:03:00,42,160,Móvel,7,202
17285,2024-01-13 00:04:00,44,101,Alimento,7,145
17286,2024-01-13 00:05:00,94,61,Brinquedo,2,155
17287,2024-01-13 00:06:00,113,73,Alimento,7,186
17288,2024-01-13 00:07:00,102,70,Eletrônico,8,172
17289,2024-01-13 00:08:00,81,155,Brinquedo,3,236
17290,2024-01-13 00:09:00,77,104,Vestuário,8,181
17291,2024-01-13 00:10:00,18,81,Alimento,7,99
17292,2024-01-13 00:11:00,78,67,Alimento,9,145
17293,2024-01-13 00:12:00,29,89,Eletrônico,2,118
17294,2024-01-13 00:13:00,86,34,Alimento,4,120
17295,2024-01-13 00:14:00,54,79,Eletrônico,7,133
17296,2024-01-13 00:15:00,77,146,Brinquedo,2,223
17297,2024-01-13 00:16:00,30,127,Eletrônico,4,157
17298,2024-01-13 00:17:00,47,58,Móvel,6,105
17299,2024-01-13 00:18:00,51,95,Eletrônico,1,146
17300,2024-01-13 00:19:00,59,13,Vestuário,6,72
17301,2024-01-13 00:20:00,56,146,Eletrônico,1,202
17302,2024-01-13 00:21:00,106,114,Móvel,7,220
17303,2024-01-13 00:22:00,40,53,Eletrônico,1,93
17304,2024-01-13 00:23:00,21,27,Móvel,2,48
17305,2024-01-13 00:24:00,100,37,Brinquedo,9,137
17306,2024-01-13 00:25:00,75,73,Eletrônico,9,148
17307,2024-01-13 00:26:00,118,55,Móvel,7,173
17308,2024-01-13 00:27:00,20,48,Móvel,6,68
17309,2024-01-13 00:28:00,56,150,Brinquedo,9,206
17310,2024-01-13 00:29:00,114,38,Vestuário,6,152
17311,2024-01-13 00:30:00,42,93,Vestuário,8,135
17312,2024-01-13 00:31:00,46,176,Vestuário,6,222
17313,2024-01-13 00:32:00,95,19,Alimento,9,114
17314,2024-01-13 00:33:00,113,169,Móvel,1,282
17315,2024-01-13 00:34:00,43,22,Eletrônico,3,65
17316,2024-01-13 00:35:00,12,146,Alimento,3,158
17317,2024-01-13 00:36:00,80,46,Móvel,5,126
17318,2024-01-13 00:37:00,18,166,Alimento,8,184
17319,2024-01-13 00:38:00,36,140,Eletrônico,4,176
17320,2024-01-13 00:39:00,38,175,Alimento,6,213
17321,2024-01-13 00:40:00,66,70,Eletrônico,5,136
17322,2024-01-13 00:41:00,28,106,Eletrônico,5,134
17323,2024-01-13 00:42:00,22,108,Brinquedo,6,130
17324,2024-01-13 00:43:00,101,98,Eletrônico,3,199
17325,2024-01-13 00:44:00,76,162,Móvel,7,238
17326,2024-01-13 00:45:00,63,23,Brinquedo,3,86
17327,2024-01-13 00:46:00,36,85,Alimento,4,121
17328,2024-01-13 00:47:00,17,31,Brinquedo,6,48
17329,2024-01-13 00:48:00,30,152,Alimento,2,182
17330,2024-01-13 00:49:00,80,37,Alimento,9,117
17331,2024-01-13 00:50:00,103,61,Alimento,3,164
17332,2024-01-13 00:51:00,53,106,Brinquedo,5,159
17333,2024-01-13 00:52:00,91,58,Vestuário,5,149
17334,2024-01-13 00:53:00,18,95,Eletrônico,2,113
17335,2024-01-13 00:54:00,85,45,Eletrônico,3,130
17336,2024-01-13 00:55:00,99,10,Alimento,8,109
17337,2024-01-13 00:56:00,112,166,Eletrônico,7,278
17338,2024-01-13 00:57:00,95,76,Móvel,7,171
17339,2024-01-13 00:58:00,46,77,Móvel,3,123
17340,2024-01-13 00:59:00,15,54,Vestuário,6,69
17341,2024-01-13 01:00:00,83,146,Eletrônico,6,229
17342,2024-01-13 01:01:00,95,117,Eletrônico,1,212
17343,2024-01-13 01:02:00,66,24,Alimento,5,90
17344,2024-01-13 01:03:00,24,72,Vestuário,4,96
17345,2024-01-13 01:04:00,101,20,Eletrônico,7,121
17346,2024-01-13 01:05:00,98,112,Eletrônico,8,210
17347,2024-01-13 01:06:00,70,59,Eletrônico,5,129
17348,2024-01-13 01:07:00,114,38,Alimento,5,152
17349,2024-01-13 01:08:00,96,107,Brinquedo,5,203
17350,2024-01-13 01:09:00,93,76,Móvel,6,169
17351,2024-01-13 01:10:00,73,12,Eletrônico,7,85
17352,2024-01-13 01:11:00,63,76,Eletrônico,5,139
17353,2024-01-13 01:12:00,60,78,Alimento,8,138
17354,2024-01-13 01:13:00,100,65,Móvel,1,165
17355,2024-01-13 01:14:00,47,35,Eletrônico,1,82
17356,2024-01-13 01:15:00,41,56,Vestuário,2,97
17357,2024-01-13 01:16:00,44,167,Móvel,2,211
17358,2024-01-13 01:17:00,116,122,Eletrônico,6,238
17359,2024-01-13 01:18:00,69,98,Eletrônico,9,167
17360,2024-01-13 01:19:00,37,79,Vestuário,5,116
17361,2024-01-13 01:20:00,69,54,Vestuário,4,123
17362,2024-01-13 01:21:00,36,151,Móvel,2,187
17363,2024-01-13 01:22:00,103,51,Eletrônico,5,154
17364,2024-01-13 01:23:00,82,148,Alimento,2,230
17365,2024-01-13 01:24:00,60,84,Alimento,8,144
17366,2024-01-13 01:25:00,103,135,Móvel,7,238
17367,2024-01-13 01:26:00,113,14,Vestuário,9,127
17368,2024-01-13 01:27:00,65,127,Vestuário,7,192
17369,2024-01-13 01:28:00,52,137,Eletrônico,3,189
17370,2024-01-13 01:29:00,119,167,Brinquedo,2,286
17371,2024-01-13 01:30:00,65,159,Alimento,3,224
17372,2024-01-13 01:31:00,96,69,Móvel,3,165
17373,2024-01-13 01:32:00,114,19,Vestuário,7,133
17374,2024-01-13 01:33:00,77,45,Eletrônico,2,122
17375,2024-01-13 01:34:00,110,10,Brinquedo,6,120
17376,2024-01-13 01:35:00,61,169,Móvel,5,230
17377,2024-01-13 01:36:00,47,99,Alimento,9,146
17378,2024-01-13 01:37:00,70,39,Móvel,9,109
17379,2024-01-13 01:38:00,116,119,Móvel,5,235
17380,2024-01-13 01:39:00,79,164,Móvel,3,243
17381,2024-01-13 01:40:00,91,37,Móvel,3,128
17382,2024-01-13 01:41:00,36,70,Alimento,6,106
17383,2024-01-13 01:42:00,111,165,Móvel,3,276
17384,2024-01-13 01:43:00,96,153,Brinquedo,1,249
17385,2024-01-13 01:44:00,68,178,Móvel,5,246
17386,2024-01-13 01:45:00,34,161,Brinquedo,9,195
17387,2024-01-13 01:46:00,62,95,Vestuário,7,157
17388,2024-01-13 01:47:00,96,46,Brinquedo,9,142
17389,2024-01-13 01:48:00,60,93,Alimento,2,153
17390,2024-01-13 01:49:00,113,123,Eletrônico,7,236
17391,2024-01-13 01:50:00,44,16,Eletrônico,4,60
17392,2024-01-13 01:51:00,44,152,Eletrônico,9,196
17393,2024-01-13 01:52:00,90,122,Móvel,3,212
17394,2024-01-13 01:53:00,98,160,Brinquedo,7,258
17395,2024-01-13 01:54:00,81,139,Vestuário,7,220
17396,2024-01-13 01:55:00,85,171,Vestuário,9,256
17397,2024-01-13 01:56:00,95,104,Brinquedo,9,199
17398,2024-01-13 01:57:00,14,89,Brinquedo,4,103
17399,2024-01-13 01:58:00,93,64,Eletrônico,1,157
17400,2024-01-13 01:59:00,46,31,Vestuário,2,77
17401,2024-01-13 02:00:00,49,18,Móvel,7,67
17402,2024-01-13 02:01:00,57,141,Móvel,9,198
17403,2024-01-13 02:02:00,64,124,Brinquedo,6,188
17404,2024-01-13 02:03:00,87,102,Vestuário,2,189
17405,2024-01-13 02:04:00,104,72,Alimento,2,176
17406,2024-01-13 02:05:00,45,23,Alimento,1,68
17407,2024-01-13 02:06:00,103,142,Vestuário,7,245
17408,2024-01-13 02:07:00,50,77,Brinquedo,8,127
17409,2024-01-13 02:08:00,89,119,Alimento,4,208
17410,2024-01-13 02:09:00,20,154,Vestuário,9,174
17411,2024-01-13 02:10:00,34,119,Vestuário,1,153
17412,2024-01-13 02:11:00,105,166,Vestuário,2,271
17413,2024-01-13 02:12:00,65,146,Vestuário,8,211
17414,2024-01-13 02:13:00,52,103,Vestuário,5,155
17415,2024-01-13 02:14:00,85,105,Eletrônico,6,190
17416,2024-01-13 02:15:00,109,68,Alimento,6,177
17417,2024-01-13 02:16:00,94,92,Vestuário,7,186
17418,2024-01-13 02:17:00,89,173,Móvel,4,262
17419,2024-01-13 02:18:00,38,139,Brinquedo,9,177
17420,2024-01-13 02:19:00,57,35,Vestuário,7,92
17421,2024-01-13 02:20:00,57,61,Eletrônico,2,118
17422,2024-01-13 02:21:00,74,171,Eletrônico,5,245
17423,2024-01-13 02:22:00,29,44,Brinquedo,7,73
17424,2024-01-13 02:23:00,10,104,Alimento,3,114
17425,2024-01-13 02:24:00,57,97,Alimento,4,154
17426,2024-01-13 02:25:00,85,112,Vestuário,2,197
17427,2024-01-13 02:26:00,10,20,Brinquedo,7,30
17428,2024-01-13 02:27:00,38,71,Vestuário,5,109
17429,2024-01-13 02:28:00,105,112,Vestuário,8,217
17430,2024-01-13 02:29:00,16,55,Brinquedo,9,71
17431,2024-01-13 02:30:00,91,164,Brinquedo,4,255
17432,2024-01-13 02:31:00,28,151,Móvel,9,179
17433,2024-01-13 02:32:00,38,76,Eletrônico,2,114
17434,2024-01-13 02:33:00,56,130,Brinquedo,8,186
17435,2024-01-13 02:34:00,112,150,Brinquedo,5,262
17436,2024-01-13 02:35:00,108,69,Móvel,4,177
17437,2024-01-13 02:36:00,90,112,Brinquedo,2,202
17438,2024-01-13 02:37:00,50,49,Móvel,5,99
17439,2024-01-13 02:38:00,82,175,Móvel,5,257
17440,2024-01-13 02:39:00,20,165,Vestuário,4,185
17441,2024-01-13 02:40:00,110,43,Vestuário,7,153
17442,2024-01-13 02:41:00,13,115,Alimento,1,128
17443,2024-01-13 02:42:00,77,111,Vestuário,2,188
17444,2024-01-13 02:43:00,71,30,Brinquedo,3,101
17445,2024-01-13 02:44:00,33,35,Móvel,9,68
17446,2024-01-13 02:45:00,75,96,Móvel,3,171
17447,2024-01-13 02:46:00,72,105,Alimento,3,177
17448,2024-01-13 02:47:00,115,82,Móvel,3,197
17449,2024-01-13 02:48:00,107,148,Alimento,8,255
17450,2024-01-13 02:49:00,61,179,Móvel,2,240
17451,2024-01-13 02:50:00,30,176,Brinquedo,9,206
17452,2024-01-13 02:51:00,17,56,Alimento,6,73
17453,2024-01-13 02:52:00,15,13,Alimento,9,28
17454,2024-01-13 02:53:00,67,109,Alimento,7,176
17455,2024-01-13 02:54:00,93,129,Móvel,1,222
17456,2024-01-13 02:55:00,119,178,Móvel,6,297
17457,2024-01-13 02:56:00,36,18,Eletrônico,8,54
17458,2024-01-13 02:57:00,69,43,Vestuário,9,112
17459,2024-01-13 02:58:00,38,83,Brinquedo,9,121
17460,2024-01-13 02:59:00,12,168,Móvel,6,180
17461,2024-01-13 03:00:00,56,159,Alimento,5,215
17462,2024-01-13 03:01:00,78,107,Eletrônico,8,185
17463,2024-01-13 03:02:00,112,116,Eletrônico,9,228
17464,2024-01-13 03:03:00,96,96,Vestuário,4,192
17465,2024-01-13 03:04:00,68,176,Vestuário,3,244
17466,2024-01-13 03:05:00,45,105,Vestuário,5,150
17467,2024-01-13 03:06:00,69,81,Eletrônico,7,150
17468,2024-01-13 03:07:00,61,137,Eletrônico,7,198
17469,2024-01-13 03:08:00,106,80,Eletrônico,4,186
17470,2024-01-13 03:09:00,37,35,Vestuário,9,72
17471,2024-01-13 03:10:00,43,23,Eletrônico,5,66
17472,2024-01-13 03:11:00,52,51,Alimento,9,103
17473,2024-01-13 03:12:00,112,74,Vestuário,9,186
17474,2024-01-13 03:13:00,59,127,Eletrônico,7,186
17475,2024-01-13 03:14:00,63,97,Vestuário,9,160
17476,2024-01-13 03:15:00,24,69,Vestuário,2,93
17477,2024-01-13 03:16:00,22,97,Brinquedo,4,119
17478,2024-01-13 03:17:00,39,22,Móvel,5,61
17479,2024-01-13 03:18:00,50,142,Alimento,4,192
17480,2024-01-13 03:19:00,101,70,Vestuário,9,171
17481,2024-01-13 03:20:00,91,53,Móvel,7,144
17482,2024-01-13 03:21:00,106,59,Alimento,8,165
17483,2024-01-13 03:22:00,43,115,Alimento,3,158
17484,2024-01-13 03:23:00,79,171,Móvel,2,250
17485,2024-01-13 03:24:00,113,30,Móvel,8,143
17486,2024-01-13 03:25:00,22,153,Brinquedo,7,175
17487,2024-01-13 03:26:00,39,79,Móvel,7,118
17488,2024-01-13 03:27:00,17,73,Vestuário,2,90
17489,2024-01-13 03:28:00,75,163,Vestuário,9,238
17490,2024-01-13 03:29:00,45,68,Alimento,5,113
17491,2024-01-13 03:30:00,42,20,Alimento,5,62
17492,2024-01-13 03:31:00,74,94,Alimento,7,168
17493,2024-01-13 03:32:00,95,69,Alimento,8,164
17494,2024-01-13 03:33:00,77,141,Brinquedo,2,218
17495,2024-01-13 03:34:00,60,105,Brinquedo,7,165
17496,2024-01-13 03:35:00,86,28,Móvel,8,114
17497,2024-01-13 03:36:00,68,135,Vestuário,2,203
17498,2024-01-13 03:37:00,104,70,Brinquedo,4,174
17499,2024-01-13 03:38:00,14,90,Eletrônico,1,104
17500,2024-01-13 03:39:00,36,143,Vestuário,7,179
17501,2024-01-13 03:40:00,44,176,Eletrônico,2,220
17502,2024-01-13 03:41:00,93,112,Móvel,8,205
17503,2024-01-13 03:42:00,37,44,Brinquedo,8,81
17504,2024-01-13 03:43:00,81,82,Vestuário,1,163
17505,2024-01-13 03:44:00,28,94,Alimento,7,122
17506,2024-01-13 03:45:00,90,36,Brinquedo,3,126
17507,2024-01-13 03:46:00,94,41,Móvel,5,135
17508,2024-01-13 03:47:00,42,90,Vestuário,6,132
17509,2024-01-13 03:48:00,65,173,Alimento,2,238
17510,2024-01-13 03:49:00,86,65,Móvel,3,151
17511,2024-01-13 03:50:00,31,96,Alimento,9,127
17512,2024-01-13 03:51:00,22,54,Vestuário,4,76
17513,2024-01-13 03:52:00,23,46,Vestuário,4,69
17514,2024-01-13 03:53:00,83,133,Alimento,6,216
17515,2024-01-13 03:54:00,95,17,Móvel,1,112
17516,2024-01-13 03:55:00,109,62,Móvel,7,171
17517,2024-01-13 03:56:00,45,86,Alimento,3,131
17518,2024-01-13 03:57:00,40,89,Brinquedo,7,129
17519,2024-01-13 03:58:00,78,166,Eletrônico,3,244
17520,2024-01-13 03:59:00,100,99,Brinquedo,3,199
17521,2024-01-13 04:00:00,107,80,Vestuário,8,187
17522,2024-01-13 04:01:00,37,124,Alimento,4,161
17523,2024-01-13 04:02:00,108,56,Alimento,8,164
17524,2024-01-13 04:03:00,115,146,Brinquedo,5,261
17525,2024-01-13 04:04:00,58,76,Móvel,2,134
17526,2024-01-13 04:05:00,61,70,Móvel,3,131
17527,2024-01-13 04:06:00,62,70,Vestuário,6,132
17528,2024-01-13 04:07:00,22,18,Eletrônico,9,40
17529,2024-01-13 04:08:00,45,123,Alimento,2,168
17530,2024-01-13 04:09:00,23,46,Brinquedo,6,69
17531,2024-01-13 04:10:00,72,92,Vestuário,9,164
17532,2024-01-13 04:11:00,113,57,Vestuário,3,170
17533,2024-01-13 04:12:00,59,38,Móvel,8,97
17534,2024-01-13 04:13:00,43,165,Alimento,9,208
17535,2024-01-13 04:14:00,16,99,Eletrônico,5,115
17536,2024-01-13 04:15:00,52,19,Brinquedo,8,71
17537,2024-01-13 04:16:00,33,174,Móvel,6,207
17538,2024-01-13 04:17:00,81,151,Brinquedo,8,232
17539,2024-01-13 04:18:00,81,55,Alimento,2,136
17540,2024-01-13 04:19:00,100,33,Brinquedo,8,133
17541,2024-01-13 04:20:00,46,86,Brinquedo,9,132
17542,2024-01-13 04:21:00,81,86,Alimento,9,167
17543,2024-01-13 04:22:00,88,17,Brinquedo,8,105
17544,2024-01-13 04:23:00,109,140,Alimento,7,249
17545,2024-01-13 04:24:00,48,115,Eletrônico,7,163
17546,2024-01-13 04:25:00,40,152,Móvel,5,192
17547,2024-01-13 04:26:00,59,45,Brinquedo,1,104
17548,2024-01-13 04:27:00,114,127,Alimento,9,241
17549,2024-01-13 04:28:00,52,54,Vestuário,7,106
17550,2024-01-13 04:29:00,112,108,Móvel,5,220
17551,2024-01-13 04:30:00,106,21,Eletrônico,3,127
17552,2024-01-13 04:31:00,57,109,Alimento,2,166
17553,2024-01-13 04:32:00,30,139,Alimento,9,169
17554,2024-01-13 04:33:00,13,37,Eletrônico,7,50
17555,2024-01-13 04:34:00,110,136,Eletrônico,7,246
17556,2024-01-13 04:35:00,49,48,Eletrônico,2,97
17557,2024-01-13 04:36:00,50,129,Eletrônico,6,179
17558,2024-01-13 04:37:00,64,80,Vestuário,8,144
17559,2024-01-13 04:38:00,80,154,Vestuário,3,234
17560,2024-01-13 04:39:00,60,98,Vestuário,6,158
17561,2024-01-13 04:40:00,65,97,Alimento,1,162
17562,2024-01-13 04:41:00,69,172,Móvel,9,241
17563,2024-01-13 04:42:00,22,118,Alimento,7,140
17564,2024-01-13 04:43:00,12,23,Móvel,2,35
17565,2024-01-13 04:44:00,34,35,Eletrônico,9,69
17566,2024-01-13 04:45:00,95,110,Vestuário,3,205
17567,2024-01-13 04:46:00,63,104,Móvel,2,167
17568,2024-01-13 04:47:00,29,104,Móvel,4,133
17569,2024-01-13 04:48:00,78,176,Vestuário,3,254
17570,2024-01-13 04:49:00,110,25,Vestuário,6,135
17571,2024-01-13 04:50:00,102,61,Vestuário,3,163
17572,2024-01-13 04:51:00,80,14,Alimento,1,94
17573,2024-01-13 04:52:00,30,18,Eletrônico,1,48
17574,2024-01-13 04:53:00,101,152,Móvel,6,253
17575,2024-01-13 04:54:00,101,176,Móvel,5,277
17576,2024-01-13 04:55:00,83,165,Brinquedo,1,248
17577,2024-01-13 04:56:00,88,69,Móvel,4,157
17578,2024-01-13 04:57:00,96,74,Alimento,4,170
17579,2024-01-13 04:58:00,105,123,Eletrônico,1,228
17580,2024-01-13 04:59:00,109,90,Vestuário,3,199
17581,2024-01-13 05:00:00,19,162,Móvel,4,181
17582,2024-01-13 05:01:00,65,60,Móvel,7,125
17583,2024-01-13 05:02:00,94,95,Móvel,8,189
17584,2024-01-13 05:03:00,76,104,Brinquedo,9,180
17585,2024-01-13 05:04:00,95,59,Eletrônico,3,154
17586,2024-01-13 05:05:00,16,34,Vestuário,9,50
17587,2024-01-13 05:06:00,94,96,Vestuário,9,190
17588,2024-01-13 05:07:00,36,104,Alimento,5,140
17589,2024-01-13 05:08:00,104,127,Móvel,4,231
17590,2024-01-13 05:09:00,72,157,Eletrônico,1,229
17591,2024-01-13 05:10:00,37,133,Vestuário,7,170
17592,2024-01-13 05:11:00,102,121,Vestuário,2,223
17593,2024-01-13 05:12:00,45,98,Vestuário,7,143
17594,2024-01-13 05:13:00,58,44,Vestuário,5,102
17595,2024-01-13 05:14:00,52,78,Vestuário,5,130
17596,2024-01-13 05:15:00,102,14,Alimento,3,116
17597,2024-01-13 05:16:00,28,73,Brinquedo,2,101
17598,2024-01-13 05:17:00,37,142,Vestuário,6,179
17599,2024-01-13 05:18:00,118,105,Móvel,9,223
17600,2024-01-13 05:19:00,24,136,Alimento,2,160
17601,2024-01-13 05:20:00,69,130,Vestuário,5,199
17602,2024-01-13 05:21:00,113,69,Móvel,6,182
17603,2024-01-13 05:22:00,97,82,Alimento,9,179
17604,2024-01-13 05:23:00,61,35,Vestuário,8,96
17605,2024-01-13 05:24:00,98,167,Eletrônico,8,265
17606,2024-01-13 05:25:00,94,129,Eletrônico,2,223
17607,2024-01-13 05:26:00,84,95,Vestuário,1,179
17608,2024-01-13 05:27:00,66,73,Alimento,4,139
17609,2024-01-13 05:28:00,30,45,Alimento,7,75
17610,2024-01-13 05:29:00,98,66,Vestuário,4,164
17611,2024-01-13 05:30:00,32,161,Alimento,3,193
17612,2024-01-13 05:31:00,119,102,Móvel,3,221
17613,2024-01-13 05:32:00,86,86,Eletrônico,7,172
17614,2024-01-13 05:33:00,62,110,Brinquedo,7,172
17615,2024-01-13 05:34:00,68,152,Móvel,1,220
17616,2024-01-13 05:35:00,102,112,Eletrônico,7,214
17617,2024-01-13 05:36:00,113,48,Vestuário,8,161
17618,2024-01-13 05:37:00,111,30,Alimento,7,141
17619,2024-01-13 05:38:00,108,67,Eletrônico,6,175
17620,2024-01-13 05:39:00,64,28,Alimento,1,92
17621,2024-01-13 05:40:00,91,86,Móvel,3,177
17622,2024-01-13 05:41:00,118,61,Alimento,9,179
17623,2024-01-13 05:42:00,32,36,Móvel,9,68
17624,2024-01-13 05:43:00,81,29,Alimento,4,110
17625,2024-01-13 05:44:00,28,16,Eletrônico,7,44
17626,2024-01-13 05:45:00,113,103,Eletrônico,3,216
17627,2024-01-13 05:46:00,91,37,Móvel,8,128
17628,2024-01-13 05:47:00,49,79,Vestuário,9,128
17629,2024-01-13 05:48:00,61,13,Vestuário,8,74
17630,2024-01-13 05:49:00,11,53,Móvel,3,64
17631,2024-01-13 05:50:00,90,167,Alimento,4,257
17632,2024-01-13 05:51:00,14,108,Vestuário,5,122
17633,2024-01-13 05:52:00,114,135,Eletrônico,6,249
17634,2024-01-13 05:53:00,51,99,Vestuário,8,150
17635,2024-01-13 05:54:00,100,122,Brinquedo,3,222
17636,2024-01-13 05:55:00,75,14,Eletrônico,3,89
17637,2024-01-13 05:56:00,114,140,Alimento,6,254
17638,2024-01-13 05:57:00,108,21,Vestuário,2,129
17639,2024-01-13 05:58:00,31,46,Móvel,2,77
17640,2024-01-13 05:59:00,86,94,Brinquedo,9,180
17641,2024-01-13 06:00:00,116,61,Eletrônico,2,177
17642,2024-01-13 06:01:00,38,139,Móvel,3,177
17643,2024-01-13 06:02:00,108,167,Alimento,9,275
17644,2024-01-13 06:03:00,16,91,Eletrônico,6,107
17645,2024-01-13 06:04:00,85,23,Alimento,2,108
17646,2024-01-13 06:05:00,83,117,Brinquedo,2,200
17647,2024-01-13 06:06:00,97,64,Móvel,6,161
17648,2024-01-13 06:07:00,42,85,Eletrônico,3,127
17649,2024-01-13 06:08:00,12,145,Alimento,8,157
17650,2024-01-13 06:09:00,73,100,Brinquedo,9,173
17651,2024-01-13 06:10:00,54,109,Móvel,4,163
17652,2024-01-13 06:11:00,20,69,Eletrônico,6,89
17653,2024-01-13 06:12:00,81,168,Alimento,6,249
17654,2024-01-13 06:13:00,58,130,Eletrônico,9,188
17655,2024-01-13 06:14:00,98,74,Eletrônico,5,172
17656,2024-01-13 06:15:00,104,20,Brinquedo,8,124
17657,2024-01-13 06:16:00,46,48,Brinquedo,7,94
17658,2024-01-13 06:17:00,88,68,Eletrônico,9,156
17659,2024-01-13 06:18:00,83,61,Vestuário,9,144
17660,2024-01-13 06:19:00,55,48,Alimento,1,103
17661,2024-01-13 06:20:00,94,106,Brinquedo,9,200
17662,2024-01-13 06:21:00,98,93,Eletrônico,7,191
17663,2024-01-13 06:22:00,117,143,Móvel,8,260
17664,2024-01-13 06:23:00,116,145,Alimento,7,261
17665,2024-01-13 06:24:00,93,37,Eletrônico,7,130
17666,2024-01-13 06:25:00,116,45,Alimento,9,161
17667,2024-01-13 06:26:00,17,144,Brinquedo,7,161
17668,2024-01-13 06:27:00,21,144,Móvel,5,165
17669,2024-01-13 06:28:00,93,125,Móvel,3,218
17670,2024-01-13 06:29:00,90,12,Alimento,2,102
17671,2024-01-13 06:30:00,97,59,Vestuário,1,156
17672,2024-01-13 06:31:00,54,102,Vestuário,9,156
17673,2024-01-13 06:32:00,49,73,Alimento,7,122
17674,2024-01-13 06:33:00,16,88,Eletrônico,1,104
17675,2024-01-13 06:34:00,39,178,Móvel,5,217
17676,2024-01-13 06:35:00,38,126,Alimento,1,164
17677,2024-01-13 06:36:00,71,94,Vestuário,7,165
17678,2024-01-13 06:37:00,69,155,Alimento,7,224
17679,2024-01-13 06:38:00,11,42,Vestuário,8,53
17680,2024-01-13 06:39:00,52,129,Vestuário,5,181
17681,2024-01-13 06:40:00,116,171,Vestuário,7,287
17682,2024-01-13 06:41:00,80,134,Vestuário,9,214
17683,2024-01-13 06:42:00,66,33,Brinquedo,8,99
17684,2024-01-13 06:43:00,94,110,Brinquedo,3,204
17685,2024-01-13 06:44:00,106,87,Eletrônico,3,193
17686,2024-01-13 06:45:00,111,38,Alimento,1,149
17687,2024-01-13 06:46:00,59,65,Eletrônico,2,124
17688,2024-01-13 06:47:00,70,123,Eletrônico,9,193
17689,2024-01-13 06:48:00,90,75,Alimento,7,165
17690,2024-01-13 06:49:00,118,160,Brinquedo,2,278
17691,2024-01-13 06:50:00,86,34,Eletrônico,4,120
17692,2024-01-13 06:51:00,28,80,Vestuário,6,108
17693,2024-01-13 06:52:00,39,167,Brinquedo,7,206
17694,2024-01-13 06:53:00,39,87,Eletrônico,2,126
17695,2024-01-13 06:54:00,35,47,Brinquedo,1,82
17696,2024-01-13 06:55:00,83,98,Alimento,9,181
17697,2024-01-13 06:56:00,93,173,Alimento,2,266
17698,2024-01-13 06:57:00,59,61,Eletrônico,2,120
17699,2024-01-13 06:58:00,48,178,Móvel,8,226
17700,2024-01-13 06:59:00,119,51,Móvel,4,170
17701,2024-01-13 07:00:00,50,134,Vestuário,9,184
17702,2024-01-13 07:01:00,40,151,Alimento,3,191
17703,2024-01-13 07:02:00,78,114,Móvel,6,192
17704,2024-01-13 07:03:00,46,133,Móvel,8,179
17705,2024-01-13 07:04:00,119,159,Brinquedo,8,278
17706,2024-01-13 07:05:00,86,130,Alimento,4,216
17707,2024-01-13 07:06:00,26,25,Vestuário,4,51
17708,2024-01-13 07:07:00,90,134,Brinquedo,4,224
17709,2024-01-13 07:08:00,46,72,Vestuário,8,118
17710,2024-01-13 07:09:00,44,155,Vestuário,7,199
17711,2024-01-13 07:10:00,13,44,Vestuário,3,57
17712,2024-01-13 07:11:00,53,139,Alimento,6,192
17713,2024-01-13 07:12:00,58,105,Móvel,3,163
17714,2024-01-13 07:13:00,30,45,Vestuário,3,75
17715,2024-01-13 07:14:00,49,55,Vestuário,7,104
17716,2024-01-13 07:15:00,13,140,Móvel,8,153
17717,2024-01-13 07:16:00,89,112,Vestuário,9,201
17718,2024-01-13 07:17:00,21,95,Eletrônico,6,116
17719,2024-01-13 07:18:00,76,108,Eletrônico,7,184
17720,2024-01-13 07:19:00,73,24,Brinquedo,5,97
17721,2024-01-13 07:20:00,39,138,Móvel,2,177
17722,2024-01-13 07:21:00,100,24,Alimento,6,124
17723,2024-01-13 07:22:00,66,144,Brinquedo,3,210
17724,2024-01-13 07:23:00,99,89,Vestuário,5,188
17725,2024-01-13 07:24:00,49,17,Eletrônico,8,66
17726,2024-01-13 07:25:00,97,105,Vestuário,7,202
17727,2024-01-13 07:26:00,50,38,Alimento,5,88
17728,2024-01-13 07:27:00,47,72,Brinquedo,1,119
17729,2024-01-13 07:28:00,47,95,Vestuário,5,142
17730,2024-01-13 07:29:00,55,48,Eletrônico,2,103
17731,2024-01-13 07:30:00,62,21,Alimento,5,83
17732,2024-01-13 07:31:00,75,152,Brinquedo,2,227
17733,2024-01-13 07:32:00,43,179,Brinquedo,3,222
17734,2024-01-13 07:33:00,77,123,Alimento,7,200
17735,2024-01-13 07:34:00,44,115,Móvel,3,159
17736,2024-01-13 07:35:00,38,152,Alimento,4,190
17737,2024-01-13 07:36:00,106,158,Móvel,7,264
17738,2024-01-13 07:37:00,25,55,Eletrônico,3,80
17739,2024-01-13 07:38:00,45,140,Eletrônico,9,185
17740,2024-01-13 07:39:00,84,133,Alimento,8,217
17741,2024-01-13 07:40:00,77,149,Vestuário,6,226
17742,2024-01-13 07:41:00,10,15,Brinquedo,5,25
17743,2024-01-13 07:42:00,114,135,Eletrônico,6,249
17744,2024-01-13 07:43:00,84,62,Brinquedo,1,146
17745,2024-01-13 07:44:00,26,119,Eletrônico,3,145
17746,2024-01-13 07:45:00,105,69,Alimento,8,174
17747,2024-01-13 07:46:00,18,45,Brinquedo,2,63
17748,2024-01-13 07:47:00,36,137,Eletrônico,9,173
17749,2024-01-13 07:48:00,119,58,Eletrônico,1,177
17750,2024-01-13 07:49:00,90,120,Eletrônico,3,210
17751,2024-01-13 07:50:00,109,161,Vestuário,8,270
17752,2024-01-13 07:51:00,98,58,Alimento,5,156
17753,2024-01-13 07:52:00,64,137,Móvel,7,201
17754,2024-01-13 07:53:00,38,101,Móvel,3,139
17755,2024-01-13 07:54:00,49,62,Alimento,3,111
17756,2024-01-13 07:55:00,109,68,Eletrônico,9,177
17757,2024-01-13 07:56:00,64,92,Vestuário,5,156
17758,2024-01-13 07:57:00,86,79,Eletrônico,7,165
17759,2024-01-13 07:58:00,39,141,Móvel,5,180
17760,2024-01-13 07:59:00,16,29,Alimento,2,45
17761,2024-01-13 08:00:00,62,84,Eletrônico,4,146
17762,2024-01-13 08:01:00,56,99,Vestuário,6,155
17763,2024-01-13 08:02:00,74,135,Vestuário,9,209
17764,2024-01-13 08:03:00,97,166,Eletrônico,4,263
17765,2024-01-13 08:04:00,56,149,Móvel,9,205
17766,2024-01-13 08:05:00,37,110,Eletrônico,1,147
17767,2024-01-13 08:06:00,13,51,Móvel,9,64
17768,2024-01-13 08:07:00,92,70,Móvel,2,162
17769,2024-01-13 08:08:00,64,75,Móvel,6,139
17770,2024-01-13 08:09:00,39,167,Alimento,5,206
17771,2024-01-13 08:10:00,61,101,Móvel,8,162
17772,2024-01-13 08:11:00,26,170,Eletrônico,7,196
17773,2024-01-13 08:12:00,47,31,Eletrônico,4,78
17774,2024-01-13 08:13:00,83,85,Brinquedo,2,168
17775,2024-01-13 08:14:00,73,131,Vestuário,7,204
17776,2024-01-13 08:15:00,87,61,Vestuário,4,148
17777,2024-01-13 08:16:00,70,52,Móvel,9,122
17778,2024-01-13 08:17:00,104,59,Móvel,3,163
17779,2024-01-13 08:18:00,32,138,Vestuário,3,170
17780,2024-01-13 08:19:00,37,97,Móvel,8,134
17781,2024-01-13 08:20:00,13,156,Alimento,3,169
17782,2024-01-13 08:21:00,88,82,Eletrônico,8,170
17783,2024-01-13 08:22:00,107,105,Vestuário,8,212
17784,2024-01-13 08:23:00,52,105,Eletrônico,7,157
17785,2024-01-13 08:24:00,34,138,Eletrônico,9,172
17786,2024-01-13 08:25:00,110,142,Brinquedo,2,252
17787,2024-01-13 08:26:00,75,48,Brinquedo,8,123
17788,2024-01-13 08:27:00,12,33,Vestuário,5,45
17789,2024-01-13 08:28:00,104,110,Vestuário,7,214
17790,2024-01-13 08:29:00,24,92,Vestuário,8,116
17791,2024-01-13 08:30:00,17,146,Vestuário,2,163
17792,2024-01-13 08:31:00,58,33,Eletrônico,4,91
17793,2024-01-13 08:32:00,26,91,Alimento,6,117
17794,2024-01-13 08:33:00,105,47,Eletrônico,5,152
17795,2024-01-13 08:34:00,109,18,Brinquedo,4,127
17796,2024-01-13 08:35:00,85,82,Eletrônico,8,167
17797,2024-01-13 08:36:00,65,146,Móvel,6,211
17798,2024-01-13 08:37:00,25,56,Alimento,4,81
17799,2024-01-13 08:38:00,100,60,Alimento,6,160
17800,2024-01-13 08:39:00,13,15,Eletrônico,4,28
17801,2024-01-13 08:40:00,70,19,Móvel,1,89
17802,2024-01-13 08:41:00,83,53,Vestuário,7,136
17803,2024-01-13 08:42:00,107,54,Móvel,3,161
17804,2024-01-13 08:43:00,25,157,Móvel,7,182
17805,2024-01-13 08:44:00,47,170,Vestuário,2,217
17806,2024-01-13 08:45:00,68,123,Alimento,1,191
17807,2024-01-13 08:46:00,82,102,Eletrônico,4,184
17808,2024-01-13 08:47:00,81,174,Móvel,7,255
17809,2024-01-13 08:48:00,86,38,Eletrônico,8,124
17810,2024-01-13 08:49:00,98,12,Alimento,3,110
17811,2024-01-13 08:50:00,78,164,Alimento,3,242
17812,2024-01-13 08:51:00,40,12,Móvel,1,52
17813,2024-01-13 08:52:00,87,152,Móvel,9,239
17814,2024-01-13 08:53:00,86,37,Brinquedo,6,123
17815,2024-01-13 08:54:00,31,179,Móvel,6,210
17816,2024-01-13 08:55:00,85,14,Brinquedo,7,99
17817,2024-01-13 08:56:00,40,129,Vestuário,8,169
17818,2024-01-13 08:57:00,91,105,Eletrônico,5,196
17819,2024-01-13 08:58:00,23,112,Brinquedo,9,135
17820,2024-01-13 08:59:00,67,158,Brinquedo,6,225
17821,2024-01-13 09:00:00,17,10,Vestuário,8,27
17822,2024-01-13 09:01:00,84,112,Vestuário,8,196
17823,2024-01-13 09:02:00,33,159,Vestuário,2,192
17824,2024-01-13 09:03:00,82,172,Eletrônico,2,254
17825,2024-01-13 09:04:00,67,56,Vestuário,7,123
17826,2024-01-13 09:05:00,101,163,Móvel,3,264
17827,2024-01-13 09:06:00,111,146,Móvel,8,257
17828,2024-01-13 09:07:00,112,81,Alimento,5,193
17829,2024-01-13 09:08:00,45,173,Alimento,2,218
17830,2024-01-13 09:09:00,72,48,Alimento,9,120
17831,2024-01-13 09:10:00,83,93,Móvel,9,176
17832,2024-01-13 09:11:00,90,143,Brinquedo,1,233
17833,2024-01-13 09:12:00,75,123,Móvel,6,198
17834,2024-01-13 09:13:00,53,131,Móvel,7,184
17835,2024-01-13 09:14:00,95,134,Vestuário,1,229
17836,2024-01-13 09:15:00,105,132,Móvel,7,237
17837,2024-01-13 09:16:00,107,85,Vestuário,6,192
17838,2024-01-13 09:17:00,58,95,Móvel,5,153
17839,2024-01-13 09:18:00,40,100,Móvel,1,140
17840,2024-01-13 09:19:00,27,156,Alimento,5,183
17841,2024-01-13 09:20:00,108,178,Vestuário,7,286
17842,2024-01-13 09:21:00,48,165,Alimento,5,213
17843,2024-01-13 09:22:00,19,49,Alimento,9,68
17844,2024-01-13 09:23:00,25,145,Móvel,3,170
17845,2024-01-13 09:24:00,84,57,Vestuário,4,141
17846,2024-01-13 09:25:00,94,17,Eletrônico,5,111
17847,2024-01-13 09:26:00,75,20,Móvel,2,95
17848,2024-01-13 09:27:00,105,95,Eletrônico,9,200
17849,2024-01-13 09:28:00,88,69,Vestuário,5,157
17850,2024-01-13 09:29:00,57,67,Alimento,5,124
17851,2024-01-13 09:30:00,100,49,Móvel,6,149
17852,2024-01-13 09:31:00,114,164,Móvel,3,278
17853,2024-01-13 09:32:00,80,124,Alimento,5,204
17854,2024-01-13 09:33:00,112,156,Brinquedo,3,268
17855,2024-01-13 09:34:00,74,106,Alimento,6,180
17856,2024-01-13 09:35:00,118,35,Móvel,9,153
17857,2024-01-13 09:36:00,115,110,Móvel,3,225
17858,2024-01-13 09:37:00,22,22,Brinquedo,4,44
17859,2024-01-13 09:38:00,62,107,Eletrônico,7,169
17860,2024-01-13 09:39:00,67,106,Alimento,1,173
17861,2024-01-13 09:40:00,41,156,Brinquedo,7,197
17862,2024-01-13 09:41:00,85,108,Móvel,3,193
17863,2024-01-13 09:42:00,75,173,Móvel,3,248
17864,2024-01-13 09:43:00,56,53,Móvel,5,109
17865,2024-01-13 09:44:00,59,39,Alimento,9,98
17866,2024-01-13 09:45:00,119,41,Vestuário,5,160
17867,2024-01-13 09:46:00,85,106,Vestuário,9,191
17868,2024-01-13 09:47:00,40,46,Vestuário,9,86
17869,2024-01-13 09:48:00,106,169,Móvel,3,275
17870,2024-01-13 09:49:00,26,166,Alimento,8,192
17871,2024-01-13 09:50:00,20,141,Móvel,2,161
17872,2024-01-13 09:51:00,91,63,Móvel,9,154
17873,2024-01-13 09:52:00,30,163,Alimento,2,193
17874,2024-01-13 09:53:00,94,132,Vestuário,2,226
17875,2024-01-13 09:54:00,35,121,Eletrônico,6,156
17876,2024-01-13 09:55:00,97,162,Vestuário,6,259
17877,2024-01-13 09:56:00,47,63,Eletrônico,8,110
17878,2024-01-13 09:57:00,84,107,Vestuário,3,191
17879,2024-01-13 09:58:00,76,69,Vestuário,8,145
17880,2024-01-13 09:59:00,47,62,Móvel,2,109
17881,2024-01-13 10:00:00,37,69,Eletrônico,9,106
17882,2024-01-13 10:01:00,42,116,Alimento,3,158
17883,2024-01-13 10:02:00,55,90,Alimento,2,145
17884,2024-01-13 10:03:00,52,144,Brinquedo,3,196
17885,2024-01-13 10:04:00,95,135,Móvel,5,230
17886,2024-01-13 10:05:00,113,137,Móvel,8,250
17887,2024-01-13 10:06:00,78,131,Móvel,5,209
17888,2024-01-13 10:07:00,78,24,Vestuário,4,102
17889,2024-01-13 10:08:00,18,89,Móvel,3,107
17890,2024-01-13 10:09:00,75,61,Brinquedo,6,136
17891,2024-01-13 10:10:00,108,13,Móvel,8,121
17892,2024-01-13 10:11:00,67,170,Eletrônico,1,237
17893,2024-01-13 10:12:00,51,78,Vestuário,6,129
17894,2024-01-13 10:13:00,36,84,Alimento,9,120
17895,2024-01-13 10:14:00,91,107,Móvel,3,198
17896,2024-01-13 10:15:00,86,14,Móvel,7,100
17897,2024-01-13 10:16:00,78,141,Vestuário,3,219
17898,2024-01-13 10:17:00,25,120,Móvel,1,145
17899,2024-01-13 10:18:00,44,162,Eletrônico,6,206
17900,2024-01-13 10:19:00,24,130,Brinquedo,2,154
17901,2024-01-13 10:20:00,35,148,Alimento,5,183
17902,2024-01-13 10:21:00,25,71,Eletrônico,7,96
17903,2024-01-13 10:22:00,56,12,Brinquedo,6,68
17904,2024-01-13 10:23:00,31,100,Eletrônico,1,131
17905,2024-01-13 10:24:00,18,22,Eletrônico,1,40
17906,2024-01-13 10:25:00,52,89,Móvel,1,141
17907,2024-01-13 10:26:00,102,116,Vestuário,9,218
17908,2024-01-13 10:27:00,68,113,Móvel,5,181
17909,2024-01-13 10:28:00,44,81,Eletrônico,4,125
17910,2024-01-13 10:29:00,104,148,Eletrônico,6,252
17911,2024-01-13 10:30:00,46,124,Alimento,3,170
17912,2024-01-13 10:31:00,35,47,Móvel,2,82
17913,2024-01-13 10:32:00,59,35,Vestuário,9,94
17914,2024-01-13 10:33:00,106,141,Móvel,6,247
17915,2024-01-13 10:34:00,72,127,Brinquedo,2,199
17916,2024-01-13 10:35:00,84,145,Brinquedo,2,229
17917,2024-01-13 10:36:00,94,27,Alimento,4,121
17918,2024-01-13 10:37:00,33,65,Brinquedo,1,98
17919,2024-01-13 10:38:00,110,81,Eletrônico,2,191
17920,2024-01-13 10:39:00,33,176,Vestuário,8,209
17921,2024-01-13 10:40:00,71,81,Eletrônico,8,152
17922,2024-01-13 10:41:00,11,33,Alimento,3,44
17923,2024-01-13 10:42:00,27,74,Eletrônico,2,101
17924,2024-01-13 10:43:00,31,94,Móvel,8,125
17925,2024-01-13 10:44:00,77,144,Eletrônico,3,221
17926,2024-01-13 10:45:00,79,75,Brinquedo,5,154
17927,2024-01-13 10:46:00,87,117,Eletrônico,6,204
17928,2024-01-13 10:47:00,62,179,Vestuário,7,241
17929,2024-01-13 10:48:00,45,115,Vestuário,5,160
17930,2024-01-13 10:49:00,55,67,Móvel,6,122
17931,2024-01-13 10:50:00,65,141,Móvel,1,206
17932,2024-01-13 10:51:00,55,122,Alimento,3,177
17933,2024-01-13 10:52:00,114,156,Eletrônico,6,270
17934,2024-01-13 10:53:00,95,66,Móvel,1,161
17935,2024-01-13 10:54:00,51,95,Brinquedo,4,146
17936,2024-01-13 10:55:00,104,122,Alimento,2,226
17937,2024-01-13 10:56:00,107,120,Brinquedo,9,227
17938,2024-01-13 10:57:00,92,72,Brinquedo,8,164
17939,2024-01-13 10:58:00,108,50,Móvel,2,158
17940,2024-01-13 10:59:00,27,39,Brinquedo,4,66
17941,2024-01-13 11:00:00,56,111,Brinquedo,1,167
17942,2024-01-13 11:01:00,111,121,Brinquedo,9,232
17943,2024-01-13 11:02:00,87,165,Eletrônico,4,252
17944,2024-01-13 11:03:00,41,146,Vestuário,3,187
17945,2024-01-13 11:04:00,99,58,Móvel,9,157
17946,2024-01-13 11:05:00,44,87,Alimento,9,131
17947,2024-01-13 11:06:00,71,73,Alimento,3,144
17948,2024-01-13 11:07:00,46,77,Móvel,7,123
17949,2024-01-13 11:08:00,83,112,Eletrônico,1,195
17950,2024-01-13 11:09:00,58,167,Vestuário,5,225
17951,2024-01-13 11:10:00,22,101,Vestuário,1,123
17952,2024-01-13 11:11:00,108,12,Vestuário,4,120
17953,2024-01-13 11:12:00,112,86,Brinquedo,7,198
17954,2024-01-13 11:13:00,87,54,Brinquedo,8,141
17955,2024-01-13 11:14:00,26,31,Brinquedo,4,57
17956,2024-01-13 11:15:00,34,85,Vestuário,4,119
17957,2024-01-13 11:16:00,17,87,Vestuário,6,104
17958,2024-01-13 11:17:00,34,170,Alimento,7,204
17959,2024-01-13 11:18:00,54,36,Móvel,1,90
17960,2024-01-13 11:19:00,57,69,Brinquedo,5,126
17961,2024-01-13 11:20:00,57,167,Móvel,5,224
17962,2024-01-13 11:21:00,103,152,Alimento,9,255
17963,2024-01-13 11:22:00,70,100,Eletrônico,6,170
17964,2024-01-13 11:23:00,111,114,Vestuário,5,225
17965,2024-01-13 11:24:00,90,36,Vestuário,2,126
17966,2024-01-13 11:25:00,70,111,Alimento,3,181
17967,2024-01-13 11:26:00,12,139,Brinquedo,2,151
17968,2024-01-13 11:27:00,71,151,Brinquedo,4,222
17969,2024-01-13 11:28:00,119,79,Móvel,3,198
17970,2024-01-13 11:29:00,32,29,Brinquedo,4,61
17971,2024-01-13 11:30:00,116,51,Vestuário,7,167
17972,2024-01-13 11:31:00,86,122,Brinquedo,1,208
17973,2024-01-13 11:32:00,75,96,Móvel,1,171
17974,2024-01-13 11:33:00,109,128,Brinquedo,7,237
17975,2024-01-13 11:34:00,53,80,Móvel,1,133
17976,2024-01-13 11:35:00,28,119,Alimento,6,147
17977,2024-01-13 11:36:00,101,51,Vestuário,4,152
17978,2024-01-13 11:37:00,70,33,Alimento,2,103
17979,2024-01-13 11:38:00,83,49,Eletrônico,7,132
17980,2024-01-13 11:39:00,52,133,Eletrônico,7,185
17981,2024-01-13 11:40:00,81,71,Vestuário,4,152
17982,2024-01-13 11:41:00,17,56,Brinquedo,3,73
17983,2024-01-13 11:42:00,46,35,Brinquedo,3,81
17984,2024-01-13 11:43:00,109,175,Alimento,9,284
17985,2024-01-13 11:44:00,117,129,Alimento,1,246
17986,2024-01-13 11:45:00,108,150,Brinquedo,6,258
17987,2024-01-13 11:46:00,33,25,Brinquedo,7,58
17988,2024-01-13 11:47:00,33,17,Alimento,2,50
17989,2024-01-13 11:48:00,91,144,Móvel,5,235
17990,2024-01-13 11:49:00,80,166,Móvel,6,246
17991,2024-01-13 11:50:00,26,52,Alimento,4,78
17992,2024-01-13 11:51:00,54,158,Vestuário,4,212
17993,2024-01-13 11:52:00,64,163,Vestuário,5,227
17994,2024-01-13 11:53:00,65,141,Alimento,9,206
17995,2024-01-13 11:54:00,10,60,Brinquedo,9,70
17996,2024-01-13 11:55:00,81,88,Eletrônico,6,169
17997,2024-01-13 11:56:00,43,73,Alimento,7,116
17998,2024-01-13 11:57:00,32,147,Brinquedo,1,179
17999,2024-01-13 11:58:00,78,171,Vestuário,8,249
18000,2024-01-13 11:59:00,69,128,Vestuário,3,197
18001,2024-01-13 12:00:00,90,112,Alimento,9,202
18002,2024-01-13 12:01:00,40,64,Alimento,4,104
18003,2024-01-13 12:02:00,70,15,Alimento,2,85
18004,2024-01-13 12:03:00,46,177,Vestuário,4,223
18005,2024-01-13 12:04:00,86,88,Móvel,9,174
18006,2024-01-13 12:05:00,70,12,Eletrônico,2,82
18007,2024-01-13 12:06:00,48,17,Eletrônico,1,65
18008,2024-01-13 12:07:00,85,116,Móvel,6,201
18009,2024-01-13 12:08:00,61,117,Vestuário,3,178
18010,2024-01-13 12:09:00,17,33,Móvel,6,50
18011,2024-01-13 12:10:00,46,106,Vestuário,1,152
18012,2024-01-13 12:11:00,101,34,Eletrônico,2,135
18013,2024-01-13 12:12:00,51,165,Vestuário,1,216
18014,2024-01-13 12:13:00,61,154,Brinquedo,9,215
18015,2024-01-13 12:14:00,26,150,Brinquedo,6,176
18016,2024-01-13 12:15:00,18,168,Móvel,9,186
18017,2024-01-13 12:16:00,88,165,Móvel,8,253
18018,2024-01-13 12:17:00,59,129,Vestuário,2,188
18019,2024-01-13 12:18:00,67,29,Eletrônico,4,96
18020,2024-01-13 12:19:00,72,151,Eletrônico,6,223
18021,2024-01-13 12:20:00,83,12,Alimento,2,95
18022,2024-01-13 12:21:00,33,178,Alimento,6,211
18023,2024-01-13 12:22:00,52,80,Vestuário,3,132
18024,2024-01-13 12:23:00,54,156,Eletrônico,5,210
18025,2024-01-13 12:24:00,43,25,Alimento,6,68
18026,2024-01-13 12:25:00,75,61,Móvel,9,136
18027,2024-01-13 12:26:00,21,39,Brinquedo,4,60
18028,2024-01-13 12:27:00,33,78,Vestuário,5,111
18029,2024-01-13 12:28:00,75,153,Vestuário,3,228
18030,2024-01-13 12:29:00,13,127,Alimento,6,140
18031,2024-01-13 12:30:00,117,177,Alimento,8,294
18032,2024-01-13 12:31:00,56,46,Vestuário,7,102
18033,2024-01-13 12:32:00,38,91,Alimento,3,129
18034,2024-01-13 12:33:00,108,143,Brinquedo,2,251
18035,2024-01-13 12:34:00,29,16,Alimento,5,45
18036,2024-01-13 12:35:00,38,105,Móvel,3,143
18037,2024-01-13 12:36:00,34,44,Móvel,8,78
18038,2024-01-13 12:37:00,26,55,Alimento,8,81
18039,2024-01-13 12:38:00,43,18,Móvel,2,61
18040,2024-01-13 12:39:00,36,25,Alimento,3,61
18041,2024-01-13 12:40:00,94,51,Brinquedo,4,145
18042,2024-01-13 12:41:00,75,133,Eletrônico,7,208
18043,2024-01-13 12:42:00,104,63,Móvel,6,167
18044,2024-01-13 12:43:00,76,84,Eletrônico,5,160
18045,2024-01-13 12:44:00,95,168,Vestuário,9,263
18046,2024-01-13 12:45:00,110,87,Eletrônico,3,197
18047,2024-01-13 12:46:00,77,29,Alimento,6,106
18048,2024-01-13 12:47:00,36,101,Móvel,2,137
18049,2024-01-13 12:48:00,82,105,Móvel,3,187
18050,2024-01-13 12:49:00,105,118,Brinquedo,2,223
18051,2024-01-13 12:50:00,31,143,Vestuário,5,174
18052,2024-01-13 12:51:00,14,170,Eletrônico,9,184
18053,2024-01-13 12:52:00,59,72,Eletrônico,9,131
18054,2024-01-13 12:53:00,18,54,Móvel,2,72
18055,2024-01-13 12:54:00,42,168,Eletrônico,6,210
18056,2024-01-13 12:55:00,61,115,Móvel,9,176
18057,2024-01-13 12:56:00,44,25,Alimento,3,69
18058,2024-01-13 12:57:00,115,103,Móvel,5,218
18059,2024-01-13 12:58:00,105,109,Eletrônico,3,214
18060,2024-01-13 12:59:00,99,54,Vestuário,6,153
18061,2024-01-13 13:00:00,106,129,Vestuário,9,235
18062,2024-01-13 13:01:00,112,26,Brinquedo,5,138
18063,2024-01-13 13:02:00,95,81,Vestuário,4,176
18064,2024-01-13 13:03:00,115,44,Vestuário,3,159
18065,2024-01-13 13:04:00,50,23,Móvel,2,73
18066,2024-01-13 13:05:00,26,52,Alimento,7,78
18067,2024-01-13 13:06:00,49,73,Eletrônico,9,122
18068,2024-01-13 13:07:00,75,63,Vestuário,3,138
18069,2024-01-13 13:08:00,110,144,Eletrônico,2,254
18070,2024-01-13 13:09:00,38,146,Alimento,7,184
18071,2024-01-13 13:10:00,92,45,Vestuário,3,137
18072,2024-01-13 13:11:00,40,123,Brinquedo,6,163
18073,2024-01-13 13:12:00,106,117,Alimento,2,223
18074,2024-01-13 13:13:00,85,24,Vestuário,2,109
18075,2024-01-13 13:14:00,14,67,Brinquedo,6,81
18076,2024-01-13 13:15:00,33,145,Alimento,4,178
18077,2024-01-13 13:16:00,14,169,Brinquedo,8,183
18078,2024-01-13 13:17:00,40,146,Móvel,8,186
18079,2024-01-13 13:18:00,67,86,Eletrônico,9,153
18080,2024-01-13 13:19:00,94,22,Alimento,9,116
18081,2024-01-13 13:20:00,49,52,Brinquedo,1,101
18082,2024-01-13 13:21:00,66,93,Eletrônico,3,159
18083,2024-01-13 13:22:00,78,108,Móvel,3,186
18084,2024-01-13 13:23:00,119,178,Móvel,6,297
18085,2024-01-13 13:24:00,86,46,Alimento,8,132
18086,2024-01-13 13:25:00,91,113,Móvel,2,204
18087,2024-01-13 13:26:00,70,91,Vestuário,9,161
18088,2024-01-13 13:27:00,84,153,Eletrônico,4,237
18089,2024-01-13 13:28:00,38,59,Vestuário,5,97
18090,2024-01-13 13:29:00,61,156,Alimento,4,217
18091,2024-01-13 13:30:00,68,177,Eletrônico,1,245
18092,2024-01-13 13:31:00,36,79,Alimento,2,115
18093,2024-01-13 13:32:00,81,94,Eletrônico,8,175
18094,2024-01-13 13:33:00,51,105,Brinquedo,5,156
18095,2024-01-13 13:34:00,91,90,Brinquedo,3,181
18096,2024-01-13 13:35:00,81,44,Alimento,2,125
18097,2024-01-13 13:36:00,106,111,Eletrônico,4,217
18098,2024-01-13 13:37:00,80,154,Alimento,4,234
18099,2024-01-13 13:38:00,102,45,Eletrônico,4,147
18100,2024-01-13 13:39:00,102,80,Eletrônico,3,182
18101,2024-01-13 13:40:00,17,60,Brinquedo,1,77
18102,2024-01-13 13:41:00,59,149,Brinquedo,2,208
18103,2024-01-13 13:42:00,111,134,Brinquedo,6,245
18104,2024-01-13 13:43:00,116,138,Móvel,3,254
18105,2024-01-13 13:44:00,77,96,Eletrônico,3,173
18106,2024-01-13 13:45:00,71,75,Brinquedo,4,146
18107,2024-01-13 13:46:00,11,90,Eletrônico,1,101
18108,2024-01-13 13:47:00,24,114,Móvel,8,138
18109,2024-01-13 13:48:00,109,36,Eletrônico,5,145
18110,2024-01-13 13:49:00,35,166,Eletrônico,1,201
18111,2024-01-13 13:50:00,43,57,Móvel,3,100
18112,2024-01-13 13:51:00,87,75,Eletrônico,6,162
18113,2024-01-13 13:52:00,89,105,Eletrônico,8,194
18114,2024-01-13 13:53:00,30,22,Eletrônico,8,52
18115,2024-01-13 13:54:00,31,16,Móvel,1,47
18116,2024-01-13 13:55:00,45,141,Vestuário,6,186
18117,2024-01-13 13:56:00,47,136,Brinquedo,9,183
18118,2024-01-13 13:57:00,68,62,Vestuário,9,130
18119,2024-01-13 13:58:00,59,146,Brinquedo,1,205
18120,2024-01-13 13:59:00,45,77,Móvel,2,122
18121,2024-01-13 14:00:00,47,55,Vestuário,6,102
18122,2024-01-13 14:01:00,84,136,Alimento,1,220
18123,2024-01-13 14:02:00,11,67,Brinquedo,9,78
18124,2024-01-13 14:03:00,83,103,Eletrônico,7,186
18125,2024-01-13 14:04:00,103,43,Vestuário,7,146
18126,2024-01-13 14:05:00,99,142,Vestuário,3,241
18127,2024-01-13 14:06:00,56,108,Eletrônico,5,164
18128,2024-01-13 14:07:00,11,111,Eletrônico,6,122
18129,2024-01-13 14:08:00,28,107,Vestuário,6,135
18130,2024-01-13 14:09:00,72,164,Brinquedo,2,236
18131,2024-01-13 14:10:00,111,172,Brinquedo,4,283
18132,2024-01-13 14:11:00,42,138,Alimento,9,180
18133,2024-01-13 14:12:00,43,141,Eletrônico,1,184
18134,2024-01-13 14:13:00,44,155,Móvel,3,199
18135,2024-01-13 14:14:00,18,112,Móvel,1,130
18136,2024-01-13 14:15:00,89,133,Eletrônico,6,222
18137,2024-01-13 14:16:00,73,151,Brinquedo,2,224
18138,2024-01-13 14:17:00,12,169,Brinquedo,6,181
18139,2024-01-13 14:18:00,16,178,Alimento,6,194
18140,2024-01-13 14:19:00,108,55,Eletrônico,1,163
18141,2024-01-13 14:20:00,23,138,Móvel,2,161
18142,2024-01-13 14:21:00,54,97,Brinquedo,8,151
18143,2024-01-13 14:22:00,28,170,Brinquedo,4,198
18144,2024-01-13 14:23:00,103,109,Brinquedo,4,212
18145,2024-01-13 14:24:00,48,20,Móvel,5,68
18146,2024-01-13 14:25:00,29,159,Vestuário,8,188
18147,2024-01-13 14:26:00,67,174,Eletrônico,2,241
18148,2024-01-13 14:27:00,58,51,Vestuário,3,109
18149,2024-01-13 14:28:00,107,151,Eletrônico,3,258
18150,2024-01-13 14:29:00,98,140,Móvel,8,238
18151,2024-01-13 14:30:00,90,71,Brinquedo,3,161
18152,2024-01-13 14:31:00,59,155,Eletrônico,3,214
18153,2024-01-13 14:32:00,17,148,Brinquedo,4,165
18154,2024-01-13 14:33:00,117,51,Vestuário,5,168
18155,2024-01-13 14:34:00,107,49,Eletrônico,1,156
18156,2024-01-13 14:35:00,56,157,Brinquedo,7,213
18157,2024-01-13 14:36:00,19,55,Eletrônico,2,74
18158,2024-01-13 14:37:00,72,102,Eletrônico,1,174
18159,2024-01-13 14:38:00,111,52,Vestuário,7,163
18160,2024-01-13 14:39:00,26,118,Alimento,6,144
18161,2024-01-13 14:40:00,109,82,Alimento,7,191
18162,2024-01-13 14:41:00,45,121,Eletrônico,9,166
18163,2024-01-13 14:42:00,106,92,Móvel,6,198
18164,2024-01-13 14:43:00,108,65,Móvel,7,173
18165,2024-01-13 14:44:00,46,153,Eletrônico,3,199
18166,2024-01-13 14:45:00,95,151,Móvel,5,246
18167,2024-01-13 14:46:00,114,164,Móvel,9,278
18168,2024-01-13 14:47:00,15,173,Vestuário,2,188
18169,2024-01-13 14:48:00,113,136,Eletrônico,3,249
18170,2024-01-13 14:49:00,37,17,Alimento,8,54
18171,2024-01-13 14:50:00,25,145,Alimento,1,170
18172,2024-01-13 14:51:00,41,172,Móvel,9,213
18173,2024-01-13 14:52:00,66,163,Móvel,8,229
18174,2024-01-13 14:53:00,84,23,Eletrônico,9,107
18175,2024-01-13 14:54:00,63,97,Alimento,5,160
18176,2024-01-13 14:55:00,98,152,Eletrônico,2,250
18177,2024-01-13 14:56:00,77,134,Brinquedo,5,211
18178,2024-01-13 14:57:00,51,23,Vestuário,2,74
18179,2024-01-13 14:58:00,91,87,Móvel,4,178
18180,2024-01-13 14:59:00,96,143,Móvel,1,239
18181,2024-01-13 15:00:00,19,86,Vestuário,1,105
18182,2024-01-13 15:01:00,13,16,Móvel,1,29
18183,2024-01-13 15:02:00,41,162,Alimento,2,203
18184,2024-01-13 15:03:00,79,81,Alimento,2,160
18185,2024-01-13 15:04:00,30,148,Brinquedo,8,178
18186,2024-01-13 15:05:00,62,39,Móvel,9,101
18187,2024-01-13 15:06:00,22,115,Alimento,6,137
18188,2024-01-13 15:07:00,114,168,Vestuário,7,282
18189,2024-01-13 15:08:00,89,18,Alimento,6,107
18190,2024-01-13 15:09:00,46,80,Brinquedo,8,126
18191,2024-01-13 15:10:00,36,59,Alimento,4,95
18192,2024-01-13 15:11:00,66,66,Eletrônico,7,132
18193,2024-01-13 15:12:00,45,35,Eletrônico,1,80
18194,2024-01-13 15:13:00,73,83,Alimento,2,156
18195,2024-01-13 15:14:00,83,62,Móvel,8,145
18196,2024-01-13 15:15:00,66,156,Brinquedo,8,222
18197,2024-01-13 15:16:00,65,152,Móvel,1,217
18198,2024-01-13 15:17:00,90,113,Móvel,5,203
18199,2024-01-13 15:18:00,43,58,Brinquedo,6,101
18200,2024-01-13 15:19:00,30,64,Eletrônico,8,94
18201,2024-01-13 15:20:00,116,145,Vestuário,4,261
18202,2024-01-13 15:21:00,91,97,Móvel,2,188
18203,2024-01-13 15:22:00,23,82,Móvel,1,105
18204,2024-01-13 15:23:00,50,16,Vestuário,8,66
18205,2024-01-13 15:24:00,77,69,Eletrônico,3,146
18206,2024-01-13 15:25:00,33,172,Móvel,5,205
18207,2024-01-13 15:26:00,54,39,Vestuário,2,93
18208,2024-01-13 15:27:00,117,141,Móvel,7,258
18209,2024-01-13 15:28:00,58,35,Eletrônico,3,93
18210,2024-01-13 15:29:00,32,152,Vestuário,7,184
18211,2024-01-13 15:30:00,57,84,Móvel,6,141
18212,2024-01-13 15:31:00,78,20,Brinquedo,8,98
18213,2024-01-13 15:32:00,53,158,Móvel,1,211
18214,2024-01-13 15:33:00,75,126,Móvel,6,201
18215,2024-01-13 15:34:00,48,51,Brinquedo,3,99
18216,2024-01-13 15:35:00,55,150,Alimento,9,205
18217,2024-01-13 15:36:00,79,174,Alimento,3,253
18218,2024-01-13 15:37:00,101,12,Brinquedo,1,113
18219,2024-01-13 15:38:00,40,168,Brinquedo,8,208
18220,2024-01-13 15:39:00,89,86,Móvel,3,175
18221,2024-01-13 15:40:00,98,38,Vestuário,1,136
18222,2024-01-13 15:41:00,116,43,Vestuário,9,159
18223,2024-01-13 15:42:00,51,55,Eletrônico,4,106
18224,2024-01-13 15:43:00,34,51,Alimento,2,85
18225,2024-01-13 15:44:00,11,22,Brinquedo,9,33
18226,2024-01-13 15:45:00,12,129,Móvel,3,141
18227,2024-01-13 15:46:00,87,100,Alimento,5,187
18228,2024-01-13 15:47:00,23,132,Alimento,5,155
18229,2024-01-13 15:48:00,96,31,Móvel,8,127
18230,2024-01-13 15:49:00,12,72,Brinquedo,3,84
18231,2024-01-13 15:50:00,44,127,Alimento,5,171
18232,2024-01-13 15:51:00,46,87,Brinquedo,3,133
18233,2024-01-13 15:52:00,29,47,Móvel,5,76
18234,2024-01-13 15:53:00,51,110,Móvel,5,161
18235,2024-01-13 15:54:00,19,24,Móvel,1,43
18236,2024-01-13 15:55:00,21,162,Móvel,6,183
18237,2024-01-13 15:56:00,108,38,Eletrônico,4,146
18238,2024-01-13 15:57:00,21,34,Brinquedo,4,55
18239,2024-01-13 15:58:00,21,100,Vestuário,7,121
18240,2024-01-13 15:59:00,107,33,Brinquedo,3,140
18241,2024-01-13 16:00:00,96,163,Vestuário,7,259
18242,2024-01-13 16:01:00,28,82,Alimento,5,110
18243,2024-01-13 16:02:00,93,101,Alimento,7,194
18244,2024-01-13 16:03:00,68,173,Alimento,3,241
18245,2024-01-13 16:04:00,117,28,Brinquedo,4,145
18246,2024-01-13 16:05:00,12,113,Vestuário,1,125
18247,2024-01-13 16:06:00,13,175,Alimento,4,188
18248,2024-01-13 16:07:00,73,124,Brinquedo,9,197
18249,2024-01-13 16:08:00,69,171,Vestuário,8,240
18250,2024-01-13 16:09:00,71,66,Alimento,5,137
18251,2024-01-13 16:10:00,85,51,Móvel,3,136
18252,2024-01-13 16:11:00,38,65,Móvel,2,103
18253,2024-01-13 16:12:00,49,92,Eletrônico,5,141
18254,2024-01-13 16:13:00,22,30,Alimento,7,52
18255,2024-01-13 16:14:00,103,96,Alimento,6,199
18256,2024-01-13 16:15:00,23,91,Móvel,7,114
18257,2024-01-13 16:16:00,90,122,Brinquedo,2,212
18258,2024-01-13 16:17:00,86,28,Alimento,4,114
18259,2024-01-13 16:18:00,46,38,Eletrônico,5,84
18260,2024-01-13 16:19:00,114,118,Móvel,5,232
18261,2024-01-13 16:20:00,79,43,Vestuário,5,122
18262,2024-01-13 16:21:00,109,107,Alimento,4,216
18263,2024-01-13 16:22:00,70,113,Brinquedo,8,183
18264,2024-01-13 16:23:00,87,79,Brinquedo,5,166
18265,2024-01-13 16:24:00,109,145,Eletrônico,4,254
18266,2024-01-13 16:25:00,41,126,Vestuário,7,167
18267,2024-01-13 16:26:00,68,155,Móvel,5,223
18268,2024-01-13 16:27:00,62,14,Vestuário,4,76
18269,2024-01-13 16:28:00,16,78,Brinquedo,3,94
18270,2024-01-13 16:29:00,42,90,Brinquedo,8,132
18271,2024-01-13 16:30:00,34,60,Vestuário,3,94
18272,2024-01-13 16:31:00,38,10,Eletrônico,5,48
18273,2024-01-13 16:32:00,69,37,Alimento,3,106
18274,2024-01-13 16:33:00,114,101,Vestuário,4,215
18275,2024-01-13 16:34:00,28,85,Brinquedo,4,113
18276,2024-01-13 16:35:00,47,147,Alimento,1,194
18277,2024-01-13 16:36:00,52,60,Alimento,3,112
18278,2024-01-13 16:37:00,118,132,Brinquedo,7,250
18279,2024-01-13 16:38:00,13,28,Vestuário,6,41
18280,2024-01-13 16:39:00,116,149,Vestuário,3,265
18281,2024-01-13 16:40:00,23,89,Vestuário,7,112
18282,2024-01-13 16:41:00,36,160,Eletrônico,9,196
18283,2024-01-13 16:42:00,39,176,Eletrônico,5,215
18284,2024-01-13 16:43:00,59,18,Alimento,9,77
18285,2024-01-13 16:44:00,59,82,Eletrônico,8,141
18286,2024-01-13 16:45:00,35,149,Alimento,7,184
18287,2024-01-13 16:46:00,69,77,Brinquedo,3,146
18288,2024-01-13 16:47:00,18,39,Alimento,1,57
18289,2024-01-13 16:48:00,26,29,Brinquedo,9,55
18290,2024-01-13 16:49:00,112,32,Brinquedo,5,144
18291,2024-01-13 16:50:00,75,116,Vestuário,2,191
18292,2024-01-13 16:51:00,22,132,Vestuário,6,154
18293,2024-01-13 16:52:00,117,83,Móvel,1,200
18294,2024-01-13 16:53:00,51,16,Alimento,9,67
18295,2024-01-13 16:54:00,58,26,Alimento,4,84
18296,2024-01-13 16:55:00,12,167,Eletrônico,1,179
18297,2024-01-13 16:56:00,11,88,Eletrônico,1,99
18298,2024-01-13 16:57:00,15,108,Alimento,6,123
18299,2024-01-13 16:58:00,27,139,Vestuário,1,166
18300,2024-01-13 16:59:00,23,40,Alimento,7,63
18301,2024-01-13 17:00:00,113,177,Alimento,9,290
18302,2024-01-13 17:01:00,64,42,Eletrônico,1,106
18303,2024-01-13 17:02:00,81,93,Alimento,9,174
18304,2024-01-13 17:03:00,16,98,Alimento,4,114
18305,2024-01-13 17:04:00,53,52,Alimento,1,105
18306,2024-01-13 17:05:00,14,87,Eletrônico,3,101
18307,2024-01-13 17:06:00,92,150,Vestuário,1,242
18308,2024-01-13 17:07:00,106,143,Brinquedo,2,249
18309,2024-01-13 17:08:00,61,130,Vestuário,9,191
18310,2024-01-13 17:09:00,69,86,Alimento,6,155
18311,2024-01-13 17:10:00,19,152,Alimento,1,171
18312,2024-01-13 17:11:00,74,16,Alimento,8,90
18313,2024-01-13 17:12:00,53,153,Brinquedo,8,206
18314,2024-01-13 17:13:00,28,16,Brinquedo,5,44
18315,2024-01-13 17:14:00,54,156,Vestuário,5,210
18316,2024-01-13 17:15:00,82,178,Vestuário,3,260
18317,2024-01-13 17:16:00,86,167,Eletrônico,9,253
18318,2024-01-13 17:17:00,27,171,Eletrônico,8,198
18319,2024-01-13 17:18:00,35,71,Móvel,5,106
18320,2024-01-13 17:19:00,64,125,Brinquedo,1,189
18321,2024-01-13 17:20:00,28,172,Vestuário,5,200
18322,2024-01-13 17:21:00,112,176,Eletrônico,1,288
18323,2024-01-13 17:22:00,52,44,Alimento,7,96
18324,2024-01-13 17:23:00,19,43,Alimento,3,62
18325,2024-01-13 17:24:00,54,76,Brinquedo,1,130
18326,2024-01-13 17:25:00,69,22,Alimento,3,91
18327,2024-01-13 17:26:00,41,126,Brinquedo,7,167
18328,2024-01-13 17:27:00,53,78,Brinquedo,6,131
18329,2024-01-13 17:28:00,102,126,Alimento,8,228
18330,2024-01-13 17:29:00,38,161,Brinquedo,5,199
18331,2024-01-13 17:30:00,117,127,Eletrônico,8,244
18332,2024-01-13 17:31:00,117,68,Brinquedo,4,185
18333,2024-01-13 17:32:00,93,118,Móvel,8,211
18334,2024-01-13 17:33:00,84,67,Alimento,9,151
18335,2024-01-13 17:34:00,117,126,Eletrônico,3,243
18336,2024-01-13 17:35:00,13,92,Eletrônico,6,105
18337,2024-01-13 17:36:00,52,138,Vestuário,2,190
18338,2024-01-13 17:37:00,98,128,Eletrônico,6,226
18339,2024-01-13 17:38:00,78,167,Móvel,3,245
18340,2024-01-13 17:39:00,58,48,Alimento,1,106
18341,2024-01-13 17:40:00,42,117,Eletrônico,8,159
18342,2024-01-13 17:41:00,38,62,Alimento,4,100
18343,2024-01-13 17:42:00,105,170,Brinquedo,7,275
18344,2024-01-13 17:43:00,106,27,Eletrônico,3,133
18345,2024-01-13 17:44:00,113,171,Alimento,4,284
18346,2024-01-13 17:45:00,81,72,Eletrônico,6,153
18347,2024-01-13 17:46:00,29,105,Brinquedo,7,134
18348,2024-01-13 17:47:00,52,109,Brinquedo,6,161
18349,2024-01-13 17:48:00,34,140,Eletrônico,5,174
18350,2024-01-13 17:49:00,73,13,Móvel,9,86
18351,2024-01-13 17:50:00,60,108,Brinquedo,2,168
18352,2024-01-13 17:51:00,21,66,Alimento,5,87
18353,2024-01-13 17:52:00,12,149,Brinquedo,4,161
18354,2024-01-13 17:53:00,108,170,Eletrônico,5,278
18355,2024-01-13 17:54:00,117,154,Alimento,5,271
18356,2024-01-13 17:55:00,28,123,Eletrônico,5,151
18357,2024-01-13 17:56:00,35,69,Brinquedo,9,104
18358,2024-01-13 17:57:00,94,170,Brinquedo,3,264
18359,2024-01-13 17:58:00,73,130,Brinquedo,6,203
18360,2024-01-13 17:59:00,70,80,Vestuário,5,150
18361,2024-01-13 18:00:00,62,95,Brinquedo,6,157
18362,2024-01-13 18:01:00,15,10,Vestuário,5,25
18363,2024-01-13 18:02:00,26,10,Brinquedo,7,36
18364,2024-01-13 18:03:00,112,67,Alimento,2,179
18365,2024-01-13 18:04:00,29,175,Alimento,5,204
18366,2024-01-13 18:05:00,50,143,Alimento,1,193
18367,2024-01-13 18:06:00,119,42,Vestuário,6,161
18368,2024-01-13 18:07:00,48,81,Vestuário,3,129
18369,2024-01-13 18:08:00,117,167,Vestuário,1,284
18370,2024-01-13 18:09:00,73,114,Vestuário,7,187
18371,2024-01-13 18:10:00,45,111,Móvel,8,156
18372,2024-01-13 18:11:00,108,24,Eletrônico,6,132
18373,2024-01-13 18:12:00,60,167,Brinquedo,6,227
18374,2024-01-13 18:13:00,61,167,Eletrônico,4,228
18375,2024-01-13 18:14:00,63,45,Brinquedo,6,108
18376,2024-01-13 18:15:00,54,59,Vestuário,3,113
18377,2024-01-13 18:16:00,68,107,Brinquedo,9,175
18378,2024-01-13 18:17:00,116,173,Brinquedo,5,289
18379,2024-01-13 18:18:00,97,70,Brinquedo,9,167
18380,2024-01-13 18:19:00,55,102,Móvel,9,157
18381,2024-01-13 18:20:00,66,33,Móvel,4,99
18382,2024-01-13 18:21:00,94,67,Eletrônico,1,161
18383,2024-01-13 18:22:00,76,141,Alimento,8,217
18384,2024-01-13 18:23:00,100,148,Eletrônico,6,248
18385,2024-01-13 18:24:00,88,67,Brinquedo,9,155
18386,2024-01-13 18:25:00,83,140,Eletrônico,8,223
18387,2024-01-13 18:26:00,42,173,Brinquedo,7,215
18388,2024-01-13 18:27:00,67,127,Eletrônico,5,194
18389,2024-01-13 18:28:00,118,49,Brinquedo,6,167
18390,2024-01-13 18:29:00,49,177,Brinquedo,1,226
18391,2024-01-13 18:30:00,115,43,Brinquedo,5,158
18392,2024-01-13 18:31:00,57,10,Eletrônico,8,67
18393,2024-01-13 18:32:00,16,83,Eletrônico,6,99
18394,2024-01-13 18:33:00,62,177,Brinquedo,2,239
18395,2024-01-13 18:34:00,78,44,Móvel,8,122
18396,2024-01-13 18:35:00,89,105,Alimento,1,194
18397,2024-01-13 18:36:00,53,156,Vestuário,9,209
18398,2024-01-13 18:37:00,21,88,Brinquedo,3,109
18399,2024-01-13 18:38:00,106,135,Alimento,2,241
18400,2024-01-13 18:39:00,37,46,Vestuário,2,83
18401,2024-01-13 18:40:00,77,17,Vestuário,5,94
18402,2024-01-13 18:41:00,87,128,Alimento,7,215
18403,2024-01-13 18:42:00,103,57,Vestuário,7,160
18404,2024-01-13 18:43:00,64,76,Móvel,8,140
18405,2024-01-13 18:44:00,17,151,Vestuário,8,168
18406,2024-01-13 18:45:00,77,17,Móvel,6,94
18407,2024-01-13 18:46:00,32,95,Eletrônico,3,127
18408,2024-01-13 18:47:00,14,12,Móvel,6,26
18409,2024-01-13 18:48:00,82,24,Alimento,3,106
18410,2024-01-13 18:49:00,113,26,Eletrônico,6,139
18411,2024-01-13 18:50:00,115,138,Alimento,5,253
18412,2024-01-13 18:51:00,110,163,Vestuário,5,273
18413,2024-01-13 18:52:00,79,84,Móvel,6,163
18414,2024-01-13 18:53:00,59,32,Eletrônico,2,91
18415,2024-01-13 18:54:00,80,86,Vestuário,3,166
18416,2024-01-13 18:55:00,39,14,Vestuário,2,53
18417,2024-01-13 18:56:00,50,128,Vestuário,1,178
18418,2024-01-13 18:57:00,63,130,Vestuário,5,193
18419,2024-01-13 18:58:00,14,170,Brinquedo,5,184
18420,2024-01-13 18:59:00,11,52,Alimento,9,63
18421,2024-01-13 19:00:00,97,161,Móvel,5,258
18422,2024-01-13 19:01:00,73,14,Eletrônico,1,87
18423,2024-01-13 19:02:00,72,83,Alimento,3,155
18424,2024-01-13 19:03:00,100,104,Vestuário,7,204
18425,2024-01-13 19:04:00,19,45,Brinquedo,2,64
18426,2024-01-13 19:05:00,31,168,Brinquedo,9,199
18427,2024-01-13 19:06:00,82,51,Vestuário,5,133
18428,2024-01-13 19:07:00,66,28,Eletrônico,5,94
18429,2024-01-13 19:08:00,59,130,Eletrônico,3,189
18430,2024-01-13 19:09:00,92,133,Brinquedo,3,225
18431,2024-01-13 19:10:00,83,143,Alimento,6,226
18432,2024-01-13 19:11:00,84,72,Eletrônico,2,156
18433,2024-01-13 19:12:00,45,84,Eletrônico,9,129
18434,2024-01-13 19:13:00,95,107,Vestuário,7,202
18435,2024-01-13 19:14:00,111,97,Vestuário,3,208
18436,2024-01-13 19:15:00,59,56,Vestuário,1,115
18437,2024-01-13 19:16:00,104,177,Móvel,1,281
18438,2024-01-13 19:17:00,106,44,Eletrônico,1,150
18439,2024-01-13 19:18:00,21,51,Móvel,7,72
18440,2024-01-13 19:19:00,63,120,Móvel,3,183
18441,2024-01-13 19:20:00,25,69,Brinquedo,6,94
18442,2024-01-13 19:21:00,49,26,Alimento,9,75
18443,2024-01-13 19:22:00,30,11,Alimento,2,41
18444,2024-01-13 19:23:00,107,106,Vestuário,5,213
18445,2024-01-13 19:24:00,55,145,Vestuário,1,200
18446,2024-01-13 19:25:00,64,163,Móvel,4,227
18447,2024-01-13 19:26:00,41,164,Móvel,9,205
18448,2024-01-13 19:27:00,43,34,Brinquedo,8,77
18449,2024-01-13 19:28:00,76,65,Eletrônico,7,141
18450,2024-01-13 19:29:00,114,37,Vestuário,9,151
18451,2024-01-13 19:30:00,12,20,Eletrônico,9,32
18452,2024-01-13 19:31:00,16,163,Alimento,2,179
18453,2024-01-13 19:32:00,101,63,Eletrônico,8,164
18454,2024-01-13 19:33:00,29,146,Alimento,9,175
18455,2024-01-13 19:34:00,41,10,Alimento,3,51
18456,2024-01-13 19:35:00,51,99,Eletrônico,9,150
18457,2024-01-13 19:36:00,41,106,Alimento,2,147
18458,2024-01-13 19:37:00,34,90,Móvel,8,124
18459,2024-01-13 19:38:00,71,84,Eletrônico,2,155
18460,2024-01-13 19:39:00,76,179,Alimento,2,255
18461,2024-01-13 19:40:00,55,23,Brinquedo,9,78
18462,2024-01-13 19:41:00,70,19,Alimento,6,89
18463,2024-01-13 19:42:00,37,138,Eletrônico,3,175
18464,2024-01-13 19:43:00,69,79,Móvel,6,148
18465,2024-01-13 19:44:00,63,43,Eletrônico,8,106
18466,2024-01-13 19:45:00,28,10,Brinquedo,1,38
18467,2024-01-13 19:46:00,12,42,Móvel,7,54
18468,2024-01-13 19:47:00,83,55,Eletrônico,2,138
18469,2024-01-13 19:48:00,110,89,Móvel,8,199
18470,2024-01-13 19:49:00,19,86,Vestuário,5,105
18471,2024-01-13 19:50:00,105,30,Alimento,5,135
18472,2024-01-13 19:51:00,49,174,Eletrônico,1,223
18473,2024-01-13 19:52:00,70,116,Vestuário,3,186
18474,2024-01-13 19:53:00,26,161,Alimento,3,187
18475,2024-01-13 19:54:00,73,147,Brinquedo,5,220
18476,2024-01-13 19:55:00,72,117,Eletrônico,6,189
18477,2024-01-13 19:56:00,70,66,Brinquedo,2,136
18478,2024-01-13 19:57:00,48,133,Móvel,8,181
18479,2024-01-13 19:58:00,50,83,Móvel,5,133
18480,2024-01-13 19:59:00,47,21,Móvel,9,68
18481,2024-01-13 20:00:00,78,133,Brinquedo,8,211
18482,2024-01-13 20:01:00,13,169,Eletrônico,9,182
18483,2024-01-13 20:02:00,84,25,Brinquedo,4,109
18484,2024-01-13 20:03:00,99,58,Vestuário,2,157
18485,2024-01-13 20:04:00,67,123,Eletrônico,2,190
18486,2024-01-13 20:05:00,17,35,Brinquedo,6,52
18487,2024-01-13 20:06:00,69,23,Móvel,4,92
18488,2024-01-13 20:07:00,118,135,Vestuário,6,253
18489,2024-01-13 20:08:00,27,125,Eletrônico,6,152
18490,2024-01-13 20:09:00,119,149,Vestuário,3,268
18491,2024-01-13 20:10:00,98,10,Brinquedo,2,108
18492,2024-01-13 20:11:00,76,76,Vestuário,9,152
18493,2024-01-13 20:12:00,81,121,Vestuário,6,202
18494,2024-01-13 20:13:00,30,121,Eletrônico,4,151
18495,2024-01-13 20:14:00,11,38,Eletrônico,3,49
18496,2024-01-13 20:15:00,35,174,Alimento,3,209
18497,2024-01-13 20:16:00,69,141,Alimento,5,210
18498,2024-01-13 20:17:00,18,165,Brinquedo,1,183
18499,2024-01-13 20:18:00,25,86,Brinquedo,2,111
18500,2024-01-13 20:19:00,49,80,Vestuário,5,129
18501,2024-01-13 20:20:00,27,78,Alimento,8,105
18502,2024-01-13 20:21:00,53,162,Eletrônico,7,215
18503,2024-01-13 20:22:00,86,82,Vestuário,9,168
18504,2024-01-13 20:23:00,38,54,Alimento,2,92
18505,2024-01-13 20:24:00,77,77,Alimento,1,154
18506,2024-01-13 20:25:00,74,16,Eletrônico,7,90
18507,2024-01-13 20:26:00,73,41,Vestuário,8,114
18508,2024-01-13 20:27:00,36,55,Alimento,3,91
18509,2024-01-13 20:28:00,67,13,Vestuário,9,80
18510,2024-01-13 20:29:00,85,157,Alimento,3,242
18511,2024-01-13 20:30:00,84,17,Vestuário,4,101
18512,2024-01-13 20:31:00,36,75,Vestuário,1,111
18513,2024-01-13 20:32:00,56,51,Alimento,1,107
18514,2024-01-13 20:33:00,84,134,Vestuário,8,218
18515,2024-01-13 20:34:00,78,103,Eletrônico,9,181
18516,2024-01-13 20:35:00,62,137,Eletrônico,9,199
18517,2024-01-13 20:36:00,114,19,Alimento,3,133
18518,2024-01-13 20:37:00,103,18,Brinquedo,5,121
18519,2024-01-13 20:38:00,115,16,Eletrônico,6,131
18520,2024-01-13 20:39:00,63,29,Brinquedo,2,92
18521,2024-01-13 20:40:00,49,138,Móvel,7,187
18522,2024-01-13 20:41:00,77,152,Vestuário,2,229
18523,2024-01-13 20:42:00,87,144,Vestuário,4,231
18524,2024-01-13 20:43:00,41,56,Móvel,5,97
18525,2024-01-13 20:44:00,103,66,Eletrônico,9,169
18526,2024-01-13 20:45:00,53,118,Vestuário,4,171
18527,2024-01-13 20:46:00,52,115,Brinquedo,8,167
18528,2024-01-13 20:47:00,76,146,Móvel,7,222
18529,2024-01-13 20:48:00,29,15,Vestuário,7,44
18530,2024-01-13 20:49:00,101,50,Alimento,9,151
18531,2024-01-13 20:50:00,37,77,Eletrônico,9,114
18532,2024-01-13 20:51:00,65,175,Brinquedo,1,240
18533,2024-01-13 20:52:00,49,40,Brinquedo,7,89
18534,2024-01-13 20:53:00,85,175,Alimento,2,260
18535,2024-01-13 20:54:00,74,73,Brinquedo,5,147
18536,2024-01-13 20:55:00,22,64,Móvel,8,86
18537,2024-01-13 20:56:00,88,80,Vestuário,1,168
18538,2024-01-13 20:57:00,16,90,Alimento,5,106
18539,2024-01-13 20:58:00,73,51,Vestuário,7,124
18540,2024-01-13 20:59:00,56,124,Brinquedo,4,180
18541,2024-01-13 21:00:00,116,174,Vestuário,6,290
18542,2024-01-13 21:01:00,108,59,Alimento,5,167
18543,2024-01-13 21:02:00,25,117,Móvel,6,142
18544,2024-01-13 21:03:00,100,33,Brinquedo,2,133
18545,2024-01-13 21:04:00,41,133,Eletrônico,4,174
18546,2024-01-13 21:05:00,22,117,Alimento,3,139
18547,2024-01-13 21:06:00,66,15,Móvel,9,81
18548,2024-01-13 21:07:00,13,54,Eletrônico,6,67
18549,2024-01-13 21:08:00,44,133,Brinquedo,7,177
18550,2024-01-13 21:09:00,39,157,Eletrônico,9,196
18551,2024-01-13 21:10:00,105,71,Eletrônico,8,176
18552,2024-01-13 21:11:00,26,18,Alimento,2,44
18553,2024-01-13 21:12:00,39,58,Eletrônico,4,97
18554,2024-01-13 21:13:00,18,170,Eletrônico,6,188
18555,2024-01-13 21:14:00,29,173,Eletrônico,5,202
18556,2024-01-13 21:15:00,60,16,Vestuário,8,76
18557,2024-01-13 21:16:00,106,44,Eletrônico,1,150
18558,2024-01-13 21:17:00,107,154,Alimento,1,261
18559,2024-01-13 21:18:00,83,88,Vestuário,6,171
18560,2024-01-13 21:19:00,44,69,Alimento,1,113
18561,2024-01-13 21:20:00,70,15,Móvel,4,85
18562,2024-01-13 21:21:00,25,23,Vestuário,7,48
18563,2024-01-13 21:22:00,113,122,Eletrônico,1,235
18564,2024-01-13 21:23:00,18,100,Alimento,4,118
18565,2024-01-13 21:24:00,12,144,Vestuário,6,156
18566,2024-01-13 21:25:00,119,82,Brinquedo,5,201
18567,2024-01-13 21:26:00,40,33,Eletrônico,6,73
18568,2024-01-13 21:27:00,10,40,Brinquedo,7,50
18569,2024-01-13 21:28:00,104,41,Brinquedo,9,145
18570,2024-01-13 21:29:00,10,147,Alimento,3,157
18571,2024-01-13 21:30:00,87,141,Vestuário,5,228
18572,2024-01-13 21:31:00,60,39,Brinquedo,4,99
18573,2024-01-13 21:32:00,19,66,Vestuário,2,85
18574,2024-01-13 21:33:00,53,146,Vestuário,9,199
18575,2024-01-13 21:34:00,16,155,Móvel,7,171
18576,2024-01-13 21:35:00,110,88,Móvel,8,198
18577,2024-01-13 21:36:00,68,112,Eletrônico,7,180
18578,2024-01-13 21:37:00,74,107,Alimento,3,181
18579,2024-01-13 21:38:00,58,164,Brinquedo,5,222
18580,2024-01-13 21:39:00,80,62,Alimento,9,142
18581,2024-01-13 21:40:00,64,35,Brinquedo,1,99
18582,2024-01-13 21:41:00,62,116,Eletrônico,8,178
18583,2024-01-13 21:42:00,72,38,Vestuário,5,110
18584,2024-01-13 21:43:00,109,72,Vestuário,4,181
18585,2024-01-13 21:44:00,99,39,Brinquedo,6,138
18586,2024-01-13 21:45:00,106,108,Móvel,9,214
18587,2024-01-13 21:46:00,78,77,Vestuário,3,155
18588,2024-01-13 21:47:00,67,64,Eletrônico,8,131
18589,2024-01-13 21:48:00,27,100,Móvel,5,127
18590,2024-01-13 21:49:00,72,99,Alimento,5,171
18591,2024-01-13 21:50:00,49,75,Móvel,1,124
18592,2024-01-13 21:51:00,21,122,Eletrônico,2,143
18593,2024-01-13 21:52:00,108,117,Móvel,5,225
18594,2024-01-13 21:53:00,24,14,Vestuário,7,38
18595,2024-01-13 21:54:00,111,128,Brinquedo,6,239
18596,2024-01-13 21:55:00,62,159,Vestuário,1,221
18597,2024-01-13 21:56:00,30,104,Brinquedo,6,134
18598,2024-01-13 21:57:00,17,24,Vestuário,8,41
18599,2024-01-13 21:58:00,80,39,Brinquedo,4,119
18600,2024-01-13 21:59:00,92,69,Vestuário,5,161
18601,2024-01-13 22:00:00,18,54,Eletrônico,2,72
18602,2024-01-13 22:01:00,95,61,Alimento,9,156
18603,2024-01-13 22:02:00,35,53,Eletrônico,1,88
18604,2024-01-13 22:03:00,96,26,Móvel,4,122
18605,2024-01-13 22:04:00,33,37,Vestuário,2,70
18606,2024-01-13 22:05:00,114,57,Móvel,8,171
18607,2024-01-13 22:06:00,97,125,Brinquedo,2,222
18608,2024-01-13 22:07:00,42,79,Móvel,8,121
18609,2024-01-13 22:08:00,34,160,Móvel,8,194
18610,2024-01-13 22:09:00,31,101,Eletrônico,5,132
18611,2024-01-13 22:10:00,69,60,Brinquedo,1,129
18612,2024-01-13 22:11:00,71,126,Móvel,6,197
18613,2024-01-13 22:12:00,20,96,Alimento,3,116
18614,2024-01-13 22:13:00,17,65,Móvel,2,82
18615,2024-01-13 22:14:00,54,10,Eletrônico,9,64
18616,2024-01-13 22:15:00,10,14,Eletrônico,9,24
18617,2024-01-13 22:16:00,99,92,Brinquedo,5,191
18618,2024-01-13 22:17:00,92,67,Eletrônico,5,159
18619,2024-01-13 22:18:00,47,43,Alimento,8,90
18620,2024-01-13 22:19:00,11,95,Eletrônico,9,106
18621,2024-01-13 22:20:00,32,158,Vestuário,2,190
18622,2024-01-13 22:21:00,101,72,Brinquedo,9,173
18623,2024-01-13 22:22:00,72,179,Vestuário,9,251
18624,2024-01-13 22:23:00,12,150,Vestuário,5,162
18625,2024-01-13 22:24:00,78,130,Alimento,9,208
18626,2024-01-13 22:25:00,108,72,Vestuário,4,180
18627,2024-01-13 22:26:00,78,147,Móvel,9,225
18628,2024-01-13 22:27:00,63,150,Brinquedo,1,213
18629,2024-01-13 22:28:00,101,42,Alimento,3,143
18630,2024-01-13 22:29:00,96,177,Eletrônico,3,273
18631,2024-01-13 22:30:00,82,130,Alimento,6,212
18632,2024-01-13 22:31:00,107,47,Brinquedo,9,154
18633,2024-01-13 22:32:00,26,29,Eletrônico,5,55
18634,2024-01-13 22:33:00,104,65,Vestuário,3,169
18635,2024-01-13 22:34:00,75,61,Brinquedo,6,136
18636,2024-01-13 22:35:00,106,160,Vestuário,7,266
18637,2024-01-13 22:36:00,119,46,Alimento,6,165
18638,2024-01-13 22:37:00,48,94,Alimento,5,142
18639,2024-01-13 22:38:00,47,135,Alimento,7,182
18640,2024-01-13 22:39:00,70,130,Eletrônico,6,200
18641,2024-01-13 22:40:00,63,141,Vestuário,5,204
18642,2024-01-13 22:41:00,19,151,Vestuário,6,170
18643,2024-01-13 22:42:00,83,55,Móvel,7,138
18644,2024-01-13 22:43:00,80,158,Vestuário,9,238
18645,2024-01-13 22:44:00,36,51,Brinquedo,9,87
18646,2024-01-13 22:45:00,111,30,Vestuário,1,141
18647,2024-01-13 22:46:00,74,141,Móvel,6,215
18648,2024-01-13 22:47:00,18,144,Alimento,5,162
18649,2024-01-13 22:48:00,17,176,Brinquedo,4,193
18650,2024-01-13 22:49:00,94,96,Vestuário,8,190
18651,2024-01-13 22:50:00,34,43,Alimento,3,77
18652,2024-01-13 22:51:00,29,122,Brinquedo,9,151
18653,2024-01-13 22:52:00,56,38,Vestuário,7,94
18654,2024-01-13 22:53:00,82,148,Móvel,8,230
18655,2024-01-13 22:54:00,77,133,Brinquedo,7,210
18656,2024-01-13 22:55:00,19,86,Alimento,5,105
18657,2024-01-13 22:56:00,22,61,Eletrônico,5,83
18658,2024-01-13 22:57:00,97,45,Alimento,6,142
18659,2024-01-13 22:58:00,65,160,Eletrônico,8,225
18660,2024-01-13 22:59:00,81,71,Vestuário,4,152
18661,2024-01-13 23:00:00,48,93,Vestuário,3,141
18662,2024-01-13 23:01:00,69,45,Vestuário,3,114
18663,2024-01-13 23:02:00,42,92,Eletrônico,5,134
18664,2024-01-13 23:03:00,99,167,Móvel,3,266
18665,2024-01-13 23:04:00,51,91,Vestuário,2,142
18666,2024-01-13 23:05:00,82,55,Vestuário,2,137
18667,2024-01-13 23:06:00,16,87,Alimento,3,103
18668,2024-01-13 23:07:00,41,156,Vestuário,8,197
18669,2024-01-13 23:08:00,62,63,Vestuário,3,125
18670,2024-01-13 23:09:00,90,52,Eletrônico,7,142
18671,2024-01-13 23:10:00,67,65,Alimento,7,132
18672,2024-01-13 23:11:00,111,59,Eletrônico,4,170
18673,2024-01-13 23:12:00,72,44,Vestuário,9,116
18674,2024-01-13 23:13:00,112,55,Eletrônico,6,167
18675,2024-01-13 23:14:00,117,139,Vestuário,7,256
18676,2024-01-13 23:15:00,97,18,Brinquedo,7,115
18677,2024-01-13 23:16:00,34,136,Vestuário,1,170
18678,2024-01-13 23:17:00,16,129,Vestuário,4,145
18679,2024-01-13 23:18:00,90,54,Vestuário,2,144
18680,2024-01-13 23:19:00,78,140,Brinquedo,8,218
18681,2024-01-13 23:20:00,45,11,Móvel,2,56
18682,2024-01-13 23:21:00,49,58,Vestuário,8,107
18683,2024-01-13 23:22:00,70,129,Eletrônico,6,199
18684,2024-01-13 23:23:00,66,95,Vestuário,9,161
18685,2024-01-13 23:24:00,20,106,Eletrônico,8,126
18686,2024-01-13 23:25:00,91,68,Brinquedo,5,159
18687,2024-01-13 23:26:00,33,36,Alimento,2,69
18688,2024-01-13 23:27:00,84,179,Eletrônico,9,263
18689,2024-01-13 23:28:00,97,94,Vestuário,5,191
18690,2024-01-13 23:29:00,100,175,Brinquedo,3,275
18691,2024-01-13 23:30:00,96,113,Eletrônico,2,209
18692,2024-01-13 23:31:00,82,75,Vestuário,5,157
18693,2024-01-13 23:32:00,62,170,Vestuário,8,232
18694,2024-01-13 23:33:00,97,28,Eletrônico,9,125
18695,2024-01-13 23:34:00,50,40,Vestuário,3,90
18696,2024-01-13 23:35:00,54,14,Eletrônico,9,68
18697,2024-01-13 23:36:00,57,115,Móvel,7,172
18698,2024-01-13 23:37:00,47,165,Brinquedo,5,212
18699,2024-01-13 23:38:00,112,27,Móvel,4,139
18700,2024-01-13 23:39:00,93,60,Móvel,1,153
18701,2024-01-13 23:40:00,46,143,Alimento,6,189
18702,2024-01-13 23:41:00,52,159,Alimento,9,211
18703,2024-01-13 23:42:00,78,72,Vestuário,7,150
18704,2024-01-13 23:43:00,40,105,Brinquedo,7,145
18705,2024-01-13 23:44:00,85,163,Móvel,6,248
18706,2024-01-13 23:45:00,109,149,Alimento,8,258
18707,2024-01-13 23:46:00,93,73,Eletrônico,9,166
18708,2024-01-13 23:47:00,25,71,Móvel,1,96
18709,2024-01-13 23:48:00,41,99,Móvel,4,140
18710,2024-01-13 23:49:00,48,49,Alimento,8,97
18711,2024-01-13 23:50:00,105,61,Móvel,7,166
18712,2024-01-13 23:51:00,74,178,Brinquedo,3,252
18713,2024-01-13 23:52:00,15,150,Vestuário,4,165
18714,2024-01-13 23:53:00,109,41,Vestuário,3,150
18715,2024-01-13 23:54:00,109,12,Móvel,9,121
18716,2024-01-13 23:55:00,54,178,Brinquedo,9,232
18717,2024-01-13 23:56:00,78,44,Eletrônico,7,122
18718,2024-01-13 23:57:00,81,99,Móvel,7,180
18719,2024-01-13 23:58:00,19,23,Eletrônico,8,42
18720,2024-01-13 23:59:00,26,110,Móvel,3,136
18721,2024-01-14 00:00:00,73,125,Brinquedo,1,198
18722,2024-01-14 00:01:00,59,17,Alimento,7,76
18723,2024-01-14 00:02:00,32,121,Eletrônico,1,153
18724,2024-01-14 00:03:00,95,151,Alimento,7,246
18725,2024-01-14 00:04:00,14,171,Brinquedo,4,185
18726,2024-01-14 00:05:00,45,179,Alimento,3,224
18727,2024-01-14 00:06:00,18,116,Brinquedo,4,134
18728,2024-01-14 00:07:00,84,63,Móvel,9,147
18729,2024-01-14 00:08:00,13,55,Eletrônico,1,68
18730,2024-01-14 00:09:00,109,119,Brinquedo,6,228
18731,2024-01-14 00:10:00,17,95,Alimento,3,112
18732,2024-01-14 00:11:00,36,42,Eletrônico,6,78
18733,2024-01-14 00:12:00,13,156,Eletrônico,5,169
18734,2024-01-14 00:13:00,17,42,Móvel,5,59
18735,2024-01-14 00:14:00,92,122,Vestuário,8,214
18736,2024-01-14 00:15:00,29,19,Eletrônico,4,48
18737,2024-01-14 00:16:00,94,175,Vestuário,1,269
18738,2024-01-14 00:17:00,57,83,Eletrônico,6,140
18739,2024-01-14 00:18:00,79,176,Móvel,4,255
18740,2024-01-14 00:19:00,22,95,Vestuário,4,117
18741,2024-01-14 00:20:00,25,23,Brinquedo,6,48
18742,2024-01-14 00:21:00,31,50,Vestuário,8,81
18743,2024-01-14 00:22:00,56,129,Eletrônico,6,185
18744,2024-01-14 00:23:00,109,23,Vestuário,6,132
18745,2024-01-14 00:24:00,57,126,Brinquedo,7,183
18746,2024-01-14 00:25:00,104,34,Alimento,1,138
18747,2024-01-14 00:26:00,63,152,Alimento,4,215
18748,2024-01-14 00:27:00,85,23,Eletrônico,3,108
18749,2024-01-14 00:28:00,102,13,Brinquedo,4,115
18750,2024-01-14 00:29:00,99,53,Alimento,7,152
18751,2024-01-14 00:30:00,92,159,Alimento,1,251
18752,2024-01-14 00:31:00,21,20,Vestuário,2,41
18753,2024-01-14 00:32:00,102,113,Móvel,3,215
18754,2024-01-14 00:33:00,34,73,Móvel,8,107
18755,2024-01-14 00:34:00,47,12,Brinquedo,6,59
18756,2024-01-14 00:35:00,84,68,Vestuário,3,152
18757,2024-01-14 00:36:00,21,36,Móvel,9,57
18758,2024-01-14 00:37:00,87,107,Vestuário,4,194
18759,2024-01-14 00:38:00,36,125,Eletrônico,5,161
18760,2024-01-14 00:39:00,114,159,Brinquedo,5,273
18761,2024-01-14 00:40:00,104,49,Eletrônico,6,153
18762,2024-01-14 00:41:00,64,137,Móvel,8,201
18763,2024-01-14 00:42:00,109,53,Móvel,9,162
18764,2024-01-14 00:43:00,76,35,Alimento,9,111
18765,2024-01-14 00:44:00,110,75,Eletrônico,8,185
18766,2024-01-14 00:45:00,16,126,Eletrônico,6,142
18767,2024-01-14 00:46:00,19,47,Alimento,4,66
18768,2024-01-14 00:47:00,103,53,Alimento,9,156
18769,2024-01-14 00:48:00,83,155,Vestuário,9,238
18770,2024-01-14 00:49:00,54,15,Eletrônico,8,69
18771,2024-01-14 00:50:00,92,118,Brinquedo,4,210
18772,2024-01-14 00:51:00,62,124,Eletrônico,2,186
18773,2024-01-14 00:52:00,71,119,Móvel,8,190
18774,2024-01-14 00:53:00,97,171,Vestuário,8,268
18775,2024-01-14 00:54:00,103,90,Alimento,9,193
18776,2024-01-14 00:55:00,100,75,Vestuário,5,175
18777,2024-01-14 00:56:00,13,122,Vestuário,9,135
18778,2024-01-14 00:57:00,20,157,Brinquedo,7,177
18779,2024-01-14 00:58:00,109,120,Eletrônico,3,229
18780,2024-01-14 00:59:00,79,133,Brinquedo,9,212
18781,2024-01-14 01:00:00,103,71,Móvel,2,174
18782,2024-01-14 01:01:00,85,85,Alimento,5,170
18783,2024-01-14 01:02:00,113,166,Móvel,6,279
18784,2024-01-14 01:03:00,23,109,Brinquedo,1,132
18785,2024-01-14 01:04:00,30,78,Brinquedo,3,108
18786,2024-01-14 01:05:00,92,73,Eletrônico,7,165
18787,2024-01-14 01:06:00,66,26,Móvel,4,92
18788,2024-01-14 01:07:00,40,62,Vestuário,9,102
18789,2024-01-14 01:08:00,11,124,Vestuário,1,135
18790,2024-01-14 01:09:00,11,108,Móvel,5,119
18791,2024-01-14 01:10:00,73,41,Brinquedo,9,114
18792,2024-01-14 01:11:00,113,98,Brinquedo,6,211
18793,2024-01-14 01:12:00,56,14,Alimento,9,70
18794,2024-01-14 01:13:00,33,67,Vestuário,1,100
18795,2024-01-14 01:14:00,37,59,Alimento,3,96
18796,2024-01-14 01:15:00,105,107,Brinquedo,3,212
18797,2024-01-14 01:16:00,74,163,Móvel,2,237
18798,2024-01-14 01:17:00,109,148,Vestuário,5,257
18799,2024-01-14 01:18:00,35,136,Eletrônico,5,171
18800,2024-01-14 01:19:00,30,29,Alimento,4,59
18801,2024-01-14 01:20:00,35,138,Brinquedo,1,173
18802,2024-01-14 01:21:00,45,150,Móvel,7,195
18803,2024-01-14 01:22:00,45,177,Móvel,8,222
18804,2024-01-14 01:23:00,100,43,Brinquedo,3,143
18805,2024-01-14 01:24:00,40,133,Eletrônico,1,173
18806,2024-01-14 01:25:00,45,35,Móvel,2,80
18807,2024-01-14 01:26:00,26,115,Móvel,5,141
18808,2024-01-14 01:27:00,106,35,Vestuário,8,141
18809,2024-01-14 01:28:00,79,87,Alimento,3,166
18810,2024-01-14 01:29:00,36,105,Móvel,1,141
18811,2024-01-14 01:30:00,94,102,Eletrônico,2,196
18812,2024-01-14 01:31:00,47,38,Vestuário,4,85
18813,2024-01-14 01:32:00,96,91,Brinquedo,7,187
18814,2024-01-14 01:33:00,59,61,Eletrônico,9,120
18815,2024-01-14 01:34:00,78,145,Brinquedo,7,223
18816,2024-01-14 01:35:00,27,88,Alimento,7,115
18817,2024-01-14 01:36:00,65,56,Móvel,8,121
18818,2024-01-14 01:37:00,20,48,Alimento,6,68
18819,2024-01-14 01:38:00,38,61,Alimento,6,99
18820,2024-01-14 01:39:00,53,61,Brinquedo,4,114
18821,2024-01-14 01:40:00,72,92,Móvel,9,164
18822,2024-01-14 01:41:00,75,130,Alimento,2,205
18823,2024-01-14 01:42:00,94,14,Brinquedo,1,108
18824,2024-01-14 01:43:00,12,62,Brinquedo,3,74
18825,2024-01-14 01:44:00,104,10,Móvel,8,114
18826,2024-01-14 01:45:00,78,166,Móvel,9,244
18827,2024-01-14 01:46:00,109,88,Brinquedo,3,197
18828,2024-01-14 01:47:00,94,162,Brinquedo,4,256
18829,2024-01-14 01:48:00,33,145,Alimento,7,178
18830,2024-01-14 01:49:00,60,16,Vestuário,6,76
18831,2024-01-14 01:50:00,18,108,Vestuário,8,126
18832,2024-01-14 01:51:00,117,58,Vestuário,6,175
18833,2024-01-14 01:52:00,35,28,Brinquedo,9,63
18834,2024-01-14 01:53:00,108,84,Vestuário,7,192
18835,2024-01-14 01:54:00,20,156,Brinquedo,6,176
18836,2024-01-14 01:55:00,13,123,Eletrônico,6,136
18837,2024-01-14 01:56:00,65,122,Eletrônico,4,187
18838,2024-01-14 01:57:00,12,17,Móvel,5,29
18839,2024-01-14 01:58:00,78,29,Alimento,1,107
18840,2024-01-14 01:59:00,113,116,Eletrônico,6,229
18841,2024-01-14 02:00:00,112,179,Brinquedo,3,291
18842,2024-01-14 02:01:00,24,32,Alimento,9,56
18843,2024-01-14 02:02:00,78,94,Móvel,7,172
18844,2024-01-14 02:03:00,91,141,Brinquedo,7,232
18845,2024-01-14 02:04:00,34,27,Alimento,7,61
18846,2024-01-14 02:05:00,32,137,Eletrônico,8,169
18847,2024-01-14 02:06:00,74,153,Eletrônico,5,227
18848,2024-01-14 02:07:00,111,113,Vestuário,3,224
18849,2024-01-14 02:08:00,28,98,Brinquedo,4,126
18850,2024-01-14 02:09:00,29,142,Vestuário,7,171
18851,2024-01-14 02:10:00,64,133,Alimento,5,197
18852,2024-01-14 02:11:00,107,10,Vestuário,5,117
18853,2024-01-14 02:12:00,19,94,Vestuário,1,113
18854,2024-01-14 02:13:00,50,113,Eletrônico,1,163
18855,2024-01-14 02:14:00,105,91,Brinquedo,1,196
18856,2024-01-14 02:15:00,22,137,Vestuário,5,159
18857,2024-01-14 02:16:00,81,126,Vestuário,8,207
18858,2024-01-14 02:17:00,69,151,Móvel,4,220
18859,2024-01-14 02:18:00,101,44,Eletrônico,8,145
18860,2024-01-14 02:19:00,35,172,Móvel,4,207
18861,2024-01-14 02:20:00,64,177,Vestuário,5,241
18862,2024-01-14 02:21:00,27,105,Móvel,9,132
18863,2024-01-14 02:22:00,119,10,Alimento,2,129
18864,2024-01-14 02:23:00,99,15,Eletrônico,1,114
18865,2024-01-14 02:24:00,91,23,Alimento,3,114
18866,2024-01-14 02:25:00,117,24,Vestuário,3,141
18867,2024-01-14 02:26:00,45,14,Brinquedo,2,59
18868,2024-01-14 02:27:00,84,44,Brinquedo,3,128
18869,2024-01-14 02:28:00,79,91,Alimento,5,170
18870,2024-01-14 02:29:00,28,156,Vestuário,8,184
18871,2024-01-14 02:30:00,91,74,Vestuário,8,165
18872,2024-01-14 02:31:00,80,63,Móvel,9,143
18873,2024-01-14 02:32:00,42,81,Brinquedo,2,123
18874,2024-01-14 02:33:00,86,87,Móvel,8,173
18875,2024-01-14 02:34:00,59,166,Eletrônico,8,225
18876,2024-01-14 02:35:00,112,81,Móvel,2,193
18877,2024-01-14 02:36:00,96,132,Vestuário,8,228
18878,2024-01-14 02:37:00,106,55,Brinquedo,5,161
18879,2024-01-14 02:38:00,103,19,Eletrônico,9,122
18880,2024-01-14 02:39:00,94,46,Alimento,1,140
18881,2024-01-14 02:40:00,40,136,Móvel,1,176
18882,2024-01-14 02:41:00,58,56,Móvel,9,114
18883,2024-01-14 02:42:00,34,59,Alimento,2,93
18884,2024-01-14 02:43:00,27,82,Brinquedo,6,109
18885,2024-01-14 02:44:00,53,24,Brinquedo,8,77
18886,2024-01-14 02:45:00,59,79,Móvel,4,138
18887,2024-01-14 02:46:00,103,115,Vestuário,9,218
18888,2024-01-14 02:47:00,85,84,Vestuário,2,169
18889,2024-01-14 02:48:00,113,109,Vestuário,5,222
18890,2024-01-14 02:49:00,11,124,Vestuário,4,135
18891,2024-01-14 02:50:00,26,107,Eletrônico,4,133
18892,2024-01-14 02:51:00,56,159,Brinquedo,6,215
18893,2024-01-14 02:52:00,95,36,Móvel,2,131
18894,2024-01-14 02:53:00,75,160,Alimento,4,235
18895,2024-01-14 02:54:00,100,50,Móvel,3,150
18896,2024-01-14 02:55:00,38,16,Vestuário,3,54
18897,2024-01-14 02:56:00,62,135,Brinquedo,8,197
18898,2024-01-14 02:57:00,58,21,Eletrônico,2,79
18899,2024-01-14 02:58:00,30,39,Eletrônico,4,69
18900,2024-01-14 02:59:00,15,78,Alimento,2,93
18901,2024-01-14 03:00:00,119,63,Vestuário,5,182
18902,2024-01-14 03:01:00,70,41,Vestuário,5,111
18903,2024-01-14 03:02:00,41,168,Eletrônico,1,209
18904,2024-01-14 03:03:00,17,104,Vestuário,4,121
18905,2024-01-14 03:04:00,83,117,Vestuário,7,200
18906,2024-01-14 03:05:00,69,163,Alimento,4,232
18907,2024-01-14 03:06:00,27,139,Móvel,3,166
18908,2024-01-14 03:07:00,16,108,Brinquedo,5,124
18909,2024-01-14 03:08:00,117,161,Móvel,6,278
18910,2024-01-14 03:09:00,30,70,Móvel,5,100
18911,2024-01-14 03:10:00,45,72,Eletrônico,5,117
18912,2024-01-14 03:11:00,74,174,Móvel,7,248
18913,2024-01-14 03:12:00,101,38,Brinquedo,9,139
18914,2024-01-14 03:13:00,83,127,Brinquedo,5,210
18915,2024-01-14 03:14:00,107,81,Alimento,2,188
18916,2024-01-14 03:15:00,27,81,Móvel,3,108
18917,2024-01-14 03:16:00,80,120,Brinquedo,5,200
18918,2024-01-14 03:17:00,34,110,Alimento,7,144
18919,2024-01-14 03:18:00,16,96,Vestuário,4,112
18920,2024-01-14 03:19:00,55,143,Vestuário,4,198
18921,2024-01-14 03:20:00,68,63,Alimento,9,131
18922,2024-01-14 03:21:00,76,171,Móvel,8,247
18923,2024-01-14 03:22:00,77,72,Eletrônico,7,149
18924,2024-01-14 03:23:00,97,168,Eletrônico,5,265
18925,2024-01-14 03:24:00,119,33,Vestuário,3,152
18926,2024-01-14 03:25:00,107,127,Móvel,2,234
18927,2024-01-14 03:26:00,63,52,Vestuário,1,115
18928,2024-01-14 03:27:00,54,78,Eletrônico,5,132
18929,2024-01-14 03:28:00,98,168,Alimento,8,266
18930,2024-01-14 03:29:00,79,98,Brinquedo,8,177
18931,2024-01-14 03:30:00,70,19,Móvel,4,89
18932,2024-01-14 03:31:00,51,172,Vestuário,9,223
18933,2024-01-14 03:32:00,80,47,Brinquedo,1,127
18934,2024-01-14 03:33:00,59,158,Alimento,7,217
18935,2024-01-14 03:34:00,26,61,Alimento,2,87
18936,2024-01-14 03:35:00,101,127,Móvel,8,228
18937,2024-01-14 03:36:00,92,145,Brinquedo,8,237
18938,2024-01-14 03:37:00,35,139,Eletrônico,9,174
18939,2024-01-14 03:38:00,70,44,Móvel,4,114
18940,2024-01-14 03:39:00,45,25,Eletrônico,4,70
18941,2024-01-14 03:40:00,47,10,Móvel,9,57
18942,2024-01-14 03:41:00,36,157,Brinquedo,8,193
18943,2024-01-14 03:42:00,107,153,Vestuário,1,260
18944,2024-01-14 03:43:00,114,103,Brinquedo,7,217
18945,2024-01-14 03:44:00,69,34,Móvel,1,103
18946,2024-01-14 03:45:00,15,28,Móvel,4,43
18947,2024-01-14 03:46:00,63,126,Vestuário,2,189
18948,2024-01-14 03:47:00,50,125,Brinquedo,6,175
18949,2024-01-14 03:48:00,77,86,Móvel,9,163
18950,2024-01-14 03:49:00,82,77,Móvel,3,159
18951,2024-01-14 03:50:00,117,136,Móvel,5,253
18952,2024-01-14 03:51:00,78,67,Alimento,4,145
18953,2024-01-14 03:52:00,68,118,Móvel,7,186
18954,2024-01-14 03:53:00,112,86,Eletrônico,1,198
18955,2024-01-14 03:54:00,35,176,Móvel,7,211
18956,2024-01-14 03:55:00,34,134,Eletrônico,5,168
18957,2024-01-14 03:56:00,49,34,Brinquedo,2,83
18958,2024-01-14 03:57:00,95,122,Vestuário,3,217
18959,2024-01-14 03:58:00,58,76,Eletrônico,4,134
18960,2024-01-14 03:59:00,78,122,Móvel,5,200
18961,2024-01-14 04:00:00,117,111,Móvel,7,228
18962,2024-01-14 04:01:00,74,175,Vestuário,3,249
18963,2024-01-14 04:02:00,107,73,Vestuário,2,180
18964,2024-01-14 04:03:00,109,95,Vestuário,8,204
18965,2024-01-14 04:04:00,45,90,Alimento,8,135
18966,2024-01-14 04:05:00,85,133,Móvel,2,218
18967,2024-01-14 04:06:00,11,103,Alimento,7,114
18968,2024-01-14 04:07:00,44,133,Brinquedo,8,177
18969,2024-01-14 04:08:00,22,73,Alimento,4,95
18970,2024-01-14 04:09:00,25,19,Móvel,3,44
18971,2024-01-14 04:10:00,118,147,Alimento,6,265
18972,2024-01-14 04:11:00,96,42,Alimento,9,138
18973,2024-01-14 04:12:00,75,39,Alimento,5,114
18974,2024-01-14 04:13:00,28,117,Eletrônico,6,145
18975,2024-01-14 04:14:00,97,19,Móvel,1,116
18976,2024-01-14 04:15:00,68,94,Móvel,4,162
18977,2024-01-14 04:16:00,44,90,Vestuário,1,134
18978,2024-01-14 04:17:00,103,144,Vestuário,9,247
18979,2024-01-14 04:18:00,119,61,Alimento,3,180
18980,2024-01-14 04:19:00,96,107,Móvel,8,203
18981,2024-01-14 04:20:00,89,153,Brinquedo,7,242
18982,2024-01-14 04:21:00,61,58,Eletrônico,3,119
18983,2024-01-14 04:22:00,63,19,Móvel,6,82
18984,2024-01-14 04:23:00,59,148,Brinquedo,5,207
18985,2024-01-14 04:24:00,22,156,Eletrônico,8,178
18986,2024-01-14 04:25:00,107,49,Alimento,2,156
18987,2024-01-14 04:26:00,94,53,Brinquedo,2,147
18988,2024-01-14 04:27:00,50,15,Móvel,2,65
18989,2024-01-14 04:28:00,29,155,Eletrônico,7,184
18990,2024-01-14 04:29:00,106,146,Brinquedo,1,252
18991,2024-01-14 04:30:00,86,142,Brinquedo,4,228
18992,2024-01-14 04:31:00,116,46,Vestuário,1,162
18993,2024-01-14 04:32:00,12,96,Móvel,2,108
18994,2024-01-14 04:33:00,40,144,Alimento,4,184
18995,2024-01-14 04:34:00,63,138,Móvel,7,201
18996,2024-01-14 04:35:00,56,152,Brinquedo,1,208
18997,2024-01-14 04:36:00,98,67,Eletrônico,7,165
18998,2024-01-14 04:37:00,103,112,Alimento,9,215
18999,2024-01-14 04:38:00,23,55,Eletrônico,3,78
19000,2024-01-14 04:39:00,53,75,Eletrônico,1,128
19001,2024-01-14 04:40:00,115,163,Móvel,9,278
19002,2024-01-14 04:41:00,58,156,Móvel,1,214
19003,2024-01-14 04:42:00,23,66,Móvel,2,89
19004,2024-01-14 04:43:00,32,111,Eletrônico,4,143
19005,2024-01-14 04:44:00,69,150,Alimento,2,219
19006,2024-01-14 04:45:00,48,120,Brinquedo,4,168
19007,2024-01-14 04:46:00,51,68,Alimento,2,119
19008,2024-01-14 04:47:00,42,87,Alimento,7,129
19009,2024-01-14 04:48:00,58,162,Brinquedo,1,220
19010,2024-01-14 04:49:00,49,11,Vestuário,1,60
19011,2024-01-14 04:50:00,89,155,Vestuário,6,244
19012,2024-01-14 04:51:00,111,65,Eletrônico,1,176
19013,2024-01-14 04:52:00,71,159,Móvel,8,230
19014,2024-01-14 04:53:00,76,13,Móvel,4,89
19015,2024-01-14 04:54:00,73,12,Móvel,5,85
19016,2024-01-14 04:55:00,16,107,Alimento,5,123
19017,2024-01-14 04:56:00,58,110,Vestuário,2,168
19018,2024-01-14 04:57:00,72,58,Móvel,3,130
19019,2024-01-14 04:58:00,69,139,Alimento,6,208
19020,2024-01-14 04:59:00,63,64,Brinquedo,8,127
19021,2024-01-14 05:00:00,77,133,Vestuário,9,210
19022,2024-01-14 05:01:00,83,88,Móvel,2,171
19023,2024-01-14 05:02:00,77,132,Brinquedo,1,209
19024,2024-01-14 05:03:00,66,20,Brinquedo,8,86
19025,2024-01-14 05:04:00,42,122,Brinquedo,3,164
19026,2024-01-14 05:05:00,89,156,Alimento,4,245
19027,2024-01-14 05:06:00,92,13,Brinquedo,7,105
19028,2024-01-14 05:07:00,80,128,Vestuário,8,208
19029,2024-01-14 05:08:00,46,65,Móvel,4,111
19030,2024-01-14 05:09:00,71,36,Vestuário,5,107
19031,2024-01-14 05:10:00,110,154,Brinquedo,7,264
19032,2024-01-14 05:11:00,23,37,Móvel,3,60
19033,2024-01-14 05:12:00,12,33,Móvel,9,45
19034,2024-01-14 05:13:00,37,48,Eletrônico,6,85
19035,2024-01-14 05:14:00,12,43,Eletrônico,7,55
19036,2024-01-14 05:15:00,29,66,Móvel,6,95
19037,2024-01-14 05:16:00,49,32,Vestuário,2,81
19038,2024-01-14 05:17:00,57,103,Móvel,7,160
19039,2024-01-14 05:18:00,50,177,Brinquedo,5,227
19040,2024-01-14 05:19:00,46,135,Brinquedo,7,181
19041,2024-01-14 05:20:00,45,41,Alimento,4,86
19042,2024-01-14 05:21:00,104,41,Eletrônico,7,145
19043,2024-01-14 05:22:00,81,32,Eletrônico,4,113
19044,2024-01-14 05:23:00,63,145,Móvel,3,208
19045,2024-01-14 05:24:00,41,10,Alimento,9,51
19046,2024-01-14 05:25:00,105,121,Vestuário,6,226
19047,2024-01-14 05:26:00,96,58,Alimento,5,154
19048,2024-01-14 05:27:00,109,61,Brinquedo,2,170
19049,2024-01-14 05:28:00,16,44,Vestuário,6,60
19050,2024-01-14 05:29:00,64,101,Móvel,3,165
19051,2024-01-14 05:30:00,51,133,Brinquedo,6,184
19052,2024-01-14 05:31:00,109,58,Alimento,9,167
19053,2024-01-14 05:32:00,81,137,Brinquedo,6,218
19054,2024-01-14 05:33:00,50,127,Vestuário,4,177
19055,2024-01-14 05:34:00,82,131,Vestuário,8,213
19056,2024-01-14 05:35:00,50,30,Eletrônico,4,80
19057,2024-01-14 05:36:00,82,129,Alimento,7,211
19058,2024-01-14 05:37:00,111,30,Alimento,3,141
19059,2024-01-14 05:38:00,72,172,Móvel,9,244
19060,2024-01-14 05:39:00,103,64,Brinquedo,1,167
19061,2024-01-14 05:40:00,40,12,Alimento,1,52
19062,2024-01-14 05:41:00,76,178,Alimento,5,254
19063,2024-01-14 05:42:00,73,171,Alimento,7,244
19064,2024-01-14 05:43:00,113,12,Alimento,9,125
19065,2024-01-14 05:44:00,45,96,Vestuário,2,141
19066,2024-01-14 05:45:00,83,66,Alimento,6,149
19067,2024-01-14 05:46:00,18,76,Vestuário,8,94
19068,2024-01-14 05:47:00,103,102,Brinquedo,2,205
19069,2024-01-14 05:48:00,65,17,Móvel,6,82
19070,2024-01-14 05:49:00,69,161,Eletrônico,3,230
19071,2024-01-14 05:50:00,87,126,Móvel,8,213
19072,2024-01-14 05:51:00,75,153,Eletrônico,5,228
19073,2024-01-14 05:52:00,85,43,Vestuário,2,128
19074,2024-01-14 05:53:00,111,15,Móvel,3,126
19075,2024-01-14 05:54:00,67,150,Alimento,6,217
19076,2024-01-14 05:55:00,16,111,Alimento,1,127
19077,2024-01-14 05:56:00,59,52,Brinquedo,6,111
19078,2024-01-14 05:57:00,59,50,Alimento,8,109
19079,2024-01-14 05:58:00,82,112,Brinquedo,3,194
19080,2024-01-14 05:59:00,73,37,Brinquedo,7,110
19081,2024-01-14 06:00:00,116,101,Móvel,2,217
19082,2024-01-14 06:01:00,37,83,Vestuário,8,120
19083,2024-01-14 06:02:00,53,94,Vestuário,8,147
19084,2024-01-14 06:03:00,72,137,Móvel,8,209
19085,2024-01-14 06:04:00,47,68,Móvel,5,115
19086,2024-01-14 06:05:00,92,96,Brinquedo,1,188
19087,2024-01-14 06:06:00,30,104,Alimento,7,134
19088,2024-01-14 06:07:00,44,125,Brinquedo,3,169
19089,2024-01-14 06:08:00,36,142,Brinquedo,9,178
19090,2024-01-14 06:09:00,25,154,Eletrônico,8,179
19091,2024-01-14 06:10:00,98,168,Vestuário,4,266
19092,2024-01-14 06:11:00,11,83,Vestuário,4,94
19093,2024-01-14 06:12:00,34,80,Alimento,7,114
19094,2024-01-14 06:13:00,63,37,Brinquedo,8,100
19095,2024-01-14 06:14:00,81,166,Eletrônico,2,247
19096,2024-01-14 06:15:00,32,52,Móvel,3,84
19097,2024-01-14 06:16:00,91,165,Móvel,2,256
19098,2024-01-14 06:17:00,68,49,Eletrônico,9,117
19099,2024-01-14 06:18:00,104,150,Vestuário,7,254
19100,2024-01-14 06:19:00,118,99,Vestuário,3,217
19101,2024-01-14 06:20:00,18,103,Móvel,9,121
19102,2024-01-14 06:21:00,46,51,Brinquedo,6,97
19103,2024-01-14 06:22:00,37,131,Brinquedo,5,168
19104,2024-01-14 06:23:00,93,119,Brinquedo,1,212
19105,2024-01-14 06:24:00,66,23,Alimento,8,89
19106,2024-01-14 06:25:00,89,64,Vestuário,8,153
19107,2024-01-14 06:26:00,90,172,Móvel,7,262
19108,2024-01-14 06:27:00,71,54,Alimento,5,125
19109,2024-01-14 06:28:00,90,61,Alimento,1,151
19110,2024-01-14 06:29:00,86,107,Alimento,2,193
19111,2024-01-14 06:30:00,116,43,Alimento,9,159
19112,2024-01-14 06:31:00,28,177,Móvel,2,205
19113,2024-01-14 06:32:00,73,72,Móvel,5,145
19114,2024-01-14 06:33:00,81,128,Alimento,8,209
19115,2024-01-14 06:34:00,76,57,Alimento,5,133
19116,2024-01-14 06:35:00,31,16,Brinquedo,9,47
19117,2024-01-14 06:36:00,10,122,Vestuário,7,132
19118,2024-01-14 06:37:00,26,13,Móvel,3,39
19119,2024-01-14 06:38:00,116,25,Alimento,9,141
19120,2024-01-14 06:39:00,96,32,Vestuário,9,128
19121,2024-01-14 06:40:00,16,43,Alimento,9,59
19122,2024-01-14 06:41:00,13,152,Eletrônico,1,165
19123,2024-01-14 06:42:00,61,18,Vestuário,2,79
19124,2024-01-14 06:43:00,58,150,Vestuário,4,208
19125,2024-01-14 06:44:00,45,105,Móvel,7,150
19126,2024-01-14 06:45:00,78,25,Eletrônico,5,103
19127,2024-01-14 06:46:00,27,59,Brinquedo,4,86
19128,2024-01-14 06:47:00,19,57,Móvel,8,76
19129,2024-01-14 06:48:00,119,94,Alimento,8,213
19130,2024-01-14 06:49:00,77,157,Eletrônico,8,234
19131,2024-01-14 06:50:00,41,15,Móvel,1,56
19132,2024-01-14 06:51:00,18,49,Móvel,8,67
19133,2024-01-14 06:52:00,114,98,Brinquedo,1,212
19134,2024-01-14 06:53:00,94,134,Vestuário,4,228
19135,2024-01-14 06:54:00,114,133,Brinquedo,3,247
19136,2024-01-14 06:55:00,40,141,Vestuário,5,181
19137,2024-01-14 06:56:00,114,157,Alimento,6,271
19138,2024-01-14 06:57:00,91,110,Alimento,9,201
19139,2024-01-14 06:58:00,100,83,Vestuário,4,183
19140,2024-01-14 06:59:00,29,162,Vestuário,7,191
19141,2024-01-14 07:00:00,82,145,Vestuário,6,227
19142,2024-01-14 07:01:00,104,125,Eletrônico,7,229
19143,2024-01-14 07:02:00,114,173,Brinquedo,4,287
19144,2024-01-14 07:03:00,64,58,Alimento,3,122
19145,2024-01-14 07:04:00,89,46,Móvel,3,135
19146,2024-01-14 07:05:00,99,16,Móvel,2,115
19147,2024-01-14 07:06:00,83,83,Móvel,1,166
19148,2024-01-14 07:07:00,98,129,Vestuário,5,227
19149,2024-01-14 07:08:00,113,140,Vestuário,8,253
19150,2024-01-14 07:09:00,56,55,Alimento,9,111
19151,2024-01-14 07:10:00,80,23,Eletrônico,1,103
19152,2024-01-14 07:11:00,79,31,Alimento,3,110
19153,2024-01-14 07:12:00,14,157,Vestuário,9,171
19154,2024-01-14 07:13:00,48,77,Eletrônico,8,125
19155,2024-01-14 07:14:00,104,46,Brinquedo,1,150
19156,2024-01-14 07:15:00,112,43,Brinquedo,4,155
19157,2024-01-14 07:16:00,90,85,Brinquedo,1,175
19158,2024-01-14 07:17:00,72,82,Móvel,1,154
19159,2024-01-14 07:18:00,96,82,Vestuário,3,178
19160,2024-01-14 07:19:00,28,34,Brinquedo,9,62
19161,2024-01-14 07:20:00,40,155,Eletrônico,3,195
19162,2024-01-14 07:21:00,86,149,Eletrônico,9,235
19163,2024-01-14 07:22:00,92,120,Brinquedo,4,212
19164,2024-01-14 07:23:00,66,136,Eletrônico,4,202
19165,2024-01-14 07:24:00,86,125,Móvel,7,211
19166,2024-01-14 07:25:00,30,147,Alimento,9,177
19167,2024-01-14 07:26:00,37,119,Vestuário,6,156
19168,2024-01-14 07:27:00,78,99,Alimento,2,177
19169,2024-01-14 07:28:00,11,146,Alimento,1,157
19170,2024-01-14 07:29:00,10,30,Alimento,2,40
19171,2024-01-14 07:30:00,45,45,Brinquedo,9,90
19172,2024-01-14 07:31:00,45,31,Alimento,8,76
19173,2024-01-14 07:32:00,51,158,Móvel,8,209
19174,2024-01-14 07:33:00,114,142,Vestuário,8,256
19175,2024-01-14 07:34:00,69,45,Vestuário,9,114
19176,2024-01-14 07:35:00,13,156,Móvel,1,169
19177,2024-01-14 07:36:00,52,54,Móvel,6,106
19178,2024-01-14 07:37:00,113,157,Vestuário,6,270
19179,2024-01-14 07:38:00,93,111,Alimento,7,204
19180,2024-01-14 07:39:00,119,68,Eletrônico,4,187
19181,2024-01-14 07:40:00,60,55,Eletrônico,5,115
19182,2024-01-14 07:41:00,56,78,Móvel,2,134
19183,2024-01-14 07:42:00,73,58,Vestuário,3,131
19184,2024-01-14 07:43:00,68,16,Móvel,2,84
19185,2024-01-14 07:44:00,116,157,Brinquedo,7,273
19186,2024-01-14 07:45:00,110,29,Móvel,2,139
19187,2024-01-14 07:46:00,62,162,Brinquedo,5,224
19188,2024-01-14 07:47:00,87,138,Brinquedo,2,225
19189,2024-01-14 07:48:00,103,136,Brinquedo,3,239
19190,2024-01-14 07:49:00,17,101,Vestuário,8,118
19191,2024-01-14 07:50:00,51,142,Eletrônico,6,193
19192,2024-01-14 07:51:00,82,173,Móvel,3,255
19193,2024-01-14 07:52:00,35,162,Vestuário,5,197
19194,2024-01-14 07:53:00,61,33,Móvel,9,94
19195,2024-01-14 07:54:00,73,78,Eletrônico,3,151
19196,2024-01-14 07:55:00,108,79,Vestuário,6,187
19197,2024-01-14 07:56:00,68,131,Eletrônico,6,199
19198,2024-01-14 07:57:00,62,127,Móvel,7,189
19199,2024-01-14 07:58:00,25,58,Vestuário,3,83
19200,2024-01-14 07:59:00,55,100,Vestuário,8,155
19201,2024-01-14 08:00:00,49,39,Móvel,5,88
19202,2024-01-14 08:01:00,37,135,Brinquedo,9,172
19203,2024-01-14 08:02:00,50,127,Vestuário,9,177
19204,2024-01-14 08:03:00,119,145,Vestuário,2,264
19205,2024-01-14 08:04:00,58,52,Móvel,2,110
19206,2024-01-14 08:05:00,74,56,Vestuário,2,130
19207,2024-01-14 08:06:00,104,111,Vestuário,5,215
19208,2024-01-14 08:07:00,16,149,Vestuário,6,165
19209,2024-01-14 08:08:00,107,16,Móvel,5,123
19210,2024-01-14 08:09:00,26,136,Móvel,1,162
19211,2024-01-14 08:10:00,108,57,Alimento,2,165
19212,2024-01-14 08:11:00,37,45,Móvel,4,82
19213,2024-01-14 08:12:00,53,110,Brinquedo,8,163
19214,2024-01-14 08:13:00,31,169,Alimento,2,200
19215,2024-01-14 08:14:00,118,91,Brinquedo,3,209
19216,2024-01-14 08:15:00,107,37,Brinquedo,9,144
19217,2024-01-14 08:16:00,88,65,Vestuário,4,153
19218,2024-01-14 08:17:00,44,20,Eletrônico,6,64
19219,2024-01-14 08:18:00,33,76,Brinquedo,1,109
19220,2024-01-14 08:19:00,106,83,Alimento,2,189
19221,2024-01-14 08:20:00,43,35,Vestuário,2,78
19222,2024-01-14 08:21:00,66,172,Eletrônico,6,238
19223,2024-01-14 08:22:00,97,107,Móvel,7,204
19224,2024-01-14 08:23:00,77,37,Eletrônico,6,114
19225,2024-01-14 08:24:00,16,60,Eletrônico,9,76
19226,2024-01-14 08:25:00,113,21,Eletrônico,1,134
19227,2024-01-14 08:26:00,42,95,Brinquedo,2,137
19228,2024-01-14 08:27:00,82,123,Vestuário,4,205
19229,2024-01-14 08:28:00,29,60,Vestuário,4,89
19230,2024-01-14 08:29:00,23,139,Móvel,3,162
19231,2024-01-14 08:30:00,102,11,Móvel,7,113
19232,2024-01-14 08:31:00,21,155,Vestuário,5,176
19233,2024-01-14 08:32:00,102,53,Eletrônico,4,155
19234,2024-01-14 08:33:00,39,52,Móvel,6,91
19235,2024-01-14 08:34:00,99,15,Eletrônico,5,114
19236,2024-01-14 08:35:00,112,97,Móvel,1,209
19237,2024-01-14 08:36:00,31,131,Alimento,8,162
19238,2024-01-14 08:37:00,97,31,Alimento,5,128
19239,2024-01-14 08:38:00,15,99,Móvel,6,114
19240,2024-01-14 08:39:00,100,61,Alimento,5,161
19241,2024-01-14 08:40:00,107,138,Eletrônico,3,245
19242,2024-01-14 08:41:00,118,23,Vestuário,4,141
19243,2024-01-14 08:42:00,61,179,Alimento,2,240
19244,2024-01-14 08:43:00,95,67,Vestuário,2,162
19245,2024-01-14 08:44:00,54,94,Vestuário,1,148
19246,2024-01-14 08:45:00,16,11,Brinquedo,2,27
19247,2024-01-14 08:46:00,85,91,Brinquedo,4,176
19248,2024-01-14 08:47:00,83,162,Móvel,1,245
19249,2024-01-14 08:48:00,96,40,Vestuário,3,136
19250,2024-01-14 08:49:00,48,102,Brinquedo,4,150
19251,2024-01-14 08:50:00,19,93,Móvel,4,112
19252,2024-01-14 08:51:00,80,59,Vestuário,8,139
19253,2024-01-14 08:52:00,109,82,Brinquedo,9,191
19254,2024-01-14 08:53:00,84,110,Brinquedo,7,194
19255,2024-01-14 08:54:00,15,50,Eletrônico,7,65
19256,2024-01-14 08:55:00,34,110,Alimento,1,144
19257,2024-01-14 08:56:00,38,10,Brinquedo,2,48
19258,2024-01-14 08:57:00,85,144,Alimento,8,229
19259,2024-01-14 08:58:00,34,105,Brinquedo,3,139
19260,2024-01-14 08:59:00,100,38,Móvel,2,138
19261,2024-01-14 09:00:00,70,128,Eletrônico,4,198
19262,2024-01-14 09:01:00,102,134,Alimento,6,236
19263,2024-01-14 09:02:00,102,90,Móvel,6,192
19264,2024-01-14 09:03:00,27,106,Eletrônico,1,133
19265,2024-01-14 09:04:00,58,174,Alimento,8,232
19266,2024-01-14 09:05:00,86,42,Móvel,5,128
19267,2024-01-14 09:06:00,36,138,Vestuário,1,174
19268,2024-01-14 09:07:00,36,27,Brinquedo,3,63
19269,2024-01-14 09:08:00,11,113,Eletrônico,3,124
19270,2024-01-14 09:09:00,39,61,Móvel,9,100
19271,2024-01-14 09:10:00,24,101,Móvel,9,125
19272,2024-01-14 09:11:00,79,142,Móvel,1,221
19273,2024-01-14 09:12:00,12,101,Móvel,4,113
19274,2024-01-14 09:13:00,43,122,Alimento,4,165
19275,2024-01-14 09:14:00,14,73,Eletrônico,8,87
19276,2024-01-14 09:15:00,60,72,Eletrônico,8,132
19277,2024-01-14 09:16:00,28,40,Brinquedo,2,68
19278,2024-01-14 09:17:00,56,45,Eletrônico,1,101
19279,2024-01-14 09:18:00,47,44,Vestuário,6,91
19280,2024-01-14 09:19:00,93,49,Eletrônico,9,142
19281,2024-01-14 09:20:00,87,37,Brinquedo,6,124
19282,2024-01-14 09:21:00,12,152,Móvel,8,164
19283,2024-01-14 09:22:00,78,11,Eletrônico,8,89
19284,2024-01-14 09:23:00,78,73,Móvel,5,151
19285,2024-01-14 09:24:00,22,153,Eletrônico,2,175
19286,2024-01-14 09:25:00,36,93,Alimento,4,129
19287,2024-01-14 09:26:00,24,105,Vestuário,4,129
19288,2024-01-14 09:27:00,12,28,Alimento,1,40
19289,2024-01-14 09:28:00,91,21,Alimento,1,112
19290,2024-01-14 09:29:00,24,83,Vestuário,3,107
19291,2024-01-14 09:30:00,69,127,Brinquedo,9,196
19292,2024-01-14 09:31:00,75,163,Vestuário,9,238
19293,2024-01-14 09:32:00,86,77,Alimento,7,163
19294,2024-01-14 09:33:00,50,28,Eletrônico,2,78
19295,2024-01-14 09:34:00,88,136,Eletrônico,2,224
19296,2024-01-14 09:35:00,71,113,Vestuário,5,184
19297,2024-01-14 09:36:00,95,49,Eletrônico,2,144
19298,2024-01-14 09:37:00,70,73,Móvel,8,143
19299,2024-01-14 09:38:00,107,49,Alimento,7,156
19300,2024-01-14 09:39:00,12,27,Brinquedo,2,39
19301,2024-01-14 09:40:00,116,54,Brinquedo,9,170
19302,2024-01-14 09:41:00,100,65,Móvel,2,165
19303,2024-01-14 09:42:00,52,39,Alimento,5,91
19304,2024-01-14 09:43:00,104,166,Vestuário,2,270
19305,2024-01-14 09:44:00,74,33,Alimento,5,107
19306,2024-01-14 09:45:00,26,33,Eletrônico,8,59
19307,2024-01-14 09:46:00,78,129,Móvel,8,207
19308,2024-01-14 09:47:00,86,143,Eletrônico,9,229
19309,2024-01-14 09:48:00,26,79,Alimento,1,105
19310,2024-01-14 09:49:00,16,18,Vestuário,2,34
19311,2024-01-14 09:50:00,58,73,Alimento,7,131
19312,2024-01-14 09:51:00,90,146,Vestuário,1,236
19313,2024-01-14 09:52:00,64,148,Brinquedo,7,212
19314,2024-01-14 09:53:00,53,87,Móvel,8,140
19315,2024-01-14 09:54:00,55,151,Brinquedo,5,206
19316,2024-01-14 09:55:00,102,51,Vestuário,1,153
19317,2024-01-14 09:56:00,36,29,Móvel,6,65
19318,2024-01-14 09:57:00,79,97,Eletrônico,5,176
19319,2024-01-14 09:58:00,79,94,Eletrônico,1,173
19320,2024-01-14 09:59:00,16,146,Vestuário,5,162
19321,2024-01-14 10:00:00,100,30,Brinquedo,8,130
19322,2024-01-14 10:01:00,47,34,Brinquedo,2,81
19323,2024-01-14 10:02:00,84,49,Alimento,1,133
19324,2024-01-14 10:03:00,62,149,Eletrônico,5,211
19325,2024-01-14 10:04:00,105,61,Móvel,3,166
19326,2024-01-14 10:05:00,85,29,Brinquedo,9,114
19327,2024-01-14 10:06:00,74,25,Brinquedo,7,99
19328,2024-01-14 10:07:00,83,26,Alimento,7,109
19329,2024-01-14 10:08:00,22,134,Móvel,2,156
19330,2024-01-14 10:09:00,34,49,Eletrônico,9,83
19331,2024-01-14 10:10:00,115,149,Móvel,9,264
19332,2024-01-14 10:11:00,73,82,Vestuário,1,155
19333,2024-01-14 10:12:00,93,46,Brinquedo,9,139
19334,2024-01-14 10:13:00,106,112,Brinquedo,6,218
19335,2024-01-14 10:14:00,86,12,Vestuário,5,98
19336,2024-01-14 10:15:00,47,10,Alimento,7,57
19337,2024-01-14 10:16:00,104,144,Vestuário,9,248
19338,2024-01-14 10:17:00,74,75,Alimento,7,149
19339,2024-01-14 10:18:00,49,62,Móvel,7,111
19340,2024-01-14 10:19:00,76,49,Vestuário,3,125
19341,2024-01-14 10:20:00,69,174,Alimento,2,243
19342,2024-01-14 10:21:00,30,146,Eletrônico,6,176
19343,2024-01-14 10:22:00,118,50,Vestuário,2,168
19344,2024-01-14 10:23:00,93,18,Móvel,1,111
19345,2024-01-14 10:24:00,104,47,Alimento,1,151
19346,2024-01-14 10:25:00,77,50,Eletrônico,7,127
19347,2024-01-14 10:26:00,51,14,Brinquedo,4,65
19348,2024-01-14 10:27:00,89,110,Móvel,6,199
19349,2024-01-14 10:28:00,104,141,Móvel,1,245
19350,2024-01-14 10:29:00,26,163,Brinquedo,4,189
19351,2024-01-14 10:30:00,80,135,Eletrônico,5,215
19352,2024-01-14 10:31:00,41,81,Alimento,3,122
19353,2024-01-14 10:32:00,117,25,Alimento,5,142
19354,2024-01-14 10:33:00,34,69,Móvel,9,103
19355,2024-01-14 10:34:00,37,80,Alimento,9,117
19356,2024-01-14 10:35:00,77,177,Eletrônico,6,254
19357,2024-01-14 10:36:00,70,57,Brinquedo,7,127
19358,2024-01-14 10:37:00,91,18,Eletrônico,8,109
19359,2024-01-14 10:38:00,70,58,Brinquedo,7,128
19360,2024-01-14 10:39:00,45,111,Vestuário,5,156
19361,2024-01-14 10:40:00,87,83,Alimento,1,170
19362,2024-01-14 10:41:00,116,127,Alimento,7,243
19363,2024-01-14 10:42:00,13,40,Alimento,8,53
19364,2024-01-14 10:43:00,19,126,Vestuário,7,145
19365,2024-01-14 10:44:00,41,40,Vestuário,3,81
19366,2024-01-14 10:45:00,73,14,Alimento,2,87
19367,2024-01-14 10:46:00,94,150,Móvel,7,244
19368,2024-01-14 10:47:00,11,101,Eletrônico,1,112
19369,2024-01-14 10:48:00,118,65,Eletrônico,5,183
19370,2024-01-14 10:49:00,104,96,Brinquedo,7,200
19371,2024-01-14 10:50:00,108,132,Vestuário,3,240
19372,2024-01-14 10:51:00,93,13,Vestuário,3,106
19373,2024-01-14 10:52:00,91,126,Eletrônico,1,217
19374,2024-01-14 10:53:00,89,158,Brinquedo,1,247
19375,2024-01-14 10:54:00,33,140,Eletrônico,6,173
19376,2024-01-14 10:55:00,40,163,Brinquedo,4,203
19377,2024-01-14 10:56:00,93,74,Vestuário,4,167
19378,2024-01-14 10:57:00,93,35,Alimento,9,128
19379,2024-01-14 10:58:00,45,63,Eletrônico,4,108
19380,2024-01-14 10:59:00,36,45,Móvel,6,81
19381,2024-01-14 11:00:00,42,88,Brinquedo,3,130
19382,2024-01-14 11:01:00,41,133,Brinquedo,3,174
19383,2024-01-14 11:02:00,119,26,Vestuário,8,145
19384,2024-01-14 11:03:00,67,69,Vestuário,4,136
19385,2024-01-14 11:04:00,112,135,Alimento,6,247
19386,2024-01-14 11:05:00,57,58,Alimento,1,115
19387,2024-01-14 11:06:00,57,67,Vestuário,7,124
19388,2024-01-14 11:07:00,63,23,Alimento,9,86
19389,2024-01-14 11:08:00,93,27,Móvel,9,120
19390,2024-01-14 11:09:00,86,85,Móvel,4,171
19391,2024-01-14 11:10:00,66,40,Brinquedo,3,106
19392,2024-01-14 11:11:00,75,52,Vestuário,5,127
19393,2024-01-14 11:12:00,49,167,Alimento,9,216
19394,2024-01-14 11:13:00,94,101,Brinquedo,4,195
19395,2024-01-14 11:14:00,89,152,Brinquedo,1,241
19396,2024-01-14 11:15:00,102,11,Móvel,9,113
19397,2024-01-14 11:16:00,31,60,Móvel,9,91
19398,2024-01-14 11:17:00,84,141,Vestuário,9,225
19399,2024-01-14 11:18:00,79,101,Alimento,3,180
19400,2024-01-14 11:19:00,36,81,Eletrônico,6,117
19401,2024-01-14 11:20:00,55,92,Alimento,7,147
19402,2024-01-14 11:21:00,27,72,Brinquedo,2,99
19403,2024-01-14 11:22:00,45,178,Eletrônico,3,223
19404,2024-01-14 11:23:00,80,33,Alimento,5,113
19405,2024-01-14 11:24:00,56,162,Alimento,5,218
19406,2024-01-14 11:25:00,45,38,Vestuário,8,83
19407,2024-01-14 11:26:00,17,106,Eletrônico,3,123
19408,2024-01-14 11:27:00,65,95,Eletrônico,6,160
19409,2024-01-14 11:28:00,103,17,Eletrônico,3,120
19410,2024-01-14 11:29:00,89,96,Brinquedo,2,185
19411,2024-01-14 11:30:00,96,49,Vestuário,5,145
19412,2024-01-14 11:31:00,45,89,Alimento,6,134
19413,2024-01-14 11:32:00,74,130,Vestuário,2,204
19414,2024-01-14 11:33:00,77,127,Móvel,1,204
19415,2024-01-14 11:34:00,63,23,Brinquedo,6,86
19416,2024-01-14 11:35:00,85,57,Brinquedo,3,142
19417,2024-01-14 11:36:00,112,70,Eletrônico,7,182
19418,2024-01-14 11:37:00,91,153,Móvel,7,244
19419,2024-01-14 11:38:00,107,53,Vestuário,2,160
19420,2024-01-14 11:39:00,78,51,Brinquedo,5,129
19421,2024-01-14 11:40:00,98,152,Brinquedo,1,250
19422,2024-01-14 11:41:00,66,104,Brinquedo,5,170
19423,2024-01-14 11:42:00,47,135,Vestuário,7,182
19424,2024-01-14 11:43:00,96,60,Eletrônico,4,156
19425,2024-01-14 11:44:00,88,76,Brinquedo,6,164
19426,2024-01-14 11:45:00,32,95,Móvel,6,127
19427,2024-01-14 11:46:00,47,15,Vestuário,3,62
19428,2024-01-14 11:47:00,50,129,Alimento,5,179
19429,2024-01-14 11:48:00,14,49,Vestuário,4,63
19430,2024-01-14 11:49:00,96,47,Vestuário,1,143
19431,2024-01-14 11:50:00,27,38,Alimento,9,65
19432,2024-01-14 11:51:00,85,172,Eletrônico,6,257
19433,2024-01-14 11:52:00,52,34,Eletrônico,1,86
19434,2024-01-14 11:53:00,87,103,Vestuário,5,190
19435,2024-01-14 11:54:00,35,20,Alimento,8,55
19436,2024-01-14 11:55:00,63,121,Vestuário,3,184
19437,2024-01-14 11:56:00,19,56,Alimento,1,75
19438,2024-01-14 11:57:00,76,111,Vestuário,4,187
19439,2024-01-14 11:58:00,38,67,Móvel,4,105
19440,2024-01-14 11:59:00,20,175,Móvel,5,195
19441,2024-01-14 12:00:00,86,33,Vestuário,9,119
19442,2024-01-14 12:01:00,89,85,Vestuário,8,174
19443,2024-01-14 12:02:00,89,87,Eletrônico,4,176
19444,2024-01-14 12:03:00,84,166,Alimento,3,250
19445,2024-01-14 12:04:00,21,16,Alimento,4,37
19446,2024-01-14 12:05:00,15,14,Móvel,2,29
19447,2024-01-14 12:06:00,23,153,Brinquedo,5,176
19448,2024-01-14 12:07:00,89,75,Móvel,2,164
19449,2024-01-14 12:08:00,62,131,Brinquedo,3,193
19450,2024-01-14 12:09:00,104,67,Vestuário,5,171
19451,2024-01-14 12:10:00,40,115,Vestuário,1,155
19452,2024-01-14 12:11:00,32,72,Vestuário,3,104
19453,2024-01-14 12:12:00,65,115,Alimento,3,180
19454,2024-01-14 12:13:00,98,162,Alimento,3,260
19455,2024-01-14 12:14:00,112,140,Móvel,4,252
19456,2024-01-14 12:15:00,50,18,Móvel,9,68
19457,2024-01-14 12:16:00,103,47,Brinquedo,1,150
19458,2024-01-14 12:17:00,94,51,Brinquedo,9,145
19459,2024-01-14 12:18:00,115,20,Alimento,8,135
19460,2024-01-14 12:19:00,74,59,Alimento,2,133
19461,2024-01-14 12:20:00,79,83,Brinquedo,1,162
19462,2024-01-14 12:21:00,35,68,Brinquedo,7,103
19463,2024-01-14 12:22:00,71,38,Vestuário,5,109
19464,2024-01-14 12:23:00,62,101,Eletrônico,3,163
19465,2024-01-14 12:24:00,23,120,Vestuário,1,143
19466,2024-01-14 12:25:00,74,125,Brinquedo,1,199
19467,2024-01-14 12:26:00,82,25,Móvel,9,107
19468,2024-01-14 12:27:00,116,88,Brinquedo,4,204
19469,2024-01-14 12:28:00,75,173,Eletrônico,2,248
19470,2024-01-14 12:29:00,105,87,Móvel,8,192
19471,2024-01-14 12:30:00,88,81,Brinquedo,9,169
19472,2024-01-14 12:31:00,72,54,Alimento,4,126
19473,2024-01-14 12:32:00,20,22,Eletrônico,2,42
19474,2024-01-14 12:33:00,50,157,Alimento,4,207
19475,2024-01-14 12:34:00,119,124,Eletrônico,7,243
19476,2024-01-14 12:35:00,75,115,Eletrônico,1,190
19477,2024-01-14 12:36:00,118,94,Vestuário,9,212
19478,2024-01-14 12:37:00,50,71,Vestuário,5,121
19479,2024-01-14 12:38:00,70,177,Alimento,2,247
19480,2024-01-14 12:39:00,72,47,Brinquedo,3,119
19481,2024-01-14 12:40:00,102,14,Móvel,7,116
19482,2024-01-14 12:41:00,106,28,Eletrônico,2,134
19483,2024-01-14 12:42:00,24,56,Eletrônico,4,80
19484,2024-01-14 12:43:00,39,139,Brinquedo,4,178
19485,2024-01-14 12:44:00,24,118,Eletrônico,9,142
19486,2024-01-14 12:45:00,78,34,Vestuário,9,112
19487,2024-01-14 12:46:00,62,164,Vestuário,8,226
19488,2024-01-14 12:47:00,75,129,Eletrônico,5,204
19489,2024-01-14 12:48:00,80,66,Brinquedo,7,146
19490,2024-01-14 12:49:00,113,38,Móvel,2,151
19491,2024-01-14 12:50:00,92,18,Móvel,2,110
19492,2024-01-14 12:51:00,39,65,Alimento,9,104
19493,2024-01-14 12:52:00,111,142,Móvel,9,253
19494,2024-01-14 12:53:00,116,35,Eletrônico,9,151
19495,2024-01-14 12:54:00,34,141,Eletrônico,5,175
19496,2024-01-14 12:55:00,50,128,Móvel,7,178
19497,2024-01-14 12:56:00,92,24,Móvel,9,116
19498,2024-01-14 12:57:00,26,81,Brinquedo,8,107
19499,2024-01-14 12:58:00,29,107,Brinquedo,7,136
19500,2024-01-14 12:59:00,56,94,Eletrônico,6,150
19501,2024-01-14 13:00:00,92,81,Alimento,5,173
19502,2024-01-14 13:01:00,86,66,Vestuário,8,152
19503,2024-01-14 13:02:00,98,152,Brinquedo,1,250
19504,2024-01-14 13:03:00,52,139,Alimento,1,191
19505,2024-01-14 13:04:00,32,144,Vestuário,8,176
19506,2024-01-14 13:05:00,56,100,Alimento,9,156
19507,2024-01-14 13:06:00,45,99,Alimento,5,144
19508,2024-01-14 13:07:00,31,20,Móvel,1,51
19509,2024-01-14 13:08:00,46,58,Móvel,7,104
19510,2024-01-14 13:09:00,48,13,Móvel,7,61
19511,2024-01-14 13:10:00,81,50,Móvel,1,131
19512,2024-01-14 13:11:00,12,72,Vestuário,5,84
19513,2024-01-14 13:12:00,76,160,Vestuário,7,236
19514,2024-01-14 13:13:00,51,136,Vestuário,2,187
19515,2024-01-14 13:14:00,103,114,Alimento,4,217
19516,2024-01-14 13:15:00,49,122,Brinquedo,9,171
19517,2024-01-14 13:16:00,105,18,Vestuário,2,123
19518,2024-01-14 13:17:00,10,169,Alimento,1,179
19519,2024-01-14 13:18:00,32,142,Brinquedo,8,174
19520,2024-01-14 13:19:00,101,22,Alimento,6,123
19521,2024-01-14 13:20:00,69,58,Móvel,5,127
19522,2024-01-14 13:21:00,31,13,Móvel,3,44
19523,2024-01-14 13:22:00,85,133,Vestuário,6,218
19524,2024-01-14 13:23:00,113,74,Móvel,2,187
19525,2024-01-14 13:24:00,107,50,Vestuário,3,157
19526,2024-01-14 13:25:00,57,112,Brinquedo,7,169
19527,2024-01-14 13:26:00,68,136,Eletrônico,9,204
19528,2024-01-14 13:27:00,51,148,Brinquedo,6,199
19529,2024-01-14 13:28:00,86,47,Brinquedo,5,133
19530,2024-01-14 13:29:00,88,49,Móvel,9,137
19531,2024-01-14 13:30:00,116,48,Brinquedo,3,164
19532,2024-01-14 13:31:00,59,30,Móvel,9,89
19533,2024-01-14 13:32:00,43,83,Brinquedo,4,126
19534,2024-01-14 13:33:00,17,46,Móvel,2,63
19535,2024-01-14 13:34:00,93,114,Móvel,9,207
19536,2024-01-14 13:35:00,61,173,Eletrônico,5,234
19537,2024-01-14 13:36:00,10,126,Eletrônico,6,136
19538,2024-01-14 13:37:00,84,98,Eletrônico,9,182
19539,2024-01-14 13:38:00,55,90,Eletrônico,3,145
19540,2024-01-14 13:39:00,32,56,Brinquedo,7,88
19541,2024-01-14 13:40:00,43,148,Alimento,4,191
19542,2024-01-14 13:41:00,66,175,Vestuário,1,241
19543,2024-01-14 13:42:00,40,87,Vestuário,5,127
19544,2024-01-14 13:43:00,15,153,Móvel,3,168
19545,2024-01-14 13:44:00,67,135,Móvel,1,202
19546,2024-01-14 13:45:00,76,85,Vestuário,6,161
19547,2024-01-14 13:46:00,46,108,Móvel,8,154
19548,2024-01-14 13:47:00,47,100,Vestuário,4,147
19549,2024-01-14 13:48:00,48,160,Brinquedo,6,208
19550,2024-01-14 13:49:00,70,81,Alimento,2,151
19551,2024-01-14 13:50:00,111,61,Brinquedo,4,172
19552,2024-01-14 13:51:00,94,98,Vestuário,3,192
19553,2024-01-14 13:52:00,80,173,Eletrônico,8,253
19554,2024-01-14 13:53:00,112,105,Alimento,2,217
19555,2024-01-14 13:54:00,48,109,Alimento,3,157
19556,2024-01-14 13:55:00,49,15,Alimento,7,64
19557,2024-01-14 13:56:00,65,37,Brinquedo,1,102
19558,2024-01-14 13:57:00,84,55,Eletrônico,9,139
19559,2024-01-14 13:58:00,69,137,Alimento,6,206
19560,2024-01-14 13:59:00,47,71,Móvel,3,118
19561,2024-01-14 14:00:00,90,82,Eletrônico,1,172
19562,2024-01-14 14:01:00,58,119,Eletrônico,5,177
19563,2024-01-14 14:02:00,103,38,Móvel,8,141
19564,2024-01-14 14:03:00,48,59,Eletrônico,4,107
19565,2024-01-14 14:04:00,50,56,Eletrônico,3,106
19566,2024-01-14 14:05:00,58,74,Brinquedo,5,132
19567,2024-01-14 14:06:00,67,27,Móvel,2,94
19568,2024-01-14 14:07:00,31,106,Móvel,4,137
19569,2024-01-14 14:08:00,74,80,Vestuário,4,154
19570,2024-01-14 14:09:00,66,47,Móvel,7,113
19571,2024-01-14 14:10:00,106,54,Eletrônico,7,160
19572,2024-01-14 14:11:00,49,65,Vestuário,4,114
19573,2024-01-14 14:12:00,24,145,Móvel,4,169
19574,2024-01-14 14:13:00,48,166,Vestuário,9,214
19575,2024-01-14 14:14:00,104,105,Brinquedo,4,209
19576,2024-01-14 14:15:00,77,26,Móvel,4,103
19577,2024-01-14 14:16:00,91,105,Brinquedo,7,196
19578,2024-01-14 14:17:00,113,138,Alimento,3,251
19579,2024-01-14 14:18:00,104,90,Vestuário,9,194
19580,2024-01-14 14:19:00,107,111,Vestuário,5,218
19581,2024-01-14 14:20:00,72,115,Eletrônico,8,187
19582,2024-01-14 14:21:00,27,91,Brinquedo,4,118
19583,2024-01-14 14:22:00,107,140,Vestuário,2,247
19584,2024-01-14 14:23:00,111,89,Eletrônico,2,200
19585,2024-01-14 14:24:00,12,116,Eletrônico,3,128
19586,2024-01-14 14:25:00,24,92,Brinquedo,8,116
19587,2024-01-14 14:26:00,59,84,Alimento,8,143
19588,2024-01-14 14:27:00,107,17,Móvel,1,124
19589,2024-01-14 14:28:00,68,47,Eletrônico,9,115
19590,2024-01-14 14:29:00,104,89,Eletrônico,8,193
19591,2024-01-14 14:30:00,114,176,Alimento,4,290
19592,2024-01-14 14:31:00,58,49,Eletrônico,7,107
19593,2024-01-14 14:32:00,19,76,Brinquedo,6,95
19594,2024-01-14 14:33:00,62,142,Eletrônico,3,204
19595,2024-01-14 14:34:00,43,102,Brinquedo,2,145
19596,2024-01-14 14:35:00,61,132,Alimento,7,193
19597,2024-01-14 14:36:00,19,149,Alimento,3,168
19598,2024-01-14 14:37:00,114,139,Vestuário,5,253
19599,2024-01-14 14:38:00,16,67,Vestuário,1,83
19600,2024-01-14 14:39:00,105,61,Alimento,5,166
19601,2024-01-14 14:40:00,98,153,Móvel,5,251
19602,2024-01-14 14:41:00,17,31,Móvel,1,48
19603,2024-01-14 14:42:00,54,80,Eletrônico,5,134
19604,2024-01-14 14:43:00,73,13,Vestuário,3,86
19605,2024-01-14 14:44:00,52,41,Alimento,8,93
19606,2024-01-14 14:45:00,107,146,Eletrônico,9,253
19607,2024-01-14 14:46:00,58,82,Alimento,5,140
19608,2024-01-14 14:47:00,54,88,Vestuário,1,142
19609,2024-01-14 14:48:00,73,63,Alimento,4,136
19610,2024-01-14 14:49:00,95,166,Móvel,2,261
19611,2024-01-14 14:50:00,82,138,Vestuário,4,220
19612,2024-01-14 14:51:00,64,11,Brinquedo,4,75
19613,2024-01-14 14:52:00,31,21,Alimento,9,52
19614,2024-01-14 14:53:00,76,16,Vestuário,8,92
19615,2024-01-14 14:54:00,33,119,Eletrônico,1,152
19616,2024-01-14 14:55:00,25,159,Vestuário,1,184
19617,2024-01-14 14:56:00,39,137,Brinquedo,7,176
19618,2024-01-14 14:57:00,24,169,Eletrônico,5,193
19619,2024-01-14 14:58:00,67,43,Vestuário,4,110
19620,2024-01-14 14:59:00,33,115,Móvel,3,148
19621,2024-01-14 15:00:00,73,178,Brinquedo,2,251
19622,2024-01-14 15:01:00,39,106,Móvel,8,145
19623,2024-01-14 15:02:00,24,144,Vestuário,8,168
19624,2024-01-14 15:03:00,79,20,Eletrônico,3,99
19625,2024-01-14 15:04:00,89,169,Vestuário,6,258
19626,2024-01-14 15:05:00,25,146,Vestuário,7,171
19627,2024-01-14 15:06:00,60,137,Eletrônico,6,197
19628,2024-01-14 15:07:00,34,96,Alimento,1,130
19629,2024-01-14 15:08:00,96,164,Móvel,7,260
19630,2024-01-14 15:09:00,83,122,Alimento,2,205
19631,2024-01-14 15:10:00,67,60,Brinquedo,1,127
19632,2024-01-14 15:11:00,47,75,Brinquedo,6,122
19633,2024-01-14 15:12:00,118,154,Alimento,9,272
19634,2024-01-14 15:13:00,81,11,Alimento,6,92
19635,2024-01-14 15:14:00,81,143,Móvel,1,224
19636,2024-01-14 15:15:00,90,73,Alimento,2,163
19637,2024-01-14 15:16:00,104,57,Móvel,1,161
19638,2024-01-14 15:17:00,61,179,Alimento,8,240
19639,2024-01-14 15:18:00,110,141,Vestuário,2,251
19640,2024-01-14 15:19:00,15,115,Brinquedo,8,130
19641,2024-01-14 15:20:00,99,47,Eletrônico,6,146
19642,2024-01-14 15:21:00,10,169,Alimento,7,179
19643,2024-01-14 15:22:00,77,83,Eletrônico,4,160
19644,2024-01-14 15:23:00,85,52,Brinquedo,5,137
19645,2024-01-14 15:24:00,25,162,Eletrônico,9,187
19646,2024-01-14 15:25:00,57,143,Eletrônico,1,200
19647,2024-01-14 15:26:00,56,148,Brinquedo,2,204
19648,2024-01-14 15:27:00,35,103,Brinquedo,3,138
19649,2024-01-14 15:28:00,103,132,Móvel,4,235
19650,2024-01-14 15:29:00,41,92,Alimento,6,133
19651,2024-01-14 15:30:00,76,89,Alimento,5,165
19652,2024-01-14 15:31:00,70,69,Brinquedo,4,139
19653,2024-01-14 15:32:00,60,29,Vestuário,2,89
19654,2024-01-14 15:33:00,52,173,Vestuário,5,225
19655,2024-01-14 15:34:00,17,124,Móvel,1,141
19656,2024-01-14 15:35:00,112,60,Vestuário,2,172
19657,2024-01-14 15:36:00,112,159,Alimento,5,271
19658,2024-01-14 15:37:00,86,89,Brinquedo,9,175
19659,2024-01-14 15:38:00,33,121,Móvel,3,154
19660,2024-01-14 15:39:00,119,75,Brinquedo,4,194
19661,2024-01-14 15:40:00,18,51,Vestuário,9,69
19662,2024-01-14 15:41:00,13,131,Eletrônico,2,144
19663,2024-01-14 15:42:00,53,84,Eletrônico,8,137
19664,2024-01-14 15:43:00,110,59,Eletrônico,9,169
19665,2024-01-14 15:44:00,75,147,Vestuário,8,222
19666,2024-01-14 15:45:00,75,72,Brinquedo,7,147
19667,2024-01-14 15:46:00,103,43,Brinquedo,8,146
19668,2024-01-14 15:47:00,52,31,Vestuário,8,83
19669,2024-01-14 15:48:00,64,44,Brinquedo,9,108
19670,2024-01-14 15:49:00,38,59,Móvel,5,97
19671,2024-01-14 15:50:00,44,71,Vestuário,7,115
19672,2024-01-14 15:51:00,23,81,Alimento,5,104
19673,2024-01-14 15:52:00,61,85,Vestuário,9,146
19674,2024-01-14 15:53:00,80,33,Eletrônico,3,113
19675,2024-01-14 15:54:00,69,114,Móvel,5,183
19676,2024-01-14 15:55:00,21,77,Alimento,9,98
19677,2024-01-14 15:56:00,61,49,Móvel,3,110
19678,2024-01-14 15:57:00,41,153,Móvel,6,194
19679,2024-01-14 15:58:00,104,69,Vestuário,6,173
19680,2024-01-14 15:59:00,62,147,Vestuário,5,209
19681,2024-01-14 16:00:00,40,115,Móvel,4,155
19682,2024-01-14 16:01:00,97,73,Móvel,6,170
19683,2024-01-14 16:02:00,90,28,Móvel,6,118
19684,2024-01-14 16:03:00,99,170,Brinquedo,7,269
19685,2024-01-14 16:04:00,31,12,Móvel,3,43
19686,2024-01-14 16:05:00,33,51,Eletrônico,5,84
19687,2024-01-14 16:06:00,21,79,Brinquedo,9,100
19688,2024-01-14 16:07:00,113,112,Móvel,9,225
19689,2024-01-14 16:08:00,65,152,Móvel,5,217
19690,2024-01-14 16:09:00,103,125,Eletrônico,6,228
19691,2024-01-14 16:10:00,49,108,Vestuário,3,157
19692,2024-01-14 16:11:00,73,156,Brinquedo,2,229
19693,2024-01-14 16:12:00,39,14,Brinquedo,3,53
19694,2024-01-14 16:13:00,45,151,Vestuário,1,196
19695,2024-01-14 16:14:00,48,173,Eletrônico,6,221
19696,2024-01-14 16:15:00,96,171,Eletrônico,3,267
19697,2024-01-14 16:16:00,80,53,Vestuário,8,133
19698,2024-01-14 16:17:00,75,78,Eletrônico,8,153
19699,2024-01-14 16:18:00,108,147,Vestuário,4,255
19700,2024-01-14 16:19:00,75,84,Alimento,6,159
19701,2024-01-14 16:20:00,108,178,Móvel,9,286
19702,2024-01-14 16:21:00,55,149,Vestuário,1,204
19703,2024-01-14 16:22:00,31,116,Brinquedo,5,147
19704,2024-01-14 16:23:00,53,126,Brinquedo,2,179
19705,2024-01-14 16:24:00,73,107,Eletrônico,9,180
19706,2024-01-14 16:25:00,22,124,Vestuário,7,146
19707,2024-01-14 16:26:00,55,154,Móvel,4,209
19708,2024-01-14 16:27:00,79,143,Móvel,8,222
19709,2024-01-14 16:28:00,99,34,Alimento,4,133
19710,2024-01-14 16:29:00,73,111,Eletrônico,2,184
19711,2024-01-14 16:30:00,78,128,Brinquedo,4,206
19712,2024-01-14 16:31:00,72,89,Móvel,4,161
19713,2024-01-14 16:32:00,68,140,Brinquedo,8,208
19714,2024-01-14 16:33:00,89,114,Eletrônico,5,203
19715,2024-01-14 16:34:00,17,134,Eletrônico,3,151
19716,2024-01-14 16:35:00,113,75,Eletrônico,2,188
19717,2024-01-14 16:36:00,48,153,Alimento,6,201
19718,2024-01-14 16:37:00,118,131,Vestuário,2,249
19719,2024-01-14 16:38:00,78,89,Móvel,1,167
19720,2024-01-14 16:39:00,68,81,Brinquedo,2,149
19721,2024-01-14 16:40:00,33,29,Brinquedo,4,62
19722,2024-01-14 16:41:00,71,25,Brinquedo,2,96
19723,2024-01-14 16:42:00,64,69,Móvel,8,133
19724,2024-01-14 16:43:00,53,110,Eletrônico,6,163
19725,2024-01-14 16:44:00,39,144,Vestuário,1,183
19726,2024-01-14 16:45:00,52,14,Brinquedo,8,66
19727,2024-01-14 16:46:00,11,142,Brinquedo,3,153
19728,2024-01-14 16:47:00,62,79,Vestuário,2,141
19729,2024-01-14 16:48:00,105,84,Móvel,8,189
19730,2024-01-14 16:49:00,64,58,Eletrônico,3,122
19731,2024-01-14 16:50:00,103,56,Eletrônico,4,159
19732,2024-01-14 16:51:00,36,111,Alimento,1,147
19733,2024-01-14 16:52:00,47,173,Alimento,6,220
19734,2024-01-14 16:53:00,20,161,Alimento,3,181
19735,2024-01-14 16:54:00,18,149,Eletrônico,8,167
19736,2024-01-14 16:55:00,25,140,Brinquedo,9,165
19737,2024-01-14 16:56:00,19,47,Móvel,2,66
19738,2024-01-14 16:57:00,118,135,Brinquedo,8,253
19739,2024-01-14 16:58:00,57,18,Móvel,1,75
19740,2024-01-14 16:59:00,11,156,Vestuário,1,167
19741,2024-01-14 17:00:00,115,10,Móvel,8,125
19742,2024-01-14 17:01:00,65,167,Alimento,8,232
19743,2024-01-14 17:02:00,89,59,Brinquedo,2,148
19744,2024-01-14 17:03:00,60,97,Eletrônico,6,157
19745,2024-01-14 17:04:00,35,110,Alimento,8,145
19746,2024-01-14 17:05:00,19,20,Eletrônico,4,39
19747,2024-01-14 17:06:00,41,171,Móvel,7,212
19748,2024-01-14 17:07:00,99,22,Eletrônico,2,121
19749,2024-01-14 17:08:00,60,135,Brinquedo,2,195
19750,2024-01-14 17:09:00,13,67,Eletrônico,8,80
19751,2024-01-14 17:10:00,106,83,Eletrônico,4,189
19752,2024-01-14 17:11:00,72,56,Alimento,4,128
19753,2024-01-14 17:12:00,77,64,Alimento,2,141
19754,2024-01-14 17:13:00,53,144,Alimento,9,197
19755,2024-01-14 17:14:00,14,18,Eletrônico,2,32
19756,2024-01-14 17:15:00,14,165,Móvel,9,179
19757,2024-01-14 17:16:00,33,10,Vestuário,4,43
19758,2024-01-14 17:17:00,104,131,Móvel,2,235
19759,2024-01-14 17:18:00,89,40,Alimento,6,129
19760,2024-01-14 17:19:00,47,155,Eletrônico,6,202
19761,2024-01-14 17:20:00,27,95,Vestuário,1,122
19762,2024-01-14 17:21:00,29,90,Brinquedo,7,119
19763,2024-01-14 17:22:00,55,35,Brinquedo,6,90
19764,2024-01-14 17:23:00,39,100,Móvel,3,139
19765,2024-01-14 17:24:00,25,168,Eletrônico,7,193
19766,2024-01-14 17:25:00,18,105,Brinquedo,9,123
19767,2024-01-14 17:26:00,100,62,Vestuário,7,162
19768,2024-01-14 17:27:00,73,22,Alimento,1,95
19769,2024-01-14 17:28:00,27,25,Vestuário,6,52
19770,2024-01-14 17:29:00,34,164,Alimento,3,198
19771,2024-01-14 17:30:00,61,60,Móvel,6,121
19772,2024-01-14 17:31:00,18,11,Alimento,4,29
19773,2024-01-14 17:32:00,44,125,Alimento,7,169
19774,2024-01-14 17:33:00,65,154,Móvel,8,219
19775,2024-01-14 17:34:00,75,167,Alimento,3,242
19776,2024-01-14 17:35:00,14,25,Vestuário,6,39
19777,2024-01-14 17:36:00,84,112,Alimento,4,196
19778,2024-01-14 17:37:00,61,124,Vestuário,9,185
19779,2024-01-14 17:38:00,77,133,Vestuário,2,210
19780,2024-01-14 17:39:00,65,145,Eletrônico,7,210
19781,2024-01-14 17:40:00,106,66,Eletrônico,3,172
19782,2024-01-14 17:41:00,64,125,Móvel,5,189
19783,2024-01-14 17:42:00,58,34,Vestuário,9,92
19784,2024-01-14 17:43:00,15,86,Eletrônico,2,101
19785,2024-01-14 17:44:00,29,41,Alimento,4,70
19786,2024-01-14 17:45:00,17,153,Brinquedo,1,170
19787,2024-01-14 17:46:00,21,46,Eletrônico,7,67
19788,2024-01-14 17:47:00,115,106,Brinquedo,7,221
19789,2024-01-14 17:48:00,63,158,Brinquedo,8,221
19790,2024-01-14 17:49:00,74,105,Eletrônico,1,179
19791,2024-01-14 17:50:00,112,79,Vestuário,7,191
19792,2024-01-14 17:51:00,16,137,Eletrônico,2,153
19793,2024-01-14 17:52:00,112,108,Brinquedo,5,220
19794,2024-01-14 17:53:00,49,107,Vestuário,6,156
19795,2024-01-14 17:54:00,77,63,Alimento,5,140
19796,2024-01-14 17:55:00,100,157,Alimento,4,257
19797,2024-01-14 17:56:00,102,38,Móvel,4,140
19798,2024-01-14 17:57:00,57,161,Vestuário,4,218
19799,2024-01-14 17:58:00,31,59,Móvel,3,90
19800,2024-01-14 17:59:00,13,74,Vestuário,4,87
19801,2024-01-14 18:00:00,106,115,Alimento,8,221
19802,2024-01-14 18:01:00,82,89,Brinquedo,3,171
19803,2024-01-14 18:02:00,80,37,Eletrônico,9,117
19804,2024-01-14 18:03:00,15,148,Eletrônico,9,163
19805,2024-01-14 18:04:00,28,74,Brinquedo,3,102
19806,2024-01-14 18:05:00,54,32,Brinquedo,7,86
19807,2024-01-14 18:06:00,114,133,Eletrônico,9,247
19808,2024-01-14 18:07:00,97,164,Vestuário,5,261
19809,2024-01-14 18:08:00,33,108,Eletrônico,7,141
19810,2024-01-14 18:09:00,40,144,Móvel,4,184
19811,2024-01-14 18:10:00,36,69,Brinquedo,6,105
19812,2024-01-14 18:11:00,42,11,Brinquedo,2,53
19813,2024-01-14 18:12:00,80,53,Móvel,7,133
19814,2024-01-14 18:13:00,54,132,Eletrônico,5,186
19815,2024-01-14 18:14:00,34,23,Móvel,6,57
19816,2024-01-14 18:15:00,99,126,Móvel,2,225
19817,2024-01-14 18:16:00,83,163,Alimento,8,246
19818,2024-01-14 18:17:00,104,42,Vestuário,8,146
19819,2024-01-14 18:18:00,76,149,Alimento,2,225
19820,2024-01-14 18:19:00,105,30,Vestuário,8,135
19821,2024-01-14 18:20:00,46,66,Brinquedo,8,112
19822,2024-01-14 18:21:00,66,72,Vestuário,1,138
19823,2024-01-14 18:22:00,108,95,Vestuário,9,203
19824,2024-01-14 18:23:00,102,47,Vestuário,8,149
19825,2024-01-14 18:24:00,51,53,Eletrônico,8,104
19826,2024-01-14 18:25:00,69,170,Eletrônico,2,239
19827,2024-01-14 18:26:00,94,105,Brinquedo,9,199
19828,2024-01-14 18:27:00,90,33,Móvel,3,123
19829,2024-01-14 18:28:00,46,65,Brinquedo,8,111
19830,2024-01-14 18:29:00,32,165,Vestuário,1,197
19831,2024-01-14 18:30:00,87,78,Brinquedo,3,165
19832,2024-01-14 18:31:00,96,124,Brinquedo,3,220
19833,2024-01-14 18:32:00,15,120,Alimento,7,135
19834,2024-01-14 18:33:00,32,142,Móvel,3,174
19835,2024-01-14 18:34:00,57,68,Brinquedo,6,125
19836,2024-01-14 18:35:00,89,144,Vestuário,6,233
19837,2024-01-14 18:36:00,118,168,Móvel,2,286
19838,2024-01-14 18:37:00,83,13,Brinquedo,1,96
19839,2024-01-14 18:38:00,44,52,Brinquedo,5,96
19840,2024-01-14 18:39:00,26,49,Brinquedo,5,75
19841,2024-01-14 18:40:00,117,169,Móvel,5,286
19842,2024-01-14 18:41:00,37,58,Alimento,4,95
19843,2024-01-14 18:42:00,91,80,Vestuário,6,171
19844,2024-01-14 18:43:00,86,174,Alimento,6,260
19845,2024-01-14 18:44:00,113,42,Móvel,8,155
19846,2024-01-14 18:45:00,80,175,Móvel,1,255
19847,2024-01-14 18:46:00,86,42,Móvel,8,128
19848,2024-01-14 18:47:00,43,160,Vestuário,4,203
19849,2024-01-14 18:48:00,109,97,Vestuário,3,206
19850,2024-01-14 18:49:00,74,35,Brinquedo,1,109
19851,2024-01-14 18:50:00,19,12,Eletrônico,4,31
19852,2024-01-14 18:51:00,98,179,Eletrônico,5,277
19853,2024-01-14 18:52:00,52,84,Eletrônico,4,136
19854,2024-01-14 18:53:00,31,118,Alimento,2,149
19855,2024-01-14 18:54:00,33,127,Móvel,2,160
19856,2024-01-14 18:55:00,18,54,Brinquedo,9,72
19857,2024-01-14 18:56:00,95,35,Vestuário,7,130
19858,2024-01-14 18:57:00,27,41,Alimento,9,68
19859,2024-01-14 18:58:00,93,154,Eletrônico,5,247
19860,2024-01-14 18:59:00,107,141,Brinquedo,4,248
19861,2024-01-14 19:00:00,48,43,Eletrônico,4,91
19862,2024-01-14 19:01:00,71,138,Brinquedo,7,209
19863,2024-01-14 19:02:00,11,136,Brinquedo,4,147
19864,2024-01-14 19:03:00,11,25,Alimento,7,36
19865,2024-01-14 19:04:00,11,176,Móvel,3,187
19866,2024-01-14 19:05:00,41,116,Alimento,4,157
19867,2024-01-14 19:06:00,66,22,Móvel,1,88
19868,2024-01-14 19:07:00,51,129,Alimento,6,180
19869,2024-01-14 19:08:00,80,144,Brinquedo,7,224
19870,2024-01-14 19:09:00,22,162,Alimento,6,184
19871,2024-01-14 19:10:00,73,169,Móvel,7,242
19872,2024-01-14 19:11:00,11,171,Alimento,6,182
19873,2024-01-14 19:12:00,68,105,Eletrônico,6,173
19874,2024-01-14 19:13:00,72,147,Eletrônico,6,219
19875,2024-01-14 19:14:00,82,19,Alimento,1,101
19876,2024-01-14 19:15:00,93,39,Eletrônico,6,132
19877,2024-01-14 19:16:00,13,150,Alimento,2,163
19878,2024-01-14 19:17:00,111,58,Vestuário,7,169
19879,2024-01-14 19:18:00,33,16,Eletrônico,8,49
19880,2024-01-14 19:19:00,16,117,Vestuário,9,133
19881,2024-01-14 19:20:00,76,76,Vestuário,7,152
19882,2024-01-14 19:21:00,44,162,Móvel,6,206
19883,2024-01-14 19:22:00,70,172,Brinquedo,6,242
19884,2024-01-14 19:23:00,52,105,Brinquedo,9,157
19885,2024-01-14 19:24:00,115,54,Vestuário,3,169
19886,2024-01-14 19:25:00,104,117,Alimento,7,221
19887,2024-01-14 19:26:00,80,49,Alimento,4,129
19888,2024-01-14 19:27:00,100,27,Móvel,8,127
19889,2024-01-14 19:28:00,76,135,Vestuário,2,211
19890,2024-01-14 19:29:00,114,66,Móvel,9,180
19891,2024-01-14 19:30:00,10,177,Alimento,6,187
19892,2024-01-14 19:31:00,13,138,Alimento,6,151
19893,2024-01-14 19:32:00,51,135,Alimento,2,186
19894,2024-01-14 19:33:00,35,82,Eletrônico,6,117
19895,2024-01-14 19:34:00,119,112,Brinquedo,4,231
19896,2024-01-14 19:35:00,88,104,Alimento,7,192
19897,2024-01-14 19:36:00,108,161,Alimento,5,269
19898,2024-01-14 19:37:00,113,13,Brinquedo,2,126
19899,2024-01-14 19:38:00,46,95,Eletrônico,2,141
19900,2024-01-14 19:39:00,72,87,Eletrônico,7,159
19901,2024-01-14 19:40:00,115,71,Móvel,9,186
19902,2024-01-14 19:41:00,75,113,Móvel,3,188
19903,2024-01-14 19:42:00,58,62,Alimento,7,120
19904,2024-01-14 19:43:00,83,115,Brinquedo,5,198
19905,2024-01-14 19:44:00,82,98,Eletrônico,5,180
19906,2024-01-14 19:45:00,84,119,Brinquedo,5,203
19907,2024-01-14 19:46:00,110,161,Brinquedo,8,271
19908,2024-01-14 19:47:00,54,18,Móvel,6,72
19909,2024-01-14 19:48:00,27,138,Eletrônico,8,165
19910,2024-01-14 19:49:00,84,55,Vestuário,9,139
19911,2024-01-14 19:50:00,19,97,Alimento,2,116
19912,2024-01-14 19:51:00,114,172,Eletrônico,2,286
19913,2024-01-14 19:52:00,81,136,Eletrônico,3,217
19914,2024-01-14 19:53:00,45,99,Eletrônico,2,144
19915,2024-01-14 19:54:00,103,45,Vestuário,6,148
19916,2024-01-14 19:55:00,43,65,Brinquedo,8,108
19917,2024-01-14 19:56:00,15,109,Alimento,6,124
19918,2024-01-14 19:57:00,107,93,Vestuário,2,200
19919,2024-01-14 19:58:00,86,17,Vestuário,2,103
19920,2024-01-14 19:59:00,50,168,Eletrônico,8,218
19921,2024-01-14 20:00:00,51,128,Brinquedo,8,179
19922,2024-01-14 20:01:00,19,25,Móvel,1,44
19923,2024-01-14 20:02:00,53,85,Vestuário,8,138
19924,2024-01-14 20:03:00,84,123,Eletrônico,1,207
19925,2024-01-14 20:04:00,116,170,Eletrônico,1,286
19926,2024-01-14 20:05:00,15,164,Brinquedo,3,179
19927,2024-01-14 20:06:00,29,153,Alimento,5,182
19928,2024-01-14 20:07:00,68,149,Vestuário,2,217
19929,2024-01-14 20:08:00,90,135,Brinquedo,5,225
19930,2024-01-14 20:09:00,111,43,Móvel,8,154
19931,2024-01-14 20:10:00,35,145,Vestuário,6,180
19932,2024-01-14 20:11:00,112,37,Brinquedo,9,149
19933,2024-01-14 20:12:00,44,75,Vestuário,9,119
19934,2024-01-14 20:13:00,12,124,Brinquedo,6,136
19935,2024-01-14 20:14:00,93,104,Vestuário,3,197
19936,2024-01-14 20:15:00,53,169,Vestuário,9,222
19937,2024-01-14 20:16:00,81,37,Móvel,6,118
19938,2024-01-14 20:17:00,114,67,Eletrônico,1,181
19939,2024-01-14 20:18:00,30,40,Alimento,8,70
19940,2024-01-14 20:19:00,39,136,Brinquedo,9,175
19941,2024-01-14 20:20:00,74,139,Brinquedo,1,213
19942,2024-01-14 20:21:00,93,117,Móvel,9,210
19943,2024-01-14 20:22:00,111,95,Vestuário,8,206
19944,2024-01-14 20:23:00,56,135,Alimento,9,191
19945,2024-01-14 20:24:00,85,56,Alimento,9,141
19946,2024-01-14 20:25:00,79,70,Alimento,3,149
19947,2024-01-14 20:26:00,30,114,Brinquedo,8,144
19948,2024-01-14 20:27:00,52,26,Eletrônico,5,78
19949,2024-01-14 20:28:00,35,134,Alimento,1,169
19950,2024-01-14 20:29:00,99,146,Alimento,9,245
19951,2024-01-14 20:30:00,70,175,Alimento,1,245
19952,2024-01-14 20:31:00,41,151,Brinquedo,7,192
19953,2024-01-14 20:32:00,108,119,Vestuário,6,227
19954,2024-01-14 20:33:00,58,139,Vestuário,2,197
19955,2024-01-14 20:34:00,15,28,Móvel,3,43
19956,2024-01-14 20:35:00,73,68,Alimento,7,141
19957,2024-01-14 20:36:00,44,93,Brinquedo,6,137
19958,2024-01-14 20:37:00,64,159,Vestuário,4,223
19959,2024-01-14 20:38:00,111,21,Vestuário,6,132
19960,2024-01-14 20:39:00,70,144,Brinquedo,9,214
19961,2024-01-14 20:40:00,30,112,Brinquedo,8,142
19962,2024-01-14 20:41:00,99,59,Móvel,7,158
19963,2024-01-14 20:42:00,89,108,Alimento,6,197
19964,2024-01-14 20:43:00,52,47,Brinquedo,4,99
19965,2024-01-14 20:44:00,60,73,Brinquedo,4,133
19966,2024-01-14 20:45:00,70,26,Vestuário,5,96
19967,2024-01-14 20:46:00,115,116,Brinquedo,1,231
19968,2024-01-14 20:47:00,26,106,Eletrônico,9,132
19969,2024-01-14 20:48:00,52,91,Alimento,9,143
19970,2024-01-14 20:49:00,58,12,Móvel,5,70
19971,2024-01-14 20:50:00,12,50,Alimento,9,62
19972,2024-01-14 20:51:00,45,154,Alimento,5,199
19973,2024-01-14 20:52:00,91,90,Vestuário,1,181
19974,2024-01-14 20:53:00,92,86,Brinquedo,3,178
19975,2024-01-14 20:54:00,56,174,Alimento,5,230
19976,2024-01-14 20:55:00,28,167,Vestuário,9,195
19977,2024-01-14 20:56:00,70,131,Alimento,4,201
19978,2024-01-14 20:57:00,57,117,Alimento,9,174
19979,2024-01-14 20:58:00,28,86,Brinquedo,5,114
19980,2024-01-14 20:59:00,102,105,Eletrônico,8,207
19981,2024-01-14 21:00:00,16,170,Móvel,3,186
19982,2024-01-14 21:01:00,34,14,Vestuário,3,48
19983,2024-01-14 21:02:00,84,39,Brinquedo,3,123
19984,2024-01-14 21:03:00,45,123,Alimento,1,168
19985,2024-01-14 21:04:00,67,85,Brinquedo,3,152
19986,2024-01-14 21:05:00,40,37,Alimento,2,77
19987,2024-01-14 21:06:00,65,89,Móvel,9,154
19988,2024-01-14 21:07:00,119,15,Brinquedo,3,134
19989,2024-01-14 21:08:00,78,123,Eletrônico,3,201
19990,2024-01-14 21:09:00,21,141,Eletrônico,9,162
19991,2024-01-14 21:10:00,80,179,Eletrônico,8,259
19992,2024-01-14 21:11:00,73,161,Vestuário,9,234
19993,2024-01-14 21:12:00,39,56,Brinquedo,6,95
19994,2024-01-14 21:13:00,72,146,Brinquedo,3,218
19995,2024-01-14 21:14:00,48,45,Vestuário,7,93
19996,2024-01-14 21:15:00,27,136,Brinquedo,6,163
19997,2024-01-14 21:16:00,19,142,Vestuário,6,161
19998,2024-01-14 21:17:00,25,27,Vestuário,1,52
19999,2024-01-14 21:18:00,27,100,Brinquedo,5,127
20000,2024-01-14 21:19:00,47,81,Alimento,6,128
20001,2024-01-14 21:20:00,83,108,Vestuário,9,191
20002,2024-01-14 21:21:00,71,17,Brinquedo,6,88
20003,2024-01-14 21:22:00,76,113,Vestuário,4,189
20004,2024-01-14 21:23:00,14,21,Alimento,9,35
20005,2024-01-14 21:24:00,55,60,Brinquedo,8,115
20006,2024-01-14 21:25:00,42,132,Brinquedo,6,174
20007,2024-01-14 21:26:00,117,119,Eletrônico,7,236
20008,2024-01-14 21:27:00,37,24,Alimento,8,61
20009,2024-01-14 21:28:00,13,65,Brinquedo,7,78
20010,2024-01-14 21:29:00,64,148,Alimento,3,212
20011,2024-01-14 21:30:00,32,111,Alimento,9,143
20012,2024-01-14 21:31:00,77,156,Brinquedo,3,233
20013,2024-01-14 21:32:00,48,39,Alimento,2,87
20014,2024-01-14 21:33:00,63,53,Eletrônico,7,116
20015,2024-01-14 21:34:00,34,71,Brinquedo,1,105
20016,2024-01-14 21:35:00,76,41,Alimento,3,117
20017,2024-01-14 21:36:00,118,98,Móvel,2,216
20018,2024-01-14 21:37:00,98,71,Eletrônico,2,169
20019,2024-01-14 21:38:00,33,110,Vestuário,1,143
20020,2024-01-14 21:39:00,21,136,Móvel,1,157
20021,2024-01-14 21:40:00,46,96,Brinquedo,1,142
20022,2024-01-14 21:41:00,30,40,Alimento,9,70
20023,2024-01-14 21:42:00,64,83,Alimento,3,147
20024,2024-01-14 21:43:00,105,136,Brinquedo,7,241
20025,2024-01-14 21:44:00,42,148,Móvel,8,190
20026,2024-01-14 21:45:00,62,40,Brinquedo,6,102
20027,2024-01-14 21:46:00,102,35,Brinquedo,7,137
20028,2024-01-14 21:47:00,65,135,Eletrônico,2,200
20029,2024-01-14 21:48:00,40,18,Brinquedo,1,58
20030,2024-01-14 21:49:00,68,34,Brinquedo,1,102
20031,2024-01-14 21:50:00,103,140,Eletrônico,6,243
20032,2024-01-14 21:51:00,95,151,Vestuário,7,246
20033,2024-01-14 21:52:00,83,120,Eletrônico,9,203
20034,2024-01-14 21:53:00,66,73,Móvel,1,139
20035,2024-01-14 21:54:00,119,44,Vestuário,5,163
20036,2024-01-14 21:55:00,69,151,Eletrônico,1,220
20037,2024-01-14 21:56:00,55,145,Brinquedo,2,200
20038,2024-01-14 21:57:00,51,47,Eletrônico,3,98
20039,2024-01-14 21:58:00,35,160,Vestuário,6,195
20040,2024-01-14 21:59:00,103,55,Alimento,4,158
20041,2024-01-14 22:00:00,114,10,Alimento,6,124
20042,2024-01-14 22:01:00,107,15,Vestuário,3,122
20043,2024-01-14 22:02:00,52,47,Brinquedo,6,99
20044,2024-01-14 22:03:00,50,176,Alimento,3,226
20045,2024-01-14 22:04:00,18,96,Móvel,5,114
20046,2024-01-14 22:05:00,90,39,Vestuário,5,129
20047,2024-01-14 22:06:00,77,173,Móvel,5,250
20048,2024-01-14 22:07:00,60,171,Brinquedo,1,231
20049,2024-01-14 22:08:00,35,112,Eletrônico,8,147
20050,2024-01-14 22:09:00,72,65,Móvel,8,137
20051,2024-01-14 22:10:00,118,172,Vestuário,7,290
20052,2024-01-14 22:11:00,91,103,Alimento,4,194
20053,2024-01-14 22:12:00,98,80,Eletrônico,3,178
20054,2024-01-14 22:13:00,54,82,Eletrônico,1,136
20055,2024-01-14 22:14:00,44,177,Brinquedo,9,221
20056,2024-01-14 22:15:00,90,67,Brinquedo,9,157
20057,2024-01-14 22:16:00,51,88,Vestuário,8,139
20058,2024-01-14 22:17:00,24,57,Eletrônico,4,81
20059,2024-01-14 22:18:00,64,145,Eletrônico,1,209
20060,2024-01-14 22:19:00,99,94,Alimento,9,193
20061,2024-01-14 22:20:00,17,169,Móvel,8,186
20062,2024-01-14 22:21:00,15,169,Móvel,8,184
20063,2024-01-14 22:22:00,75,97,Móvel,3,172
20064,2024-01-14 22:23:00,113,158,Eletrônico,8,271
20065,2024-01-14 22:24:00,40,177,Vestuário,9,217
20066,2024-01-14 22:25:00,68,127,Alimento,5,195
20067,2024-01-14 22:26:00,84,121,Eletrônico,2,205
20068,2024-01-14 22:27:00,77,53,Eletrônico,9,130
20069,2024-01-14 22:28:00,95,116,Móvel,3,211
20070,2024-01-14 22:29:00,82,57,Móvel,4,139
20071,2024-01-14 22:30:00,25,103,Eletrônico,8,128
20072,2024-01-14 22:31:00,54,38,Móvel,3,92
20073,2024-01-14 22:32:00,69,100,Brinquedo,6,169
20074,2024-01-14 22:33:00,18,43,Brinquedo,7,61
20075,2024-01-14 22:34:00,103,56,Alimento,1,159
20076,2024-01-14 22:35:00,113,77,Móvel,7,190
20077,2024-01-14 22:36:00,58,139,Eletrônico,2,197
20078,2024-01-14 22:37:00,32,149,Móvel,4,181
20079,2024-01-14 22:38:00,76,61,Brinquedo,1,137
20080,2024-01-14 22:39:00,15,110,Eletrônico,2,125
20081,2024-01-14 22:40:00,98,87,Brinquedo,8,185
20082,2024-01-14 22:41:00,84,156,Brinquedo,4,240
20083,2024-01-14 22:42:00,78,119,Móvel,6,197
20084,2024-01-14 22:43:00,87,13,Vestuário,6,100
20085,2024-01-14 22:44:00,83,152,Eletrônico,6,235
20086,2024-01-14 22:45:00,81,87,Vestuário,1,168
20087,2024-01-14 22:46:00,84,146,Alimento,1,230
20088,2024-01-14 22:47:00,66,74,Alimento,7,140
20089,2024-01-14 22:48:00,80,97,Vestuário,6,177
20090,2024-01-14 22:49:00,80,38,Alimento,2,118
20091,2024-01-14 22:50:00,83,139,Alimento,2,222
20092,2024-01-14 22:51:00,84,47,Brinquedo,6,131
20093,2024-01-14 22:52:00,25,81,Brinquedo,8,106
20094,2024-01-14 22:53:00,71,54,Vestuário,2,125
20095,2024-01-14 22:54:00,74,21,Alimento,9,95
20096,2024-01-14 22:55:00,112,11,Eletrônico,4,123
20097,2024-01-14 22:56:00,20,23,Vestuário,9,43
20098,2024-01-14 22:57:00,39,110,Móvel,1,149
20099,2024-01-14 22:58:00,40,51,Eletrônico,7,91
20100,2024-01-14 22:59:00,46,70,Eletrônico,9,116
20101,2024-01-14 23:00:00,52,113,Brinquedo,9,165
20102,2024-01-14 23:01:00,68,148,Vestuário,3,216
20103,2024-01-14 23:02:00,42,151,Eletrônico,8,193
20104,2024-01-14 23:03:00,87,19,Móvel,7,106
20105,2024-01-14 23:04:00,57,76,Eletrônico,9,133
20106,2024-01-14 23:05:00,46,42,Eletrônico,3,88
20107,2024-01-14 23:06:00,101,44,Móvel,8,145
20108,2024-01-14 23:07:00,97,81,Vestuário,8,178
20109,2024-01-14 23:08:00,82,135,Vestuário,5,217
20110,2024-01-14 23:09:00,28,28,Móvel,3,56
20111,2024-01-14 23:10:00,59,121,Vestuário,1,180
20112,2024-01-14 23:11:00,37,14,Brinquedo,7,51
20113,2024-01-14 23:12:00,14,108,Móvel,7,122
20114,2024-01-14 23:13:00,87,168,Eletrônico,6,255
20115,2024-01-14 23:14:00,20,140,Eletrônico,8,160
20116,2024-01-14 23:15:00,21,154,Móvel,3,175
20117,2024-01-14 23:16:00,22,145,Móvel,3,167
20118,2024-01-14 23:17:00,14,79,Móvel,4,93
20119,2024-01-14 23:18:00,36,57,Eletrônico,8,93
20120,2024-01-14 23:19:00,87,58,Alimento,2,145
20121,2024-01-14 23:20:00,59,152,Móvel,8,211
20122,2024-01-14 23:21:00,70,137,Alimento,4,207
20123,2024-01-14 23:22:00,80,66,Eletrônico,4,146
20124,2024-01-14 23:23:00,12,146,Eletrônico,8,158
20125,2024-01-14 23:24:00,13,147,Móvel,8,160
20126,2024-01-14 23:25:00,57,113,Brinquedo,3,170
20127,2024-01-14 23:26:00,112,131,Alimento,1,243
20128,2024-01-14 23:27:00,112,174,Alimento,9,286
20129,2024-01-14 23:28:00,107,54,Alimento,8,161
20130,2024-01-14 23:29:00,53,68,Móvel,6,121
20131,2024-01-14 23:30:00,88,85,Vestuário,6,173
20132,2024-01-14 23:31:00,29,75,Alimento,2,104
20133,2024-01-14 23:32:00,70,127,Brinquedo,6,197
20134,2024-01-14 23:33:00,76,123,Eletrônico,9,199
20135,2024-01-14 23:34:00,38,122,Eletrônico,8,160
20136,2024-01-14 23:35:00,36,125,Vestuário,1,161
20137,2024-01-14 23:36:00,110,155,Móvel,5,265
20138,2024-01-14 23:37:00,37,160,Vestuário,5,197
20139,2024-01-14 23:38:00,92,99,Eletrônico,8,191
20140,2024-01-14 23:39:00,85,167,Vestuário,5,252
20141,2024-01-14 23:40:00,35,73,Móvel,4,108
20142,2024-01-14 23:41:00,15,60,Eletrônico,6,75
20143,2024-01-14 23:42:00,54,22,Vestuário,9,76
20144,2024-01-14 23:43:00,15,90,Brinquedo,7,105
20145,2024-01-14 23:44:00,25,158,Eletrônico,6,183
20146,2024-01-14 23:45:00,23,57,Móvel,4,80
20147,2024-01-14 23:46:00,81,151,Eletrônico,1,232
20148,2024-01-14 23:47:00,118,151,Alimento,5,269
20149,2024-01-14 23:48:00,87,89,Móvel,4,176
20150,2024-01-14 23:49:00,14,167,Vestuário,3,181
20151,2024-01-14 23:50:00,91,96,Móvel,7,187
20152,2024-01-14 23:51:00,37,42,Eletrônico,1,79
20153,2024-01-14 23:52:00,35,73,Alimento,4,108
20154,2024-01-14 23:53:00,63,139,Vestuário,9,202
20155,2024-01-14 23:54:00,93,129,Brinquedo,8,222
20156,2024-01-14 23:55:00,34,76,Vestuário,2,110
20157,2024-01-14 23:56:00,59,53,Móvel,9,112
20158,2024-01-14 23:57:00,109,19,Brinquedo,4,128
20159,2024-01-14 23:58:00,98,31,Brinquedo,9,129
20160,2024-01-14 23:59:00,37,115,Móvel,3,152
20161,2024-01-15 00:00:00,105,141,Eletrônico,1,246
20162,2024-01-15 00:01:00,71,147,Eletrônico,5,218
20163,2024-01-15 00:02:00,20,89,Móvel,3,109
20164,2024-01-15 00:03:00,97,22,Brinquedo,9,119
20165,2024-01-15 00:04:00,98,143,Eletrônico,5,241
20166,2024-01-15 00:05:00,35,53,Móvel,7,88
20167,2024-01-15 00:06:00,16,56,Brinquedo,3,72
20168,2024-01-15 00:07:00,80,20,Móvel,3,100
20169,2024-01-15 00:08:00,90,93,Vestuário,7,183
20170,2024-01-15 00:09:00,68,173,Vestuário,2,241
20171,2024-01-15 00:10:00,68,164,Vestuário,9,232
20172,2024-01-15 00:11:00,111,145,Eletrônico,9,256
20173,2024-01-15 00:12:00,93,60,Alimento,5,153
20174,2024-01-15 00:13:00,12,86,Vestuário,7,98
20175,2024-01-15 00:14:00,115,155,Móvel,3,270
20176,2024-01-15 00:15:00,28,104,Brinquedo,8,132
20177,2024-01-15 00:16:00,16,126,Eletrônico,3,142
20178,2024-01-15 00:17:00,118,118,Eletrônico,1,236
20179,2024-01-15 00:18:00,111,37,Vestuário,1,148
20180,2024-01-15 00:19:00,72,10,Alimento,7,82
20181,2024-01-15 00:20:00,17,38,Brinquedo,1,55
20182,2024-01-15 00:21:00,55,101,Móvel,4,156
20183,2024-01-15 00:22:00,87,159,Eletrônico,5,246
20184,2024-01-15 00:23:00,27,71,Alimento,9,98
20185,2024-01-15 00:24:00,10,78,Brinquedo,7,88
20186,2024-01-15 00:25:00,47,168,Alimento,9,215
20187,2024-01-15 00:26:00,28,22,Brinquedo,1,50
20188,2024-01-15 00:27:00,53,131,Eletrônico,1,184
20189,2024-01-15 00:28:00,27,35,Alimento,1,62
20190,2024-01-15 00:29:00,70,143,Eletrônico,6,213
20191,2024-01-15 00:30:00,102,175,Brinquedo,8,277
20192,2024-01-15 00:31:00,79,70,Eletrônico,6,149
20193,2024-01-15 00:32:00,62,45,Eletrônico,1,107
20194,2024-01-15 00:33:00,24,54,Móvel,6,78
20195,2024-01-15 00:34:00,74,153,Alimento,5,227
20196,2024-01-15 00:35:00,103,10,Móvel,2,113
20197,2024-01-15 00:36:00,103,31,Alimento,7,134
20198,2024-01-15 00:37:00,64,63,Brinquedo,3,127
20199,2024-01-15 00:38:00,44,14,Brinquedo,1,58
20200,2024-01-15 00:39:00,17,170,Vestuário,1,187
20201,2024-01-15 00:40:00,11,49,Vestuário,8,60
20202,2024-01-15 00:41:00,102,120,Eletrônico,2,222
20203,2024-01-15 00:42:00,31,127,Vestuário,9,158
20204,2024-01-15 00:43:00,44,66,Eletrônico,2,110
20205,2024-01-15 00:44:00,30,139,Vestuário,3,169
20206,2024-01-15 00:45:00,58,167,Vestuário,2,225
20207,2024-01-15 00:46:00,25,30,Brinquedo,2,55
20208,2024-01-15 00:47:00,100,174,Alimento,3,274
20209,2024-01-15 00:48:00,94,94,Eletrônico,7,188
20210,2024-01-15 00:49:00,59,10,Alimento,6,69
20211,2024-01-15 00:50:00,12,16,Móvel,5,28
20212,2024-01-15 00:51:00,111,68,Eletrônico,3,179
20213,2024-01-15 00:52:00,112,53,Móvel,7,165
20214,2024-01-15 00:53:00,37,168,Alimento,2,205
20215,2024-01-15 00:54:00,99,150,Eletrônico,8,249
20216,2024-01-15 00:55:00,39,104,Móvel,8,143
20217,2024-01-15 00:56:00,112,43,Brinquedo,6,155
20218,2024-01-15 00:57:00,16,50,Brinquedo,5,66
20219,2024-01-15 00:58:00,113,25,Brinquedo,1,138
20220,2024-01-15 00:59:00,56,72,Móvel,1,128
20221,2024-01-15 01:00:00,20,44,Eletrônico,8,64
20222,2024-01-15 01:01:00,40,164,Brinquedo,3,204
20223,2024-01-15 01:02:00,26,84,Eletrônico,4,110
20224,2024-01-15 01:03:00,50,76,Brinquedo,7,126
20225,2024-01-15 01:04:00,90,137,Móvel,1,227
20226,2024-01-15 01:05:00,79,145,Vestuário,4,224
20227,2024-01-15 01:06:00,92,140,Alimento,6,232
20228,2024-01-15 01:07:00,113,69,Móvel,9,182
20229,2024-01-15 01:08:00,18,164,Vestuário,2,182
20230,2024-01-15 01:09:00,108,121,Móvel,7,229
20231,2024-01-15 01:10:00,32,41,Alimento,6,73
20232,2024-01-15 01:11:00,18,11,Alimento,4,29
20233,2024-01-15 01:12:00,98,70,Vestuário,2,168
20234,2024-01-15 01:13:00,42,127,Alimento,6,169
20235,2024-01-15 01:14:00,52,88,Alimento,3,140
20236,2024-01-15 01:15:00,31,10,Alimento,8,41
20237,2024-01-15 01:16:00,39,57,Móvel,5,96
20238,2024-01-15 01:17:00,62,102,Vestuário,3,164
20239,2024-01-15 01:18:00,15,92,Móvel,5,107
20240,2024-01-15 01:19:00,86,70,Brinquedo,7,156
20241,2024-01-15 01:20:00,100,55,Alimento,7,155
20242,2024-01-15 01:21:00,67,121,Alimento,1,188
20243,2024-01-15 01:22:00,10,51,Brinquedo,4,61
20244,2024-01-15 01:23:00,15,87,Brinquedo,7,102
20245,2024-01-15 01:24:00,90,21,Alimento,3,111
20246,2024-01-15 01:25:00,88,43,Alimento,1,131
20247,2024-01-15 01:26:00,108,27,Brinquedo,3,135
20248,2024-01-15 01:27:00,72,116,Eletrônico,2,188
20249,2024-01-15 01:28:00,51,108,Vestuário,1,159
20250,2024-01-15 01:29:00,29,149,Brinquedo,4,178
20251,2024-01-15 01:30:00,110,160,Brinquedo,5,270
20252,2024-01-15 01:31:00,49,33,Alimento,9,82
20253,2024-01-15 01:32:00,49,155,Alimento,6,204
20254,2024-01-15 01:33:00,38,65,Alimento,8,103
20255,2024-01-15 01:34:00,101,20,Brinquedo,8,121
20256,2024-01-15 01:35:00,66,127,Móvel,9,193
20257,2024-01-15 01:36:00,114,129,Eletrônico,7,243
20258,2024-01-15 01:37:00,55,91,Móvel,3,146
20259,2024-01-15 01:38:00,19,131,Móvel,9,150
20260,2024-01-15 01:39:00,106,134,Vestuário,4,240
20261,2024-01-15 01:40:00,23,43,Móvel,4,66
20262,2024-01-15 01:41:00,82,95,Brinquedo,8,177
20263,2024-01-15 01:42:00,54,24,Brinquedo,9,78
20264,2024-01-15 01:43:00,48,87,Brinquedo,8,135
20265,2024-01-15 01:44:00,56,57,Vestuário,8,113
20266,2024-01-15 01:45:00,43,86,Brinquedo,2,129
20267,2024-01-15 01:46:00,47,111,Brinquedo,6,158
20268,2024-01-15 01:47:00,20,138,Alimento,8,158
20269,2024-01-15 01:48:00,55,140,Móvel,3,195
20270,2024-01-15 01:49:00,108,88,Brinquedo,8,196
20271,2024-01-15 01:50:00,115,59,Vestuário,7,174
20272,2024-01-15 01:51:00,10,162,Eletrônico,7,172
20273,2024-01-15 01:52:00,73,22,Móvel,4,95
20274,2024-01-15 01:53:00,117,68,Móvel,1,185
20275,2024-01-15 01:54:00,34,32,Móvel,1,66
20276,2024-01-15 01:55:00,86,93,Vestuário,8,179
20277,2024-01-15 01:56:00,70,52,Alimento,4,122
20278,2024-01-15 01:57:00,51,167,Brinquedo,6,218
20279,2024-01-15 01:58:00,51,20,Eletrônico,2,71
20280,2024-01-15 01:59:00,22,171,Móvel,6,193
20281,2024-01-15 02:00:00,19,112,Eletrônico,3,131
20282,2024-01-15 02:01:00,51,68,Móvel,6,119
20283,2024-01-15 02:02:00,118,138,Brinquedo,6,256
20284,2024-01-15 02:03:00,79,145,Móvel,5,224
20285,2024-01-15 02:04:00,20,26,Móvel,6,46
20286,2024-01-15 02:05:00,11,77,Vestuário,4,88
20287,2024-01-15 02:06:00,75,19,Eletrônico,6,94
20288,2024-01-15 02:07:00,91,19,Brinquedo,9,110
20289,2024-01-15 02:08:00,48,73,Móvel,5,121
20290,2024-01-15 02:09:00,35,19,Eletrônico,2,54
20291,2024-01-15 02:10:00,89,69,Móvel,1,158
20292,2024-01-15 02:11:00,30,69,Alimento,1,99
20293,2024-01-15 02:12:00,55,81,Brinquedo,8,136
20294,2024-01-15 02:13:00,11,151,Eletrônico,2,162
20295,2024-01-15 02:14:00,46,46,Eletrônico,8,92
20296,2024-01-15 02:15:00,68,112,Vestuário,9,180
20297,2024-01-15 02:16:00,116,82,Alimento,7,198
20298,2024-01-15 02:17:00,94,141,Eletrônico,6,235
20299,2024-01-15 02:18:00,115,134,Móvel,7,249
20300,2024-01-15 02:19:00,50,56,Alimento,9,106
20301,2024-01-15 02:20:00,55,75,Brinquedo,5,130
20302,2024-01-15 02:21:00,30,157,Brinquedo,4,187
20303,2024-01-15 02:22:00,97,119,Brinquedo,2,216
20304,2024-01-15 02:23:00,39,58,Alimento,8,97
20305,2024-01-15 02:24:00,25,172,Brinquedo,1,197
20306,2024-01-15 02:25:00,98,53,Alimento,7,151
20307,2024-01-15 02:26:00,102,20,Vestuário,3,122
20308,2024-01-15 02:27:00,109,173,Brinquedo,8,282
20309,2024-01-15 02:28:00,74,138,Brinquedo,5,212
20310,2024-01-15 02:29:00,51,146,Brinquedo,2,197
20311,2024-01-15 02:30:00,102,17,Eletrônico,7,119
20312,2024-01-15 02:31:00,42,114,Móvel,8,156
20313,2024-01-15 02:32:00,63,103,Eletrônico,1,166
20314,2024-01-15 02:33:00,99,148,Vestuário,4,247
20315,2024-01-15 02:34:00,97,112,Alimento,7,209
20316,2024-01-15 02:35:00,31,53,Brinquedo,2,84
20317,2024-01-15 02:36:00,96,124,Alimento,1,220
20318,2024-01-15 02:37:00,14,173,Alimento,6,187
20319,2024-01-15 02:38:00,28,58,Eletrônico,6,86
20320,2024-01-15 02:39:00,62,168,Brinquedo,1,230
20321,2024-01-15 02:40:00,92,97,Móvel,7,189
20322,2024-01-15 02:41:00,38,15,Vestuário,4,53
20323,2024-01-15 02:42:00,56,69,Alimento,6,125
20324,2024-01-15 02:43:00,69,24,Vestuário,4,93
20325,2024-01-15 02:44:00,46,101,Eletrônico,8,147
20326,2024-01-15 02:45:00,37,148,Vestuário,8,185
20327,2024-01-15 02:46:00,34,95,Móvel,4,129
20328,2024-01-15 02:47:00,60,120,Brinquedo,1,180
20329,2024-01-15 02:48:00,74,108,Alimento,5,182
20330,2024-01-15 02:49:00,42,160,Móvel,2,202
20331,2024-01-15 02:50:00,80,100,Eletrônico,9,180
20332,2024-01-15 02:51:00,30,96,Vestuário,9,126
20333,2024-01-15 02:52:00,50,110,Eletrônico,8,160
20334,2024-01-15 02:53:00,88,137,Alimento,3,225
20335,2024-01-15 02:54:00,12,122,Móvel,9,134
20336,2024-01-15 02:55:00,44,58,Vestuário,4,102
20337,2024-01-15 02:56:00,71,75,Eletrônico,5,146
20338,2024-01-15 02:57:00,106,31,Brinquedo,7,137
20339,2024-01-15 02:58:00,66,145,Brinquedo,1,211
20340,2024-01-15 02:59:00,46,117,Brinquedo,1,163
20341,2024-01-15 03:00:00,105,32,Móvel,3,137
20342,2024-01-15 03:01:00,20,30,Alimento,2,50
20343,2024-01-15 03:02:00,48,162,Móvel,9,210
20344,2024-01-15 03:03:00,13,32,Vestuário,8,45
20345,2024-01-15 03:04:00,66,37,Brinquedo,9,103
20346,2024-01-15 03:05:00,76,45,Brinquedo,2,121
20347,2024-01-15 03:06:00,48,179,Alimento,9,227
20348,2024-01-15 03:07:00,102,93,Vestuário,3,195
20349,2024-01-15 03:08:00,27,47,Vestuário,4,74
20350,2024-01-15 03:09:00,15,68,Vestuário,7,83
20351,2024-01-15 03:10:00,112,116,Vestuário,9,228
20352,2024-01-15 03:11:00,15,179,Móvel,5,194
20353,2024-01-15 03:12:00,87,157,Vestuário,4,244
20354,2024-01-15 03:13:00,36,105,Eletrônico,1,141
20355,2024-01-15 03:14:00,52,122,Vestuário,4,174
20356,2024-01-15 03:15:00,77,49,Alimento,2,126
20357,2024-01-15 03:16:00,108,35,Brinquedo,9,143
20358,2024-01-15 03:17:00,68,162,Vestuário,7,230
20359,2024-01-15 03:18:00,17,12,Brinquedo,6,29
20360,2024-01-15 03:19:00,19,156,Eletrônico,2,175
20361,2024-01-15 03:20:00,56,154,Brinquedo,5,210
20362,2024-01-15 03:21:00,64,90,Móvel,7,154
20363,2024-01-15 03:22:00,65,99,Alimento,5,164
20364,2024-01-15 03:23:00,82,153,Brinquedo,1,235
20365,2024-01-15 03:24:00,66,175,Alimento,5,241
20366,2024-01-15 03:25:00,100,170,Brinquedo,4,270
20367,2024-01-15 03:26:00,88,22,Eletrônico,5,110
20368,2024-01-15 03:27:00,37,165,Móvel,8,202
20369,2024-01-15 03:28:00,42,145,Brinquedo,6,187
20370,2024-01-15 03:29:00,114,39,Brinquedo,6,153
20371,2024-01-15 03:30:00,19,162,Alimento,9,181
20372,2024-01-15 03:31:00,29,155,Vestuário,9,184
20373,2024-01-15 03:32:00,84,11,Brinquedo,1,95
20374,2024-01-15 03:33:00,79,81,Móvel,8,160
20375,2024-01-15 03:34:00,108,143,Vestuário,9,251
20376,2024-01-15 03:35:00,38,131,Móvel,7,169
20377,2024-01-15 03:36:00,100,163,Brinquedo,1,263
20378,2024-01-15 03:37:00,74,135,Brinquedo,5,209
20379,2024-01-15 03:38:00,14,133,Brinquedo,5,147
20380,2024-01-15 03:39:00,36,18,Vestuário,7,54
20381,2024-01-15 03:40:00,82,130,Brinquedo,5,212
20382,2024-01-15 03:41:00,100,84,Móvel,4,184
20383,2024-01-15 03:42:00,32,53,Alimento,4,85
20384,2024-01-15 03:43:00,51,79,Móvel,3,130
20385,2024-01-15 03:44:00,59,16,Eletrônico,9,75
20386,2024-01-15 03:45:00,45,15,Brinquedo,7,60
20387,2024-01-15 03:46:00,26,145,Alimento,5,171
20388,2024-01-15 03:47:00,22,89,Vestuário,9,111
20389,2024-01-15 03:48:00,89,118,Móvel,3,207
20390,2024-01-15 03:49:00,23,171,Móvel,2,194
20391,2024-01-15 03:50:00,87,61,Eletrônico,5,148
20392,2024-01-15 03:51:00,102,167,Eletrônico,8,269
20393,2024-01-15 03:52:00,80,105,Móvel,7,185
20394,2024-01-15 03:53:00,81,105,Móvel,9,186
20395,2024-01-15 03:54:00,97,158,Vestuário,1,255
20396,2024-01-15 03:55:00,21,116,Vestuário,6,137
20397,2024-01-15 03:56:00,94,159,Vestuário,3,253
20398,2024-01-15 03:57:00,46,89,Vestuário,9,135
20399,2024-01-15 03:58:00,88,145,Móvel,6,233
20400,2024-01-15 03:59:00,28,107,Vestuário,2,135
20401,2024-01-15 04:00:00,42,88,Móvel,5,130
20402,2024-01-15 04:01:00,58,82,Alimento,9,140
20403,2024-01-15 04:02:00,65,152,Brinquedo,8,217
20404,2024-01-15 04:03:00,97,38,Alimento,4,135
20405,2024-01-15 04:04:00,45,17,Móvel,6,62
20406,2024-01-15 04:05:00,81,118,Alimento,4,199
20407,2024-01-15 04:06:00,89,63,Brinquedo,6,152
20408,2024-01-15 04:07:00,74,10,Brinquedo,8,84
20409,2024-01-15 04:08:00,94,141,Eletrônico,8,235
20410,2024-01-15 04:09:00,91,54,Brinquedo,5,145
20411,2024-01-15 04:10:00,82,59,Eletrônico,8,141
20412,2024-01-15 04:11:00,115,77,Vestuário,2,192
20413,2024-01-15 04:12:00,82,20,Brinquedo,7,102
20414,2024-01-15 04:13:00,86,89,Alimento,7,175
20415,2024-01-15 04:14:00,44,19,Móvel,8,63
20416,2024-01-15 04:15:00,42,146,Eletrônico,7,188
20417,2024-01-15 04:16:00,36,159,Vestuário,4,195
20418,2024-01-15 04:17:00,16,66,Móvel,3,82
20419,2024-01-15 04:18:00,36,63,Eletrônico,4,99
20420,2024-01-15 04:19:00,73,63,Brinquedo,7,136
20421,2024-01-15 04:20:00,113,133,Vestuário,8,246
20422,2024-01-15 04:21:00,105,142,Alimento,1,247
20423,2024-01-15 04:22:00,119,54,Brinquedo,6,173
20424,2024-01-15 04:23:00,97,128,Alimento,2,225
20425,2024-01-15 04:24:00,113,44,Vestuário,7,157
20426,2024-01-15 04:25:00,49,18,Eletrônico,4,67
20427,2024-01-15 04:26:00,11,84,Brinquedo,6,95
20428,2024-01-15 04:27:00,78,135,Vestuário,7,213
20429,2024-01-15 04:28:00,119,151,Eletrônico,6,270
20430,2024-01-15 04:29:00,11,55,Brinquedo,5,66
20431,2024-01-15 04:30:00,24,162,Eletrônico,9,186
20432,2024-01-15 04:31:00,10,152,Móvel,5,162
20433,2024-01-15 04:32:00,11,18,Vestuário,9,29
20434,2024-01-15 04:33:00,32,107,Brinquedo,2,139
20435,2024-01-15 04:34:00,56,51,Eletrônico,5,107
20436,2024-01-15 04:35:00,60,163,Vestuário,2,223
20437,2024-01-15 04:36:00,90,119,Eletrônico,3,209
20438,2024-01-15 04:37:00,112,48,Eletrônico,6,160
20439,2024-01-15 04:38:00,66,61,Brinquedo,4,127
20440,2024-01-15 04:39:00,20,28,Alimento,1,48
20441,2024-01-15 04:40:00,52,62,Alimento,1,114
20442,2024-01-15 04:41:00,64,93,Móvel,9,157
20443,2024-01-15 04:42:00,82,129,Móvel,5,211
20444,2024-01-15 04:43:00,49,21,Eletrônico,7,70
20445,2024-01-15 04:44:00,84,104,Móvel,3,188
20446,2024-01-15 04:45:00,106,163,Brinquedo,4,269
20447,2024-01-15 04:46:00,27,138,Móvel,8,165
20448,2024-01-15 04:47:00,87,148,Móvel,6,235
20449,2024-01-15 04:48:00,55,24,Vestuário,2,79
20450,2024-01-15 04:49:00,81,18,Brinquedo,9,99
20451,2024-01-15 04:50:00,16,22,Vestuário,5,38
20452,2024-01-15 04:51:00,76,129,Eletrônico,4,205
20453,2024-01-15 04:52:00,19,90,Eletrônico,9,109
20454,2024-01-15 04:53:00,63,49,Alimento,6,112
20455,2024-01-15 04:54:00,70,126,Vestuário,2,196
20456,2024-01-15 04:55:00,36,20,Móvel,7,56
20457,2024-01-15 04:56:00,80,117,Alimento,7,197
20458,2024-01-15 04:57:00,26,78,Móvel,9,104
20459,2024-01-15 04:58:00,18,99,Eletrônico,3,117
20460,2024-01-15 04:59:00,23,56,Eletrônico,2,79
20461,2024-01-15 05:00:00,36,135,Brinquedo,9,171
20462,2024-01-15 05:01:00,91,86,Eletrônico,3,177
20463,2024-01-15 05:02:00,31,100,Móvel,3,131
20464,2024-01-15 05:03:00,102,96,Eletrônico,7,198
20465,2024-01-15 05:04:00,107,137,Alimento,7,244
20466,2024-01-15 05:05:00,32,174,Eletrônico,4,206
20467,2024-01-15 05:06:00,114,83,Eletrônico,2,197
20468,2024-01-15 05:07:00,25,74,Vestuário,8,99
20469,2024-01-15 05:08:00,80,149,Eletrônico,2,229
20470,2024-01-15 05:09:00,63,97,Móvel,1,160
20471,2024-01-15 05:10:00,54,97,Alimento,9,151
20472,2024-01-15 05:11:00,57,85,Móvel,5,142
20473,2024-01-15 05:12:00,117,57,Eletrônico,2,174
20474,2024-01-15 05:13:00,66,128,Vestuário,7,194
20475,2024-01-15 05:14:00,67,170,Alimento,8,237
20476,2024-01-15 05:15:00,89,40,Brinquedo,8,129
20477,2024-01-15 05:16:00,51,116,Brinquedo,5,167
20478,2024-01-15 05:17:00,67,41,Eletrônico,3,108
20479,2024-01-15 05:18:00,83,163,Alimento,8,246
20480,2024-01-15 05:19:00,49,90,Eletrônico,3,139
20481,2024-01-15 05:20:00,70,172,Alimento,3,242
20482,2024-01-15 05:21:00,26,113,Móvel,8,139
20483,2024-01-15 05:22:00,65,51,Vestuário,2,116
20484,2024-01-15 05:23:00,95,118,Vestuário,8,213
20485,2024-01-15 05:24:00,103,78,Alimento,5,181
20486,2024-01-15 05:25:00,37,70,Alimento,6,107
20487,2024-01-15 05:26:00,76,120,Eletrônico,4,196
20488,2024-01-15 05:27:00,11,144,Alimento,8,155
20489,2024-01-15 05:28:00,42,98,Alimento,5,140
20490,2024-01-15 05:29:00,37,107,Alimento,6,144
20491,2024-01-15 05:30:00,29,105,Brinquedo,2,134
20492,2024-01-15 05:31:00,99,173,Brinquedo,2,272
20493,2024-01-15 05:32:00,76,123,Brinquedo,5,199
20494,2024-01-15 05:33:00,54,147,Vestuário,6,201
20495,2024-01-15 05:34:00,67,138,Brinquedo,6,205
20496,2024-01-15 05:35:00,94,42,Vestuário,7,136
20497,2024-01-15 05:36:00,19,76,Eletrônico,7,95
20498,2024-01-15 05:37:00,14,53,Alimento,2,67
20499,2024-01-15 05:38:00,88,115,Alimento,4,203
20500,2024-01-15 05:39:00,109,69,Brinquedo,4,178
20501,2024-01-15 05:40:00,45,88,Vestuário,8,133
20502,2024-01-15 05:41:00,108,161,Brinquedo,4,269
20503,2024-01-15 05:42:00,99,74,Eletrônico,4,173
20504,2024-01-15 05:43:00,15,161,Vestuário,6,176
20505,2024-01-15 05:44:00,65,152,Móvel,4,217
20506,2024-01-15 05:45:00,72,66,Alimento,5,138
20507,2024-01-15 05:46:00,25,57,Vestuário,5,82
20508,2024-01-15 05:47:00,75,50,Vestuário,8,125
20509,2024-01-15 05:48:00,104,11,Eletrônico,8,115
20510,2024-01-15 05:49:00,66,159,Móvel,4,225
20511,2024-01-15 05:50:00,106,88,Vestuário,8,194
20512,2024-01-15 05:51:00,20,131,Vestuário,2,151
20513,2024-01-15 05:52:00,102,40,Alimento,1,142
20514,2024-01-15 05:53:00,109,92,Móvel,1,201
20515,2024-01-15 05:54:00,102,174,Eletrônico,6,276
20516,2024-01-15 05:55:00,38,48,Móvel,5,86
20517,2024-01-15 05:56:00,29,31,Vestuário,3,60
20518,2024-01-15 05:57:00,86,114,Móvel,1,200
20519,2024-01-15 05:58:00,80,124,Móvel,7,204
20520,2024-01-15 05:59:00,14,45,Móvel,3,59
20521,2024-01-15 06:00:00,74,68,Alimento,2,142
20522,2024-01-15 06:01:00,100,66,Vestuário,6,166
20523,2024-01-15 06:02:00,35,122,Vestuário,8,157
20524,2024-01-15 06:03:00,89,91,Alimento,5,180
20525,2024-01-15 06:04:00,33,156,Alimento,5,189
20526,2024-01-15 06:05:00,76,145,Eletrônico,2,221
20527,2024-01-15 06:06:00,14,142,Móvel,2,156
20528,2024-01-15 06:07:00,91,161,Móvel,4,252
20529,2024-01-15 06:08:00,29,73,Vestuário,3,102
20530,2024-01-15 06:09:00,84,47,Brinquedo,2,131
20531,2024-01-15 06:10:00,84,46,Eletrônico,3,130
20532,2024-01-15 06:11:00,39,145,Eletrônico,9,184
20533,2024-01-15 06:12:00,115,178,Móvel,5,293
20534,2024-01-15 06:13:00,40,137,Brinquedo,4,177
20535,2024-01-15 06:14:00,38,167,Eletrônico,3,205
20536,2024-01-15 06:15:00,36,131,Brinquedo,7,167
20537,2024-01-15 06:16:00,20,71,Brinquedo,5,91
20538,2024-01-15 06:17:00,119,19,Móvel,9,138
20539,2024-01-15 06:18:00,51,34,Eletrônico,6,85
20540,2024-01-15 06:19:00,68,47,Móvel,7,115
20541,2024-01-15 06:20:00,38,92,Alimento,8,130
20542,2024-01-15 06:21:00,60,163,Móvel,8,223
20543,2024-01-15 06:22:00,36,83,Brinquedo,6,119
20544,2024-01-15 06:23:00,85,13,Brinquedo,6,98
20545,2024-01-15 06:24:00,82,64,Eletrônico,7,146
20546,2024-01-15 06:25:00,54,146,Alimento,8,200
20547,2024-01-15 06:26:00,100,83,Brinquedo,8,183
20548,2024-01-15 06:27:00,43,127,Alimento,7,170
20549,2024-01-15 06:28:00,10,55,Alimento,1,65
20550,2024-01-15 06:29:00,33,132,Brinquedo,2,165
20551,2024-01-15 06:30:00,103,33,Eletrônico,3,136
20552,2024-01-15 06:31:00,54,56,Alimento,9,110
20553,2024-01-15 06:32:00,21,172,Brinquedo,5,193
20554,2024-01-15 06:33:00,45,74,Vestuário,5,119
20555,2024-01-15 06:34:00,72,15,Eletrônico,3,87
20556,2024-01-15 06:35:00,21,126,Alimento,1,147
20557,2024-01-15 06:36:00,48,123,Alimento,5,171
20558,2024-01-15 06:37:00,64,54,Vestuário,7,118
20559,2024-01-15 06:38:00,75,151,Móvel,5,226
20560,2024-01-15 06:39:00,94,129,Vestuário,6,223
20561,2024-01-15 06:40:00,38,118,Alimento,3,156
20562,2024-01-15 06:41:00,51,155,Alimento,2,206
20563,2024-01-15 06:42:00,52,94,Eletrônico,6,146
20564,2024-01-15 06:43:00,69,34,Móvel,1,103
20565,2024-01-15 06:44:00,28,149,Eletrônico,2,177
20566,2024-01-15 06:45:00,87,60,Brinquedo,5,147
20567,2024-01-15 06:46:00,98,178,Alimento,9,276
20568,2024-01-15 06:47:00,17,58,Vestuário,8,75
20569,2024-01-15 06:48:00,21,41,Alimento,5,62
20570,2024-01-15 06:49:00,52,14,Brinquedo,7,66
20571,2024-01-15 06:50:00,80,27,Móvel,6,107
20572,2024-01-15 06:51:00,88,22,Móvel,3,110
20573,2024-01-15 06:52:00,18,178,Alimento,8,196
20574,2024-01-15 06:53:00,35,158,Móvel,3,193
20575,2024-01-15 06:54:00,115,30,Brinquedo,6,145
20576,2024-01-15 06:55:00,100,62,Móvel,4,162
20577,2024-01-15 06:56:00,58,51,Móvel,3,109
20578,2024-01-15 06:57:00,46,22,Vestuário,3,68
20579,2024-01-15 06:58:00,105,99,Brinquedo,5,204
20580,2024-01-15 06:59:00,104,135,Eletrônico,4,239
20581,2024-01-15 07:00:00,26,109,Eletrônico,3,135
20582,2024-01-15 07:01:00,15,128,Alimento,5,143
20583,2024-01-15 07:02:00,31,34,Móvel,3,65
20584,2024-01-15 07:03:00,75,64,Móvel,5,139
20585,2024-01-15 07:04:00,114,109,Eletrônico,5,223
20586,2024-01-15 07:05:00,27,77,Móvel,9,104
20587,2024-01-15 07:06:00,38,139,Brinquedo,3,177
20588,2024-01-15 07:07:00,75,68,Móvel,1,143
20589,2024-01-15 07:08:00,15,13,Eletrônico,4,28
20590,2024-01-15 07:09:00,101,139,Eletrônico,3,240
20591,2024-01-15 07:10:00,116,169,Alimento,4,285
20592,2024-01-15 07:11:00,104,19,Alimento,9,123
20593,2024-01-15 07:12:00,109,116,Eletrônico,2,225
20594,2024-01-15 07:13:00,81,126,Brinquedo,2,207
20595,2024-01-15 07:14:00,81,69,Móvel,2,150
20596,2024-01-15 07:15:00,62,85,Vestuário,8,147
20597,2024-01-15 07:16:00,113,46,Eletrônico,3,159
20598,2024-01-15 07:17:00,72,76,Móvel,9,148
20599,2024-01-15 07:18:00,77,140,Alimento,2,217
20600,2024-01-15 07:19:00,79,143,Móvel,8,222
20601,2024-01-15 07:20:00,69,60,Brinquedo,2,129
20602,2024-01-15 07:21:00,60,73,Vestuário,2,133
20603,2024-01-15 07:22:00,47,125,Eletrônico,2,172
20604,2024-01-15 07:23:00,16,171,Eletrônico,6,187
20605,2024-01-15 07:24:00,102,152,Alimento,5,254
20606,2024-01-15 07:25:00,115,73,Alimento,7,188
20607,2024-01-15 07:26:00,92,170,Alimento,8,262
20608,2024-01-15 07:27:00,41,160,Vestuário,4,201
20609,2024-01-15 07:28:00,22,176,Brinquedo,2,198
20610,2024-01-15 07:29:00,48,50,Eletrônico,1,98
20611,2024-01-15 07:30:00,52,15,Vestuário,6,67
20612,2024-01-15 07:31:00,107,34,Vestuário,5,141
20613,2024-01-15 07:32:00,56,83,Eletrônico,8,139
20614,2024-01-15 07:33:00,50,17,Vestuário,3,67
20615,2024-01-15 07:34:00,77,95,Brinquedo,1,172
20616,2024-01-15 07:35:00,13,176,Móvel,9,189
20617,2024-01-15 07:36:00,33,102,Alimento,7,135
20618,2024-01-15 07:37:00,114,79,Eletrônico,3,193
20619,2024-01-15 07:38:00,89,125,Vestuário,4,214
20620,2024-01-15 07:39:00,81,108,Vestuário,3,189
20621,2024-01-15 07:40:00,54,108,Vestuário,5,162
20622,2024-01-15 07:41:00,40,10,Alimento,9,50
20623,2024-01-15 07:42:00,65,38,Alimento,3,103
20624,2024-01-15 07:43:00,59,164,Vestuário,3,223
20625,2024-01-15 07:44:00,102,179,Brinquedo,7,281
20626,2024-01-15 07:45:00,30,36,Eletrônico,8,66
20627,2024-01-15 07:46:00,105,22,Brinquedo,7,127
20628,2024-01-15 07:47:00,80,116,Brinquedo,2,196
20629,2024-01-15 07:48:00,63,113,Móvel,5,176
20630,2024-01-15 07:49:00,40,114,Eletrônico,7,154
20631,2024-01-15 07:50:00,53,179,Eletrônico,9,232
20632,2024-01-15 07:51:00,78,108,Alimento,7,186
20633,2024-01-15 07:52:00,71,151,Brinquedo,1,222
20634,2024-01-15 07:53:00,47,124,Vestuário,8,171
20635,2024-01-15 07:54:00,48,67,Alimento,1,115
20636,2024-01-15 07:55:00,20,71,Vestuário,4,91
20637,2024-01-15 07:56:00,115,98,Brinquedo,5,213
20638,2024-01-15 07:57:00,25,69,Alimento,1,94
20639,2024-01-15 07:58:00,18,159,Vestuário,5,177
20640,2024-01-15 07:59:00,21,84,Brinquedo,6,105
20641,2024-01-15 08:00:00,100,58,Móvel,5,158
20642,2024-01-15 08:01:00,84,177,Móvel,5,261
20643,2024-01-15 08:02:00,92,123,Brinquedo,7,215
20644,2024-01-15 08:03:00,107,87,Alimento,5,194
20645,2024-01-15 08:04:00,78,93,Móvel,2,171
20646,2024-01-15 08:05:00,63,73,Brinquedo,2,136
20647,2024-01-15 08:06:00,44,145,Brinquedo,5,189
20648,2024-01-15 08:07:00,22,28,Brinquedo,5,50
20649,2024-01-15 08:08:00,51,177,Móvel,6,228
20650,2024-01-15 08:09:00,56,71,Brinquedo,1,127
20651,2024-01-15 08:10:00,39,147,Vestuário,1,186
20652,2024-01-15 08:11:00,64,16,Vestuário,3,80
20653,2024-01-15 08:12:00,73,19,Brinquedo,9,92
20654,2024-01-15 08:13:00,55,136,Brinquedo,7,191
20655,2024-01-15 08:14:00,64,60,Vestuário,8,124
20656,2024-01-15 08:15:00,16,133,Alimento,8,149
20657,2024-01-15 08:16:00,51,162,Vestuário,8,213
20658,2024-01-15 08:17:00,51,14,Vestuário,9,65
20659,2024-01-15 08:18:00,58,176,Brinquedo,3,234
20660,2024-01-15 08:19:00,56,173,Alimento,1,229
20661,2024-01-15 08:20:00,12,42,Eletrônico,8,54
20662,2024-01-15 08:21:00,105,166,Móvel,8,271
20663,2024-01-15 08:22:00,111,48,Móvel,4,159
20664,2024-01-15 08:23:00,102,142,Móvel,1,244
20665,2024-01-15 08:24:00,19,66,Alimento,4,85
20666,2024-01-15 08:25:00,23,99,Brinquedo,8,122
20667,2024-01-15 08:26:00,95,90,Alimento,9,185
20668,2024-01-15 08:27:00,117,51,Vestuário,6,168
20669,2024-01-15 08:28:00,30,91,Vestuário,9,121
20670,2024-01-15 08:29:00,110,53,Vestuário,7,163
20671,2024-01-15 08:30:00,70,149,Eletrônico,4,219
20672,2024-01-15 08:31:00,66,167,Vestuário,1,233
20673,2024-01-15 08:32:00,43,25,Alimento,9,68
20674,2024-01-15 08:33:00,55,42,Eletrônico,4,97
20675,2024-01-15 08:34:00,93,99,Alimento,4,192
20676,2024-01-15 08:35:00,37,26,Móvel,5,63
20677,2024-01-15 08:36:00,40,57,Vestuário,1,97
20678,2024-01-15 08:37:00,30,142,Móvel,5,172
20679,2024-01-15 08:38:00,107,77,Brinquedo,9,184
20680,2024-01-15 08:39:00,56,47,Alimento,7,103
20681,2024-01-15 08:40:00,85,151,Vestuário,6,236
20682,2024-01-15 08:41:00,11,60,Eletrônico,8,71
20683,2024-01-15 08:42:00,14,50,Brinquedo,4,64
20684,2024-01-15 08:43:00,93,163,Eletrônico,5,256
20685,2024-01-15 08:44:00,73,127,Eletrônico,1,200
20686,2024-01-15 08:45:00,88,15,Móvel,7,103
20687,2024-01-15 08:46:00,23,179,Alimento,4,202
20688,2024-01-15 08:47:00,27,49,Eletrônico,2,76
20689,2024-01-15 08:48:00,68,174,Eletrônico,3,242
20690,2024-01-15 08:49:00,22,57,Alimento,2,79
20691,2024-01-15 08:50:00,42,27,Vestuário,9,69
20692,2024-01-15 08:51:00,101,126,Alimento,4,227
20693,2024-01-15 08:52:00,33,136,Brinquedo,2,169
20694,2024-01-15 08:53:00,44,162,Brinquedo,2,206
20695,2024-01-15 08:54:00,18,61,Alimento,8,79
20696,2024-01-15 08:55:00,70,25,Eletrônico,8,95
20697,2024-01-15 08:56:00,86,179,Alimento,5,265
20698,2024-01-15 08:57:00,27,55,Móvel,8,82
20699,2024-01-15 08:58:00,27,60,Eletrônico,4,87
20700,2024-01-15 08:59:00,67,150,Móvel,6,217
20701,2024-01-15 09:00:00,36,13,Eletrônico,1,49
20702,2024-01-15 09:01:00,92,106,Eletrônico,5,198
20703,2024-01-15 09:02:00,72,15,Brinquedo,9,87
20704,2024-01-15 09:03:00,106,66,Móvel,8,172
20705,2024-01-15 09:04:00,16,35,Alimento,8,51
20706,2024-01-15 09:05:00,64,142,Vestuário,2,206
20707,2024-01-15 09:06:00,79,42,Eletrônico,4,121
20708,2024-01-15 09:07:00,109,168,Brinquedo,1,277
20709,2024-01-15 09:08:00,78,48,Eletrônico,6,126
20710,2024-01-15 09:09:00,66,71,Vestuário,6,137
20711,2024-01-15 09:10:00,16,16,Vestuário,9,32
20712,2024-01-15 09:11:00,65,175,Brinquedo,5,240
20713,2024-01-15 09:12:00,98,73,Móvel,3,171
20714,2024-01-15 09:13:00,68,155,Alimento,7,223
20715,2024-01-15 09:14:00,14,104,Móvel,1,118
20716,2024-01-15 09:15:00,13,22,Vestuário,7,35
20717,2024-01-15 09:16:00,28,122,Vestuário,5,150
20718,2024-01-15 09:17:00,97,33,Eletrônico,3,130
20719,2024-01-15 09:18:00,13,26,Vestuário,4,39
20720,2024-01-15 09:19:00,33,35,Móvel,9,68
20721,2024-01-15 09:20:00,46,76,Vestuário,8,122
20722,2024-01-15 09:21:00,12,166,Eletrônico,7,178
20723,2024-01-15 09:22:00,117,65,Alimento,9,182
20724,2024-01-15 09:23:00,17,70,Móvel,5,87
20725,2024-01-15 09:24:00,23,152,Eletrônico,2,175
20726,2024-01-15 09:25:00,17,102,Vestuário,3,119
20727,2024-01-15 09:26:00,100,21,Alimento,4,121
20728,2024-01-15 09:27:00,74,153,Alimento,1,227
20729,2024-01-15 09:28:00,86,25,Eletrônico,6,111
20730,2024-01-15 09:29:00,78,60,Brinquedo,3,138
20731,2024-01-15 09:30:00,60,90,Alimento,5,150
20732,2024-01-15 09:31:00,60,49,Alimento,8,109
20733,2024-01-15 09:32:00,31,111,Brinquedo,2,142
20734,2024-01-15 09:33:00,85,28,Eletrônico,9,113
20735,2024-01-15 09:34:00,79,75,Vestuário,2,154
20736,2024-01-15 09:35:00,35,63,Brinquedo,8,98
20737,2024-01-15 09:36:00,24,149,Alimento,9,173
20738,2024-01-15 09:37:00,65,16,Móvel,3,81
20739,2024-01-15 09:38:00,47,76,Móvel,6,123
20740,2024-01-15 09:39:00,26,131,Alimento,5,157
20741,2024-01-15 09:40:00,29,157,Vestuário,3,186
20742,2024-01-15 09:41:00,51,49,Brinquedo,8,100
20743,2024-01-15 09:42:00,58,179,Eletrônico,1,237
20744,2024-01-15 09:43:00,108,138,Alimento,8,246
20745,2024-01-15 09:44:00,13,100,Eletrônico,3,113
20746,2024-01-15 09:45:00,19,126,Alimento,9,145
20747,2024-01-15 09:46:00,106,66,Eletrônico,9,172
20748,2024-01-15 09:47:00,86,161,Alimento,4,247
20749,2024-01-15 09:48:00,70,153,Eletrônico,4,223
20750,2024-01-15 09:49:00,100,67,Móvel,1,167
20751,2024-01-15 09:50:00,107,139,Vestuário,1,246
20752,2024-01-15 09:51:00,52,28,Móvel,1,80
20753,2024-01-15 09:52:00,101,48,Alimento,7,149
20754,2024-01-15 09:53:00,58,84,Vestuário,1,142
20755,2024-01-15 09:54:00,57,63,Móvel,3,120
20756,2024-01-15 09:55:00,20,142,Vestuário,1,162
20757,2024-01-15 09:56:00,56,101,Vestuário,6,157
20758,2024-01-15 09:57:00,56,164,Móvel,9,220
20759,2024-01-15 09:58:00,103,55,Eletrônico,2,158
20760,2024-01-15 09:59:00,45,29,Alimento,2,74
20761,2024-01-15 10:00:00,80,89,Móvel,1,169
20762,2024-01-15 10:01:00,107,53,Móvel,9,160
20763,2024-01-15 10:02:00,57,144,Alimento,8,201
20764,2024-01-15 10:03:00,44,44,Alimento,4,88
20765,2024-01-15 10:04:00,34,177,Eletrônico,6,211
20766,2024-01-15 10:05:00,42,131,Alimento,9,173
20767,2024-01-15 10:06:00,114,39,Alimento,2,153
20768,2024-01-15 10:07:00,84,51,Brinquedo,6,135
20769,2024-01-15 10:08:00,27,155,Alimento,5,182
20770,2024-01-15 10:09:00,88,91,Móvel,7,179
20771,2024-01-15 10:10:00,98,33,Móvel,9,131
20772,2024-01-15 10:11:00,47,116,Eletrônico,9,163
20773,2024-01-15 10:12:00,77,28,Brinquedo,1,105
20774,2024-01-15 10:13:00,69,99,Brinquedo,3,168
20775,2024-01-15 10:14:00,50,179,Brinquedo,3,229
20776,2024-01-15 10:15:00,33,43,Brinquedo,1,76
20777,2024-01-15 10:16:00,25,137,Vestuário,5,162
20778,2024-01-15 10:17:00,17,30,Brinquedo,3,47
20779,2024-01-15 10:18:00,39,93,Brinquedo,9,132
20780,2024-01-15 10:19:00,107,101,Brinquedo,3,208
20781,2024-01-15 10:20:00,92,134,Alimento,2,226
20782,2024-01-15 10:21:00,46,137,Eletrônico,1,183
20783,2024-01-15 10:22:00,35,99,Móvel,5,134
20784,2024-01-15 10:23:00,116,79,Brinquedo,3,195
20785,2024-01-15 10:24:00,96,53,Móvel,7,149
20786,2024-01-15 10:25:00,22,19,Vestuário,7,41
20787,2024-01-15 10:26:00,104,38,Alimento,3,142
20788,2024-01-15 10:27:00,105,149,Alimento,3,254
20789,2024-01-15 10:28:00,39,67,Brinquedo,6,106
20790,2024-01-15 10:29:00,56,72,Vestuário,6,128
20791,2024-01-15 10:30:00,97,64,Brinquedo,8,161
20792,2024-01-15 10:31:00,80,159,Brinquedo,1,239
20793,2024-01-15 10:32:00,86,57,Alimento,9,143
20794,2024-01-15 10:33:00,86,35,Vestuário,1,121
20795,2024-01-15 10:34:00,103,78,Móvel,7,181
20796,2024-01-15 10:35:00,72,32,Brinquedo,7,104
20797,2024-01-15 10:36:00,50,107,Vestuário,3,157
20798,2024-01-15 10:37:00,27,168,Alimento,3,195
20799,2024-01-15 10:38:00,110,88,Eletrônico,5,198
20800,2024-01-15 10:39:00,36,91,Alimento,2,127
20801,2024-01-15 10:40:00,63,163,Eletrônico,6,226
20802,2024-01-15 10:41:00,45,165,Móvel,3,210
20803,2024-01-15 10:42:00,30,125,Vestuário,1,155
20804,2024-01-15 10:43:00,45,162,Móvel,9,207
20805,2024-01-15 10:44:00,85,173,Eletrônico,4,258
20806,2024-01-15 10:45:00,104,158,Alimento,4,262
20807,2024-01-15 10:46:00,10,109,Móvel,2,119
20808,2024-01-15 10:47:00,34,140,Vestuário,2,174
20809,2024-01-15 10:48:00,98,148,Brinquedo,9,246
20810,2024-01-15 10:49:00,60,144,Eletrônico,1,204
20811,2024-01-15 10:50:00,44,59,Vestuário,7,103
20812,2024-01-15 10:51:00,83,70,Móvel,9,153
20813,2024-01-15 10:52:00,101,95,Brinquedo,5,196
20814,2024-01-15 10:53:00,10,78,Vestuário,2,88
20815,2024-01-15 10:54:00,74,134,Vestuário,6,208
20816,2024-01-15 10:55:00,96,176,Brinquedo,1,272
20817,2024-01-15 10:56:00,88,65,Vestuário,5,153
20818,2024-01-15 10:57:00,12,45,Alimento,3,57
20819,2024-01-15 10:58:00,43,21,Alimento,9,64
20820,2024-01-15 10:59:00,82,174,Brinquedo,2,256
20821,2024-01-15 11:00:00,61,18,Alimento,7,79
20822,2024-01-15 11:01:00,119,86,Eletrônico,3,205
20823,2024-01-15 11:02:00,47,151,Eletrônico,9,198
20824,2024-01-15 11:03:00,20,121,Móvel,3,141
20825,2024-01-15 11:04:00,59,120,Móvel,8,179
20826,2024-01-15 11:05:00,25,85,Móvel,2,110
20827,2024-01-15 11:06:00,81,115,Brinquedo,7,196
20828,2024-01-15 11:07:00,42,110,Móvel,9,152
20829,2024-01-15 11:08:00,116,160,Brinquedo,3,276
20830,2024-01-15 11:09:00,85,48,Brinquedo,2,133
20831,2024-01-15 11:10:00,47,47,Móvel,8,94
20832,2024-01-15 11:11:00,52,54,Alimento,3,106
20833,2024-01-15 11:12:00,53,78,Alimento,4,131
20834,2024-01-15 11:13:00,68,64,Móvel,7,132
20835,2024-01-15 11:14:00,29,148,Alimento,3,177
20836,2024-01-15 11:15:00,63,96,Vestuário,4,159
20837,2024-01-15 11:16:00,69,12,Móvel,2,81
20838,2024-01-15 11:17:00,78,24,Móvel,2,102
20839,2024-01-15 11:18:00,15,69,Eletrônico,5,84
20840,2024-01-15 11:19:00,39,50,Eletrônico,8,89
20841,2024-01-15 11:20:00,29,138,Brinquedo,1,167
20842,2024-01-15 11:21:00,77,122,Eletrônico,8,199
20843,2024-01-15 11:22:00,91,132,Alimento,9,223
20844,2024-01-15 11:23:00,63,153,Vestuário,3,216
20845,2024-01-15 11:24:00,64,138,Alimento,1,202
20846,2024-01-15 11:25:00,59,174,Móvel,7,233
20847,2024-01-15 11:26:00,19,67,Brinquedo,8,86
20848,2024-01-15 11:27:00,15,108,Móvel,3,123
20849,2024-01-15 11:28:00,89,47,Vestuário,8,136
20850,2024-01-15 11:29:00,91,65,Alimento,9,156
20851,2024-01-15 11:30:00,91,91,Alimento,5,182
20852,2024-01-15 11:31:00,11,163,Alimento,7,174
20853,2024-01-15 11:32:00,111,150,Alimento,7,261
20854,2024-01-15 11:33:00,42,12,Brinquedo,7,54
20855,2024-01-15 11:34:00,91,175,Eletrônico,7,266
20856,2024-01-15 11:35:00,112,168,Brinquedo,6,280
20857,2024-01-15 11:36:00,60,33,Eletrônico,6,93
20858,2024-01-15 11:37:00,36,112,Móvel,6,148
20859,2024-01-15 11:38:00,23,140,Eletrônico,3,163
20860,2024-01-15 11:39:00,69,145,Eletrônico,1,214
20861,2024-01-15 11:40:00,43,15,Móvel,8,58
20862,2024-01-15 11:41:00,33,91,Brinquedo,2,124
20863,2024-01-15 11:42:00,21,144,Alimento,3,165
20864,2024-01-15 11:43:00,93,174,Móvel,6,267
20865,2024-01-15 11:44:00,95,58,Alimento,1,153
20866,2024-01-15 11:45:00,16,126,Vestuário,7,142
20867,2024-01-15 11:46:00,118,135,Vestuário,7,253
20868,2024-01-15 11:47:00,72,166,Eletrônico,4,238
20869,2024-01-15 11:48:00,52,90,Vestuário,5,142
20870,2024-01-15 11:49:00,96,41,Eletrônico,4,137
20871,2024-01-15 11:50:00,96,12,Vestuário,3,108
20872,2024-01-15 11:51:00,107,114,Brinquedo,1,221
20873,2024-01-15 11:52:00,112,28,Eletrônico,5,140
20874,2024-01-15 11:53:00,21,77,Vestuário,5,98
20875,2024-01-15 11:54:00,116,157,Móvel,6,273
20876,2024-01-15 11:55:00,32,92,Eletrônico,3,124
20877,2024-01-15 11:56:00,61,97,Alimento,7,158
20878,2024-01-15 11:57:00,10,59,Brinquedo,4,69
20879,2024-01-15 11:58:00,57,26,Móvel,7,83
20880,2024-01-15 11:59:00,57,141,Vestuário,9,198
20881,2024-01-15 12:00:00,42,146,Alimento,9,188
20882,2024-01-15 12:01:00,14,46,Eletrônico,4,60
20883,2024-01-15 12:02:00,72,178,Brinquedo,4,250
20884,2024-01-15 12:03:00,28,132,Móvel,7,160
20885,2024-01-15 12:04:00,115,161,Vestuário,9,276
20886,2024-01-15 12:05:00,68,57,Eletrônico,7,125
20887,2024-01-15 12:06:00,114,126,Eletrônico,8,240
20888,2024-01-15 12:07:00,40,124,Móvel,8,164
20889,2024-01-15 12:08:00,56,144,Vestuário,8,200
20890,2024-01-15 12:09:00,79,125,Alimento,9,204
20891,2024-01-15 12:10:00,109,164,Eletrônico,6,273
20892,2024-01-15 12:11:00,90,153,Brinquedo,9,243
20893,2024-01-15 12:12:00,109,156,Brinquedo,1,265
20894,2024-01-15 12:13:00,58,171,Brinquedo,5,229
20895,2024-01-15 12:14:00,77,157,Vestuário,4,234
20896,2024-01-15 12:15:00,113,101,Eletrônico,1,214
20897,2024-01-15 12:16:00,28,64,Alimento,6,92
20898,2024-01-15 12:17:00,44,30,Móvel,7,74
20899,2024-01-15 12:18:00,31,138,Móvel,5,169
20900,2024-01-15 12:19:00,11,66,Eletrônico,5,77
20901,2024-01-15 12:20:00,79,79,Eletrônico,4,158
20902,2024-01-15 12:21:00,28,124,Alimento,7,152
20903,2024-01-15 12:22:00,26,31,Brinquedo,4,57
20904,2024-01-15 12:23:00,70,175,Alimento,4,245
20905,2024-01-15 12:24:00,112,43,Alimento,9,155
20906,2024-01-15 12:25:00,89,15,Alimento,1,104
20907,2024-01-15 12:26:00,87,89,Alimento,4,176
20908,2024-01-15 12:27:00,34,17,Brinquedo,5,51
20909,2024-01-15 12:28:00,65,147,Vestuário,4,212
20910,2024-01-15 12:29:00,104,96,Brinquedo,6,200
20911,2024-01-15 12:30:00,103,83,Alimento,8,186
20912,2024-01-15 12:31:00,86,27,Eletrônico,8,113
20913,2024-01-15 12:32:00,66,24,Eletrônico,5,90
20914,2024-01-15 12:33:00,21,83,Vestuário,2,104
20915,2024-01-15 12:34:00,84,47,Vestuário,8,131
20916,2024-01-15 12:35:00,36,14,Eletrônico,9,50
20917,2024-01-15 12:36:00,65,152,Alimento,9,217
20918,2024-01-15 12:37:00,87,10,Móvel,8,97
20919,2024-01-15 12:38:00,96,52,Brinquedo,4,148
20920,2024-01-15 12:39:00,66,24,Móvel,1,90
20921,2024-01-15 12:40:00,20,146,Eletrônico,4,166
20922,2024-01-15 12:41:00,50,95,Eletrônico,2,145
20923,2024-01-15 12:42:00,46,68,Eletrônico,7,114
20924,2024-01-15 12:43:00,28,18,Vestuário,2,46
20925,2024-01-15 12:44:00,35,168,Alimento,4,203
20926,2024-01-15 12:45:00,118,151,Móvel,6,269
20927,2024-01-15 12:46:00,91,50,Brinquedo,6,141
20928,2024-01-15 12:47:00,81,166,Móvel,1,247
20929,2024-01-15 12:48:00,36,39,Móvel,3,75
20930,2024-01-15 12:49:00,89,139,Eletrônico,1,228
20931,2024-01-15 12:50:00,112,95,Eletrônico,1,207
20932,2024-01-15 12:51:00,112,171,Alimento,8,283
20933,2024-01-15 12:52:00,112,125,Brinquedo,1,237
20934,2024-01-15 12:53:00,37,178,Vestuário,7,215
20935,2024-01-15 12:54:00,35,115,Eletrônico,4,150
20936,2024-01-15 12:55:00,27,66,Móvel,6,93
20937,2024-01-15 12:56:00,107,139,Eletrônico,2,246
20938,2024-01-15 12:57:00,50,153,Eletrônico,3,203
20939,2024-01-15 12:58:00,24,101,Vestuário,4,125
20940,2024-01-15 12:59:00,96,139,Brinquedo,1,235
20941,2024-01-15 13:00:00,25,109,Alimento,1,134
20942,2024-01-15 13:01:00,47,54,Móvel,9,101
20943,2024-01-15 13:02:00,38,172,Móvel,2,210
20944,2024-01-15 13:03:00,102,63,Brinquedo,9,165
20945,2024-01-15 13:04:00,82,166,Vestuário,3,248
20946,2024-01-15 13:05:00,58,141,Brinquedo,1,199
20947,2024-01-15 13:06:00,56,104,Brinquedo,6,160
20948,2024-01-15 13:07:00,27,132,Eletrônico,9,159
20949,2024-01-15 13:08:00,85,103,Móvel,3,188
20950,2024-01-15 13:09:00,93,58,Vestuário,1,151
20951,2024-01-15 13:10:00,68,77,Alimento,5,145
20952,2024-01-15 13:11:00,47,10,Brinquedo,4,57
20953,2024-01-15 13:12:00,57,78,Alimento,5,135
20954,2024-01-15 13:13:00,56,10,Vestuário,6,66
20955,2024-01-15 13:14:00,64,27,Móvel,3,91
20956,2024-01-15 13:15:00,19,39,Alimento,8,58
20957,2024-01-15 13:16:00,26,77,Brinquedo,7,103
20958,2024-01-15 13:17:00,25,114,Móvel,1,139
20959,2024-01-15 13:18:00,14,88,Brinquedo,7,102
20960,2024-01-15 13:19:00,63,113,Alimento,9,176
20961,2024-01-15 13:20:00,72,142,Eletrônico,2,214
20962,2024-01-15 13:21:00,109,28,Móvel,1,137
20963,2024-01-15 13:22:00,113,166,Vestuário,1,279
20964,2024-01-15 13:23:00,15,166,Eletrônico,1,181
20965,2024-01-15 13:24:00,56,41,Vestuário,1,97
20966,2024-01-15 13:25:00,35,78,Vestuário,5,113
20967,2024-01-15 13:26:00,39,81,Alimento,1,120
20968,2024-01-15 13:27:00,101,12,Móvel,4,113
20969,2024-01-15 13:28:00,43,46,Móvel,2,89
20970,2024-01-15 13:29:00,27,106,Eletrônico,6,133
20971,2024-01-15 13:30:00,80,175,Vestuário,3,255
20972,2024-01-15 13:31:00,97,139,Móvel,9,236
20973,2024-01-15 13:32:00,119,98,Vestuário,8,217
20974,2024-01-15 13:33:00,115,47,Brinquedo,8,162
20975,2024-01-15 13:34:00,33,75,Alimento,4,108
20976,2024-01-15 13:35:00,76,14,Brinquedo,2,90
20977,2024-01-15 13:36:00,95,146,Alimento,4,241
20978,2024-01-15 13:37:00,27,176,Brinquedo,1,203
20979,2024-01-15 13:38:00,108,81,Vestuário,8,189
20980,2024-01-15 13:39:00,14,177,Vestuário,9,191
20981,2024-01-15 13:40:00,57,86,Eletrônico,5,143
20982,2024-01-15 13:41:00,53,68,Brinquedo,8,121
20983,2024-01-15 13:42:00,115,111,Brinquedo,6,226
20984,2024-01-15 13:43:00,118,119,Alimento,8,237
20985,2024-01-15 13:44:00,25,78,Brinquedo,6,103
20986,2024-01-15 13:45:00,97,50,Vestuário,5,147
20987,2024-01-15 13:46:00,76,44,Alimento,4,120
20988,2024-01-15 13:47:00,82,109,Brinquedo,5,191
20989,2024-01-15 13:48:00,57,37,Brinquedo,1,94
20990,2024-01-15 13:49:00,70,69,Alimento,6,139
20991,2024-01-15 13:50:00,45,122,Vestuário,3,167
20992,2024-01-15 13:51:00,17,139,Eletrônico,3,156
20993,2024-01-15 13:52:00,67,171,Alimento,1,238
20994,2024-01-15 13:53:00,21,102,Vestuário,3,123
20995,2024-01-15 13:54:00,43,145,Móvel,2,188
20996,2024-01-15 13:55:00,98,97,Móvel,6,195
20997,2024-01-15 13:56:00,47,160,Eletrônico,6,207
20998,2024-01-15 13:57:00,27,90,Alimento,5,117
20999,2024-01-15 13:58:00,67,94,Vestuário,9,161
21000,2024-01-15 13:59:00,54,20,Brinquedo,9,74
21001,2024-01-15 14:00:00,67,37,Brinquedo,5,104
21002,2024-01-15 14:01:00,69,100,Móvel,6,169
21003,2024-01-15 14:02:00,47,72,Alimento,6,119
21004,2024-01-15 14:03:00,117,24,Vestuário,5,141
21005,2024-01-15 14:04:00,27,155,Vestuário,8,182
21006,2024-01-15 14:05:00,19,162,Vestuário,7,181
21007,2024-01-15 14:06:00,22,30,Eletrônico,4,52
21008,2024-01-15 14:07:00,64,30,Brinquedo,1,94
21009,2024-01-15 14:08:00,29,139,Alimento,1,168
21010,2024-01-15 14:09:00,109,179,Vestuário,1,288
21011,2024-01-15 14:10:00,78,123,Eletrônico,7,201
21012,2024-01-15 14:11:00,91,101,Vestuário,9,192
21013,2024-01-15 14:12:00,112,130,Móvel,4,242
21014,2024-01-15 14:13:00,68,137,Vestuário,4,205
21015,2024-01-15 14:14:00,73,54,Eletrônico,7,127
21016,2024-01-15 14:15:00,86,163,Vestuário,3,249
21017,2024-01-15 14:16:00,19,134,Móvel,6,153
21018,2024-01-15 14:17:00,119,70,Alimento,3,189
21019,2024-01-15 14:18:00,79,85,Vestuário,4,164
21020,2024-01-15 14:19:00,65,112,Alimento,7,177
21021,2024-01-15 14:20:00,71,102,Vestuário,7,173
21022,2024-01-15 14:21:00,50,61,Brinquedo,2,111
21023,2024-01-15 14:22:00,103,155,Brinquedo,3,258
21024,2024-01-15 14:23:00,78,52,Brinquedo,4,130
21025,2024-01-15 14:24:00,88,17,Eletrônico,7,105
21026,2024-01-15 14:25:00,103,54,Vestuário,8,157
21027,2024-01-15 14:26:00,50,60,Móvel,3,110
21028,2024-01-15 14:27:00,94,102,Eletrônico,5,196
21029,2024-01-15 14:28:00,17,35,Eletrônico,6,52
21030,2024-01-15 14:29:00,91,55,Móvel,8,146
21031,2024-01-15 14:30:00,32,11,Vestuário,7,43
21032,2024-01-15 14:31:00,56,127,Alimento,3,183
21033,2024-01-15 14:32:00,40,29,Brinquedo,7,69
21034,2024-01-15 14:33:00,66,28,Alimento,3,94
21035,2024-01-15 14:34:00,95,110,Móvel,6,205
21036,2024-01-15 14:35:00,114,127,Vestuário,6,241
21037,2024-01-15 14:36:00,19,93,Eletrônico,8,112
21038,2024-01-15 14:37:00,102,50,Alimento,1,152
21039,2024-01-15 14:38:00,18,116,Alimento,2,134
21040,2024-01-15 14:39:00,118,80,Brinquedo,3,198
21041,2024-01-15 14:40:00,72,33,Vestuário,2,105
21042,2024-01-15 14:41:00,83,167,Móvel,3,250
21043,2024-01-15 14:42:00,91,113,Móvel,1,204
21044,2024-01-15 14:43:00,85,161,Alimento,5,246
21045,2024-01-15 14:44:00,85,28,Alimento,7,113
21046,2024-01-15 14:45:00,117,169,Eletrônico,7,286
21047,2024-01-15 14:46:00,84,172,Móvel,9,256
21048,2024-01-15 14:47:00,115,89,Eletrônico,9,204
21049,2024-01-15 14:48:00,62,143,Vestuário,5,205
21050,2024-01-15 14:49:00,60,112,Eletrônico,6,172
21051,2024-01-15 14:50:00,83,41,Vestuário,3,124
21052,2024-01-15 14:51:00,87,96,Móvel,3,183
21053,2024-01-15 14:52:00,46,146,Brinquedo,2,192
21054,2024-01-15 14:53:00,68,110,Móvel,8,178
21055,2024-01-15 14:54:00,45,14,Móvel,1,59
21056,2024-01-15 14:55:00,116,49,Brinquedo,6,165
21057,2024-01-15 14:56:00,66,27,Alimento,7,93
21058,2024-01-15 14:57:00,52,151,Vestuário,4,203
21059,2024-01-15 14:58:00,52,121,Brinquedo,1,173
21060,2024-01-15 14:59:00,26,157,Móvel,6,183
21061,2024-01-15 15:00:00,29,173,Eletrônico,8,202
21062,2024-01-15 15:01:00,57,89,Brinquedo,6,146
21063,2024-01-15 15:02:00,80,118,Brinquedo,9,198
21064,2024-01-15 15:03:00,76,113,Brinquedo,1,189
21065,2024-01-15 15:04:00,70,117,Alimento,2,187
21066,2024-01-15 15:05:00,14,49,Vestuário,6,63
21067,2024-01-15 15:06:00,28,146,Eletrônico,4,174
21068,2024-01-15 15:07:00,40,100,Eletrônico,6,140
21069,2024-01-15 15:08:00,117,80,Vestuário,8,197
21070,2024-01-15 15:09:00,110,49,Alimento,6,159
21071,2024-01-15 15:10:00,38,158,Móvel,4,196
21072,2024-01-15 15:11:00,36,35,Alimento,5,71
21073,2024-01-15 15:12:00,52,63,Brinquedo,6,115
21074,2024-01-15 15:13:00,84,101,Móvel,1,185
21075,2024-01-15 15:14:00,88,144,Vestuário,1,232
21076,2024-01-15 15:15:00,56,25,Brinquedo,5,81
21077,2024-01-15 15:16:00,107,67,Alimento,5,174
21078,2024-01-15 15:17:00,107,167,Alimento,6,274
21079,2024-01-15 15:18:00,67,137,Eletrônico,9,204
21080,2024-01-15 15:19:00,92,163,Eletrônico,3,255
21081,2024-01-15 15:20:00,64,73,Eletrônico,4,137
21082,2024-01-15 15:21:00,56,71,Vestuário,6,127
21083,2024-01-15 15:22:00,50,61,Brinquedo,6,111
21084,2024-01-15 15:23:00,44,47,Móvel,4,91
21085,2024-01-15 15:24:00,67,95,Vestuário,2,162
21086,2024-01-15 15:25:00,21,140,Brinquedo,9,161
21087,2024-01-15 15:26:00,65,168,Móvel,3,233
21088,2024-01-15 15:27:00,25,152,Brinquedo,7,177
21089,2024-01-15 15:28:00,72,139,Alimento,3,211
21090,2024-01-15 15:29:00,94,12,Alimento,5,106
21091,2024-01-15 15:30:00,61,13,Alimento,3,74
21092,2024-01-15 15:31:00,45,145,Brinquedo,7,190
21093,2024-01-15 15:32:00,116,71,Móvel,9,187
21094,2024-01-15 15:33:00,52,54,Vestuário,1,106
21095,2024-01-15 15:34:00,48,142,Alimento,9,190
21096,2024-01-15 15:35:00,118,25,Móvel,2,143
21097,2024-01-15 15:36:00,85,160,Brinquedo,9,245
21098,2024-01-15 15:37:00,53,106,Vestuário,5,159
21099,2024-01-15 15:38:00,94,44,Vestuário,4,138
21100,2024-01-15 15:39:00,41,132,Móvel,6,173
21101,2024-01-15 15:40:00,85,39,Brinquedo,4,124
21102,2024-01-15 15:41:00,63,165,Móvel,6,228
21103,2024-01-15 15:42:00,80,103,Móvel,1,183
21104,2024-01-15 15:43:00,72,48,Alimento,5,120
21105,2024-01-15 15:44:00,87,35,Vestuário,9,122
21106,2024-01-15 15:45:00,47,105,Móvel,3,152
21107,2024-01-15 15:46:00,109,93,Móvel,3,202
21108,2024-01-15 15:47:00,57,45,Brinquedo,6,102
21109,2024-01-15 15:48:00,35,105,Eletrônico,9,140
21110,2024-01-15 15:49:00,34,165,Móvel,3,199
21111,2024-01-15 15:50:00,59,173,Eletrônico,4,232
21112,2024-01-15 15:51:00,74,10,Móvel,7,84
21113,2024-01-15 15:52:00,15,160,Alimento,8,175
21114,2024-01-15 15:53:00,73,166,Vestuário,4,239
21115,2024-01-15 15:54:00,54,120,Alimento,4,174
21116,2024-01-15 15:55:00,64,143,Brinquedo,7,207
21117,2024-01-15 15:56:00,75,47,Móvel,4,122
21118,2024-01-15 15:57:00,15,125,Móvel,7,140
21119,2024-01-15 15:58:00,106,126,Eletrônico,5,232
21120,2024-01-15 15:59:00,107,45,Vestuário,5,152
21121,2024-01-15 16:00:00,109,118,Alimento,7,227
21122,2024-01-15 16:01:00,116,24,Móvel,2,140
21123,2024-01-15 16:02:00,105,34,Alimento,8,139
21124,2024-01-15 16:03:00,39,92,Eletrônico,3,131
21125,2024-01-15 16:04:00,84,66,Móvel,1,150
21126,2024-01-15 16:05:00,40,17,Alimento,3,57
21127,2024-01-15 16:06:00,72,116,Eletrônico,7,188
21128,2024-01-15 16:07:00,46,154,Vestuário,3,200
21129,2024-01-15 16:08:00,15,129,Móvel,8,144
21130,2024-01-15 16:09:00,39,86,Móvel,6,125
21131,2024-01-15 16:10:00,89,86,Móvel,1,175
21132,2024-01-15 16:11:00,115,75,Alimento,6,190
21133,2024-01-15 16:12:00,31,17,Alimento,4,48
21134,2024-01-15 16:13:00,111,178,Alimento,1,289
21135,2024-01-15 16:14:00,51,15,Alimento,5,66
21136,2024-01-15 16:15:00,38,134,Móvel,4,172
21137,2024-01-15 16:16:00,100,90,Eletrônico,1,190
21138,2024-01-15 16:17:00,78,131,Vestuário,8,209
21139,2024-01-15 16:18:00,116,52,Alimento,6,168
21140,2024-01-15 16:19:00,25,163,Eletrônico,8,188
21141,2024-01-15 16:20:00,78,45,Móvel,2,123
21142,2024-01-15 16:21:00,84,33,Vestuário,8,117
21143,2024-01-15 16:22:00,112,161,Móvel,8,273
21144,2024-01-15 16:23:00,88,23,Alimento,7,111
21145,2024-01-15 16:24:00,47,16,Brinquedo,8,63
21146,2024-01-15 16:25:00,114,168,Alimento,2,282
21147,2024-01-15 16:26:00,90,171,Alimento,7,261
21148,2024-01-15 16:27:00,68,100,Brinquedo,5,168
21149,2024-01-15 16:28:00,49,139,Alimento,6,188
21150,2024-01-15 16:29:00,44,147,Alimento,7,191
21151,2024-01-15 16:30:00,14,120,Alimento,9,134
21152,2024-01-15 16:31:00,80,157,Móvel,1,237
21153,2024-01-15 16:32:00,15,103,Móvel,3,118
21154,2024-01-15 16:33:00,42,135,Móvel,1,177
21155,2024-01-15 16:34:00,70,29,Brinquedo,8,99
21156,2024-01-15 16:35:00,106,38,Vestuário,6,144
21157,2024-01-15 16:36:00,24,135,Vestuário,4,159
21158,2024-01-15 16:37:00,23,125,Alimento,7,148
21159,2024-01-15 16:38:00,92,47,Móvel,1,139
21160,2024-01-15 16:39:00,110,109,Brinquedo,3,219
21161,2024-01-15 16:40:00,92,60,Eletrônico,4,152
21162,2024-01-15 16:41:00,67,115,Brinquedo,6,182
21163,2024-01-15 16:42:00,49,118,Brinquedo,2,167
21164,2024-01-15 16:43:00,54,64,Brinquedo,9,118
21165,2024-01-15 16:44:00,49,24,Móvel,2,73
21166,2024-01-15 16:45:00,37,98,Brinquedo,7,135
21167,2024-01-15 16:46:00,45,130,Vestuário,5,175
21168,2024-01-15 16:47:00,20,57,Vestuário,1,77
21169,2024-01-15 16:48:00,14,100,Brinquedo,1,114
21170,2024-01-15 16:49:00,49,44,Vestuário,9,93
21171,2024-01-15 16:50:00,92,97,Brinquedo,3,189
21172,2024-01-15 16:51:00,53,51,Brinquedo,9,104
21173,2024-01-15 16:52:00,112,158,Vestuário,1,270
21174,2024-01-15 16:53:00,46,60,Móvel,3,106
21175,2024-01-15 16:54:00,56,50,Vestuário,5,106
21176,2024-01-15 16:55:00,85,97,Alimento,3,182
21177,2024-01-15 16:56:00,26,153,Móvel,3,179
21178,2024-01-15 16:57:00,47,40,Alimento,2,87
21179,2024-01-15 16:58:00,38,24,Eletrônico,5,62
21180,2024-01-15 16:59:00,61,105,Móvel,2,166
21181,2024-01-15 17:00:00,34,22,Brinquedo,8,56
21182,2024-01-15 17:01:00,12,25,Eletrônico,3,37
21183,2024-01-15 17:02:00,114,70,Eletrônico,3,184
21184,2024-01-15 17:03:00,43,125,Brinquedo,5,168
21185,2024-01-15 17:04:00,50,160,Vestuário,7,210
21186,2024-01-15 17:05:00,45,110,Alimento,2,155
21187,2024-01-15 17:06:00,89,10,Vestuário,9,99
21188,2024-01-15 17:07:00,79,33,Vestuário,5,112
21189,2024-01-15 17:08:00,29,109,Eletrônico,8,138
21190,2024-01-15 17:09:00,84,132,Alimento,2,216
21191,2024-01-15 17:10:00,80,65,Móvel,7,145
21192,2024-01-15 17:11:00,40,151,Alimento,3,191
21193,2024-01-15 17:12:00,90,157,Eletrônico,8,247
21194,2024-01-15 17:13:00,101,146,Vestuário,6,247
21195,2024-01-15 17:14:00,49,134,Alimento,8,183
21196,2024-01-15 17:15:00,115,34,Brinquedo,6,149
21197,2024-01-15 17:16:00,63,29,Vestuário,6,92
21198,2024-01-15 17:17:00,115,57,Brinquedo,9,172
21199,2024-01-15 17:18:00,109,15,Brinquedo,3,124
21200,2024-01-15 17:19:00,84,105,Eletrônico,1,189
21201,2024-01-15 17:20:00,54,121,Móvel,5,175
21202,2024-01-15 17:21:00,89,172,Alimento,8,261
21203,2024-01-15 17:22:00,34,97,Alimento,8,131
21204,2024-01-15 17:23:00,38,176,Móvel,3,214
21205,2024-01-15 17:24:00,97,159,Móvel,7,256
21206,2024-01-15 17:25:00,44,163,Alimento,2,207
21207,2024-01-15 17:26:00,11,48,Móvel,1,59
21208,2024-01-15 17:27:00,16,110,Vestuário,8,126
21209,2024-01-15 17:28:00,84,48,Vestuário,7,132
21210,2024-01-15 17:29:00,38,131,Móvel,9,169
21211,2024-01-15 17:30:00,21,150,Alimento,1,171
21212,2024-01-15 17:31:00,82,67,Alimento,7,149
21213,2024-01-15 17:32:00,114,126,Alimento,9,240
21214,2024-01-15 17:33:00,28,132,Vestuário,2,160
21215,2024-01-15 17:34:00,44,119,Alimento,6,163
21216,2024-01-15 17:35:00,70,170,Eletrônico,5,240
21217,2024-01-15 17:36:00,71,38,Móvel,9,109
21218,2024-01-15 17:37:00,75,125,Eletrônico,8,200
21219,2024-01-15 17:38:00,48,109,Brinquedo,8,157
21220,2024-01-15 17:39:00,30,78,Eletrônico,3,108
21221,2024-01-15 17:40:00,41,104,Móvel,1,145
21222,2024-01-15 17:41:00,67,12,Vestuário,6,79
21223,2024-01-15 17:42:00,57,53,Alimento,7,110
21224,2024-01-15 17:43:00,43,27,Brinquedo,6,70
21225,2024-01-15 17:44:00,119,174,Móvel,6,293
21226,2024-01-15 17:45:00,63,135,Eletrônico,5,198
21227,2024-01-15 17:46:00,78,32,Vestuário,5,110
21228,2024-01-15 17:47:00,71,41,Brinquedo,7,112
21229,2024-01-15 17:48:00,77,67,Vestuário,3,144
21230,2024-01-15 17:49:00,65,47,Móvel,4,112
21231,2024-01-15 17:50:00,116,114,Alimento,4,230
21232,2024-01-15 17:51:00,101,114,Vestuário,3,215
21233,2024-01-15 17:52:00,47,83,Eletrônico,7,130
21234,2024-01-15 17:53:00,85,57,Vestuário,6,142
21235,2024-01-15 17:54:00,25,24,Brinquedo,8,49
21236,2024-01-15 17:55:00,93,124,Brinquedo,2,217
21237,2024-01-15 17:56:00,45,65,Móvel,9,110
21238,2024-01-15 17:57:00,33,97,Eletrônico,9,130
21239,2024-01-15 17:58:00,23,20,Eletrônico,2,43
21240,2024-01-15 17:59:00,15,62,Alimento,9,77
21241,2024-01-15 18:00:00,72,177,Móvel,8,249
21242,2024-01-15 18:01:00,12,50,Móvel,5,62
21243,2024-01-15 18:02:00,34,156,Móvel,2,190
21244,2024-01-15 18:03:00,73,113,Alimento,5,186
21245,2024-01-15 18:04:00,117,59,Eletrônico,6,176
21246,2024-01-15 18:05:00,69,149,Brinquedo,9,218
21247,2024-01-15 18:06:00,18,122,Brinquedo,8,140
21248,2024-01-15 18:07:00,66,11,Móvel,7,77
21249,2024-01-15 18:08:00,39,35,Móvel,4,74
21250,2024-01-15 18:09:00,17,120,Eletrônico,6,137
21251,2024-01-15 18:10:00,69,133,Brinquedo,7,202
21252,2024-01-15 18:11:00,17,45,Móvel,1,62
21253,2024-01-15 18:12:00,30,58,Alimento,8,88
21254,2024-01-15 18:13:00,96,172,Móvel,3,268
21255,2024-01-15 18:14:00,104,161,Alimento,6,265
21256,2024-01-15 18:15:00,99,138,Vestuário,4,237
21257,2024-01-15 18:16:00,34,58,Alimento,6,92
21258,2024-01-15 18:17:00,31,174,Brinquedo,7,205
21259,2024-01-15 18:18:00,30,149,Vestuário,2,179
21260,2024-01-15 18:19:00,92,146,Brinquedo,3,238
21261,2024-01-15 18:20:00,113,81,Eletrônico,8,194
21262,2024-01-15 18:21:00,64,91,Brinquedo,4,155
21263,2024-01-15 18:22:00,36,40,Móvel,8,76
21264,2024-01-15 18:23:00,101,100,Brinquedo,6,201
21265,2024-01-15 18:24:00,46,123,Brinquedo,1,169
21266,2024-01-15 18:25:00,47,157,Móvel,4,204
21267,2024-01-15 18:26:00,114,35,Alimento,1,149
21268,2024-01-15 18:27:00,56,153,Brinquedo,2,209
21269,2024-01-15 18:28:00,87,66,Móvel,3,153
21270,2024-01-15 18:29:00,113,108,Alimento,5,221
21271,2024-01-15 18:30:00,20,97,Alimento,4,117
21272,2024-01-15 18:31:00,119,74,Brinquedo,3,193
21273,2024-01-15 18:32:00,103,21,Brinquedo,2,124
21274,2024-01-15 18:33:00,23,11,Eletrônico,1,34
21275,2024-01-15 18:34:00,85,104,Alimento,9,189
21276,2024-01-15 18:35:00,52,32,Móvel,9,84
21277,2024-01-15 18:36:00,69,20,Alimento,5,89
21278,2024-01-15 18:37:00,21,104,Móvel,3,125
21279,2024-01-15 18:38:00,115,102,Alimento,6,217
21280,2024-01-15 18:39:00,110,81,Alimento,8,191
21281,2024-01-15 18:40:00,65,79,Alimento,8,144
21282,2024-01-15 18:41:00,82,167,Vestuário,7,249
21283,2024-01-15 18:42:00,38,38,Móvel,5,76
21284,2024-01-15 18:43:00,85,129,Brinquedo,2,214
21285,2024-01-15 18:44:00,88,11,Móvel,9,99
21286,2024-01-15 18:45:00,60,128,Alimento,1,188
21287,2024-01-15 18:46:00,42,23,Eletrônico,4,65
21288,2024-01-15 18:47:00,73,52,Brinquedo,5,125
21289,2024-01-15 18:48:00,118,163,Brinquedo,2,281
21290,2024-01-15 18:49:00,51,60,Móvel,1,111
21291,2024-01-15 18:50:00,46,92,Vestuário,5,138
21292,2024-01-15 18:51:00,50,174,Móvel,6,224
21293,2024-01-15 18:52:00,62,64,Móvel,5,126
21294,2024-01-15 18:53:00,117,36,Vestuário,5,153
21295,2024-01-15 18:54:00,43,51,Eletrônico,7,94
21296,2024-01-15 18:55:00,40,119,Alimento,1,159
21297,2024-01-15 18:56:00,113,178,Eletrônico,5,291
21298,2024-01-15 18:57:00,24,46,Móvel,3,70
21299,2024-01-15 18:58:00,24,115,Vestuário,5,139
21300,2024-01-15 18:59:00,52,88,Alimento,9,140
21301,2024-01-15 19:00:00,66,22,Alimento,4,88
21302,2024-01-15 19:01:00,69,161,Vestuário,2,230
21303,2024-01-15 19:02:00,97,15,Móvel,8,112
21304,2024-01-15 19:03:00,69,117,Móvel,7,186
21305,2024-01-15 19:04:00,13,93,Vestuário,5,106
21306,2024-01-15 19:05:00,30,86,Alimento,2,116
21307,2024-01-15 19:06:00,27,125,Móvel,6,152
21308,2024-01-15 19:07:00,91,136,Brinquedo,1,227
21309,2024-01-15 19:08:00,83,48,Móvel,7,131
21310,2024-01-15 19:09:00,82,172,Eletrônico,3,254
21311,2024-01-15 19:10:00,67,172,Eletrônico,3,239
21312,2024-01-15 19:11:00,22,161,Brinquedo,1,183
21313,2024-01-15 19:12:00,61,58,Eletrônico,7,119
21314,2024-01-15 19:13:00,109,148,Móvel,8,257
21315,2024-01-15 19:14:00,13,89,Eletrônico,2,102
21316,2024-01-15 19:15:00,44,48,Móvel,3,92
21317,2024-01-15 19:16:00,102,68,Móvel,9,170
21318,2024-01-15 19:17:00,96,63,Brinquedo,4,159
21319,2024-01-15 19:18:00,113,122,Vestuário,8,235
21320,2024-01-15 19:19:00,59,104,Eletrônico,1,163
21321,2024-01-15 19:20:00,100,177,Móvel,6,277
21322,2024-01-15 19:21:00,49,62,Móvel,1,111
21323,2024-01-15 19:22:00,78,178,Vestuário,6,256
21324,2024-01-15 19:23:00,111,156,Eletrônico,3,267
21325,2024-01-15 19:24:00,11,109,Alimento,5,120
21326,2024-01-15 19:25:00,41,102,Móvel,4,143
21327,2024-01-15 19:26:00,77,148,Vestuário,9,225
21328,2024-01-15 19:27:00,30,130,Vestuário,8,160
21329,2024-01-15 19:28:00,53,122,Brinquedo,5,175
21330,2024-01-15 19:29:00,10,57,Brinquedo,6,67
21331,2024-01-15 19:30:00,85,12,Brinquedo,3,97
21332,2024-01-15 19:31:00,93,99,Móvel,5,192
21333,2024-01-15 19:32:00,21,140,Vestuário,4,161
21334,2024-01-15 19:33:00,39,15,Móvel,4,54
21335,2024-01-15 19:34:00,20,134,Móvel,5,154
21336,2024-01-15 19:35:00,55,173,Vestuário,7,228
21337,2024-01-15 19:36:00,37,124,Eletrônico,8,161
21338,2024-01-15 19:37:00,96,176,Móvel,3,272
21339,2024-01-15 19:38:00,63,67,Móvel,1,130
21340,2024-01-15 19:39:00,15,79,Brinquedo,5,94
21341,2024-01-15 19:40:00,65,155,Brinquedo,7,220
21342,2024-01-15 19:41:00,111,22,Móvel,3,133
21343,2024-01-15 19:42:00,28,51,Móvel,7,79
21344,2024-01-15 19:43:00,31,89,Brinquedo,5,120
21345,2024-01-15 19:44:00,114,41,Vestuário,5,155
21346,2024-01-15 19:45:00,102,130,Brinquedo,1,232
21347,2024-01-15 19:46:00,35,64,Alimento,9,99
21348,2024-01-15 19:47:00,113,155,Brinquedo,1,268
21349,2024-01-15 19:48:00,91,43,Móvel,9,134
21350,2024-01-15 19:49:00,115,80,Alimento,4,195
21351,2024-01-15 19:50:00,10,55,Alimento,3,65
21352,2024-01-15 19:51:00,25,153,Eletrônico,8,178
21353,2024-01-15 19:52:00,33,67,Vestuário,8,100
21354,2024-01-15 19:53:00,68,116,Vestuário,3,184
21355,2024-01-15 19:54:00,66,149,Alimento,3,215
21356,2024-01-15 19:55:00,75,158,Alimento,8,233
21357,2024-01-15 19:56:00,74,110,Vestuário,2,184
21358,2024-01-15 19:57:00,39,150,Alimento,9,189
21359,2024-01-15 19:58:00,21,171,Vestuário,7,192
21360,2024-01-15 19:59:00,86,36,Alimento,4,122
21361,2024-01-15 20:00:00,67,49,Alimento,5,116
21362,2024-01-15 20:01:00,88,176,Móvel,5,264
21363,2024-01-15 20:02:00,33,15,Alimento,7,48
21364,2024-01-15 20:03:00,79,55,Eletrônico,2,134
21365,2024-01-15 20:04:00,41,118,Alimento,3,159
21366,2024-01-15 20:05:00,119,151,Alimento,4,270
21367,2024-01-15 20:06:00,41,83,Brinquedo,5,124
21368,2024-01-15 20:07:00,48,85,Brinquedo,4,133
21369,2024-01-15 20:08:00,96,125,Móvel,3,221
21370,2024-01-15 20:09:00,51,88,Vestuário,5,139
21371,2024-01-15 20:10:00,76,14,Brinquedo,6,90
21372,2024-01-15 20:11:00,54,172,Alimento,4,226
21373,2024-01-15 20:12:00,65,138,Brinquedo,5,203
21374,2024-01-15 20:13:00,80,87,Alimento,6,167
21375,2024-01-15 20:14:00,10,73,Brinquedo,1,83
21376,2024-01-15 20:15:00,54,112,Móvel,7,166
21377,2024-01-15 20:16:00,84,16,Vestuário,9,100
21378,2024-01-15 20:17:00,84,10,Eletrônico,6,94
21379,2024-01-15 20:18:00,19,146,Alimento,7,165
21380,2024-01-15 20:19:00,83,164,Brinquedo,3,247
21381,2024-01-15 20:20:00,68,160,Alimento,1,228
21382,2024-01-15 20:21:00,93,175,Alimento,5,268
21383,2024-01-15 20:22:00,52,51,Móvel,3,103
21384,2024-01-15 20:23:00,115,44,Brinquedo,6,159
21385,2024-01-15 20:24:00,45,79,Brinquedo,4,124
21386,2024-01-15 20:25:00,64,27,Brinquedo,5,91
21387,2024-01-15 20:26:00,88,159,Eletrônico,9,247
21388,2024-01-15 20:27:00,43,20,Brinquedo,1,63
21389,2024-01-15 20:28:00,94,98,Vestuário,5,192
21390,2024-01-15 20:29:00,37,144,Alimento,4,181
21391,2024-01-15 20:30:00,103,13,Vestuário,4,116
21392,2024-01-15 20:31:00,30,23,Eletrônico,5,53
21393,2024-01-15 20:32:00,97,71,Móvel,3,168
21394,2024-01-15 20:33:00,62,158,Vestuário,9,220
21395,2024-01-15 20:34:00,85,110,Alimento,6,195
21396,2024-01-15 20:35:00,94,40,Vestuário,8,134
21397,2024-01-15 20:36:00,96,161,Eletrônico,8,257
21398,2024-01-15 20:37:00,25,55,Brinquedo,7,80
21399,2024-01-15 20:38:00,32,179,Vestuário,2,211
21400,2024-01-15 20:39:00,101,127,Brinquedo,2,228
21401,2024-01-15 20:40:00,58,23,Brinquedo,5,81
21402,2024-01-15 20:41:00,30,140,Eletrônico,9,170
21403,2024-01-15 20:42:00,115,128,Eletrônico,4,243
21404,2024-01-15 20:43:00,62,66,Brinquedo,4,128
21405,2024-01-15 20:44:00,79,113,Móvel,3,192
21406,2024-01-15 20:45:00,73,90,Móvel,1,163
21407,2024-01-15 20:46:00,84,169,Alimento,2,253
21408,2024-01-15 20:47:00,27,172,Alimento,8,199
21409,2024-01-15 20:48:00,62,43,Móvel,5,105
21410,2024-01-15 20:49:00,54,35,Brinquedo,2,89
21411,2024-01-15 20:50:00,95,147,Eletrônico,8,242
21412,2024-01-15 20:51:00,32,177,Alimento,2,209
21413,2024-01-15 20:52:00,97,65,Móvel,9,162
21414,2024-01-15 20:53:00,16,92,Alimento,1,108
21415,2024-01-15 20:54:00,40,106,Vestuário,8,146
21416,2024-01-15 20:55:00,118,92,Móvel,1,210
21417,2024-01-15 20:56:00,62,26,Vestuário,4,88
21418,2024-01-15 20:57:00,21,92,Vestuário,6,113
21419,2024-01-15 20:58:00,45,11,Móvel,3,56
21420,2024-01-15 20:59:00,76,148,Eletrônico,6,224
21421,2024-01-15 21:00:00,103,156,Móvel,8,259
21422,2024-01-15 21:01:00,84,121,Vestuário,9,205
21423,2024-01-15 21:02:00,53,29,Brinquedo,2,82
21424,2024-01-15 21:03:00,55,67,Vestuário,5,122
21425,2024-01-15 21:04:00,57,39,Vestuário,1,96
21426,2024-01-15 21:05:00,22,27,Vestuário,2,49
21427,2024-01-15 21:06:00,90,145,Alimento,4,235
21428,2024-01-15 21:07:00,118,173,Móvel,9,291
21429,2024-01-15 21:08:00,53,98,Brinquedo,3,151
21430,2024-01-15 21:09:00,76,34,Brinquedo,5,110
21431,2024-01-15 21:10:00,29,34,Brinquedo,5,63
21432,2024-01-15 21:11:00,47,17,Vestuário,3,64
21433,2024-01-15 21:12:00,73,144,Brinquedo,5,217
21434,2024-01-15 21:13:00,23,52,Móvel,4,75
21435,2024-01-15 21:14:00,76,87,Vestuário,7,163
21436,2024-01-15 21:15:00,115,97,Brinquedo,9,212
21437,2024-01-15 21:16:00,102,82,Brinquedo,2,184
21438,2024-01-15 21:17:00,35,42,Móvel,7,77
21439,2024-01-15 21:18:00,108,29,Alimento,5,137
21440,2024-01-15 21:19:00,43,71,Brinquedo,8,114
21441,2024-01-15 21:20:00,61,59,Eletrônico,1,120
21442,2024-01-15 21:21:00,17,67,Brinquedo,9,84
21443,2024-01-15 21:22:00,87,18,Eletrônico,1,105
21444,2024-01-15 21:23:00,99,116,Brinquedo,3,215
21445,2024-01-15 21:24:00,32,99,Móvel,6,131
21446,2024-01-15 21:25:00,53,113,Brinquedo,7,166
21447,2024-01-15 21:26:00,54,178,Alimento,1,232
21448,2024-01-15 21:27:00,67,69,Brinquedo,1,136
21449,2024-01-15 21:28:00,31,111,Móvel,9,142
21450,2024-01-15 21:29:00,115,140,Móvel,1,255
21451,2024-01-15 21:30:00,38,151,Brinquedo,6,189
21452,2024-01-15 21:31:00,100,151,Vestuário,9,251
21453,2024-01-15 21:32:00,51,43,Alimento,7,94
21454,2024-01-15 21:33:00,116,117,Vestuário,2,233
21455,2024-01-15 21:34:00,25,26,Alimento,4,51
21456,2024-01-15 21:35:00,65,40,Alimento,9,105
21457,2024-01-15 21:36:00,65,145,Vestuário,6,210
21458,2024-01-15 21:37:00,56,14,Eletrônico,6,70
21459,2024-01-15 21:38:00,16,146,Vestuário,8,162
21460,2024-01-15 21:39:00,48,116,Móvel,6,164
21461,2024-01-15 21:40:00,40,160,Eletrônico,8,200
21462,2024-01-15 21:41:00,55,156,Móvel,5,211
21463,2024-01-15 21:42:00,55,129,Eletrônico,1,184
21464,2024-01-15 21:43:00,82,78,Vestuário,5,160
21465,2024-01-15 21:44:00,37,31,Brinquedo,4,68
21466,2024-01-15 21:45:00,45,63,Vestuário,4,108
21467,2024-01-15 21:46:00,53,163,Vestuário,3,216
21468,2024-01-15 21:47:00,118,121,Brinquedo,6,239
21469,2024-01-15 21:48:00,11,69,Vestuário,5,80
21470,2024-01-15 21:49:00,50,130,Eletrônico,6,180
21471,2024-01-15 21:50:00,31,138,Brinquedo,1,169
21472,2024-01-15 21:51:00,78,62,Alimento,5,140
21473,2024-01-15 21:52:00,50,121,Eletrônico,7,171
21474,2024-01-15 21:53:00,44,35,Brinquedo,5,79
21475,2024-01-15 21:54:00,115,53,Vestuário,2,168
21476,2024-01-15 21:55:00,77,80,Brinquedo,9,157
21477,2024-01-15 21:56:00,50,132,Vestuário,7,182
21478,2024-01-15 21:57:00,79,113,Eletrônico,4,192
21479,2024-01-15 21:58:00,75,16,Vestuário,3,91
21480,2024-01-15 21:59:00,66,116,Móvel,8,182
21481,2024-01-15 22:00:00,57,110,Móvel,2,167
21482,2024-01-15 22:01:00,42,160,Brinquedo,4,202
21483,2024-01-15 22:02:00,40,76,Móvel,8,116
21484,2024-01-15 22:03:00,51,106,Eletrônico,3,157
21485,2024-01-15 22:04:00,36,34,Móvel,7,70
21486,2024-01-15 22:05:00,33,175,Vestuário,3,208
21487,2024-01-15 22:06:00,79,122,Alimento,3,201
21488,2024-01-15 22:07:00,49,56,Vestuário,4,105
21489,2024-01-15 22:08:00,99,72,Eletrônico,8,171
21490,2024-01-15 22:09:00,116,50,Móvel,4,166
21491,2024-01-15 22:10:00,81,111,Eletrônico,8,192
21492,2024-01-15 22:11:00,116,92,Vestuário,5,208
21493,2024-01-15 22:12:00,76,133,Brinquedo,3,209
21494,2024-01-15 22:13:00,101,153,Brinquedo,3,254
21495,2024-01-15 22:14:00,60,140,Alimento,2,200
21496,2024-01-15 22:15:00,66,38,Brinquedo,9,104
21497,2024-01-15 22:16:00,22,136,Brinquedo,3,158
21498,2024-01-15 22:17:00,119,166,Alimento,5,285
21499,2024-01-15 22:18:00,48,64,Eletrônico,8,112
21500,2024-01-15 22:19:00,44,171,Alimento,9,215
21501,2024-01-15 22:20:00,36,162,Eletrônico,9,198
21502,2024-01-15 22:21:00,56,46,Alimento,3,102
21503,2024-01-15 22:22:00,45,28,Brinquedo,8,73
21504,2024-01-15 22:23:00,39,109,Eletrônico,2,148
21505,2024-01-15 22:24:00,91,54,Eletrônico,1,145
21506,2024-01-15 22:25:00,55,15,Vestuário,1,70
21507,2024-01-15 22:26:00,25,26,Móvel,8,51
21508,2024-01-15 22:27:00,82,116,Alimento,5,198
21509,2024-01-15 22:28:00,29,155,Móvel,8,184
21510,2024-01-15 22:29:00,21,67,Vestuário,2,88
21511,2024-01-15 22:30:00,77,176,Móvel,2,253
21512,2024-01-15 22:31:00,119,163,Móvel,4,282
21513,2024-01-15 22:32:00,11,80,Alimento,7,91
21514,2024-01-15 22:33:00,41,104,Eletrônico,1,145
21515,2024-01-15 22:34:00,56,37,Alimento,7,93
21516,2024-01-15 22:35:00,71,29,Móvel,5,100
21517,2024-01-15 22:36:00,106,89,Eletrônico,6,195
21518,2024-01-15 22:37:00,51,65,Móvel,6,116
21519,2024-01-15 22:38:00,112,167,Alimento,8,279
21520,2024-01-15 22:39:00,96,161,Móvel,9,257
21521,2024-01-15 22:40:00,42,71,Brinquedo,1,113
21522,2024-01-15 22:41:00,53,51,Vestuário,8,104
21523,2024-01-15 22:42:00,114,162,Eletrônico,1,276
21524,2024-01-15 22:43:00,74,17,Brinquedo,4,91
21525,2024-01-15 22:44:00,76,132,Alimento,6,208
21526,2024-01-15 22:45:00,93,42,Móvel,8,135
21527,2024-01-15 22:46:00,72,46,Vestuário,9,118
21528,2024-01-15 22:47:00,84,34,Vestuário,3,118
21529,2024-01-15 22:48:00,34,139,Brinquedo,9,173
21530,2024-01-15 22:49:00,14,89,Eletrônico,4,103
21531,2024-01-15 22:50:00,50,65,Móvel,5,115
21532,2024-01-15 22:51:00,31,68,Brinquedo,7,99
21533,2024-01-15 22:52:00,51,87,Eletrônico,8,138
21534,2024-01-15 22:53:00,107,58,Vestuário,8,165
21535,2024-01-15 22:54:00,34,111,Alimento,4,145
21536,2024-01-15 22:55:00,61,62,Brinquedo,6,123
21537,2024-01-15 22:56:00,32,138,Vestuário,5,170
21538,2024-01-15 22:57:00,37,168,Alimento,4,205
21539,2024-01-15 22:58:00,55,28,Alimento,1,83
21540,2024-01-15 22:59:00,60,38,Eletrônico,1,98
21541,2024-01-15 23:00:00,20,72,Brinquedo,2,92
21542,2024-01-15 23:01:00,74,58,Vestuário,1,132
21543,2024-01-15 23:02:00,59,114,Móvel,1,173
21544,2024-01-15 23:03:00,108,152,Brinquedo,5,260
21545,2024-01-15 23:04:00,97,114,Brinquedo,2,211
21546,2024-01-15 23:05:00,76,175,Eletrônico,7,251
21547,2024-01-15 23:06:00,28,161,Brinquedo,2,189
21548,2024-01-15 23:07:00,82,18,Alimento,4,100
21549,2024-01-15 23:08:00,88,106,Vestuário,1,194
21550,2024-01-15 23:09:00,56,101,Vestuário,5,157
21551,2024-01-15 23:10:00,116,114,Vestuário,4,230
21552,2024-01-15 23:11:00,90,103,Vestuário,8,193
21553,2024-01-15 23:12:00,91,104,Móvel,6,195
21554,2024-01-15 23:13:00,25,121,Vestuário,1,146
21555,2024-01-15 23:14:00,59,40,Brinquedo,1,99
21556,2024-01-15 23:15:00,60,82,Eletrônico,7,142
21557,2024-01-15 23:16:00,69,61,Móvel,1,130
21558,2024-01-15 23:17:00,92,147,Vestuário,6,239
21559,2024-01-15 23:18:00,77,131,Eletrônico,4,208
21560,2024-01-15 23:19:00,118,92,Vestuário,4,210
21561,2024-01-15 23:20:00,119,14,Brinquedo,9,133
21562,2024-01-15 23:21:00,118,52,Eletrônico,8,170
21563,2024-01-15 23:22:00,79,54,Vestuário,5,133
21564,2024-01-15 23:23:00,43,152,Vestuário,8,195
21565,2024-01-15 23:24:00,59,18,Móvel,2,77
21566,2024-01-15 23:25:00,32,119,Brinquedo,5,151
21567,2024-01-15 23:26:00,33,19,Vestuário,8,52
21568,2024-01-15 23:27:00,117,81,Brinquedo,3,198
21569,2024-01-15 23:28:00,26,14,Vestuário,7,40
21570,2024-01-15 23:29:00,33,174,Alimento,7,207
21571,2024-01-15 23:30:00,50,13,Alimento,2,63
21572,2024-01-15 23:31:00,110,151,Alimento,6,261
21573,2024-01-15 23:32:00,116,89,Alimento,2,205
21574,2024-01-15 23:33:00,47,77,Alimento,9,124
21575,2024-01-15 23:34:00,44,117,Brinquedo,7,161
21576,2024-01-15 23:35:00,96,145,Alimento,9,241
21577,2024-01-15 23:36:00,119,129,Brinquedo,3,248
21578,2024-01-15 23:37:00,18,54,Móvel,3,72
21579,2024-01-15 23:38:00,82,23,Brinquedo,1,105
21580,2024-01-15 23:39:00,105,11,Eletrônico,1,116
21581,2024-01-15 23:40:00,76,35,Vestuário,4,111
21582,2024-01-15 23:41:00,43,154,Vestuário,7,197
21583,2024-01-15 23:42:00,75,46,Eletrônico,4,121
21584,2024-01-15 23:43:00,101,99,Móvel,7,200
21585,2024-01-15 23:44:00,107,105,Vestuário,7,212
21586,2024-01-15 23:45:00,57,22,Vestuário,2,79
21587,2024-01-15 23:46:00,38,114,Móvel,7,152
21588,2024-01-15 23:47:00,34,60,Vestuário,5,94
21589,2024-01-15 23:48:00,100,176,Eletrônico,3,276
21590,2024-01-15 23:49:00,79,88,Móvel,5,167
21591,2024-01-15 23:50:00,58,109,Eletrônico,5,167
21592,2024-01-15 23:51:00,79,104,Móvel,5,183
21593,2024-01-15 23:52:00,90,138,Vestuário,2,228
21594,2024-01-15 23:53:00,45,64,Brinquedo,2,109
21595,2024-01-15 23:54:00,64,25,Vestuário,1,89
21596,2024-01-15 23:55:00,117,59,Eletrônico,4,176
21597,2024-01-15 23:56:00,74,131,Móvel,3,205
21598,2024-01-15 23:57:00,19,90,Móvel,9,109
21599,2024-01-15 23:58:00,76,53,Brinquedo,1,129
21600,2024-01-15 23:59:00,84,169,Móvel,4,253
21601,2024-01-16 00:00:00,74,112,Alimento,7,186
21602,2024-01-16 00:01:00,10,34,Eletrônico,6,44
21603,2024-01-16 00:02:00,22,161,Alimento,5,183
21604,2024-01-16 00:03:00,72,104,Brinquedo,3,176
21605,2024-01-16 00:04:00,91,139,Móvel,7,230
21606,2024-01-16 00:05:00,88,94,Vestuário,7,182
21607,2024-01-16 00:06:00,102,19,Vestuário,1,121
21608,2024-01-16 00:07:00,18,56,Vestuário,1,74
21609,2024-01-16 00:08:00,90,47,Vestuário,4,137
21610,2024-01-16 00:09:00,72,28,Móvel,9,100
21611,2024-01-16 00:10:00,39,98,Eletrônico,5,137
21612,2024-01-16 00:11:00,85,159,Brinquedo,1,244
21613,2024-01-16 00:12:00,101,154,Móvel,6,255
21614,2024-01-16 00:13:00,107,56,Vestuário,5,163
21615,2024-01-16 00:14:00,20,27,Móvel,2,47
21616,2024-01-16 00:15:00,110,27,Eletrônico,4,137
21617,2024-01-16 00:16:00,83,109,Alimento,8,192
21618,2024-01-16 00:17:00,14,19,Alimento,5,33
21619,2024-01-16 00:18:00,63,97,Brinquedo,1,160
21620,2024-01-16 00:19:00,52,76,Alimento,9,128
21621,2024-01-16 00:20:00,60,41,Móvel,6,101
21622,2024-01-16 00:21:00,38,61,Brinquedo,4,99
21623,2024-01-16 00:22:00,60,126,Vestuário,2,186
21624,2024-01-16 00:23:00,43,34,Móvel,5,77
21625,2024-01-16 00:24:00,23,126,Vestuário,7,149
21626,2024-01-16 00:25:00,88,13,Móvel,8,101
21627,2024-01-16 00:26:00,111,170,Eletrônico,3,281
21628,2024-01-16 00:27:00,30,165,Vestuário,6,195
21629,2024-01-16 00:28:00,43,57,Alimento,6,100
21630,2024-01-16 00:29:00,26,21,Vestuário,1,47
21631,2024-01-16 00:30:00,113,73,Alimento,5,186
21632,2024-01-16 00:31:00,17,74,Alimento,6,91
21633,2024-01-16 00:32:00,96,113,Brinquedo,6,209
21634,2024-01-16 00:33:00,28,129,Brinquedo,1,157
21635,2024-01-16 00:34:00,47,135,Alimento,5,182
21636,2024-01-16 00:35:00,99,54,Móvel,8,153
21637,2024-01-16 00:36:00,65,118,Eletrônico,1,183
21638,2024-01-16 00:37:00,46,56,Eletrônico,2,102
21639,2024-01-16 00:38:00,28,36,Móvel,1,64
21640,2024-01-16 00:39:00,50,72,Brinquedo,1,122
21641,2024-01-16 00:40:00,12,125,Alimento,9,137
21642,2024-01-16 00:41:00,13,167,Brinquedo,6,180
21643,2024-01-16 00:42:00,10,85,Brinquedo,8,95
21644,2024-01-16 00:43:00,111,53,Eletrônico,5,164
21645,2024-01-16 00:44:00,18,90,Móvel,1,108
21646,2024-01-16 00:45:00,23,96,Alimento,2,119
21647,2024-01-16 00:46:00,61,81,Alimento,9,142
21648,2024-01-16 00:47:00,51,89,Brinquedo,1,140
21649,2024-01-16 00:48:00,84,59,Alimento,1,143
21650,2024-01-16 00:49:00,16,145,Vestuário,3,161
21651,2024-01-16 00:50:00,28,144,Brinquedo,1,172
21652,2024-01-16 00:51:00,37,140,Vestuário,1,177
21653,2024-01-16 00:52:00,34,55,Brinquedo,5,89
21654,2024-01-16 00:53:00,61,99,Móvel,9,160
21655,2024-01-16 00:54:00,83,14,Eletrônico,7,97
21656,2024-01-16 00:55:00,36,39,Vestuário,3,75
21657,2024-01-16 00:56:00,44,138,Vestuário,4,182
21658,2024-01-16 00:57:00,18,23,Eletrônico,3,41
21659,2024-01-16 00:58:00,16,52,Móvel,7,68
21660,2024-01-16 00:59:00,36,54,Eletrônico,7,90
21661,2024-01-16 01:00:00,15,32,Alimento,5,47
21662,2024-01-16 01:01:00,19,126,Vestuário,7,145
21663,2024-01-16 01:02:00,28,176,Eletrônico,1,204
21664,2024-01-16 01:03:00,10,82,Vestuário,2,92
21665,2024-01-16 01:04:00,44,126,Móvel,2,170
21666,2024-01-16 01:05:00,20,127,Móvel,6,147
21667,2024-01-16 01:06:00,99,131,Móvel,3,230
21668,2024-01-16 01:07:00,88,36,Vestuário,1,124
21669,2024-01-16 01:08:00,46,157,Móvel,7,203
21670,2024-01-16 01:09:00,31,160,Vestuário,2,191
21671,2024-01-16 01:10:00,13,112,Eletrônico,7,125
21672,2024-01-16 01:11:00,17,176,Eletrônico,5,193
21673,2024-01-16 01:12:00,52,60,Alimento,8,112
21674,2024-01-16 01:13:00,99,92,Vestuário,7,191
21675,2024-01-16 01:14:00,44,169,Móvel,3,213
21676,2024-01-16 01:15:00,26,31,Móvel,5,57
21677,2024-01-16 01:16:00,107,86,Alimento,8,193
21678,2024-01-16 01:17:00,108,27,Brinquedo,6,135
21679,2024-01-16 01:18:00,98,168,Alimento,9,266
21680,2024-01-16 01:19:00,71,92,Alimento,7,163
21681,2024-01-16 01:20:00,54,39,Eletrônico,6,93
21682,2024-01-16 01:21:00,81,163,Eletrônico,7,244
21683,2024-01-16 01:22:00,111,122,Eletrônico,9,233
21684,2024-01-16 01:23:00,19,41,Brinquedo,5,60
21685,2024-01-16 01:24:00,14,79,Alimento,7,93
21686,2024-01-16 01:25:00,84,175,Eletrônico,4,259
21687,2024-01-16 01:26:00,75,43,Eletrônico,5,118
21688,2024-01-16 01:27:00,31,14,Eletrônico,1,45
21689,2024-01-16 01:28:00,71,117,Vestuário,5,188
21690,2024-01-16 01:29:00,99,55,Vestuário,4,154
21691,2024-01-16 01:30:00,59,29,Brinquedo,7,88
21692,2024-01-16 01:31:00,65,50,Móvel,7,115
21693,2024-01-16 01:32:00,110,156,Vestuário,9,266
21694,2024-01-16 01:33:00,73,67,Móvel,6,140
21695,2024-01-16 01:34:00,42,37,Vestuário,7,79
21696,2024-01-16 01:35:00,25,53,Brinquedo,5,78
21697,2024-01-16 01:36:00,90,93,Vestuário,6,183
21698,2024-01-16 01:37:00,16,158,Móvel,8,174
21699,2024-01-16 01:38:00,31,178,Eletrônico,9,209
21700,2024-01-16 01:39:00,81,156,Vestuário,6,237
21701,2024-01-16 01:40:00,29,146,Eletrônico,1,175
21702,2024-01-16 01:41:00,16,96,Brinquedo,4,112
21703,2024-01-16 01:42:00,72,20,Brinquedo,7,92
21704,2024-01-16 01:43:00,66,110,Vestuário,7,176
21705,2024-01-16 01:44:00,76,85,Brinquedo,7,161
21706,2024-01-16 01:45:00,106,146,Eletrônico,1,252
21707,2024-01-16 01:46:00,64,143,Brinquedo,5,207
21708,2024-01-16 01:47:00,74,93,Eletrônico,7,167
21709,2024-01-16 01:48:00,119,127,Móvel,3,246
21710,2024-01-16 01:49:00,23,114,Vestuário,1,137
21711,2024-01-16 01:50:00,34,143,Brinquedo,8,177
21712,2024-01-16 01:51:00,63,11,Eletrônico,3,74
21713,2024-01-16 01:52:00,93,39,Móvel,7,132
21714,2024-01-16 01:53:00,36,161,Eletrônico,5,197
21715,2024-01-16 01:54:00,100,97,Vestuário,3,197
21716,2024-01-16 01:55:00,115,165,Brinquedo,1,280
21717,2024-01-16 01:56:00,38,154,Alimento,1,192
21718,2024-01-16 01:57:00,72,76,Brinquedo,1,148
21719,2024-01-16 01:58:00,88,23,Vestuário,7,111
21720,2024-01-16 01:59:00,90,170,Eletrônico,2,260
21721,2024-01-16 02:00:00,40,121,Alimento,3,161
21722,2024-01-16 02:01:00,80,136,Eletrônico,5,216
21723,2024-01-16 02:02:00,19,55,Vestuário,2,74
21724,2024-01-16 02:03:00,69,168,Móvel,9,237
21725,2024-01-16 02:04:00,90,174,Brinquedo,8,264
21726,2024-01-16 02:05:00,28,120,Eletrônico,2,148
21727,2024-01-16 02:06:00,71,139,Alimento,5,210
21728,2024-01-16 02:07:00,34,85,Eletrônico,6,119
21729,2024-01-16 02:08:00,90,164,Móvel,3,254
21730,2024-01-16 02:09:00,101,20,Vestuário,2,121
21731,2024-01-16 02:10:00,90,97,Vestuário,9,187
21732,2024-01-16 02:11:00,81,10,Móvel,6,91
21733,2024-01-16 02:12:00,77,78,Móvel,8,155
21734,2024-01-16 02:13:00,79,34,Alimento,7,113
21735,2024-01-16 02:14:00,114,56,Móvel,1,170
21736,2024-01-16 02:15:00,12,41,Vestuário,4,53
21737,2024-01-16 02:16:00,86,89,Eletrônico,8,175
21738,2024-01-16 02:17:00,33,138,Alimento,6,171
21739,2024-01-16 02:18:00,93,122,Alimento,2,215
21740,2024-01-16 02:19:00,69,134,Eletrônico,1,203
21741,2024-01-16 02:20:00,67,171,Vestuário,2,238
21742,2024-01-16 02:21:00,67,110,Brinquedo,3,177
21743,2024-01-16 02:22:00,37,149,Brinquedo,4,186
21744,2024-01-16 02:23:00,73,71,Móvel,9,144
21745,2024-01-16 02:24:00,77,30,Alimento,5,107
21746,2024-01-16 02:25:00,74,64,Eletrônico,7,138
21747,2024-01-16 02:26:00,12,138,Vestuário,1,150
21748,2024-01-16 02:27:00,32,109,Eletrônico,9,141
21749,2024-01-16 02:28:00,92,123,Móvel,1,215
21750,2024-01-16 02:29:00,62,51,Eletrônico,6,113
21751,2024-01-16 02:30:00,48,11,Vestuário,8,59
21752,2024-01-16 02:31:00,62,50,Alimento,7,112
21753,2024-01-16 02:32:00,47,152,Eletrônico,4,199
21754,2024-01-16 02:33:00,26,26,Vestuário,5,52
21755,2024-01-16 02:34:00,103,161,Brinquedo,6,264
21756,2024-01-16 02:35:00,56,173,Eletrônico,4,229
21757,2024-01-16 02:36:00,41,148,Móvel,5,189
21758,2024-01-16 02:37:00,99,110,Eletrônico,2,209
21759,2024-01-16 02:38:00,117,27,Vestuário,2,144
21760,2024-01-16 02:39:00,104,48,Brinquedo,3,152
21761,2024-01-16 02:40:00,45,28,Eletrônico,5,73
21762,2024-01-16 02:41:00,33,30,Alimento,9,63
21763,2024-01-16 02:42:00,41,100,Vestuário,9,141
21764,2024-01-16 02:43:00,57,69,Móvel,4,126
21765,2024-01-16 02:44:00,77,133,Alimento,3,210
21766,2024-01-16 02:45:00,46,62,Brinquedo,1,108
21767,2024-01-16 02:46:00,77,47,Brinquedo,1,124
21768,2024-01-16 02:47:00,17,78,Alimento,5,95
21769,2024-01-16 02:48:00,56,85,Móvel,4,141
21770,2024-01-16 02:49:00,71,14,Vestuário,7,85
21771,2024-01-16 02:50:00,45,119,Brinquedo,9,164
21772,2024-01-16 02:51:00,20,54,Eletrônico,4,74
21773,2024-01-16 02:52:00,66,16,Móvel,4,82
21774,2024-01-16 02:53:00,82,58,Brinquedo,1,140
21775,2024-01-16 02:54:00,69,61,Brinquedo,3,130
21776,2024-01-16 02:55:00,56,96,Móvel,1,152
21777,2024-01-16 02:56:00,34,99,Vestuário,2,133
21778,2024-01-16 02:57:00,59,63,Alimento,7,122
21779,2024-01-16 02:58:00,45,143,Alimento,4,188
21780,2024-01-16 02:59:00,63,73,Brinquedo,9,136
21781,2024-01-16 03:00:00,108,121,Vestuário,2,229
21782,2024-01-16 03:01:00,107,59,Vestuário,8,166
21783,2024-01-16 03:02:00,58,103,Eletrônico,9,161
21784,2024-01-16 03:03:00,37,119,Eletrônico,9,156
21785,2024-01-16 03:04:00,81,23,Alimento,9,104
21786,2024-01-16 03:05:00,101,109,Eletrônico,2,210
21787,2024-01-16 03:06:00,113,116,Alimento,7,229
21788,2024-01-16 03:07:00,60,152,Alimento,9,212
21789,2024-01-16 03:08:00,34,127,Vestuário,5,161
21790,2024-01-16 03:09:00,38,90,Móvel,8,128
21791,2024-01-16 03:10:00,55,41,Brinquedo,3,96
21792,2024-01-16 03:11:00,67,71,Brinquedo,7,138
21793,2024-01-16 03:12:00,89,92,Vestuário,5,181
21794,2024-01-16 03:13:00,114,170,Vestuário,9,284
21795,2024-01-16 03:14:00,81,129,Alimento,1,210
21796,2024-01-16 03:15:00,29,44,Móvel,3,73
21797,2024-01-16 03:16:00,48,151,Móvel,2,199
21798,2024-01-16 03:17:00,81,95,Alimento,3,176
21799,2024-01-16 03:18:00,80,94,Vestuário,4,174
21800,2024-01-16 03:19:00,86,85,Brinquedo,7,171
21801,2024-01-16 03:20:00,49,69,Vestuário,2,118
21802,2024-01-16 03:21:00,111,48,Vestuário,8,159
21803,2024-01-16 03:22:00,44,77,Vestuário,4,121
21804,2024-01-16 03:23:00,71,153,Alimento,6,224
21805,2024-01-16 03:24:00,69,49,Alimento,2,118
21806,2024-01-16 03:25:00,26,56,Vestuário,3,82
21807,2024-01-16 03:26:00,46,18,Vestuário,1,64
21808,2024-01-16 03:27:00,39,66,Eletrônico,6,105
21809,2024-01-16 03:28:00,59,177,Eletrônico,9,236
21810,2024-01-16 03:29:00,38,108,Vestuário,6,146
21811,2024-01-16 03:30:00,97,156,Brinquedo,9,253
21812,2024-01-16 03:31:00,115,15,Brinquedo,9,130
21813,2024-01-16 03:32:00,30,36,Alimento,8,66
21814,2024-01-16 03:33:00,37,74,Alimento,9,111
21815,2024-01-16 03:34:00,115,56,Alimento,3,171
21816,2024-01-16 03:35:00,95,147,Móvel,7,242
21817,2024-01-16 03:36:00,26,54,Eletrônico,1,80
21818,2024-01-16 03:37:00,39,112,Móvel,7,151
21819,2024-01-16 03:38:00,92,57,Eletrônico,3,149
21820,2024-01-16 03:39:00,15,85,Vestuário,2,100
21821,2024-01-16 03:40:00,43,67,Móvel,2,110
21822,2024-01-16 03:41:00,28,74,Brinquedo,5,102
21823,2024-01-16 03:42:00,73,147,Brinquedo,3,220
21824,2024-01-16 03:43:00,79,65,Eletrônico,3,144
21825,2024-01-16 03:44:00,71,119,Alimento,5,190
21826,2024-01-16 03:45:00,12,169,Brinquedo,6,181
21827,2024-01-16 03:46:00,103,64,Vestuário,6,167
21828,2024-01-16 03:47:00,18,62,Alimento,4,80
21829,2024-01-16 03:48:00,108,176,Alimento,8,284
21830,2024-01-16 03:49:00,119,113,Eletrônico,4,232
21831,2024-01-16 03:50:00,113,57,Alimento,1,170
21832,2024-01-16 03:51:00,96,75,Brinquedo,3,171
21833,2024-01-16 03:52:00,44,136,Alimento,1,180
21834,2024-01-16 03:53:00,30,38,Alimento,1,68
21835,2024-01-16 03:54:00,83,35,Eletrônico,5,118
21836,2024-01-16 03:55:00,75,11,Alimento,5,86
21837,2024-01-16 03:56:00,76,110,Móvel,2,186
21838,2024-01-16 03:57:00,25,108,Eletrônico,8,133
21839,2024-01-16 03:58:00,62,66,Brinquedo,9,128
21840,2024-01-16 03:59:00,24,27,Brinquedo,3,51
21841,2024-01-16 04:00:00,38,117,Vestuário,8,155
21842,2024-01-16 04:01:00,74,100,Móvel,2,174
21843,2024-01-16 04:02:00,61,162,Vestuário,8,223
21844,2024-01-16 04:03:00,16,93,Brinquedo,4,109
21845,2024-01-16 04:04:00,82,54,Brinquedo,7,136
21846,2024-01-16 04:05:00,67,118,Eletrônico,1,185
21847,2024-01-16 04:06:00,112,86,Alimento,7,198
21848,2024-01-16 04:07:00,62,149,Alimento,4,211
21849,2024-01-16 04:08:00,29,75,Brinquedo,5,104
21850,2024-01-16 04:09:00,67,120,Brinquedo,4,187
21851,2024-01-16 04:10:00,79,49,Eletrônico,6,128
21852,2024-01-16 04:11:00,79,119,Eletrônico,2,198
21853,2024-01-16 04:12:00,88,50,Móvel,7,138
21854,2024-01-16 04:13:00,101,148,Eletrônico,3,249
21855,2024-01-16 04:14:00,93,63,Alimento,5,156
21856,2024-01-16 04:15:00,91,32,Eletrônico,9,123
21857,2024-01-16 04:16:00,17,154,Brinquedo,5,171
21858,2024-01-16 04:17:00,26,141,Alimento,9,167
21859,2024-01-16 04:18:00,58,158,Móvel,3,216
21860,2024-01-16 04:19:00,42,82,Brinquedo,7,124
21861,2024-01-16 04:20:00,42,66,Alimento,7,108
21862,2024-01-16 04:21:00,60,72,Vestuário,8,132
21863,2024-01-16 04:22:00,107,80,Vestuário,3,187
21864,2024-01-16 04:23:00,17,45,Alimento,1,62
21865,2024-01-16 04:24:00,72,144,Alimento,4,216
21866,2024-01-16 04:25:00,101,33,Móvel,5,134
21867,2024-01-16 04:26:00,96,159,Brinquedo,7,255
21868,2024-01-16 04:27:00,49,23,Vestuário,8,72
21869,2024-01-16 04:28:00,37,96,Vestuário,6,133
21870,2024-01-16 04:29:00,54,88,Móvel,4,142
21871,2024-01-16 04:30:00,65,34,Móvel,5,99
21872,2024-01-16 04:31:00,45,72,Móvel,1,117
21873,2024-01-16 04:32:00,10,85,Alimento,9,95
21874,2024-01-16 04:33:00,51,100,Vestuário,6,151
21875,2024-01-16 04:34:00,31,102,Vestuário,6,133
21876,2024-01-16 04:35:00,12,23,Eletrônico,8,35
21877,2024-01-16 04:36:00,99,24,Alimento,5,123
21878,2024-01-16 04:37:00,118,73,Brinquedo,7,191
21879,2024-01-16 04:38:00,83,125,Móvel,6,208
21880,2024-01-16 04:39:00,59,51,Vestuário,5,110
21881,2024-01-16 04:40:00,91,171,Vestuário,9,262
21882,2024-01-16 04:41:00,79,67,Móvel,1,146
21883,2024-01-16 04:42:00,97,60,Alimento,4,157
21884,2024-01-16 04:43:00,64,73,Eletrônico,7,137
21885,2024-01-16 04:44:00,48,46,Brinquedo,7,94
21886,2024-01-16 04:45:00,90,90,Eletrônico,4,180
21887,2024-01-16 04:46:00,96,148,Brinquedo,9,244
21888,2024-01-16 04:47:00,40,49,Alimento,7,89
21889,2024-01-16 04:48:00,115,168,Vestuário,5,283
21890,2024-01-16 04:49:00,34,14,Vestuário,9,48
21891,2024-01-16 04:50:00,91,32,Eletrônico,5,123
21892,2024-01-16 04:51:00,79,93,Alimento,6,172
21893,2024-01-16 04:52:00,69,64,Vestuário,8,133
21894,2024-01-16 04:53:00,90,155,Vestuário,9,245
21895,2024-01-16 04:54:00,106,92,Vestuário,1,198
21896,2024-01-16 04:55:00,58,130,Alimento,8,188
21897,2024-01-16 04:56:00,44,149,Alimento,7,193
21898,2024-01-16 04:57:00,116,146,Eletrônico,2,262
21899,2024-01-16 04:58:00,46,12,Alimento,9,58
21900,2024-01-16 04:59:00,86,160,Vestuário,7,246
21901,2024-01-16 05:00:00,114,19,Brinquedo,1,133
21902,2024-01-16 05:01:00,64,99,Alimento,2,163
21903,2024-01-16 05:02:00,68,79,Brinquedo,1,147
21904,2024-01-16 05:03:00,14,92,Eletrônico,2,106
21905,2024-01-16 05:04:00,16,82,Alimento,3,98
21906,2024-01-16 05:05:00,100,62,Brinquedo,6,162
21907,2024-01-16 05:06:00,36,90,Eletrônico,1,126
21908,2024-01-16 05:07:00,114,147,Eletrônico,2,261
21909,2024-01-16 05:08:00,22,109,Alimento,6,131
21910,2024-01-16 05:09:00,33,115,Eletrônico,3,148
21911,2024-01-16 05:10:00,32,10,Alimento,9,42
21912,2024-01-16 05:11:00,33,114,Móvel,8,147
21913,2024-01-16 05:12:00,76,80,Vestuário,7,156
21914,2024-01-16 05:13:00,42,64,Eletrônico,3,106
21915,2024-01-16 05:14:00,96,39,Móvel,1,135
21916,2024-01-16 05:15:00,59,167,Brinquedo,9,226
21917,2024-01-16 05:16:00,65,106,Brinquedo,9,171
21918,2024-01-16 05:17:00,44,167,Eletrônico,2,211
21919,2024-01-16 05:18:00,56,136,Brinquedo,3,192
21920,2024-01-16 05:19:00,49,40,Móvel,3,89
21921,2024-01-16 05:20:00,63,51,Brinquedo,6,114
21922,2024-01-16 05:21:00,39,88,Móvel,6,127
21923,2024-01-16 05:22:00,86,155,Alimento,7,241
21924,2024-01-16 05:23:00,55,20,Eletrônico,6,75
21925,2024-01-16 05:24:00,37,83,Vestuário,5,120
21926,2024-01-16 05:25:00,57,41,Brinquedo,8,98
21927,2024-01-16 05:26:00,50,35,Alimento,5,85
21928,2024-01-16 05:27:00,64,178,Móvel,7,242
21929,2024-01-16 05:28:00,55,138,Móvel,3,193
21930,2024-01-16 05:29:00,46,28,Alimento,3,74
21931,2024-01-16 05:30:00,63,48,Móvel,1,111
21932,2024-01-16 05:31:00,53,173,Vestuário,9,226
21933,2024-01-16 05:32:00,58,37,Brinquedo,6,95
21934,2024-01-16 05:33:00,98,86,Alimento,6,184
21935,2024-01-16 05:34:00,114,125,Móvel,5,239
21936,2024-01-16 05:35:00,42,139,Brinquedo,3,181
21937,2024-01-16 05:36:00,21,52,Vestuário,7,73
21938,2024-01-16 05:37:00,87,117,Móvel,4,204
21939,2024-01-16 05:38:00,28,140,Móvel,1,168
21940,2024-01-16 05:39:00,83,84,Móvel,5,167
21941,2024-01-16 05:40:00,62,115,Eletrônico,8,177
21942,2024-01-16 05:41:00,63,55,Vestuário,9,118
21943,2024-01-16 05:42:00,11,16,Vestuário,6,27
21944,2024-01-16 05:43:00,110,80,Brinquedo,7,190
21945,2024-01-16 05:44:00,78,135,Móvel,6,213
21946,2024-01-16 05:45:00,70,69,Vestuário,7,139
21947,2024-01-16 05:46:00,115,19,Brinquedo,2,134
21948,2024-01-16 05:47:00,97,109,Eletrônico,6,206
21949,2024-01-16 05:48:00,86,49,Vestuário,6,135
21950,2024-01-16 05:49:00,82,27,Eletrônico,4,109
21951,2024-01-16 05:50:00,51,26,Eletrônico,4,77
21952,2024-01-16 05:51:00,115,14,Alimento,5,129
21953,2024-01-16 05:52:00,98,126,Alimento,2,224
21954,2024-01-16 05:53:00,17,30,Brinquedo,6,47
21955,2024-01-16 05:54:00,14,95,Móvel,9,109
21956,2024-01-16 05:55:00,30,161,Brinquedo,6,191
21957,2024-01-16 05:56:00,105,130,Brinquedo,9,235
21958,2024-01-16 05:57:00,75,111,Móvel,2,186
21959,2024-01-16 05:58:00,32,143,Eletrônico,3,175
21960,2024-01-16 05:59:00,106,113,Alimento,5,219
21961,2024-01-16 06:00:00,87,58,Eletrônico,1,145
21962,2024-01-16 06:01:00,61,135,Móvel,2,196
21963,2024-01-16 06:02:00,117,107,Móvel,6,224
21964,2024-01-16 06:03:00,41,21,Eletrônico,5,62
21965,2024-01-16 06:04:00,20,41,Alimento,3,61
21966,2024-01-16 06:05:00,11,49,Brinquedo,3,60
21967,2024-01-16 06:06:00,68,176,Alimento,7,244
21968,2024-01-16 06:07:00,11,115,Brinquedo,1,126
21969,2024-01-16 06:08:00,14,148,Brinquedo,8,162
21970,2024-01-16 06:09:00,79,102,Eletrônico,6,181
21971,2024-01-16 06:10:00,58,135,Brinquedo,9,193
21972,2024-01-16 06:11:00,28,119,Brinquedo,1,147
21973,2024-01-16 06:12:00,58,157,Eletrônico,1,215
21974,2024-01-16 06:13:00,92,165,Brinquedo,8,257
21975,2024-01-16 06:14:00,112,139,Brinquedo,6,251
21976,2024-01-16 06:15:00,100,110,Eletrônico,4,210
21977,2024-01-16 06:16:00,15,56,Alimento,7,71
21978,2024-01-16 06:17:00,86,30,Eletrônico,7,116
21979,2024-01-16 06:18:00,73,179,Alimento,5,252
21980,2024-01-16 06:19:00,67,46,Vestuário,5,113
21981,2024-01-16 06:20:00,90,85,Alimento,2,175
21982,2024-01-16 06:21:00,36,63,Vestuário,2,99
21983,2024-01-16 06:22:00,72,14,Brinquedo,4,86
21984,2024-01-16 06:23:00,98,22,Alimento,3,120
21985,2024-01-16 06:24:00,97,96,Vestuário,3,193
21986,2024-01-16 06:25:00,36,54,Vestuário,3,90
21987,2024-01-16 06:26:00,19,147,Móvel,7,166
21988,2024-01-16 06:27:00,28,28,Alimento,9,56
21989,2024-01-16 06:28:00,84,177,Móvel,7,261
21990,2024-01-16 06:29:00,91,20,Eletrônico,4,111
21991,2024-01-16 06:30:00,13,160,Móvel,6,173
21992,2024-01-16 06:31:00,85,96,Móvel,4,181
21993,2024-01-16 06:32:00,34,41,Eletrônico,6,75
21994,2024-01-16 06:33:00,112,56,Vestuário,3,168
21995,2024-01-16 06:34:00,29,124,Alimento,8,153
21996,2024-01-16 06:35:00,115,48,Móvel,1,163
21997,2024-01-16 06:36:00,117,130,Brinquedo,4,247
21998,2024-01-16 06:37:00,83,72,Brinquedo,8,155
21999,2024-01-16 06:38:00,24,73,Brinquedo,3,97
22000,2024-01-16 06:39:00,32,31,Brinquedo,5,63
22001,2024-01-16 06:40:00,13,99,Brinquedo,8,112
22002,2024-01-16 06:41:00,111,100,Móvel,8,211
22003,2024-01-16 06:42:00,27,70,Eletrônico,7,97
22004,2024-01-16 06:43:00,94,135,Brinquedo,5,229
22005,2024-01-16 06:44:00,57,127,Móvel,9,184
22006,2024-01-16 06:45:00,34,19,Brinquedo,7,53
22007,2024-01-16 06:46:00,21,100,Vestuário,5,121
22008,2024-01-16 06:47:00,18,152,Móvel,8,170
22009,2024-01-16 06:48:00,81,124,Eletrônico,1,205
22010,2024-01-16 06:49:00,61,132,Alimento,3,193
22011,2024-01-16 06:50:00,106,153,Brinquedo,9,259
22012,2024-01-16 06:51:00,73,97,Alimento,6,170
22013,2024-01-16 06:52:00,42,49,Alimento,2,91
22014,2024-01-16 06:53:00,12,11,Móvel,8,23
22015,2024-01-16 06:54:00,54,33,Vestuário,2,87
22016,2024-01-16 06:55:00,11,174,Alimento,9,185
22017,2024-01-16 06:56:00,54,21,Eletrônico,1,75
22018,2024-01-16 06:57:00,30,120,Eletrônico,6,150
22019,2024-01-16 06:58:00,117,49,Eletrônico,5,166
22020,2024-01-16 06:59:00,87,115,Móvel,2,202
22021,2024-01-16 07:00:00,85,126,Alimento,4,211
22022,2024-01-16 07:01:00,47,27,Eletrônico,7,74
22023,2024-01-16 07:02:00,68,155,Vestuário,6,223
22024,2024-01-16 07:03:00,83,129,Alimento,7,212
22025,2024-01-16 07:04:00,49,158,Alimento,7,207
22026,2024-01-16 07:05:00,69,109,Alimento,5,178
22027,2024-01-16 07:06:00,89,137,Eletrônico,5,226
22028,2024-01-16 07:07:00,30,78,Móvel,3,108
22029,2024-01-16 07:08:00,55,105,Alimento,5,160
22030,2024-01-16 07:09:00,28,158,Vestuário,1,186
22031,2024-01-16 07:10:00,104,145,Brinquedo,9,249
22032,2024-01-16 07:11:00,115,158,Vestuário,5,273
22033,2024-01-16 07:12:00,116,21,Móvel,4,137
22034,2024-01-16 07:13:00,91,128,Alimento,3,219
22035,2024-01-16 07:14:00,74,151,Alimento,7,225
22036,2024-01-16 07:15:00,25,10,Móvel,1,35
22037,2024-01-16 07:16:00,66,70,Móvel,2,136
22038,2024-01-16 07:17:00,64,112,Móvel,1,176
22039,2024-01-16 07:18:00,59,177,Alimento,8,236
22040,2024-01-16 07:19:00,41,45,Eletrônico,5,86
22041,2024-01-16 07:20:00,88,59,Móvel,2,147
22042,2024-01-16 07:21:00,78,47,Eletrônico,2,125
22043,2024-01-16 07:22:00,20,25,Vestuário,3,45
22044,2024-01-16 07:23:00,75,87,Brinquedo,3,162
22045,2024-01-16 07:24:00,84,11,Alimento,4,95
22046,2024-01-16 07:25:00,75,140,Brinquedo,3,215
22047,2024-01-16 07:26:00,67,31,Alimento,9,98
22048,2024-01-16 07:27:00,55,37,Vestuário,5,92
22049,2024-01-16 07:28:00,48,48,Móvel,1,96
22050,2024-01-16 07:29:00,28,60,Eletrônico,4,88
22051,2024-01-16 07:30:00,82,52,Alimento,8,134
22052,2024-01-16 07:31:00,52,134,Vestuário,5,186
22053,2024-01-16 07:32:00,14,153,Brinquedo,5,167
22054,2024-01-16 07:33:00,15,10,Eletrônico,6,25
22055,2024-01-16 07:34:00,41,92,Alimento,8,133
22056,2024-01-16 07:35:00,35,38,Eletrônico,2,73
22057,2024-01-16 07:36:00,63,14,Brinquedo,5,77
22058,2024-01-16 07:37:00,119,23,Brinquedo,6,142
22059,2024-01-16 07:38:00,74,145,Alimento,8,219
22060,2024-01-16 07:39:00,72,50,Eletrônico,4,122
22061,2024-01-16 07:40:00,107,23,Vestuário,7,130
22062,2024-01-16 07:41:00,34,128,Eletrônico,4,162
22063,2024-01-16 07:42:00,10,68,Móvel,5,78
22064,2024-01-16 07:43:00,63,47,Móvel,3,110
22065,2024-01-16 07:44:00,23,106,Brinquedo,1,129
22066,2024-01-16 07:45:00,25,174,Brinquedo,4,199
22067,2024-01-16 07:46:00,69,119,Vestuário,7,188
22068,2024-01-16 07:47:00,71,171,Vestuário,3,242
22069,2024-01-16 07:48:00,78,39,Alimento,4,117
22070,2024-01-16 07:49:00,21,117,Brinquedo,1,138
22071,2024-01-16 07:50:00,118,54,Brinquedo,9,172
22072,2024-01-16 07:51:00,20,159,Alimento,8,179
22073,2024-01-16 07:52:00,49,136,Vestuário,1,185
22074,2024-01-16 07:53:00,10,116,Vestuário,8,126
22075,2024-01-16 07:54:00,18,114,Eletrônico,5,132
22076,2024-01-16 07:55:00,72,115,Alimento,9,187
22077,2024-01-16 07:56:00,18,99,Alimento,8,117
22078,2024-01-16 07:57:00,46,32,Brinquedo,5,78
22079,2024-01-16 07:58:00,12,100,Vestuário,1,112
22080,2024-01-16 07:59:00,107,158,Eletrônico,6,265
22081,2024-01-16 08:00:00,12,65,Móvel,2,77
22082,2024-01-16 08:01:00,84,112,Brinquedo,4,196
22083,2024-01-16 08:02:00,60,51,Vestuário,8,111
22084,2024-01-16 08:03:00,17,165,Vestuário,5,182
22085,2024-01-16 08:04:00,25,179,Vestuário,9,204
22086,2024-01-16 08:05:00,119,57,Eletrônico,1,176
22087,2024-01-16 08:06:00,82,83,Móvel,6,165
22088,2024-01-16 08:07:00,109,146,Brinquedo,9,255
22089,2024-01-16 08:08:00,14,163,Brinquedo,3,177
22090,2024-01-16 08:09:00,77,101,Eletrônico,7,178
22091,2024-01-16 08:10:00,19,163,Vestuário,4,182
22092,2024-01-16 08:11:00,23,44,Eletrônico,2,67
22093,2024-01-16 08:12:00,113,70,Alimento,5,183
22094,2024-01-16 08:13:00,13,173,Vestuário,7,186
22095,2024-01-16 08:14:00,110,18,Vestuário,8,128
22096,2024-01-16 08:15:00,78,23,Vestuário,4,101
22097,2024-01-16 08:16:00,27,52,Brinquedo,7,79
22098,2024-01-16 08:17:00,52,41,Vestuário,6,93
22099,2024-01-16 08:18:00,113,133,Eletrônico,8,246
22100,2024-01-16 08:19:00,22,13,Móvel,9,35
22101,2024-01-16 08:20:00,111,66,Eletrônico,8,177
22102,2024-01-16 08:21:00,31,20,Brinquedo,6,51
22103,2024-01-16 08:22:00,55,50,Móvel,8,105
22104,2024-01-16 08:23:00,79,159,Eletrônico,1,238
22105,2024-01-16 08:24:00,39,94,Brinquedo,4,133
22106,2024-01-16 08:25:00,74,64,Eletrônico,4,138
22107,2024-01-16 08:26:00,84,121,Móvel,7,205
22108,2024-01-16 08:27:00,28,77,Brinquedo,1,105
22109,2024-01-16 08:28:00,69,44,Móvel,7,113
22110,2024-01-16 08:29:00,113,169,Brinquedo,2,282
22111,2024-01-16 08:30:00,112,35,Eletrônico,6,147
22112,2024-01-16 08:31:00,111,131,Eletrônico,8,242
22113,2024-01-16 08:32:00,60,116,Brinquedo,4,176
22114,2024-01-16 08:33:00,106,21,Alimento,9,127
22115,2024-01-16 08:34:00,17,156,Brinquedo,4,173
22116,2024-01-16 08:35:00,80,155,Alimento,2,235
22117,2024-01-16 08:36:00,82,72,Alimento,3,154
22118,2024-01-16 08:37:00,117,112,Móvel,4,229
22119,2024-01-16 08:38:00,10,61,Eletrônico,9,71
22120,2024-01-16 08:39:00,66,96,Eletrônico,5,162
22121,2024-01-16 08:40:00,55,136,Vestuário,1,191
22122,2024-01-16 08:41:00,68,57,Alimento,9,125
22123,2024-01-16 08:42:00,37,56,Móvel,1,93
22124,2024-01-16 08:43:00,60,80,Eletrônico,4,140
22125,2024-01-16 08:44:00,12,48,Vestuário,3,60
22126,2024-01-16 08:45:00,17,123,Alimento,4,140
22127,2024-01-16 08:46:00,63,104,Eletrônico,6,167
22128,2024-01-16 08:47:00,71,127,Eletrônico,1,198
22129,2024-01-16 08:48:00,72,82,Brinquedo,1,154
22130,2024-01-16 08:49:00,88,106,Brinquedo,6,194
22131,2024-01-16 08:50:00,82,78,Eletrônico,9,160
22132,2024-01-16 08:51:00,55,36,Alimento,6,91
22133,2024-01-16 08:52:00,97,12,Vestuário,1,109
22134,2024-01-16 08:53:00,114,32,Brinquedo,3,146
22135,2024-01-16 08:54:00,107,56,Móvel,1,163
22136,2024-01-16 08:55:00,119,141,Brinquedo,4,260
22137,2024-01-16 08:56:00,31,47,Móvel,1,78
22138,2024-01-16 08:57:00,15,108,Vestuário,3,123
22139,2024-01-16 08:58:00,67,42,Alimento,2,109
22140,2024-01-16 08:59:00,85,149,Vestuário,6,234
22141,2024-01-16 09:00:00,19,178,Móvel,6,197
22142,2024-01-16 09:01:00,103,157,Eletrônico,3,260
22143,2024-01-16 09:02:00,118,160,Vestuário,5,278
22144,2024-01-16 09:03:00,79,166,Vestuário,9,245
22145,2024-01-16 09:04:00,11,89,Móvel,5,100
22146,2024-01-16 09:05:00,93,62,Alimento,5,155
22147,2024-01-16 09:06:00,68,130,Móvel,1,198
22148,2024-01-16 09:07:00,70,32,Brinquedo,3,102
22149,2024-01-16 09:08:00,70,36,Móvel,7,106
22150,2024-01-16 09:09:00,10,158,Alimento,6,168
22151,2024-01-16 09:10:00,49,79,Alimento,2,128
22152,2024-01-16 09:11:00,62,52,Vestuário,2,114
22153,2024-01-16 09:12:00,80,41,Vestuário,1,121
22154,2024-01-16 09:13:00,78,163,Móvel,3,241
22155,2024-01-16 09:14:00,109,160,Alimento,4,269
22156,2024-01-16 09:15:00,28,65,Eletrônico,9,93
22157,2024-01-16 09:16:00,93,88,Móvel,3,181
22158,2024-01-16 09:17:00,105,125,Alimento,9,230
22159,2024-01-16 09:18:00,34,80,Brinquedo,2,114
22160,2024-01-16 09:19:00,63,158,Alimento,4,221
22161,2024-01-16 09:20:00,118,127,Brinquedo,3,245
22162,2024-01-16 09:21:00,114,172,Eletrônico,5,286
22163,2024-01-16 09:22:00,119,91,Eletrônico,1,210
22164,2024-01-16 09:23:00,40,54,Eletrônico,6,94
22165,2024-01-16 09:24:00,35,36,Eletrônico,8,71
22166,2024-01-16 09:25:00,94,68,Alimento,5,162
22167,2024-01-16 09:26:00,15,107,Alimento,5,122
22168,2024-01-16 09:27:00,111,66,Brinquedo,7,177
22169,2024-01-16 09:28:00,14,57,Vestuário,3,71
22170,2024-01-16 09:29:00,104,136,Eletrônico,9,240
22171,2024-01-16 09:30:00,106,152,Vestuário,5,258
22172,2024-01-16 09:31:00,83,26,Eletrônico,4,109
22173,2024-01-16 09:32:00,110,105,Móvel,4,215
22174,2024-01-16 09:33:00,37,156,Alimento,1,193
22175,2024-01-16 09:34:00,78,47,Alimento,9,125
22176,2024-01-16 09:35:00,75,31,Alimento,2,106
22177,2024-01-16 09:36:00,51,116,Alimento,7,167
22178,2024-01-16 09:37:00,76,75,Vestuário,9,151
22179,2024-01-16 09:38:00,97,34,Alimento,5,131
22180,2024-01-16 09:39:00,89,135,Vestuário,9,224
22181,2024-01-16 09:40:00,70,125,Eletrônico,4,195
22182,2024-01-16 09:41:00,34,108,Vestuário,4,142
22183,2024-01-16 09:42:00,103,53,Brinquedo,1,156
22184,2024-01-16 09:43:00,32,177,Alimento,9,209
22185,2024-01-16 09:44:00,102,63,Vestuário,9,165
22186,2024-01-16 09:45:00,109,100,Alimento,2,209
22187,2024-01-16 09:46:00,84,69,Eletrônico,5,153
22188,2024-01-16 09:47:00,15,131,Alimento,7,146
22189,2024-01-16 09:48:00,49,45,Eletrônico,7,94
22190,2024-01-16 09:49:00,45,30,Brinquedo,7,75
22191,2024-01-16 09:50:00,28,28,Eletrônico,9,56
22192,2024-01-16 09:51:00,49,63,Alimento,7,112
22193,2024-01-16 09:52:00,14,62,Móvel,4,76
22194,2024-01-16 09:53:00,68,111,Alimento,3,179
22195,2024-01-16 09:54:00,50,122,Brinquedo,3,172
22196,2024-01-16 09:55:00,92,77,Vestuário,3,169
22197,2024-01-16 09:56:00,85,154,Móvel,9,239
22198,2024-01-16 09:57:00,17,47,Eletrônico,5,64
22199,2024-01-16 09:58:00,97,26,Brinquedo,5,123
22200,2024-01-16 09:59:00,11,63,Vestuário,9,74
22201,2024-01-16 10:00:00,47,18,Brinquedo,1,65
22202,2024-01-16 10:01:00,113,21,Alimento,9,134
22203,2024-01-16 10:02:00,105,38,Eletrônico,6,143
22204,2024-01-16 10:03:00,20,111,Alimento,2,131
22205,2024-01-16 10:04:00,11,159,Móvel,7,170
22206,2024-01-16 10:05:00,70,173,Vestuário,4,243
22207,2024-01-16 10:06:00,16,108,Eletrônico,5,124
22208,2024-01-16 10:07:00,110,47,Móvel,8,157
22209,2024-01-16 10:08:00,53,62,Vestuário,8,115
22210,2024-01-16 10:09:00,44,166,Vestuário,9,210
22211,2024-01-16 10:10:00,64,179,Brinquedo,6,243
22212,2024-01-16 10:11:00,74,110,Alimento,2,184
22213,2024-01-16 10:12:00,66,173,Eletrônico,3,239
22214,2024-01-16 10:13:00,114,107,Alimento,1,221
22215,2024-01-16 10:14:00,28,67,Brinquedo,1,95
22216,2024-01-16 10:15:00,65,71,Eletrônico,6,136
22217,2024-01-16 10:16:00,71,169,Móvel,8,240
22218,2024-01-16 10:17:00,19,40,Móvel,6,59
22219,2024-01-16 10:18:00,92,59,Alimento,2,151
22220,2024-01-16 10:19:00,40,21,Eletrônico,9,61
22221,2024-01-16 10:20:00,107,163,Eletrônico,5,270
22222,2024-01-16 10:21:00,82,92,Eletrônico,1,174
22223,2024-01-16 10:22:00,111,148,Alimento,1,259
22224,2024-01-16 10:23:00,77,67,Eletrônico,8,144
22225,2024-01-16 10:24:00,109,64,Móvel,4,173
22226,2024-01-16 10:25:00,97,75,Móvel,3,172
22227,2024-01-16 10:26:00,89,55,Móvel,4,144
22228,2024-01-16 10:27:00,80,38,Móvel,2,118
22229,2024-01-16 10:28:00,39,178,Vestuário,8,217
22230,2024-01-16 10:29:00,87,138,Móvel,1,225
22231,2024-01-16 10:30:00,27,116,Brinquedo,5,143
22232,2024-01-16 10:31:00,62,134,Brinquedo,1,196
22233,2024-01-16 10:32:00,66,87,Brinquedo,7,153
22234,2024-01-16 10:33:00,10,179,Eletrônico,8,189
22235,2024-01-16 10:34:00,99,91,Móvel,8,190
22236,2024-01-16 10:35:00,65,173,Vestuário,2,238
22237,2024-01-16 10:36:00,13,69,Vestuário,6,82
22238,2024-01-16 10:37:00,54,83,Alimento,6,137
22239,2024-01-16 10:38:00,44,43,Móvel,5,87
22240,2024-01-16 10:39:00,73,30,Alimento,2,103
22241,2024-01-16 10:40:00,69,43,Brinquedo,8,112
22242,2024-01-16 10:41:00,22,30,Alimento,1,52
22243,2024-01-16 10:42:00,40,23,Brinquedo,5,63
22244,2024-01-16 10:43:00,77,163,Eletrônico,7,240
22245,2024-01-16 10:44:00,74,174,Brinquedo,8,248
22246,2024-01-16 10:45:00,116,73,Brinquedo,8,189
22247,2024-01-16 10:46:00,116,66,Vestuário,4,182
22248,2024-01-16 10:47:00,114,156,Alimento,1,270
22249,2024-01-16 10:48:00,113,105,Eletrônico,3,218
22250,2024-01-16 10:49:00,115,120,Brinquedo,7,235
22251,2024-01-16 10:50:00,70,83,Eletrônico,1,153
22252,2024-01-16 10:51:00,98,146,Eletrônico,7,244
22253,2024-01-16 10:52:00,118,154,Móvel,8,272
22254,2024-01-16 10:53:00,74,116,Eletrônico,2,190
22255,2024-01-16 10:54:00,20,44,Móvel,7,64
22256,2024-01-16 10:55:00,112,27,Eletrônico,4,139
22257,2024-01-16 10:56:00,99,122,Brinquedo,3,221
22258,2024-01-16 10:57:00,10,30,Brinquedo,8,40
22259,2024-01-16 10:58:00,85,41,Eletrônico,2,126
22260,2024-01-16 10:59:00,82,157,Brinquedo,1,239
22261,2024-01-16 11:00:00,29,66,Vestuário,7,95
22262,2024-01-16 11:01:00,94,90,Alimento,6,184
22263,2024-01-16 11:02:00,44,15,Móvel,9,59
22264,2024-01-16 11:03:00,115,75,Vestuário,9,190
22265,2024-01-16 11:04:00,85,39,Alimento,5,124
22266,2024-01-16 11:05:00,12,29,Eletrônico,4,41
22267,2024-01-16 11:06:00,86,77,Eletrônico,7,163
22268,2024-01-16 11:07:00,73,31,Brinquedo,3,104
22269,2024-01-16 11:08:00,64,87,Vestuário,1,151
22270,2024-01-16 11:09:00,27,128,Vestuário,9,155
22271,2024-01-16 11:10:00,12,129,Vestuário,8,141
22272,2024-01-16 11:11:00,58,30,Brinquedo,1,88
22273,2024-01-16 11:12:00,95,41,Alimento,8,136
22274,2024-01-16 11:13:00,69,123,Vestuário,5,192
22275,2024-01-16 11:14:00,46,84,Brinquedo,1,130
22276,2024-01-16 11:15:00,18,25,Eletrônico,5,43
22277,2024-01-16 11:16:00,15,146,Brinquedo,8,161
22278,2024-01-16 11:17:00,49,82,Brinquedo,1,131
22279,2024-01-16 11:18:00,72,145,Alimento,4,217
22280,2024-01-16 11:19:00,87,15,Móvel,8,102
22281,2024-01-16 11:20:00,19,140,Vestuário,8,159
22282,2024-01-16 11:21:00,81,67,Brinquedo,7,148
22283,2024-01-16 11:22:00,82,48,Móvel,5,130
22284,2024-01-16 11:23:00,82,59,Móvel,2,141
22285,2024-01-16 11:24:00,79,139,Vestuário,9,218
22286,2024-01-16 11:25:00,65,11,Eletrônico,9,76
22287,2024-01-16 11:26:00,107,39,Eletrônico,7,146
22288,2024-01-16 11:27:00,24,150,Eletrônico,1,174
22289,2024-01-16 11:28:00,102,132,Eletrônico,8,234
22290,2024-01-16 11:29:00,28,132,Vestuário,9,160
22291,2024-01-16 11:30:00,105,176,Eletrônico,4,281
22292,2024-01-16 11:31:00,19,96,Alimento,7,115
22293,2024-01-16 11:32:00,92,80,Alimento,6,172
22294,2024-01-16 11:33:00,42,155,Brinquedo,1,197
22295,2024-01-16 11:34:00,87,108,Brinquedo,7,195
22296,2024-01-16 11:35:00,75,96,Vestuário,7,171
22297,2024-01-16 11:36:00,96,50,Alimento,4,146
22298,2024-01-16 11:37:00,27,60,Eletrônico,5,87
22299,2024-01-16 11:38:00,69,111,Móvel,7,180
22300,2024-01-16 11:39:00,63,68,Alimento,6,131
22301,2024-01-16 11:40:00,86,82,Vestuário,4,168
22302,2024-01-16 11:41:00,11,163,Brinquedo,8,174
22303,2024-01-16 11:42:00,59,42,Eletrônico,5,101
22304,2024-01-16 11:43:00,37,32,Vestuário,7,69
22305,2024-01-16 11:44:00,23,66,Eletrônico,9,89
22306,2024-01-16 11:45:00,95,149,Brinquedo,6,244
22307,2024-01-16 11:46:00,91,79,Eletrônico,9,170
22308,2024-01-16 11:47:00,11,155,Alimento,4,166
22309,2024-01-16 11:48:00,25,115,Brinquedo,6,140
22310,2024-01-16 11:49:00,58,47,Vestuário,8,105
22311,2024-01-16 11:50:00,110,59,Vestuário,4,169
22312,2024-01-16 11:51:00,42,93,Eletrônico,1,135
22313,2024-01-16 11:52:00,35,14,Móvel,4,49
22314,2024-01-16 11:53:00,12,73,Eletrônico,2,85
22315,2024-01-16 11:54:00,13,148,Eletrônico,3,161
22316,2024-01-16 11:55:00,41,147,Móvel,9,188
22317,2024-01-16 11:56:00,104,128,Vestuário,2,232
22318,2024-01-16 11:57:00,42,132,Alimento,9,174
22319,2024-01-16 11:58:00,59,105,Vestuário,6,164
22320,2024-01-16 11:59:00,34,121,Móvel,9,155
22321,2024-01-16 12:00:00,38,111,Alimento,2,149
22322,2024-01-16 12:01:00,104,33,Vestuário,9,137
22323,2024-01-16 12:02:00,59,156,Vestuário,1,215
22324,2024-01-16 12:03:00,63,138,Vestuário,3,201
22325,2024-01-16 12:04:00,118,153,Vestuário,9,271
22326,2024-01-16 12:05:00,119,103,Eletrônico,2,222
22327,2024-01-16 12:06:00,90,169,Vestuário,8,259
22328,2024-01-16 12:07:00,63,28,Eletrônico,9,91
22329,2024-01-16 12:08:00,47,109,Brinquedo,2,156
22330,2024-01-16 12:09:00,51,148,Alimento,3,199
22331,2024-01-16 12:10:00,45,179,Vestuário,1,224
22332,2024-01-16 12:11:00,101,169,Eletrônico,2,270
22333,2024-01-16 12:12:00,52,130,Vestuário,4,182
22334,2024-01-16 12:13:00,107,31,Alimento,9,138
22335,2024-01-16 12:14:00,98,113,Móvel,9,211
22336,2024-01-16 12:15:00,97,47,Eletrônico,6,144
22337,2024-01-16 12:16:00,81,103,Vestuário,7,184
22338,2024-01-16 12:17:00,102,149,Móvel,8,251
22339,2024-01-16 12:18:00,64,12,Brinquedo,6,76
22340,2024-01-16 12:19:00,51,45,Vestuário,9,96
22341,2024-01-16 12:20:00,88,159,Alimento,2,247
22342,2024-01-16 12:21:00,18,27,Alimento,4,45
22343,2024-01-16 12:22:00,32,18,Eletrônico,4,50
22344,2024-01-16 12:23:00,57,140,Eletrônico,8,197
22345,2024-01-16 12:24:00,91,105,Eletrônico,4,196
22346,2024-01-16 12:25:00,19,172,Vestuário,3,191
22347,2024-01-16 12:26:00,67,123,Brinquedo,5,190
22348,2024-01-16 12:27:00,87,100,Alimento,4,187
22349,2024-01-16 12:28:00,99,67,Alimento,5,166
22350,2024-01-16 12:29:00,91,94,Vestuário,8,185
22351,2024-01-16 12:30:00,91,134,Alimento,5,225
22352,2024-01-16 12:31:00,37,122,Móvel,9,159
22353,2024-01-16 12:32:00,13,55,Vestuário,1,68
22354,2024-01-16 12:33:00,60,89,Móvel,2,149
22355,2024-01-16 12:34:00,28,130,Eletrônico,3,158
22356,2024-01-16 12:35:00,52,32,Móvel,5,84
22357,2024-01-16 12:36:00,38,123,Eletrônico,3,161
22358,2024-01-16 12:37:00,30,15,Brinquedo,4,45
22359,2024-01-16 12:38:00,51,28,Alimento,2,79
22360,2024-01-16 12:39:00,45,61,Móvel,3,106
22361,2024-01-16 12:40:00,28,77,Móvel,4,105
22362,2024-01-16 12:41:00,62,24,Vestuário,9,86
22363,2024-01-16 12:42:00,57,172,Alimento,3,229
22364,2024-01-16 12:43:00,91,133,Móvel,1,224
22365,2024-01-16 12:44:00,114,126,Eletrônico,4,240
22366,2024-01-16 12:45:00,86,39,Vestuário,1,125
22367,2024-01-16 12:46:00,67,68,Brinquedo,3,135
22368,2024-01-16 12:47:00,31,102,Eletrônico,3,133
22369,2024-01-16 12:48:00,21,28,Vestuário,8,49
22370,2024-01-16 12:49:00,93,172,Eletrônico,9,265
22371,2024-01-16 12:50:00,78,126,Vestuário,3,204
22372,2024-01-16 12:51:00,67,163,Móvel,5,230
22373,2024-01-16 12:52:00,98,85,Móvel,2,183
22374,2024-01-16 12:53:00,15,16,Eletrônico,7,31
22375,2024-01-16 12:54:00,108,24,Vestuário,1,132
22376,2024-01-16 12:55:00,82,83,Móvel,9,165
22377,2024-01-16 12:56:00,55,90,Alimento,1,145
22378,2024-01-16 12:57:00,42,30,Vestuário,9,72
22379,2024-01-16 12:58:00,117,59,Alimento,6,176
22380,2024-01-16 12:59:00,111,98,Alimento,2,209
22381,2024-01-16 13:00:00,58,162,Vestuário,7,220
22382,2024-01-16 13:01:00,50,93,Vestuário,8,143
22383,2024-01-16 13:02:00,39,159,Vestuário,3,198
22384,2024-01-16 13:03:00,59,106,Móvel,4,165
22385,2024-01-16 13:04:00,50,153,Móvel,4,203
22386,2024-01-16 13:05:00,98,99,Brinquedo,2,197
22387,2024-01-16 13:06:00,35,161,Alimento,1,196
22388,2024-01-16 13:07:00,92,62,Eletrônico,4,154
22389,2024-01-16 13:08:00,30,50,Brinquedo,4,80
22390,2024-01-16 13:09:00,87,10,Alimento,8,97
22391,2024-01-16 13:10:00,84,62,Eletrônico,6,146
22392,2024-01-16 13:11:00,104,72,Brinquedo,3,176
22393,2024-01-16 13:12:00,57,100,Alimento,2,157
22394,2024-01-16 13:13:00,113,131,Eletrônico,9,244
22395,2024-01-16 13:14:00,98,151,Brinquedo,7,249
22396,2024-01-16 13:15:00,109,43,Brinquedo,8,152
22397,2024-01-16 13:16:00,100,71,Móvel,4,171
22398,2024-01-16 13:17:00,71,100,Eletrônico,7,171
22399,2024-01-16 13:18:00,102,169,Vestuário,4,271
22400,2024-01-16 13:19:00,69,157,Vestuário,6,226
22401,2024-01-16 13:20:00,115,48,Vestuário,2,163
22402,2024-01-16 13:21:00,27,66,Eletrônico,5,93
22403,2024-01-16 13:22:00,102,138,Móvel,9,240
22404,2024-01-16 13:23:00,88,179,Móvel,9,267
22405,2024-01-16 13:24:00,51,101,Vestuário,2,152
22406,2024-01-16 13:25:00,33,29,Eletrônico,2,62
22407,2024-01-16 13:26:00,13,118,Eletrônico,1,131
22408,2024-01-16 13:27:00,48,137,Alimento,5,185
22409,2024-01-16 13:28:00,74,106,Alimento,7,180
22410,2024-01-16 13:29:00,113,126,Brinquedo,7,239
22411,2024-01-16 13:30:00,42,109,Móvel,3,151
22412,2024-01-16 13:31:00,83,157,Eletrônico,8,240
22413,2024-01-16 13:32:00,52,100,Brinquedo,2,152
22414,2024-01-16 13:33:00,79,156,Brinquedo,4,235
22415,2024-01-16 13:34:00,70,153,Brinquedo,5,223
22416,2024-01-16 13:35:00,53,104,Vestuário,2,157
22417,2024-01-16 13:36:00,55,12,Vestuário,2,67
22418,2024-01-16 13:37:00,59,44,Alimento,5,103
22419,2024-01-16 13:38:00,85,67,Eletrônico,5,152
22420,2024-01-16 13:39:00,77,13,Eletrônico,4,90
22421,2024-01-16 13:40:00,117,68,Brinquedo,7,185
22422,2024-01-16 13:41:00,23,29,Alimento,3,52
22423,2024-01-16 13:42:00,58,71,Brinquedo,1,129
22424,2024-01-16 13:43:00,91,179,Eletrônico,3,270
22425,2024-01-16 13:44:00,101,96,Móvel,1,197
22426,2024-01-16 13:45:00,29,56,Vestuário,1,85
22427,2024-01-16 13:46:00,78,137,Brinquedo,5,215
22428,2024-01-16 13:47:00,100,23,Eletrônico,3,123
22429,2024-01-16 13:48:00,99,50,Brinquedo,9,149
22430,2024-01-16 13:49:00,16,127,Alimento,4,143
22431,2024-01-16 13:50:00,41,167,Brinquedo,7,208
22432,2024-01-16 13:51:00,95,172,Brinquedo,5,267
22433,2024-01-16 13:52:00,108,139,Eletrônico,2,247
22434,2024-01-16 13:53:00,105,48,Vestuário,1,153
22435,2024-01-16 13:54:00,111,74,Vestuário,1,185
22436,2024-01-16 13:55:00,109,117,Vestuário,6,226
22437,2024-01-16 13:56:00,35,38,Brinquedo,5,73
22438,2024-01-16 13:57:00,27,117,Alimento,7,144
22439,2024-01-16 13:58:00,40,66,Vestuário,9,106
22440,2024-01-16 13:59:00,28,167,Vestuário,7,195
22441,2024-01-16 14:00:00,40,51,Eletrônico,9,91
22442,2024-01-16 14:01:00,117,160,Brinquedo,1,277
22443,2024-01-16 14:02:00,114,115,Brinquedo,2,229
22444,2024-01-16 14:03:00,55,146,Eletrônico,4,201
22445,2024-01-16 14:04:00,14,13,Móvel,5,27
22446,2024-01-16 14:05:00,88,87,Vestuário,7,175
22447,2024-01-16 14:06:00,56,24,Móvel,4,80
22448,2024-01-16 14:07:00,68,78,Eletrônico,1,146
22449,2024-01-16 14:08:00,20,82,Alimento,8,102
22450,2024-01-16 14:09:00,61,68,Eletrônico,8,129
22451,2024-01-16 14:10:00,68,101,Vestuário,9,169
22452,2024-01-16 14:11:00,86,101,Vestuário,6,187
22453,2024-01-16 14:12:00,73,47,Vestuário,9,120
22454,2024-01-16 14:13:00,56,87,Alimento,2,143
22455,2024-01-16 14:14:00,63,77,Brinquedo,9,140
22456,2024-01-16 14:15:00,20,90,Brinquedo,4,110
22457,2024-01-16 14:16:00,98,104,Móvel,2,202
22458,2024-01-16 14:17:00,117,174,Brinquedo,7,291
22459,2024-01-16 14:18:00,105,14,Móvel,8,119
22460,2024-01-16 14:19:00,66,147,Vestuário,5,213
22461,2024-01-16 14:20:00,108,122,Alimento,2,230
22462,2024-01-16 14:21:00,89,97,Brinquedo,6,186
22463,2024-01-16 14:22:00,94,63,Vestuário,4,157
22464,2024-01-16 14:23:00,76,84,Móvel,4,160
22465,2024-01-16 14:24:00,68,174,Brinquedo,2,242
22466,2024-01-16 14:25:00,42,84,Vestuário,4,126
22467,2024-01-16 14:26:00,40,68,Alimento,6,108
22468,2024-01-16 14:27:00,84,18,Móvel,1,102
22469,2024-01-16 14:28:00,17,36,Alimento,9,53
22470,2024-01-16 14:29:00,64,121,Vestuário,5,185
22471,2024-01-16 14:30:00,52,80,Móvel,5,132
22472,2024-01-16 14:31:00,25,39,Eletrônico,6,64
22473,2024-01-16 14:32:00,24,137,Eletrônico,2,161
22474,2024-01-16 14:33:00,46,178,Móvel,7,224
22475,2024-01-16 14:34:00,116,63,Alimento,7,179
22476,2024-01-16 14:35:00,34,175,Móvel,8,209
22477,2024-01-16 14:36:00,90,77,Eletrônico,2,167
22478,2024-01-16 14:37:00,98,42,Alimento,1,140
22479,2024-01-16 14:38:00,18,10,Móvel,1,28
22480,2024-01-16 14:39:00,100,50,Brinquedo,5,150
22481,2024-01-16 14:40:00,45,10,Móvel,8,55
22482,2024-01-16 14:41:00,41,78,Brinquedo,4,119
22483,2024-01-16 14:42:00,92,44,Vestuário,9,136
22484,2024-01-16 14:43:00,16,155,Eletrônico,5,171
22485,2024-01-16 14:44:00,60,48,Vestuário,3,108
22486,2024-01-16 14:45:00,68,90,Vestuário,9,158
22487,2024-01-16 14:46:00,86,172,Alimento,4,258
22488,2024-01-16 14:47:00,82,80,Alimento,9,162
22489,2024-01-16 14:48:00,72,160,Eletrônico,2,232
22490,2024-01-16 14:49:00,74,136,Vestuário,7,210
22491,2024-01-16 14:50:00,37,11,Alimento,8,48
22492,2024-01-16 14:51:00,40,41,Alimento,9,81
22493,2024-01-16 14:52:00,106,22,Alimento,2,128
22494,2024-01-16 14:53:00,106,87,Brinquedo,5,193
22495,2024-01-16 14:54:00,16,138,Alimento,1,154
22496,2024-01-16 14:55:00,32,138,Vestuário,8,170
22497,2024-01-16 14:56:00,110,42,Eletrônico,6,152
22498,2024-01-16 14:57:00,115,22,Vestuário,5,137
22499,2024-01-16 14:58:00,64,106,Vestuário,4,170
22500,2024-01-16 14:59:00,74,31,Alimento,4,105
22501,2024-01-16 15:00:00,97,120,Móvel,8,217
22502,2024-01-16 15:01:00,114,177,Eletrônico,7,291
22503,2024-01-16 15:02:00,76,95,Alimento,9,171
22504,2024-01-16 15:03:00,108,173,Alimento,6,281
22505,2024-01-16 15:04:00,95,137,Eletrônico,7,232
22506,2024-01-16 15:05:00,111,106,Móvel,7,217
22507,2024-01-16 15:06:00,99,49,Alimento,7,148
22508,2024-01-16 15:07:00,40,90,Vestuário,6,130
22509,2024-01-16 15:08:00,43,154,Móvel,4,197
22510,2024-01-16 15:09:00,34,30,Alimento,7,64
22511,2024-01-16 15:10:00,34,24,Móvel,5,58
22512,2024-01-16 15:11:00,71,117,Vestuário,9,188
22513,2024-01-16 15:12:00,94,100,Móvel,7,194
22514,2024-01-16 15:13:00,76,149,Móvel,5,225
22515,2024-01-16 15:14:00,119,77,Móvel,5,196
22516,2024-01-16 15:15:00,82,153,Vestuário,3,235
22517,2024-01-16 15:16:00,93,116,Vestuário,3,209
22518,2024-01-16 15:17:00,88,63,Brinquedo,4,151
22519,2024-01-16 15:18:00,54,93,Alimento,1,147
22520,2024-01-16 15:19:00,59,168,Brinquedo,5,227
22521,2024-01-16 15:20:00,61,151,Alimento,8,212
22522,2024-01-16 15:21:00,44,127,Brinquedo,4,171
22523,2024-01-16 15:22:00,95,88,Alimento,8,183
22524,2024-01-16 15:23:00,29,152,Brinquedo,4,181
22525,2024-01-16 15:24:00,55,48,Brinquedo,9,103
22526,2024-01-16 15:25:00,25,21,Alimento,8,46
22527,2024-01-16 15:26:00,17,122,Eletrônico,4,139
22528,2024-01-16 15:27:00,76,21,Alimento,9,97
22529,2024-01-16 15:28:00,13,28,Eletrônico,7,41
22530,2024-01-16 15:29:00,37,101,Móvel,1,138
22531,2024-01-16 15:30:00,10,72,Alimento,2,82
22532,2024-01-16 15:31:00,69,85,Móvel,2,154
22533,2024-01-16 15:32:00,36,107,Alimento,9,143
22534,2024-01-16 15:33:00,54,55,Alimento,3,109
22535,2024-01-16 15:34:00,31,76,Brinquedo,6,107
22536,2024-01-16 15:35:00,81,11,Brinquedo,6,92
22537,2024-01-16 15:36:00,69,10,Vestuário,3,79
22538,2024-01-16 15:37:00,19,149,Alimento,2,168
22539,2024-01-16 15:38:00,18,18,Móvel,8,36
22540,2024-01-16 15:39:00,58,60,Brinquedo,9,118
22541,2024-01-16 15:40:00,46,98,Móvel,5,144
22542,2024-01-16 15:41:00,101,25,Eletrônico,7,126
22543,2024-01-16 15:42:00,45,109,Eletrônico,6,154
22544,2024-01-16 15:43:00,85,72,Eletrônico,4,157
22545,2024-01-16 15:44:00,42,103,Vestuário,9,145
22546,2024-01-16 15:45:00,109,17,Móvel,4,126
22547,2024-01-16 15:46:00,47,134,Brinquedo,9,181
22548,2024-01-16 15:47:00,63,104,Vestuário,5,167
22549,2024-01-16 15:48:00,102,87,Brinquedo,9,189
22550,2024-01-16 15:49:00,118,150,Móvel,7,268
22551,2024-01-16 15:50:00,38,99,Móvel,5,137
22552,2024-01-16 15:51:00,93,126,Alimento,5,219
22553,2024-01-16 15:52:00,48,146,Eletrônico,1,194
22554,2024-01-16 15:53:00,27,36,Brinquedo,9,63
22555,2024-01-16 15:54:00,82,173,Vestuário,4,255
22556,2024-01-16 15:55:00,116,37,Eletrônico,9,153
22557,2024-01-16 15:56:00,56,21,Vestuário,7,77
22558,2024-01-16 15:57:00,75,175,Vestuário,9,250
22559,2024-01-16 15:58:00,80,17,Brinquedo,6,97
22560,2024-01-16 15:59:00,73,143,Brinquedo,4,216
22561,2024-01-16 16:00:00,40,38,Eletrônico,5,78
22562,2024-01-16 16:01:00,110,179,Vestuário,3,289
22563,2024-01-16 16:02:00,31,122,Alimento,4,153
22564,2024-01-16 16:03:00,71,28,Alimento,4,99
22565,2024-01-16 16:04:00,52,65,Vestuário,7,117
22566,2024-01-16 16:05:00,73,99,Móvel,7,172
22567,2024-01-16 16:06:00,23,136,Brinquedo,6,159
22568,2024-01-16 16:07:00,95,92,Móvel,1,187
22569,2024-01-16 16:08:00,54,25,Brinquedo,8,79
22570,2024-01-16 16:09:00,10,10,Vestuário,3,20
22571,2024-01-16 16:10:00,96,75,Eletrônico,1,171
22572,2024-01-16 16:11:00,26,39,Alimento,9,65
22573,2024-01-16 16:12:00,34,107,Vestuário,3,141
22574,2024-01-16 16:13:00,21,147,Vestuário,9,168
22575,2024-01-16 16:14:00,83,99,Brinquedo,2,182
22576,2024-01-16 16:15:00,12,44,Alimento,9,56
22577,2024-01-16 16:16:00,69,29,Alimento,9,98
22578,2024-01-16 16:17:00,25,41,Brinquedo,9,66
22579,2024-01-16 16:18:00,52,80,Vestuário,1,132
22580,2024-01-16 16:19:00,46,18,Móvel,1,64
22581,2024-01-16 16:20:00,10,31,Vestuário,3,41
22582,2024-01-16 16:21:00,72,125,Alimento,5,197
22583,2024-01-16 16:22:00,100,146,Eletrônico,8,246
22584,2024-01-16 16:23:00,92,99,Brinquedo,7,191
22585,2024-01-16 16:24:00,74,171,Eletrônico,7,245
22586,2024-01-16 16:25:00,61,135,Alimento,5,196
22587,2024-01-16 16:26:00,83,30,Alimento,2,113
22588,2024-01-16 16:27:00,105,159,Alimento,5,264
22589,2024-01-16 16:28:00,42,40,Vestuário,2,82
22590,2024-01-16 16:29:00,105,55,Eletrônico,5,160
22591,2024-01-16 16:30:00,47,65,Móvel,7,112
22592,2024-01-16 16:31:00,93,63,Eletrônico,8,156
22593,2024-01-16 16:32:00,80,113,Brinquedo,6,193
22594,2024-01-16 16:33:00,88,164,Brinquedo,6,252
22595,2024-01-16 16:34:00,97,90,Móvel,3,187
22596,2024-01-16 16:35:00,72,33,Alimento,9,105
22597,2024-01-16 16:36:00,117,19,Alimento,8,136
22598,2024-01-16 16:37:00,47,163,Vestuário,2,210
22599,2024-01-16 16:38:00,45,147,Alimento,4,192
22600,2024-01-16 16:39:00,58,24,Brinquedo,2,82
22601,2024-01-16 16:40:00,44,92,Vestuário,6,136
22602,2024-01-16 16:41:00,13,86,Eletrônico,9,99
22603,2024-01-16 16:42:00,68,51,Eletrônico,1,119
22604,2024-01-16 16:43:00,71,127,Brinquedo,3,198
22605,2024-01-16 16:44:00,20,139,Brinquedo,9,159
22606,2024-01-16 16:45:00,57,143,Alimento,6,200
22607,2024-01-16 16:46:00,99,163,Móvel,3,262
22608,2024-01-16 16:47:00,55,15,Alimento,9,70
22609,2024-01-16 16:48:00,76,16,Vestuário,9,92
22610,2024-01-16 16:49:00,50,95,Brinquedo,9,145
22611,2024-01-16 16:50:00,21,130,Vestuário,2,151
22612,2024-01-16 16:51:00,73,175,Vestuário,2,248
22613,2024-01-16 16:52:00,48,29,Vestuário,7,77
22614,2024-01-16 16:53:00,74,52,Móvel,1,126
22615,2024-01-16 16:54:00,108,147,Móvel,5,255
22616,2024-01-16 16:55:00,32,77,Móvel,2,109
22617,2024-01-16 16:56:00,34,30,Alimento,1,64
22618,2024-01-16 16:57:00,37,140,Brinquedo,3,177
22619,2024-01-16 16:58:00,36,121,Brinquedo,3,157
22620,2024-01-16 16:59:00,57,53,Alimento,1,110
22621,2024-01-16 17:00:00,78,92,Alimento,3,170
22622,2024-01-16 17:01:00,13,34,Alimento,3,47
22623,2024-01-16 17:02:00,73,73,Alimento,9,146
22624,2024-01-16 17:03:00,116,53,Vestuário,7,169
22625,2024-01-16 17:04:00,65,90,Eletrônico,4,155
22626,2024-01-16 17:05:00,88,88,Eletrônico,5,176
22627,2024-01-16 17:06:00,73,76,Vestuário,9,149
22628,2024-01-16 17:07:00,54,129,Alimento,5,183
22629,2024-01-16 17:08:00,64,25,Alimento,6,89
22630,2024-01-16 17:09:00,54,60,Alimento,1,114
22631,2024-01-16 17:10:00,57,144,Brinquedo,7,201
22632,2024-01-16 17:11:00,17,58,Eletrônico,6,75
22633,2024-01-16 17:12:00,61,56,Móvel,8,117
22634,2024-01-16 17:13:00,76,58,Eletrônico,7,134
22635,2024-01-16 17:14:00,13,39,Eletrônico,9,52
22636,2024-01-16 17:15:00,11,131,Eletrônico,5,142
22637,2024-01-16 17:16:00,34,39,Brinquedo,3,73
22638,2024-01-16 17:17:00,70,11,Móvel,7,81
22639,2024-01-16 17:18:00,19,149,Móvel,1,168
22640,2024-01-16 17:19:00,73,118,Vestuário,6,191
22641,2024-01-16 17:20:00,24,179,Eletrônico,4,203
22642,2024-01-16 17:21:00,100,74,Brinquedo,8,174
22643,2024-01-16 17:22:00,99,41,Alimento,1,140
22644,2024-01-16 17:23:00,116,68,Móvel,8,184
22645,2024-01-16 17:24:00,74,38,Eletrônico,7,112
22646,2024-01-16 17:25:00,119,91,Brinquedo,5,210
22647,2024-01-16 17:26:00,21,178,Alimento,2,199
22648,2024-01-16 17:27:00,101,16,Vestuário,3,117
22649,2024-01-16 17:28:00,78,48,Vestuário,7,126
22650,2024-01-16 17:29:00,103,123,Alimento,4,226
22651,2024-01-16 17:30:00,85,163,Alimento,1,248
22652,2024-01-16 17:31:00,100,88,Alimento,8,188
22653,2024-01-16 17:32:00,34,37,Vestuário,1,71
22654,2024-01-16 17:33:00,61,116,Móvel,4,177
22655,2024-01-16 17:34:00,73,179,Móvel,4,252
22656,2024-01-16 17:35:00,85,69,Alimento,6,154
22657,2024-01-16 17:36:00,46,129,Eletrônico,4,175
22658,2024-01-16 17:37:00,85,20,Eletrônico,4,105
22659,2024-01-16 17:38:00,117,172,Alimento,6,289
22660,2024-01-16 17:39:00,19,123,Alimento,1,142
22661,2024-01-16 17:40:00,48,47,Eletrônico,8,95
22662,2024-01-16 17:41:00,53,98,Eletrônico,9,151
22663,2024-01-16 17:42:00,105,109,Alimento,9,214
22664,2024-01-16 17:43:00,39,160,Eletrônico,4,199
22665,2024-01-16 17:44:00,58,129,Alimento,4,187
22666,2024-01-16 17:45:00,67,33,Eletrônico,1,100
22667,2024-01-16 17:46:00,84,94,Eletrônico,6,178
22668,2024-01-16 17:47:00,106,143,Móvel,7,249
22669,2024-01-16 17:48:00,116,29,Vestuário,5,145
22670,2024-01-16 17:49:00,104,116,Eletrônico,7,220
22671,2024-01-16 17:50:00,78,72,Brinquedo,7,150
22672,2024-01-16 17:51:00,92,142,Eletrônico,4,234
22673,2024-01-16 17:52:00,97,155,Eletrônico,6,252
22674,2024-01-16 17:53:00,33,22,Alimento,7,55
22675,2024-01-16 17:54:00,119,120,Brinquedo,9,239
22676,2024-01-16 17:55:00,54,91,Vestuário,2,145
22677,2024-01-16 17:56:00,41,81,Eletrônico,9,122
22678,2024-01-16 17:57:00,100,103,Eletrônico,4,203
22679,2024-01-16 17:58:00,70,152,Móvel,7,222
22680,2024-01-16 17:59:00,64,138,Eletrônico,4,202
22681,2024-01-16 18:00:00,67,16,Vestuário,7,83
22682,2024-01-16 18:01:00,13,85,Móvel,1,98
22683,2024-01-16 18:02:00,119,154,Alimento,6,273
22684,2024-01-16 18:03:00,49,65,Vestuário,9,114
22685,2024-01-16 18:04:00,57,52,Móvel,3,109
22686,2024-01-16 18:05:00,18,133,Móvel,1,151
22687,2024-01-16 18:06:00,24,33,Móvel,2,57
22688,2024-01-16 18:07:00,78,165,Eletrônico,3,243
22689,2024-01-16 18:08:00,112,11,Brinquedo,1,123
22690,2024-01-16 18:09:00,30,101,Eletrônico,3,131
22691,2024-01-16 18:10:00,88,148,Brinquedo,3,236
22692,2024-01-16 18:11:00,107,34,Vestuário,7,141
22693,2024-01-16 18:12:00,38,155,Eletrônico,2,193
22694,2024-01-16 18:13:00,72,64,Vestuário,4,136
22695,2024-01-16 18:14:00,56,155,Alimento,5,211
22696,2024-01-16 18:15:00,35,136,Eletrônico,4,171
22697,2024-01-16 18:16:00,65,13,Vestuário,5,78
22698,2024-01-16 18:17:00,92,16,Vestuário,7,108
22699,2024-01-16 18:18:00,107,132,Brinquedo,5,239
22700,2024-01-16 18:19:00,23,90,Brinquedo,5,113
22701,2024-01-16 18:20:00,55,175,Eletrônico,4,230
22702,2024-01-16 18:21:00,41,42,Alimento,3,83
22703,2024-01-16 18:22:00,110,102,Vestuário,6,212
22704,2024-01-16 18:23:00,100,99,Eletrônico,1,199
22705,2024-01-16 18:24:00,109,40,Móvel,7,149
22706,2024-01-16 18:25:00,87,55,Eletrônico,9,142
22707,2024-01-16 18:26:00,77,66,Eletrônico,9,143
22708,2024-01-16 18:27:00,89,42,Eletrônico,3,131
22709,2024-01-16 18:28:00,95,109,Alimento,9,204
22710,2024-01-16 18:29:00,31,154,Alimento,1,185
22711,2024-01-16 18:30:00,14,47,Vestuário,4,61
22712,2024-01-16 18:31:00,19,111,Brinquedo,8,130
22713,2024-01-16 18:32:00,50,29,Brinquedo,5,79
22714,2024-01-16 18:33:00,10,155,Eletrônico,7,165
22715,2024-01-16 18:34:00,69,41,Alimento,1,110
22716,2024-01-16 18:35:00,51,157,Eletrônico,1,208
22717,2024-01-16 18:36:00,38,139,Brinquedo,2,177
22718,2024-01-16 18:37:00,31,58,Eletrônico,5,89
22719,2024-01-16 18:38:00,53,107,Vestuário,6,160
22720,2024-01-16 18:39:00,21,97,Móvel,7,118
22721,2024-01-16 18:40:00,50,11,Alimento,4,61
22722,2024-01-16 18:41:00,53,170,Móvel,6,223
22723,2024-01-16 18:42:00,56,82,Alimento,9,138
22724,2024-01-16 18:43:00,91,82,Eletrônico,7,173
22725,2024-01-16 18:44:00,118,92,Móvel,7,210
22726,2024-01-16 18:45:00,78,102,Brinquedo,2,180
22727,2024-01-16 18:46:00,115,105,Eletrônico,3,220
22728,2024-01-16 18:47:00,102,105,Móvel,4,207
22729,2024-01-16 18:48:00,36,34,Alimento,6,70
22730,2024-01-16 18:49:00,84,155,Brinquedo,9,239
22731,2024-01-16 18:50:00,22,51,Brinquedo,1,73
22732,2024-01-16 18:51:00,26,42,Alimento,8,68
22733,2024-01-16 18:52:00,70,59,Brinquedo,5,129
22734,2024-01-16 18:53:00,38,104,Brinquedo,6,142
22735,2024-01-16 18:54:00,49,166,Móvel,2,215
22736,2024-01-16 18:55:00,43,143,Brinquedo,3,186
22737,2024-01-16 18:56:00,97,59,Alimento,4,156
22738,2024-01-16 18:57:00,24,141,Móvel,3,165
22739,2024-01-16 18:58:00,63,111,Móvel,9,174
22740,2024-01-16 18:59:00,112,169,Eletrônico,2,281
22741,2024-01-16 19:00:00,93,77,Brinquedo,3,170
22742,2024-01-16 19:01:00,72,19,Alimento,8,91
22743,2024-01-16 19:02:00,112,160,Eletrônico,6,272
22744,2024-01-16 19:03:00,36,123,Alimento,4,159
22745,2024-01-16 19:04:00,95,71,Eletrônico,8,166
22746,2024-01-16 19:05:00,65,119,Eletrônico,4,184
22747,2024-01-16 19:06:00,117,179,Eletrônico,7,296
22748,2024-01-16 19:07:00,118,172,Eletrônico,8,290
22749,2024-01-16 19:08:00,114,141,Vestuário,3,255
22750,2024-01-16 19:09:00,102,22,Eletrônico,1,124
22751,2024-01-16 19:10:00,119,23,Alimento,3,142
22752,2024-01-16 19:11:00,48,52,Brinquedo,9,100
22753,2024-01-16 19:12:00,30,59,Eletrônico,9,89
22754,2024-01-16 19:13:00,15,113,Brinquedo,7,128
22755,2024-01-16 19:14:00,12,145,Brinquedo,8,157
22756,2024-01-16 19:15:00,18,27,Móvel,9,45
22757,2024-01-16 19:16:00,103,49,Vestuário,3,152
22758,2024-01-16 19:17:00,58,52,Eletrônico,6,110
22759,2024-01-16 19:18:00,31,161,Vestuário,2,192
22760,2024-01-16 19:19:00,81,176,Móvel,7,257
22761,2024-01-16 19:20:00,107,42,Eletrônico,7,149
22762,2024-01-16 19:21:00,88,101,Móvel,4,189
22763,2024-01-16 19:22:00,17,70,Brinquedo,1,87
22764,2024-01-16 19:23:00,29,140,Móvel,8,169
22765,2024-01-16 19:24:00,64,112,Alimento,1,176
22766,2024-01-16 19:25:00,48,151,Móvel,9,199
22767,2024-01-16 19:26:00,102,90,Vestuário,2,192
22768,2024-01-16 19:27:00,44,94,Móvel,1,138
22769,2024-01-16 19:28:00,73,80,Brinquedo,4,153
22770,2024-01-16 19:29:00,108,178,Eletrônico,9,286
22771,2024-01-16 19:30:00,34,114,Alimento,1,148
22772,2024-01-16 19:31:00,77,74,Alimento,5,151
22773,2024-01-16 19:32:00,36,149,Móvel,7,185
22774,2024-01-16 19:33:00,24,28,Alimento,8,52
22775,2024-01-16 19:34:00,114,118,Alimento,1,232
22776,2024-01-16 19:35:00,22,83,Brinquedo,5,105
22777,2024-01-16 19:36:00,89,91,Eletrônico,3,180
22778,2024-01-16 19:37:00,82,92,Móvel,1,174
22779,2024-01-16 19:38:00,25,89,Vestuário,7,114
22780,2024-01-16 19:39:00,102,48,Vestuário,4,150
22781,2024-01-16 19:40:00,14,119,Brinquedo,5,133
22782,2024-01-16 19:41:00,66,59,Eletrônico,5,125
22783,2024-01-16 19:42:00,95,40,Eletrônico,6,135
22784,2024-01-16 19:43:00,70,95,Vestuário,1,165
22785,2024-01-16 19:44:00,57,85,Brinquedo,6,142
22786,2024-01-16 19:45:00,29,170,Eletrônico,4,199
22787,2024-01-16 19:46:00,35,50,Móvel,5,85
22788,2024-01-16 19:47:00,65,115,Brinquedo,4,180
22789,2024-01-16 19:48:00,28,162,Brinquedo,1,190
22790,2024-01-16 19:49:00,10,162,Vestuário,8,172
22791,2024-01-16 19:50:00,35,83,Eletrônico,8,118
22792,2024-01-16 19:51:00,68,159,Alimento,1,227
22793,2024-01-16 19:52:00,16,25,Eletrônico,5,41
22794,2024-01-16 19:53:00,79,130,Móvel,1,209
22795,2024-01-16 19:54:00,61,84,Móvel,8,145
22796,2024-01-16 19:55:00,14,174,Vestuário,4,188
22797,2024-01-16 19:56:00,68,44,Eletrônico,5,112
22798,2024-01-16 19:57:00,11,36,Vestuário,8,47
22799,2024-01-16 19:58:00,105,169,Brinquedo,3,274
22800,2024-01-16 19:59:00,112,136,Alimento,3,248
22801,2024-01-16 20:00:00,20,65,Brinquedo,9,85
22802,2024-01-16 20:01:00,57,86,Brinquedo,3,143
22803,2024-01-16 20:02:00,26,28,Móvel,3,54
22804,2024-01-16 20:03:00,117,167,Brinquedo,8,284
22805,2024-01-16 20:04:00,99,97,Eletrônico,1,196
22806,2024-01-16 20:05:00,78,157,Eletrônico,5,235
22807,2024-01-16 20:06:00,20,170,Vestuário,9,190
22808,2024-01-16 20:07:00,84,10,Vestuário,2,94
22809,2024-01-16 20:08:00,90,22,Eletrônico,6,112
22810,2024-01-16 20:09:00,61,95,Alimento,9,156
22811,2024-01-16 20:10:00,73,54,Móvel,9,127
22812,2024-01-16 20:11:00,106,111,Vestuário,4,217
22813,2024-01-16 20:12:00,81,117,Brinquedo,4,198
22814,2024-01-16 20:13:00,85,49,Brinquedo,9,134
22815,2024-01-16 20:14:00,91,43,Alimento,8,134
22816,2024-01-16 20:15:00,108,20,Eletrônico,2,128
22817,2024-01-16 20:16:00,25,163,Alimento,8,188
22818,2024-01-16 20:17:00,106,127,Móvel,2,233
22819,2024-01-16 20:18:00,58,113,Vestuário,8,171
22820,2024-01-16 20:19:00,63,157,Eletrônico,3,220
22821,2024-01-16 20:20:00,99,163,Brinquedo,9,262
22822,2024-01-16 20:21:00,93,102,Brinquedo,6,195
22823,2024-01-16 20:22:00,54,19,Brinquedo,9,73
22824,2024-01-16 20:23:00,40,36,Brinquedo,5,76
22825,2024-01-16 20:24:00,30,52,Eletrônico,5,82
22826,2024-01-16 20:25:00,31,120,Brinquedo,5,151
22827,2024-01-16 20:26:00,45,156,Móvel,7,201
22828,2024-01-16 20:27:00,46,68,Eletrônico,3,114
22829,2024-01-16 20:28:00,48,103,Alimento,6,151
22830,2024-01-16 20:29:00,35,123,Móvel,5,158
22831,2024-01-16 20:30:00,32,134,Vestuário,7,166
22832,2024-01-16 20:31:00,88,79,Vestuário,4,167
22833,2024-01-16 20:32:00,110,169,Vestuário,9,279
22834,2024-01-16 20:33:00,62,15,Vestuário,9,77
22835,2024-01-16 20:34:00,30,165,Vestuário,5,195
22836,2024-01-16 20:35:00,88,155,Móvel,4,243
22837,2024-01-16 20:36:00,15,19,Alimento,6,34
22838,2024-01-16 20:37:00,16,35,Eletrônico,8,51
22839,2024-01-16 20:38:00,17,45,Móvel,7,62
22840,2024-01-16 20:39:00,40,36,Móvel,3,76
22841,2024-01-16 20:40:00,114,133,Alimento,8,247
22842,2024-01-16 20:41:00,112,153,Alimento,7,265
22843,2024-01-16 20:42:00,100,43,Móvel,4,143
22844,2024-01-16 20:43:00,56,10,Vestuário,8,66
22845,2024-01-16 20:44:00,44,116,Eletrônico,3,160
22846,2024-01-16 20:45:00,100,27,Vestuário,6,127
22847,2024-01-16 20:46:00,17,54,Alimento,8,71
22848,2024-01-16 20:47:00,88,124,Alimento,9,212
22849,2024-01-16 20:48:00,117,74,Móvel,2,191
22850,2024-01-16 20:49:00,48,56,Alimento,7,104
22851,2024-01-16 20:50:00,63,155,Eletrônico,3,218
22852,2024-01-16 20:51:00,67,112,Brinquedo,7,179
22853,2024-01-16 20:52:00,21,105,Vestuário,5,126
22854,2024-01-16 20:53:00,117,104,Móvel,6,221
22855,2024-01-16 20:54:00,44,91,Vestuário,5,135
22856,2024-01-16 20:55:00,59,41,Alimento,8,100
22857,2024-01-16 20:56:00,12,157,Móvel,8,169
22858,2024-01-16 20:57:00,24,128,Brinquedo,2,152
22859,2024-01-16 20:58:00,49,155,Vestuário,5,204
22860,2024-01-16 20:59:00,34,36,Brinquedo,8,70
22861,2024-01-16 21:00:00,50,125,Alimento,1,175
22862,2024-01-16 21:01:00,80,101,Móvel,8,181
22863,2024-01-16 21:02:00,111,93,Alimento,7,204
22864,2024-01-16 21:03:00,95,71,Vestuário,7,166
22865,2024-01-16 21:04:00,31,79,Vestuário,1,110
22866,2024-01-16 21:05:00,45,64,Vestuário,4,109
22867,2024-01-16 21:06:00,86,12,Móvel,8,98
22868,2024-01-16 21:07:00,55,125,Brinquedo,8,180
22869,2024-01-16 21:08:00,65,168,Móvel,4,233
22870,2024-01-16 21:09:00,87,88,Eletrônico,6,175
22871,2024-01-16 21:10:00,100,94,Brinquedo,2,194
22872,2024-01-16 21:11:00,24,49,Brinquedo,7,73
22873,2024-01-16 21:12:00,107,14,Eletrônico,1,121
22874,2024-01-16 21:13:00,32,126,Móvel,2,158
22875,2024-01-16 21:14:00,72,167,Eletrônico,2,239
22876,2024-01-16 21:15:00,28,58,Vestuário,8,86
22877,2024-01-16 21:16:00,59,154,Eletrônico,2,213
22878,2024-01-16 21:17:00,14,103,Brinquedo,8,117
22879,2024-01-16 21:18:00,101,66,Vestuário,6,167
22880,2024-01-16 21:19:00,41,22,Móvel,7,63
22881,2024-01-16 21:20:00,116,171,Vestuário,8,287
22882,2024-01-16 21:21:00,43,114,Eletrônico,5,157
22883,2024-01-16 21:22:00,66,55,Vestuário,1,121
22884,2024-01-16 21:23:00,105,132,Vestuário,6,237
22885,2024-01-16 21:24:00,64,85,Alimento,4,149
22886,2024-01-16 21:25:00,88,145,Alimento,8,233
22887,2024-01-16 21:26:00,45,37,Brinquedo,4,82
22888,2024-01-16 21:27:00,27,40,Vestuário,8,67
22889,2024-01-16 21:28:00,96,81,Vestuário,6,177
22890,2024-01-16 21:29:00,97,143,Móvel,4,240
22891,2024-01-16 21:30:00,16,162,Brinquedo,9,178
22892,2024-01-16 21:31:00,13,162,Móvel,5,175
22893,2024-01-16 21:32:00,44,58,Alimento,5,102
22894,2024-01-16 21:33:00,87,103,Eletrônico,8,190
22895,2024-01-16 21:34:00,108,77,Móvel,4,185
22896,2024-01-16 21:35:00,51,122,Móvel,5,173
22897,2024-01-16 21:36:00,106,91,Alimento,6,197
22898,2024-01-16 21:37:00,19,101,Alimento,8,120
22899,2024-01-16 21:38:00,13,132,Alimento,2,145
22900,2024-01-16 21:39:00,22,119,Brinquedo,5,141
22901,2024-01-16 21:40:00,97,56,Brinquedo,2,153
22902,2024-01-16 21:41:00,92,35,Móvel,2,127
22903,2024-01-16 21:42:00,16,123,Alimento,7,139
22904,2024-01-16 21:43:00,98,38,Brinquedo,2,136
22905,2024-01-16 21:44:00,57,148,Alimento,1,205
22906,2024-01-16 21:45:00,66,60,Alimento,4,126
22907,2024-01-16 21:46:00,39,52,Vestuário,3,91
22908,2024-01-16 21:47:00,23,71,Móvel,7,94
22909,2024-01-16 21:48:00,89,125,Alimento,1,214
22910,2024-01-16 21:49:00,116,125,Eletrônico,1,241
22911,2024-01-16 21:50:00,107,122,Móvel,1,229
22912,2024-01-16 21:51:00,84,19,Eletrônico,4,103
22913,2024-01-16 21:52:00,11,11,Vestuário,8,22
22914,2024-01-16 21:53:00,52,115,Móvel,9,167
22915,2024-01-16 21:54:00,118,85,Vestuário,5,203
22916,2024-01-16 21:55:00,76,40,Alimento,3,116
22917,2024-01-16 21:56:00,113,94,Móvel,8,207
22918,2024-01-16 21:57:00,54,51,Alimento,1,105
22919,2024-01-16 21:58:00,13,154,Móvel,2,167
22920,2024-01-16 21:59:00,85,130,Vestuário,1,215
22921,2024-01-16 22:00:00,18,61,Eletrônico,2,79
22922,2024-01-16 22:01:00,94,117,Brinquedo,5,211
22923,2024-01-16 22:02:00,102,17,Móvel,7,119
22924,2024-01-16 22:03:00,48,82,Alimento,6,130
22925,2024-01-16 22:04:00,63,117,Eletrônico,1,180
22926,2024-01-16 22:05:00,100,143,Brinquedo,7,243
22927,2024-01-16 22:06:00,41,83,Vestuário,4,124
22928,2024-01-16 22:07:00,25,152,Eletrônico,6,177
22929,2024-01-16 22:08:00,94,10,Brinquedo,9,104
22930,2024-01-16 22:09:00,27,43,Eletrônico,4,70
22931,2024-01-16 22:10:00,108,146,Vestuário,5,254
22932,2024-01-16 22:11:00,14,64,Eletrônico,2,78
22933,2024-01-16 22:12:00,54,45,Alimento,9,99
22934,2024-01-16 22:13:00,25,110,Eletrônico,5,135
22935,2024-01-16 22:14:00,98,155,Vestuário,1,253
22936,2024-01-16 22:15:00,11,176,Móvel,8,187
22937,2024-01-16 22:16:00,81,14,Móvel,7,95
22938,2024-01-16 22:17:00,50,102,Eletrônico,3,152
22939,2024-01-16 22:18:00,10,135,Eletrônico,6,145
22940,2024-01-16 22:19:00,106,101,Eletrônico,2,207
22941,2024-01-16 22:20:00,11,166,Alimento,4,177
22942,2024-01-16 22:21:00,63,99,Móvel,2,162
22943,2024-01-16 22:22:00,94,47,Móvel,1,141
22944,2024-01-16 22:23:00,24,146,Brinquedo,7,170
22945,2024-01-16 22:24:00,107,63,Móvel,9,170
22946,2024-01-16 22:25:00,97,73,Móvel,5,170
22947,2024-01-16 22:26:00,11,53,Eletrônico,6,64
22948,2024-01-16 22:27:00,70,19,Móvel,8,89
22949,2024-01-16 22:28:00,75,92,Móvel,4,167
22950,2024-01-16 22:29:00,98,100,Alimento,1,198
22951,2024-01-16 22:30:00,83,123,Vestuário,7,206
22952,2024-01-16 22:31:00,41,145,Vestuário,7,186
22953,2024-01-16 22:32:00,110,176,Vestuário,6,286
22954,2024-01-16 22:33:00,116,41,Eletrônico,5,157
22955,2024-01-16 22:34:00,39,95,Vestuário,8,134
22956,2024-01-16 22:35:00,71,123,Móvel,3,194
22957,2024-01-16 22:36:00,97,65,Móvel,7,162
22958,2024-01-16 22:37:00,118,19,Eletrônico,6,137
22959,2024-01-16 22:38:00,58,116,Eletrônico,6,174
22960,2024-01-16 22:39:00,59,155,Eletrônico,2,214
22961,2024-01-16 22:40:00,14,88,Móvel,5,102
22962,2024-01-16 22:41:00,48,145,Vestuário,1,193
22963,2024-01-16 22:42:00,27,17,Vestuário,8,44
22964,2024-01-16 22:43:00,37,152,Brinquedo,2,189
22965,2024-01-16 22:44:00,40,107,Brinquedo,8,147
22966,2024-01-16 22:45:00,51,95,Alimento,4,146
22967,2024-01-16 22:46:00,37,114,Alimento,8,151
22968,2024-01-16 22:47:00,61,163,Alimento,1,224
22969,2024-01-16 22:48:00,28,163,Alimento,2,191
22970,2024-01-16 22:49:00,83,70,Brinquedo,9,153
22971,2024-01-16 22:50:00,31,78,Vestuário,1,109
22972,2024-01-16 22:51:00,12,165,Vestuário,5,177
22973,2024-01-16 22:52:00,119,169,Vestuário,4,288
22974,2024-01-16 22:53:00,113,128,Vestuário,3,241
22975,2024-01-16 22:54:00,20,36,Eletrônico,9,56
22976,2024-01-16 22:55:00,61,132,Alimento,2,193
22977,2024-01-16 22:56:00,15,98,Brinquedo,9,113
22978,2024-01-16 22:57:00,12,12,Eletrônico,3,24
22979,2024-01-16 22:58:00,50,126,Eletrônico,8,176
22980,2024-01-16 22:59:00,16,110,Alimento,5,126
22981,2024-01-16 23:00:00,18,59,Alimento,8,77
22982,2024-01-16 23:01:00,76,71,Móvel,3,147
22983,2024-01-16 23:02:00,112,140,Eletrônico,8,252
22984,2024-01-16 23:03:00,35,145,Alimento,1,180
22985,2024-01-16 23:04:00,10,161,Alimento,8,171
22986,2024-01-16 23:05:00,91,47,Vestuário,2,138
22987,2024-01-16 23:06:00,37,42,Alimento,3,79
22988,2024-01-16 23:07:00,46,11,Alimento,5,57
22989,2024-01-16 23:08:00,13,32,Alimento,4,45
22990,2024-01-16 23:09:00,79,97,Vestuário,3,176
22991,2024-01-16 23:10:00,107,116,Vestuário,7,223
22992,2024-01-16 23:11:00,54,82,Vestuário,8,136
22993,2024-01-16 23:12:00,97,163,Alimento,9,260
22994,2024-01-16 23:13:00,10,108,Vestuário,5,118
22995,2024-01-16 23:14:00,28,100,Vestuário,4,128
22996,2024-01-16 23:15:00,98,137,Eletrônico,9,235
22997,2024-01-16 23:16:00,94,156,Eletrônico,7,250
22998,2024-01-16 23:17:00,98,145,Brinquedo,4,243
22999,2024-01-16 23:18:00,57,13,Alimento,2,70
23000,2024-01-16 23:19:00,81,125,Alimento,5,206
23001,2024-01-16 23:20:00,94,157,Eletrônico,2,251
23002,2024-01-16 23:21:00,38,118,Vestuário,6,156
23003,2024-01-16 23:22:00,20,130,Vestuário,7,150
23004,2024-01-16 23:23:00,17,108,Brinquedo,8,125
23005,2024-01-16 23:24:00,41,149,Alimento,2,190
23006,2024-01-16 23:25:00,20,44,Eletrônico,2,64
23007,2024-01-16 23:26:00,111,136,Brinquedo,8,247
23008,2024-01-16 23:27:00,103,65,Eletrônico,3,168
23009,2024-01-16 23:28:00,97,104,Brinquedo,8,201
23010,2024-01-16 23:29:00,55,158,Eletrônico,5,213
23011,2024-01-16 23:30:00,119,69,Brinquedo,3,188
23012,2024-01-16 23:31:00,22,77,Eletrônico,2,99
23013,2024-01-16 23:32:00,116,56,Brinquedo,4,172
23014,2024-01-16 23:33:00,103,122,Móvel,5,225
23015,2024-01-16 23:34:00,64,49,Vestuário,2,113
23016,2024-01-16 23:35:00,80,48,Brinquedo,3,128
23017,2024-01-16 23:36:00,37,61,Móvel,6,98
23018,2024-01-16 23:37:00,70,19,Móvel,8,89
23019,2024-01-16 23:38:00,119,81,Alimento,3,200
23020,2024-01-16 23:39:00,21,23,Móvel,7,44
23021,2024-01-16 23:40:00,28,130,Alimento,1,158
23022,2024-01-16 23:41:00,74,20,Alimento,7,94
23023,2024-01-16 23:42:00,100,111,Eletrônico,8,211
23024,2024-01-16 23:43:00,101,165,Alimento,1,266
23025,2024-01-16 23:44:00,41,85,Móvel,3,126
23026,2024-01-16 23:45:00,34,41,Vestuário,8,75
23027,2024-01-16 23:46:00,13,62,Vestuário,2,75
23028,2024-01-16 23:47:00,54,79,Vestuário,2,133
23029,2024-01-16 23:48:00,66,35,Vestuário,5,101
23030,2024-01-16 23:49:00,104,98,Brinquedo,5,202
23031,2024-01-16 23:50:00,91,141,Alimento,1,232
23032,2024-01-16 23:51:00,31,11,Vestuário,9,42
23033,2024-01-16 23:52:00,111,155,Eletrônico,9,266
23034,2024-01-16 23:53:00,95,119,Brinquedo,4,214
23035,2024-01-16 23:54:00,54,106,Alimento,2,160
23036,2024-01-16 23:55:00,92,170,Móvel,8,262
23037,2024-01-16 23:56:00,59,119,Eletrônico,4,178
23038,2024-01-16 23:57:00,50,142,Móvel,6,192
23039,2024-01-16 23:58:00,119,32,Vestuário,1,151
23040,2024-01-16 23:59:00,61,137,Móvel,5,198
23041,2024-01-17 00:00:00,15,161,Vestuário,9,176
23042,2024-01-17 00:01:00,57,128,Alimento,5,185
23043,2024-01-17 00:02:00,115,124,Vestuário,9,239
23044,2024-01-17 00:03:00,89,104,Eletrônico,6,193
23045,2024-01-17 00:04:00,69,26,Alimento,9,95
23046,2024-01-17 00:05:00,119,59,Brinquedo,4,178
23047,2024-01-17 00:06:00,12,96,Vestuário,6,108
23048,2024-01-17 00:07:00,44,17,Brinquedo,3,61
23049,2024-01-17 00:08:00,110,113,Móvel,2,223
23050,2024-01-17 00:09:00,39,135,Vestuário,5,174
23051,2024-01-17 00:10:00,97,121,Vestuário,4,218
23052,2024-01-17 00:11:00,113,150,Vestuário,3,263
23053,2024-01-17 00:12:00,70,179,Móvel,9,249
23054,2024-01-17 00:13:00,59,125,Eletrônico,9,184
23055,2024-01-17 00:14:00,47,177,Vestuário,5,224
23056,2024-01-17 00:15:00,81,76,Vestuário,4,157
23057,2024-01-17 00:16:00,104,88,Móvel,6,192
23058,2024-01-17 00:17:00,26,95,Eletrônico,6,121
23059,2024-01-17 00:18:00,107,111,Eletrônico,7,218
23060,2024-01-17 00:19:00,66,118,Brinquedo,6,184
23061,2024-01-17 00:20:00,24,54,Brinquedo,4,78
23062,2024-01-17 00:21:00,88,72,Alimento,7,160
23063,2024-01-17 00:22:00,24,146,Alimento,2,170
23064,2024-01-17 00:23:00,101,175,Móvel,3,276
23065,2024-01-17 00:24:00,59,56,Brinquedo,3,115
23066,2024-01-17 00:25:00,104,82,Brinquedo,3,186
23067,2024-01-17 00:26:00,83,165,Eletrônico,9,248
23068,2024-01-17 00:27:00,90,116,Alimento,3,206
23069,2024-01-17 00:28:00,88,64,Brinquedo,5,152
23070,2024-01-17 00:29:00,17,160,Brinquedo,2,177
23071,2024-01-17 00:30:00,96,51,Móvel,4,147
23072,2024-01-17 00:31:00,108,155,Alimento,6,263
23073,2024-01-17 00:32:00,48,36,Brinquedo,5,84
23074,2024-01-17 00:33:00,108,144,Alimento,5,252
23075,2024-01-17 00:34:00,27,79,Vestuário,4,106
23076,2024-01-17 00:35:00,65,93,Alimento,9,158
23077,2024-01-17 00:36:00,12,164,Alimento,5,176
23078,2024-01-17 00:37:00,59,111,Eletrônico,8,170
23079,2024-01-17 00:38:00,31,70,Brinquedo,3,101
23080,2024-01-17 00:39:00,22,85,Eletrônico,2,107
23081,2024-01-17 00:40:00,47,134,Vestuário,3,181
23082,2024-01-17 00:41:00,57,74,Alimento,6,131
23083,2024-01-17 00:42:00,94,12,Brinquedo,8,106
23084,2024-01-17 00:43:00,68,175,Móvel,4,243
23085,2024-01-17 00:44:00,18,177,Alimento,2,195
23086,2024-01-17 00:45:00,116,94,Eletrônico,8,210
23087,2024-01-17 00:46:00,20,41,Alimento,9,61
23088,2024-01-17 00:47:00,23,138,Eletrônico,4,161
23089,2024-01-17 00:48:00,115,106,Móvel,2,221
23090,2024-01-17 00:49:00,115,122,Alimento,6,237
23091,2024-01-17 00:50:00,74,141,Brinquedo,5,215
23092,2024-01-17 00:51:00,108,97,Eletrônico,9,205
23093,2024-01-17 00:52:00,90,81,Móvel,3,171
23094,2024-01-17 00:53:00,83,75,Brinquedo,3,158
23095,2024-01-17 00:54:00,77,130,Alimento,2,207
23096,2024-01-17 00:55:00,65,63,Brinquedo,5,128
23097,2024-01-17 00:56:00,110,53,Vestuário,7,163
23098,2024-01-17 00:57:00,64,151,Móvel,5,215
23099,2024-01-17 00:58:00,100,124,Vestuário,7,224
23100,2024-01-17 00:59:00,40,65,Móvel,1,105
23101,2024-01-17 01:00:00,53,72,Brinquedo,8,125
23102,2024-01-17 01:01:00,25,129,Alimento,1,154
23103,2024-01-17 01:02:00,18,11,Brinquedo,8,29
23104,2024-01-17 01:03:00,62,106,Eletrônico,6,168
23105,2024-01-17 01:04:00,88,45,Alimento,8,133
23106,2024-01-17 01:05:00,17,131,Eletrônico,9,148
23107,2024-01-17 01:06:00,108,176,Vestuário,3,284
23108,2024-01-17 01:07:00,110,16,Alimento,6,126
23109,2024-01-17 01:08:00,15,62,Móvel,6,77
23110,2024-01-17 01:09:00,90,102,Brinquedo,5,192
23111,2024-01-17 01:10:00,101,65,Eletrônico,4,166
23112,2024-01-17 01:11:00,70,64,Eletrônico,9,134
23113,2024-01-17 01:12:00,101,144,Vestuário,3,245
23114,2024-01-17 01:13:00,57,88,Brinquedo,8,145
23115,2024-01-17 01:14:00,100,62,Alimento,5,162
23116,2024-01-17 01:15:00,59,33,Eletrônico,7,92
23117,2024-01-17 01:16:00,19,158,Móvel,7,177
23118,2024-01-17 01:17:00,84,155,Brinquedo,8,239
23119,2024-01-17 01:18:00,74,142,Móvel,7,216
23120,2024-01-17 01:19:00,15,105,Vestuário,9,120
23121,2024-01-17 01:20:00,101,137,Brinquedo,4,238
23122,2024-01-17 01:21:00,45,21,Móvel,3,66
23123,2024-01-17 01:22:00,53,164,Móvel,9,217
23124,2024-01-17 01:23:00,49,43,Móvel,5,92
23125,2024-01-17 01:24:00,62,50,Alimento,6,112
23126,2024-01-17 01:25:00,10,179,Móvel,7,189
23127,2024-01-17 01:26:00,50,99,Alimento,5,149
23128,2024-01-17 01:27:00,110,112,Móvel,1,222
23129,2024-01-17 01:28:00,39,33,Móvel,6,72
23130,2024-01-17 01:29:00,81,141,Vestuário,9,222
23131,2024-01-17 01:30:00,43,72,Brinquedo,2,115
23132,2024-01-17 01:31:00,30,157,Vestuário,2,187
23133,2024-01-17 01:32:00,36,17,Móvel,7,53
23134,2024-01-17 01:33:00,52,84,Vestuário,5,136
23135,2024-01-17 01:34:00,89,89,Brinquedo,4,178
23136,2024-01-17 01:35:00,110,143,Alimento,4,253
23137,2024-01-17 01:36:00,23,40,Brinquedo,3,63
23138,2024-01-17 01:37:00,118,20,Brinquedo,9,138
23139,2024-01-17 01:38:00,85,139,Vestuário,7,224
23140,2024-01-17 01:39:00,54,153,Vestuário,4,207
23141,2024-01-17 01:40:00,31,130,Eletrônico,4,161
23142,2024-01-17 01:41:00,30,43,Alimento,2,73
23143,2024-01-17 01:42:00,110,166,Móvel,2,276
23144,2024-01-17 01:43:00,104,58,Eletrônico,9,162
23145,2024-01-17 01:44:00,66,107,Brinquedo,3,173
23146,2024-01-17 01:45:00,96,12,Brinquedo,9,108
23147,2024-01-17 01:46:00,113,140,Brinquedo,4,253
23148,2024-01-17 01:47:00,70,110,Vestuário,9,180
23149,2024-01-17 01:48:00,60,73,Móvel,1,133
23150,2024-01-17 01:49:00,59,69,Eletrônico,7,128
23151,2024-01-17 01:50:00,107,134,Vestuário,7,241
23152,2024-01-17 01:51:00,69,22,Móvel,6,91
23153,2024-01-17 01:52:00,73,37,Alimento,9,110
23154,2024-01-17 01:53:00,60,171,Móvel,1,231
23155,2024-01-17 01:54:00,24,95,Móvel,9,119
23156,2024-01-17 01:55:00,61,135,Vestuário,3,196
23157,2024-01-17 01:56:00,108,173,Vestuário,4,281
23158,2024-01-17 01:57:00,57,122,Eletrônico,6,179
23159,2024-01-17 01:58:00,13,65,Alimento,7,78
23160,2024-01-17 01:59:00,62,170,Brinquedo,3,232
23161,2024-01-17 02:00:00,19,127,Vestuário,7,146
23162,2024-01-17 02:01:00,57,142,Alimento,8,199
23163,2024-01-17 02:02:00,93,82,Móvel,7,175
23164,2024-01-17 02:03:00,52,39,Vestuário,8,91
23165,2024-01-17 02:04:00,52,56,Alimento,9,108
23166,2024-01-17 02:05:00,70,78,Móvel,8,148
23167,2024-01-17 02:06:00,83,10,Vestuário,6,93
23168,2024-01-17 02:07:00,44,133,Móvel,8,177
23169,2024-01-17 02:08:00,99,173,Vestuário,5,272
23170,2024-01-17 02:09:00,29,174,Brinquedo,3,203
23171,2024-01-17 02:10:00,63,174,Móvel,3,237
23172,2024-01-17 02:11:00,76,154,Brinquedo,4,230
23173,2024-01-17 02:12:00,112,94,Vestuário,6,206
23174,2024-01-17 02:13:00,72,81,Brinquedo,6,153
23175,2024-01-17 02:14:00,47,27,Móvel,9,74
23176,2024-01-17 02:15:00,33,146,Alimento,4,179
23177,2024-01-17 02:16:00,101,59,Alimento,4,160
23178,2024-01-17 02:17:00,30,85,Móvel,8,115
23179,2024-01-17 02:18:00,87,15,Alimento,5,102
23180,2024-01-17 02:19:00,69,80,Alimento,6,149
23181,2024-01-17 02:20:00,57,134,Vestuário,2,191
23182,2024-01-17 02:21:00,11,124,Alimento,8,135
23183,2024-01-17 02:22:00,112,78,Alimento,7,190
23184,2024-01-17 02:23:00,84,149,Eletrônico,5,233
23185,2024-01-17 02:24:00,63,68,Alimento,3,131
23186,2024-01-17 02:25:00,29,19,Eletrônico,4,48
23187,2024-01-17 02:26:00,106,86,Eletrônico,5,192
23188,2024-01-17 02:27:00,30,121,Eletrônico,2,151
23189,2024-01-17 02:28:00,39,147,Móvel,4,186
23190,2024-01-17 02:29:00,35,94,Eletrônico,3,129
23191,2024-01-17 02:30:00,55,29,Vestuário,8,84
23192,2024-01-17 02:31:00,10,42,Brinquedo,2,52
23193,2024-01-17 02:32:00,41,90,Alimento,8,131
23194,2024-01-17 02:33:00,29,15,Móvel,5,44
23195,2024-01-17 02:34:00,48,92,Eletrônico,9,140
23196,2024-01-17 02:35:00,101,143,Eletrônico,3,244
23197,2024-01-17 02:36:00,83,39,Eletrônico,9,122
23198,2024-01-17 02:37:00,17,127,Móvel,3,144
23199,2024-01-17 02:38:00,109,79,Vestuário,4,188
23200,2024-01-17 02:39:00,104,79,Móvel,4,183
23201,2024-01-17 02:40:00,78,90,Brinquedo,3,168
23202,2024-01-17 02:41:00,20,178,Vestuário,4,198
23203,2024-01-17 02:42:00,28,12,Alimento,2,40
23204,2024-01-17 02:43:00,10,38,Brinquedo,5,48
23205,2024-01-17 02:44:00,48,78,Alimento,2,126
23206,2024-01-17 02:45:00,29,98,Eletrônico,5,127
23207,2024-01-17 02:46:00,70,68,Vestuário,6,138
23208,2024-01-17 02:47:00,104,160,Vestuário,4,264
23209,2024-01-17 02:48:00,24,46,Alimento,2,70
23210,2024-01-17 02:49:00,52,63,Brinquedo,1,115
23211,2024-01-17 02:50:00,27,91,Eletrônico,2,118
23212,2024-01-17 02:51:00,96,21,Móvel,4,117
23213,2024-01-17 02:52:00,20,39,Alimento,8,59
23214,2024-01-17 02:53:00,39,41,Vestuário,5,80
23215,2024-01-17 02:54:00,83,73,Vestuário,8,156
23216,2024-01-17 02:55:00,80,73,Alimento,2,153
23217,2024-01-17 02:56:00,81,49,Eletrônico,5,130
23218,2024-01-17 02:57:00,92,48,Alimento,8,140
23219,2024-01-17 02:58:00,85,173,Vestuário,6,258
23220,2024-01-17 02:59:00,17,83,Brinquedo,7,100
23221,2024-01-17 03:00:00,61,117,Eletrônico,9,178
23222,2024-01-17 03:01:00,26,107,Brinquedo,3,133
23223,2024-01-17 03:02:00,44,44,Vestuário,4,88
23224,2024-01-17 03:03:00,46,159,Alimento,4,205
23225,2024-01-17 03:04:00,30,163,Vestuário,6,193
23226,2024-01-17 03:05:00,116,97,Vestuário,2,213
23227,2024-01-17 03:06:00,85,46,Brinquedo,1,131
23228,2024-01-17 03:07:00,39,76,Móvel,7,115
23229,2024-01-17 03:08:00,36,131,Brinquedo,2,167
23230,2024-01-17 03:09:00,80,100,Eletrônico,9,180
23231,2024-01-17 03:10:00,115,19,Móvel,4,134
23232,2024-01-17 03:11:00,58,150,Alimento,3,208
23233,2024-01-17 03:12:00,105,148,Eletrônico,1,253
23234,2024-01-17 03:13:00,72,128,Eletrônico,5,200
23235,2024-01-17 03:14:00,94,19,Vestuário,5,113
23236,2024-01-17 03:15:00,94,148,Alimento,1,242
23237,2024-01-17 03:16:00,20,37,Vestuário,1,57
23238,2024-01-17 03:17:00,64,91,Móvel,6,155
23239,2024-01-17 03:18:00,119,173,Eletrônico,2,292
23240,2024-01-17 03:19:00,66,139,Brinquedo,2,205
23241,2024-01-17 03:20:00,77,160,Móvel,4,237
23242,2024-01-17 03:21:00,107,172,Brinquedo,2,279
23243,2024-01-17 03:22:00,75,156,Eletrônico,1,231
23244,2024-01-17 03:23:00,58,29,Alimento,5,87
23245,2024-01-17 03:24:00,78,146,Alimento,2,224
23246,2024-01-17 03:25:00,109,23,Móvel,6,132
23247,2024-01-17 03:26:00,109,155,Eletrônico,9,264
23248,2024-01-17 03:27:00,35,10,Vestuário,4,45
23249,2024-01-17 03:28:00,36,118,Vestuário,8,154
23250,2024-01-17 03:29:00,63,87,Móvel,9,150
23251,2024-01-17 03:30:00,77,20,Vestuário,8,97
23252,2024-01-17 03:31:00,69,35,Eletrônico,8,104
23253,2024-01-17 03:32:00,33,43,Móvel,9,76
23254,2024-01-17 03:33:00,53,109,Eletrônico,8,162
23255,2024-01-17 03:34:00,14,14,Vestuário,9,28
23256,2024-01-17 03:35:00,31,158,Eletrônico,1,189
23257,2024-01-17 03:36:00,94,102,Vestuário,4,196
23258,2024-01-17 03:37:00,46,22,Eletrônico,6,68
23259,2024-01-17 03:38:00,33,148,Brinquedo,7,181
23260,2024-01-17 03:39:00,56,81,Móvel,7,137
23261,2024-01-17 03:40:00,26,12,Eletrônico,4,38
23262,2024-01-17 03:41:00,110,80,Eletrônico,5,190
23263,2024-01-17 03:42:00,59,91,Brinquedo,3,150
23264,2024-01-17 03:43:00,28,57,Móvel,5,85
23265,2024-01-17 03:44:00,117,10,Eletrônico,8,127
23266,2024-01-17 03:45:00,41,20,Eletrônico,4,61
23267,2024-01-17 03:46:00,91,89,Brinquedo,7,180
23268,2024-01-17 03:47:00,33,16,Eletrônico,2,49
23269,2024-01-17 03:48:00,118,32,Móvel,6,150
23270,2024-01-17 03:49:00,15,41,Vestuário,2,56
23271,2024-01-17 03:50:00,19,106,Móvel,1,125
23272,2024-01-17 03:51:00,78,11,Alimento,1,89
23273,2024-01-17 03:52:00,83,101,Móvel,8,184
23274,2024-01-17 03:53:00,27,127,Vestuário,4,154
23275,2024-01-17 03:54:00,16,75,Brinquedo,2,91
23276,2024-01-17 03:55:00,47,52,Alimento,8,99
23277,2024-01-17 03:56:00,71,117,Vestuário,7,188
23278,2024-01-17 03:57:00,55,75,Móvel,3,130
23279,2024-01-17 03:58:00,91,170,Brinquedo,9,261
23280,2024-01-17 03:59:00,99,86,Eletrônico,1,185
23281,2024-01-17 04:00:00,64,74,Móvel,1,138
23282,2024-01-17 04:01:00,43,29,Brinquedo,3,72
23283,2024-01-17 04:02:00,34,61,Vestuário,6,95
23284,2024-01-17 04:03:00,37,62,Alimento,3,99
23285,2024-01-17 04:04:00,115,168,Vestuário,2,283
23286,2024-01-17 04:05:00,88,176,Vestuário,1,264
23287,2024-01-17 04:06:00,50,128,Vestuário,8,178
23288,2024-01-17 04:07:00,29,38,Brinquedo,2,67
23289,2024-01-17 04:08:00,69,161,Eletrônico,7,230
23290,2024-01-17 04:09:00,64,127,Alimento,5,191
23291,2024-01-17 04:10:00,115,37,Brinquedo,2,152
23292,2024-01-17 04:11:00,51,57,Móvel,8,108
23293,2024-01-17 04:12:00,111,174,Alimento,4,285
23294,2024-01-17 04:13:00,82,163,Eletrônico,1,245
23295,2024-01-17 04:14:00,100,35,Brinquedo,6,135
23296,2024-01-17 04:15:00,92,43,Móvel,4,135
23297,2024-01-17 04:16:00,59,33,Vestuário,3,92
23298,2024-01-17 04:17:00,42,119,Alimento,4,161
23299,2024-01-17 04:18:00,12,174,Brinquedo,4,186
23300,2024-01-17 04:19:00,31,122,Eletrônico,6,153
23301,2024-01-17 04:20:00,87,100,Eletrônico,9,187
23302,2024-01-17 04:21:00,96,23,Alimento,2,119
23303,2024-01-17 04:22:00,85,139,Móvel,6,224
23304,2024-01-17 04:23:00,47,107,Eletrônico,2,154
23305,2024-01-17 04:24:00,42,157,Eletrônico,9,199
23306,2024-01-17 04:25:00,36,89,Eletrônico,1,125
23307,2024-01-17 04:26:00,50,84,Eletrônico,3,134
23308,2024-01-17 04:27:00,89,171,Móvel,3,260
23309,2024-01-17 04:28:00,117,24,Vestuário,3,141
23310,2024-01-17 04:29:00,33,157,Eletrônico,5,190
23311,2024-01-17 04:30:00,84,81,Móvel,7,165
23312,2024-01-17 04:31:00,41,81,Eletrônico,9,122
23313,2024-01-17 04:32:00,116,46,Brinquedo,5,162
23314,2024-01-17 04:33:00,58,61,Vestuário,5,119
23315,2024-01-17 04:34:00,100,177,Móvel,5,277
23316,2024-01-17 04:35:00,16,147,Vestuário,3,163
23317,2024-01-17 04:36:00,119,60,Eletrônico,1,179
23318,2024-01-17 04:37:00,67,11,Móvel,3,78
23319,2024-01-17 04:38:00,113,178,Eletrônico,2,291
23320,2024-01-17 04:39:00,38,16,Móvel,5,54
23321,2024-01-17 04:40:00,113,63,Vestuário,8,176
23322,2024-01-17 04:41:00,115,21,Brinquedo,6,136
23323,2024-01-17 04:42:00,11,164,Alimento,8,175
23324,2024-01-17 04:43:00,18,143,Alimento,8,161
23325,2024-01-17 04:44:00,92,42,Móvel,8,134
23326,2024-01-17 04:45:00,117,117,Alimento,5,234
23327,2024-01-17 04:46:00,47,90,Móvel,1,137
23328,2024-01-17 04:47:00,54,20,Brinquedo,3,74
23329,2024-01-17 04:48:00,85,90,Vestuário,9,175
23330,2024-01-17 04:49:00,30,80,Eletrônico,3,110
23331,2024-01-17 04:50:00,95,57,Brinquedo,9,152
23332,2024-01-17 04:51:00,12,93,Móvel,3,105
23333,2024-01-17 04:52:00,83,139,Brinquedo,9,222
23334,2024-01-17 04:53:00,64,161,Vestuário,1,225
23335,2024-01-17 04:54:00,84,122,Brinquedo,9,206
23336,2024-01-17 04:55:00,117,110,Vestuário,7,227
23337,2024-01-17 04:56:00,68,139,Eletrônico,5,207
23338,2024-01-17 04:57:00,93,102,Vestuário,9,195
23339,2024-01-17 04:58:00,10,85,Eletrônico,9,95
23340,2024-01-17 04:59:00,118,103,Eletrônico,6,221
23341,2024-01-17 05:00:00,102,25,Brinquedo,2,127
23342,2024-01-17 05:01:00,36,152,Eletrônico,7,188
23343,2024-01-17 05:02:00,104,136,Móvel,3,240
23344,2024-01-17 05:03:00,56,96,Móvel,8,152
23345,2024-01-17 05:04:00,41,164,Vestuário,5,205
23346,2024-01-17 05:05:00,84,72,Eletrônico,3,156
23347,2024-01-17 05:06:00,33,67,Móvel,2,100
23348,2024-01-17 05:07:00,55,85,Alimento,4,140
23349,2024-01-17 05:08:00,69,14,Brinquedo,4,83
23350,2024-01-17 05:09:00,94,88,Brinquedo,8,182
23351,2024-01-17 05:10:00,16,52,Alimento,6,68
23352,2024-01-17 05:11:00,65,25,Eletrônico,3,90
23353,2024-01-17 05:12:00,101,112,Brinquedo,6,213
23354,2024-01-17 05:13:00,36,62,Móvel,1,98
23355,2024-01-17 05:14:00,45,130,Brinquedo,4,175
23356,2024-01-17 05:15:00,96,164,Alimento,6,260
23357,2024-01-17 05:16:00,14,24,Móvel,6,38
23358,2024-01-17 05:17:00,37,67,Eletrônico,3,104
23359,2024-01-17 05:18:00,33,137,Vestuário,8,170
23360,2024-01-17 05:19:00,96,157,Brinquedo,8,253
23361,2024-01-17 05:20:00,57,177,Móvel,8,234
23362,2024-01-17 05:21:00,56,136,Vestuário,8,192
23363,2024-01-17 05:22:00,10,50,Eletrônico,5,60
23364,2024-01-17 05:23:00,18,39,Móvel,4,57
23365,2024-01-17 05:24:00,39,117,Alimento,2,156
23366,2024-01-17 05:25:00,76,91,Alimento,7,167
23367,2024-01-17 05:26:00,20,110,Brinquedo,7,130
23368,2024-01-17 05:27:00,10,18,Alimento,6,28
23369,2024-01-17 05:28:00,17,63,Alimento,4,80
23370,2024-01-17 05:29:00,56,131,Vestuário,6,187
23371,2024-01-17 05:30:00,104,124,Móvel,7,228
23372,2024-01-17 05:31:00,97,31,Alimento,5,128
23373,2024-01-17 05:32:00,16,37,Eletrônico,6,53
23374,2024-01-17 05:33:00,77,82,Alimento,9,159
23375,2024-01-17 05:34:00,114,77,Alimento,7,191
23376,2024-01-17 05:35:00,27,67,Alimento,2,94
23377,2024-01-17 05:36:00,40,143,Brinquedo,3,183
23378,2024-01-17 05:37:00,42,47,Vestuário,2,89
23379,2024-01-17 05:38:00,59,108,Eletrônico,1,167
23380,2024-01-17 05:39:00,98,61,Alimento,2,159
23381,2024-01-17 05:40:00,43,146,Vestuário,4,189
23382,2024-01-17 05:41:00,79,143,Alimento,5,222
23383,2024-01-17 05:42:00,35,68,Brinquedo,3,103
23384,2024-01-17 05:43:00,112,91,Móvel,8,203
23385,2024-01-17 05:44:00,48,30,Brinquedo,8,78
23386,2024-01-17 05:45:00,10,43,Alimento,7,53
23387,2024-01-17 05:46:00,76,52,Eletrônico,1,128
23388,2024-01-17 05:47:00,65,74,Móvel,9,139
23389,2024-01-17 05:48:00,98,132,Móvel,9,230
23390,2024-01-17 05:49:00,103,165,Eletrônico,7,268
23391,2024-01-17 05:50:00,104,20,Móvel,8,124
23392,2024-01-17 05:51:00,105,128,Brinquedo,7,233
23393,2024-01-17 05:52:00,79,70,Brinquedo,2,149
23394,2024-01-17 05:53:00,98,23,Alimento,7,121
23395,2024-01-17 05:54:00,39,69,Brinquedo,6,108
23396,2024-01-17 05:55:00,38,120,Móvel,4,158
23397,2024-01-17 05:56:00,94,159,Eletrônico,7,253
23398,2024-01-17 05:57:00,45,14,Alimento,9,59
23399,2024-01-17 05:58:00,98,119,Brinquedo,2,217
23400,2024-01-17 05:59:00,40,174,Vestuário,7,214
23401,2024-01-17 06:00:00,106,93,Vestuário,7,199
23402,2024-01-17 06:01:00,102,106,Brinquedo,4,208
23403,2024-01-17 06:02:00,51,141,Alimento,5,192
23404,2024-01-17 06:03:00,47,110,Brinquedo,6,157
23405,2024-01-17 06:04:00,16,103,Eletrônico,9,119
23406,2024-01-17 06:05:00,94,156,Móvel,1,250
23407,2024-01-17 06:06:00,30,135,Vestuário,3,165
23408,2024-01-17 06:07:00,83,63,Móvel,8,146
23409,2024-01-17 06:08:00,77,132,Alimento,4,209
23410,2024-01-17 06:09:00,10,164,Alimento,8,174
23411,2024-01-17 06:10:00,44,122,Vestuário,9,166
23412,2024-01-17 06:11:00,23,176,Móvel,7,199
23413,2024-01-17 06:12:00,41,42,Móvel,9,83
23414,2024-01-17 06:13:00,12,58,Vestuário,9,70
23415,2024-01-17 06:14:00,74,129,Vestuário,4,203
23416,2024-01-17 06:15:00,57,55,Eletrônico,6,112
23417,2024-01-17 06:16:00,77,48,Alimento,8,125
23418,2024-01-17 06:17:00,72,165,Brinquedo,2,237
23419,2024-01-17 06:18:00,24,69,Vestuário,4,93
23420,2024-01-17 06:19:00,67,168,Alimento,9,235
23421,2024-01-17 06:20:00,95,88,Vestuário,4,183
23422,2024-01-17 06:21:00,30,62,Eletrônico,2,92
23423,2024-01-17 06:22:00,74,127,Alimento,4,201
23424,2024-01-17 06:23:00,20,21,Alimento,1,41
23425,2024-01-17 06:24:00,65,68,Brinquedo,1,133
23426,2024-01-17 06:25:00,90,151,Vestuário,3,241
23427,2024-01-17 06:26:00,25,125,Alimento,8,150
23428,2024-01-17 06:27:00,95,89,Alimento,8,184
23429,2024-01-17 06:28:00,67,37,Eletrônico,8,104
23430,2024-01-17 06:29:00,108,13,Móvel,6,121
23431,2024-01-17 06:30:00,44,142,Brinquedo,9,186
23432,2024-01-17 06:31:00,82,94,Brinquedo,2,176
23433,2024-01-17 06:32:00,58,177,Eletrônico,5,235
23434,2024-01-17 06:33:00,65,72,Móvel,6,137
23435,2024-01-17 06:34:00,51,120,Brinquedo,4,171
23436,2024-01-17 06:35:00,24,20,Alimento,4,44
23437,2024-01-17 06:36:00,67,21,Vestuário,8,88
23438,2024-01-17 06:37:00,20,136,Móvel,9,156
23439,2024-01-17 06:38:00,13,39,Móvel,9,52
23440,2024-01-17 06:39:00,98,12,Brinquedo,4,110
23441,2024-01-17 06:40:00,12,138,Eletrônico,7,150
23442,2024-01-17 06:41:00,118,51,Móvel,2,169
23443,2024-01-17 06:42:00,99,20,Alimento,1,119
23444,2024-01-17 06:43:00,114,21,Vestuário,5,135
23445,2024-01-17 06:44:00,38,122,Eletrônico,9,160
23446,2024-01-17 06:45:00,62,145,Vestuário,1,207
23447,2024-01-17 06:46:00,26,86,Vestuário,4,112
23448,2024-01-17 06:47:00,77,69,Brinquedo,1,146
23449,2024-01-17 06:48:00,69,19,Vestuário,4,88
23450,2024-01-17 06:49:00,73,11,Vestuário,2,84
23451,2024-01-17 06:50:00,15,105,Eletrônico,4,120
23452,2024-01-17 06:51:00,50,120,Vestuário,3,170
23453,2024-01-17 06:52:00,97,111,Brinquedo,4,208
23454,2024-01-17 06:53:00,104,115,Brinquedo,5,219
23455,2024-01-17 06:54:00,66,115,Brinquedo,5,181
23456,2024-01-17 06:55:00,114,158,Brinquedo,8,272
23457,2024-01-17 06:56:00,31,141,Móvel,4,172
23458,2024-01-17 06:57:00,80,146,Vestuário,2,226
23459,2024-01-17 06:58:00,93,71,Alimento,5,164
23460,2024-01-17 06:59:00,119,37,Móvel,1,156
23461,2024-01-17 07:00:00,30,105,Eletrônico,4,135
23462,2024-01-17 07:01:00,46,107,Vestuário,5,153
23463,2024-01-17 07:02:00,24,43,Alimento,4,67
23464,2024-01-17 07:03:00,21,56,Brinquedo,2,77
23465,2024-01-17 07:04:00,88,33,Alimento,4,121
23466,2024-01-17 07:05:00,87,55,Vestuário,2,142
23467,2024-01-17 07:06:00,90,38,Vestuário,3,128
23468,2024-01-17 07:07:00,116,86,Alimento,1,202
23469,2024-01-17 07:08:00,109,101,Alimento,2,210
23470,2024-01-17 07:09:00,83,111,Brinquedo,8,194
23471,2024-01-17 07:10:00,54,139,Brinquedo,1,193
23472,2024-01-17 07:11:00,116,30,Alimento,3,146
23473,2024-01-17 07:12:00,102,37,Vestuário,6,139
23474,2024-01-17 07:13:00,107,39,Vestuário,1,146
23475,2024-01-17 07:14:00,66,122,Vestuário,2,188
23476,2024-01-17 07:15:00,52,113,Eletrônico,2,165
23477,2024-01-17 07:16:00,52,26,Eletrônico,9,78
23478,2024-01-17 07:17:00,67,102,Vestuário,7,169
23479,2024-01-17 07:18:00,67,65,Vestuário,4,132
23480,2024-01-17 07:19:00,98,43,Eletrônico,8,141
23481,2024-01-17 07:20:00,116,20,Brinquedo,8,136
23482,2024-01-17 07:21:00,70,17,Alimento,5,87
23483,2024-01-17 07:22:00,29,17,Eletrônico,3,46
23484,2024-01-17 07:23:00,115,14,Móvel,2,129
23485,2024-01-17 07:24:00,91,51,Brinquedo,9,142
23486,2024-01-17 07:25:00,106,175,Alimento,6,281
23487,2024-01-17 07:26:00,101,49,Móvel,6,150
23488,2024-01-17 07:27:00,74,96,Alimento,4,170
23489,2024-01-17 07:28:00,93,35,Alimento,8,128
23490,2024-01-17 07:29:00,34,63,Vestuário,5,97
23491,2024-01-17 07:30:00,74,52,Vestuário,5,126
23492,2024-01-17 07:31:00,119,25,Alimento,2,144
23493,2024-01-17 07:32:00,81,24,Vestuário,9,105
23494,2024-01-17 07:33:00,14,94,Eletrônico,4,108
23495,2024-01-17 07:34:00,71,146,Brinquedo,3,217
23496,2024-01-17 07:35:00,86,83,Vestuário,4,169
23497,2024-01-17 07:36:00,90,136,Alimento,2,226
23498,2024-01-17 07:37:00,26,163,Vestuário,4,189
23499,2024-01-17 07:38:00,29,53,Alimento,1,82
23500,2024-01-17 07:39:00,44,80,Alimento,3,124
23501,2024-01-17 07:40:00,65,152,Alimento,5,217
23502,2024-01-17 07:41:00,30,154,Brinquedo,8,184
23503,2024-01-17 07:42:00,38,105,Eletrônico,1,143
23504,2024-01-17 07:43:00,87,97,Vestuário,6,184
23505,2024-01-17 07:44:00,115,31,Brinquedo,2,146
23506,2024-01-17 07:45:00,39,117,Brinquedo,7,156
23507,2024-01-17 07:46:00,71,170,Alimento,4,241
23508,2024-01-17 07:47:00,20,116,Móvel,8,136
23509,2024-01-17 07:48:00,18,27,Brinquedo,3,45
23510,2024-01-17 07:49:00,89,84,Vestuário,8,173
23511,2024-01-17 07:50:00,50,125,Móvel,6,175
23512,2024-01-17 07:51:00,70,73,Alimento,2,143
23513,2024-01-17 07:52:00,22,101,Eletrônico,2,123
23514,2024-01-17 07:53:00,51,118,Vestuário,3,169
23515,2024-01-17 07:54:00,57,89,Móvel,6,146
23516,2024-01-17 07:55:00,17,91,Brinquedo,4,108
23517,2024-01-17 07:56:00,39,102,Vestuário,4,141
23518,2024-01-17 07:57:00,101,131,Brinquedo,8,232
23519,2024-01-17 07:58:00,103,35,Vestuário,5,138
23520,2024-01-17 07:59:00,87,103,Móvel,1,190
23521,2024-01-17 08:00:00,101,173,Alimento,9,274
23522,2024-01-17 08:01:00,55,55,Brinquedo,7,110
23523,2024-01-17 08:02:00,83,163,Vestuário,5,246
23524,2024-01-17 08:03:00,17,156,Alimento,1,173
23525,2024-01-17 08:04:00,11,14,Alimento,2,25
23526,2024-01-17 08:05:00,70,131,Alimento,1,201
23527,2024-01-17 08:06:00,42,52,Alimento,9,94
23528,2024-01-17 08:07:00,55,12,Eletrônico,6,67
23529,2024-01-17 08:08:00,66,81,Eletrônico,6,147
23530,2024-01-17 08:09:00,31,87,Alimento,9,118
23531,2024-01-17 08:10:00,55,50,Eletrônico,9,105
23532,2024-01-17 08:11:00,17,16,Alimento,2,33
23533,2024-01-17 08:12:00,81,142,Móvel,6,223
23534,2024-01-17 08:13:00,39,55,Móvel,3,94
23535,2024-01-17 08:14:00,44,53,Brinquedo,8,97
23536,2024-01-17 08:15:00,61,104,Eletrônico,3,165
23537,2024-01-17 08:16:00,104,175,Brinquedo,8,279
23538,2024-01-17 08:17:00,43,49,Alimento,9,92
23539,2024-01-17 08:18:00,94,34,Eletrônico,4,128
23540,2024-01-17 08:19:00,18,109,Móvel,1,127
23541,2024-01-17 08:20:00,40,90,Eletrônico,7,130
23542,2024-01-17 08:21:00,80,68,Alimento,8,148
23543,2024-01-17 08:22:00,39,171,Brinquedo,6,210
23544,2024-01-17 08:23:00,100,115,Vestuário,1,215
23545,2024-01-17 08:24:00,48,30,Vestuário,5,78
23546,2024-01-17 08:25:00,66,111,Vestuário,9,177
23547,2024-01-17 08:26:00,86,102,Eletrônico,9,188
23548,2024-01-17 08:27:00,15,167,Móvel,7,182
23549,2024-01-17 08:28:00,113,130,Brinquedo,1,243
23550,2024-01-17 08:29:00,82,80,Alimento,8,162
23551,2024-01-17 08:30:00,77,16,Brinquedo,4,93
23552,2024-01-17 08:31:00,88,137,Brinquedo,8,225
23553,2024-01-17 08:32:00,69,86,Brinquedo,1,155
23554,2024-01-17 08:33:00,37,25,Vestuário,3,62
23555,2024-01-17 08:34:00,97,64,Móvel,8,161
23556,2024-01-17 08:35:00,31,115,Móvel,3,146
23557,2024-01-17 08:36:00,42,116,Alimento,3,158
23558,2024-01-17 08:37:00,54,141,Vestuário,6,195
23559,2024-01-17 08:38:00,47,178,Eletrônico,8,225
23560,2024-01-17 08:39:00,21,137,Alimento,7,158
23561,2024-01-17 08:40:00,38,26,Móvel,2,64
23562,2024-01-17 08:41:00,21,94,Vestuário,8,115
23563,2024-01-17 08:42:00,87,12,Brinquedo,1,99
23564,2024-01-17 08:43:00,25,130,Brinquedo,3,155
23565,2024-01-17 08:44:00,22,81,Móvel,3,103
23566,2024-01-17 08:45:00,61,28,Vestuário,3,89
23567,2024-01-17 08:46:00,55,32,Eletrônico,4,87
23568,2024-01-17 08:47:00,28,153,Eletrônico,8,181
23569,2024-01-17 08:48:00,36,114,Brinquedo,4,150
23570,2024-01-17 08:49:00,27,123,Eletrônico,1,150
23571,2024-01-17 08:50:00,104,169,Alimento,1,273
23572,2024-01-17 08:51:00,23,169,Alimento,8,192
23573,2024-01-17 08:52:00,93,47,Móvel,5,140
23574,2024-01-17 08:53:00,13,95,Brinquedo,5,108
23575,2024-01-17 08:54:00,79,30,Brinquedo,2,109
23576,2024-01-17 08:55:00,41,44,Vestuário,2,85
23577,2024-01-17 08:56:00,26,138,Brinquedo,2,164
23578,2024-01-17 08:57:00,65,89,Vestuário,9,154
23579,2024-01-17 08:58:00,85,14,Alimento,7,99
23580,2024-01-17 08:59:00,41,24,Vestuário,4,65
23581,2024-01-17 09:00:00,23,47,Eletrônico,6,70
23582,2024-01-17 09:01:00,47,175,Vestuário,2,222
23583,2024-01-17 09:02:00,65,18,Brinquedo,6,83
23584,2024-01-17 09:03:00,79,81,Móvel,4,160
23585,2024-01-17 09:04:00,49,139,Alimento,4,188
23586,2024-01-17 09:05:00,104,134,Brinquedo,1,238
23587,2024-01-17 09:06:00,45,72,Alimento,5,117
23588,2024-01-17 09:07:00,39,100,Brinquedo,7,139
23589,2024-01-17 09:08:00,40,133,Brinquedo,9,173
23590,2024-01-17 09:09:00,18,18,Alimento,1,36
23591,2024-01-17 09:10:00,53,42,Brinquedo,1,95
23592,2024-01-17 09:11:00,118,157,Alimento,3,275
23593,2024-01-17 09:12:00,108,52,Móvel,7,160
23594,2024-01-17 09:13:00,59,43,Vestuário,8,102
23595,2024-01-17 09:14:00,70,158,Alimento,9,228
23596,2024-01-17 09:15:00,18,147,Vestuário,1,165
23597,2024-01-17 09:16:00,40,47,Alimento,8,87
23598,2024-01-17 09:17:00,41,50,Vestuário,9,91
23599,2024-01-17 09:18:00,31,151,Alimento,7,182
23600,2024-01-17 09:19:00,48,110,Alimento,1,158
23601,2024-01-17 09:20:00,39,109,Móvel,3,148
23602,2024-01-17 09:21:00,36,136,Eletrônico,3,172
23603,2024-01-17 09:22:00,84,69,Alimento,5,153
23604,2024-01-17 09:23:00,36,178,Eletrônico,6,214
23605,2024-01-17 09:24:00,47,37,Vestuário,7,84
23606,2024-01-17 09:25:00,20,172,Brinquedo,8,192
23607,2024-01-17 09:26:00,82,32,Vestuário,3,114
23608,2024-01-17 09:27:00,38,100,Vestuário,8,138
23609,2024-01-17 09:28:00,47,82,Brinquedo,5,129
23610,2024-01-17 09:29:00,69,12,Vestuário,2,81
23611,2024-01-17 09:30:00,38,39,Eletrônico,6,77
23612,2024-01-17 09:31:00,35,107,Alimento,5,142
23613,2024-01-17 09:32:00,19,130,Eletrônico,7,149
23614,2024-01-17 09:33:00,14,139,Móvel,6,153
23615,2024-01-17 09:34:00,53,83,Móvel,4,136
23616,2024-01-17 09:35:00,65,139,Móvel,8,204
23617,2024-01-17 09:36:00,71,70,Alimento,5,141
23618,2024-01-17 09:37:00,11,105,Vestuário,8,116
23619,2024-01-17 09:38:00,119,81,Móvel,9,200
23620,2024-01-17 09:39:00,32,163,Vestuário,5,195
23621,2024-01-17 09:40:00,112,99,Eletrônico,9,211
23622,2024-01-17 09:41:00,118,66,Brinquedo,3,184
23623,2024-01-17 09:42:00,62,138,Vestuário,4,200
23624,2024-01-17 09:43:00,71,123,Eletrônico,3,194
23625,2024-01-17 09:44:00,39,72,Vestuário,5,111
23626,2024-01-17 09:45:00,20,107,Eletrônico,7,127
23627,2024-01-17 09:46:00,61,164,Brinquedo,5,225
23628,2024-01-17 09:47:00,62,145,Brinquedo,1,207
23629,2024-01-17 09:48:00,97,175,Alimento,9,272
23630,2024-01-17 09:49:00,73,69,Vestuário,3,142
23631,2024-01-17 09:50:00,101,10,Móvel,3,111
23632,2024-01-17 09:51:00,12,122,Móvel,8,134
23633,2024-01-17 09:52:00,98,48,Móvel,5,146
23634,2024-01-17 09:53:00,76,97,Vestuário,4,173
23635,2024-01-17 09:54:00,54,132,Eletrônico,8,186
23636,2024-01-17 09:55:00,74,46,Alimento,8,120
23637,2024-01-17 09:56:00,45,97,Alimento,7,142
23638,2024-01-17 09:57:00,54,53,Brinquedo,4,107
23639,2024-01-17 09:58:00,55,113,Brinquedo,7,168
23640,2024-01-17 09:59:00,113,63,Eletrônico,2,176
23641,2024-01-17 10:00:00,87,113,Brinquedo,4,200
23642,2024-01-17 10:01:00,101,70,Móvel,1,171
23643,2024-01-17 10:02:00,33,148,Alimento,8,181
23644,2024-01-17 10:03:00,86,25,Alimento,3,111
23645,2024-01-17 10:04:00,70,43,Alimento,9,113
23646,2024-01-17 10:05:00,14,101,Brinquedo,2,115
23647,2024-01-17 10:06:00,91,145,Alimento,7,236
23648,2024-01-17 10:07:00,16,168,Vestuário,5,184
23649,2024-01-17 10:08:00,30,42,Móvel,5,72
23650,2024-01-17 10:09:00,12,176,Eletrônico,1,188
23651,2024-01-17 10:10:00,12,119,Brinquedo,7,131
23652,2024-01-17 10:11:00,15,161,Móvel,5,176
23653,2024-01-17 10:12:00,116,177,Eletrônico,7,293
23654,2024-01-17 10:13:00,40,163,Móvel,5,203
23655,2024-01-17 10:14:00,65,164,Vestuário,6,229
23656,2024-01-17 10:15:00,25,91,Vestuário,1,116
23657,2024-01-17 10:16:00,49,93,Alimento,9,142
23658,2024-01-17 10:17:00,111,101,Alimento,1,212
23659,2024-01-17 10:18:00,66,117,Alimento,8,183
23660,2024-01-17 10:19:00,48,51,Brinquedo,6,99
23661,2024-01-17 10:20:00,64,34,Vestuário,1,98
23662,2024-01-17 10:21:00,26,152,Eletrônico,8,178
23663,2024-01-17 10:22:00,54,160,Alimento,9,214
23664,2024-01-17 10:23:00,18,80,Vestuário,9,98
23665,2024-01-17 10:24:00,12,97,Vestuário,5,109
23666,2024-01-17 10:25:00,102,44,Vestuário,3,146
23667,2024-01-17 10:26:00,19,111,Móvel,4,130
23668,2024-01-17 10:27:00,11,70,Eletrônico,5,81
23669,2024-01-17 10:28:00,68,65,Alimento,8,133
23670,2024-01-17 10:29:00,84,34,Alimento,9,118
23671,2024-01-17 10:30:00,42,160,Eletrônico,2,202
23672,2024-01-17 10:31:00,113,174,Alimento,3,287
23673,2024-01-17 10:32:00,32,57,Vestuário,6,89
23674,2024-01-17 10:33:00,88,137,Vestuário,2,225
23675,2024-01-17 10:34:00,67,69,Eletrônico,4,136
23676,2024-01-17 10:35:00,51,165,Alimento,2,216
23677,2024-01-17 10:36:00,96,38,Vestuário,9,134
23678,2024-01-17 10:37:00,96,117,Brinquedo,5,213
23679,2024-01-17 10:38:00,81,71,Brinquedo,7,152
23680,2024-01-17 10:39:00,11,177,Brinquedo,7,188
23681,2024-01-17 10:40:00,70,28,Móvel,8,98
23682,2024-01-17 10:41:00,68,56,Brinquedo,1,124
23683,2024-01-17 10:42:00,76,134,Alimento,9,210
23684,2024-01-17 10:43:00,15,113,Alimento,4,128
23685,2024-01-17 10:44:00,36,173,Eletrônico,9,209
23686,2024-01-17 10:45:00,33,74,Brinquedo,1,107
23687,2024-01-17 10:46:00,41,113,Vestuário,3,154
23688,2024-01-17 10:47:00,75,130,Vestuário,8,205
23689,2024-01-17 10:48:00,106,74,Móvel,1,180
23690,2024-01-17 10:49:00,10,149,Eletrônico,8,159
23691,2024-01-17 10:50:00,87,10,Alimento,6,97
23692,2024-01-17 10:51:00,116,25,Vestuário,8,141
23693,2024-01-17 10:52:00,105,120,Vestuário,3,225
23694,2024-01-17 10:53:00,23,115,Eletrônico,6,138
23695,2024-01-17 10:54:00,11,121,Vestuário,5,132
23696,2024-01-17 10:55:00,114,11,Alimento,3,125
23697,2024-01-17 10:56:00,29,83,Alimento,2,112
23698,2024-01-17 10:57:00,35,157,Vestuário,8,192
23699,2024-01-17 10:58:00,72,125,Alimento,5,197
23700,2024-01-17 10:59:00,53,99,Brinquedo,2,152
23701,2024-01-17 11:00:00,13,160,Vestuário,3,173
23702,2024-01-17 11:01:00,40,22,Vestuário,8,62
23703,2024-01-17 11:02:00,87,121,Eletrônico,4,208
23704,2024-01-17 11:03:00,68,94,Móvel,8,162
23705,2024-01-17 11:04:00,81,102,Brinquedo,3,183
23706,2024-01-17 11:05:00,21,39,Brinquedo,1,60
23707,2024-01-17 11:06:00,63,43,Eletrônico,2,106
23708,2024-01-17 11:07:00,117,134,Brinquedo,7,251
23709,2024-01-17 11:08:00,90,119,Eletrônico,9,209
23710,2024-01-17 11:09:00,58,61,Eletrônico,7,119
23711,2024-01-17 11:10:00,66,29,Vestuário,1,95
23712,2024-01-17 11:11:00,107,32,Alimento,3,139
23713,2024-01-17 11:12:00,59,101,Vestuário,1,160
23714,2024-01-17 11:13:00,98,78,Alimento,6,176
23715,2024-01-17 11:14:00,60,124,Vestuário,7,184
23716,2024-01-17 11:15:00,103,107,Eletrônico,9,210
23717,2024-01-17 11:16:00,72,15,Vestuário,7,87
23718,2024-01-17 11:17:00,20,153,Eletrônico,6,173
23719,2024-01-17 11:18:00,31,54,Brinquedo,2,85
23720,2024-01-17 11:19:00,107,29,Vestuário,2,136
23721,2024-01-17 11:20:00,116,133,Eletrônico,5,249
23722,2024-01-17 11:21:00,54,141,Brinquedo,7,195
23723,2024-01-17 11:22:00,110,98,Alimento,9,208
23724,2024-01-17 11:23:00,70,31,Alimento,1,101
23725,2024-01-17 11:24:00,116,96,Vestuário,4,212
23726,2024-01-17 11:25:00,99,129,Móvel,3,228
23727,2024-01-17 11:26:00,78,86,Eletrônico,1,164
23728,2024-01-17 11:27:00,61,66,Eletrônico,9,127
23729,2024-01-17 11:28:00,62,55,Alimento,4,117
23730,2024-01-17 11:29:00,10,152,Vestuário,6,162
23731,2024-01-17 11:30:00,90,119,Vestuário,8,209
23732,2024-01-17 11:31:00,38,56,Alimento,2,94
23733,2024-01-17 11:32:00,112,154,Móvel,8,266
23734,2024-01-17 11:33:00,40,97,Eletrônico,2,137
23735,2024-01-17 11:34:00,15,166,Eletrônico,4,181
23736,2024-01-17 11:35:00,42,122,Vestuário,5,164
23737,2024-01-17 11:36:00,23,150,Brinquedo,5,173
23738,2024-01-17 11:37:00,116,24,Eletrônico,5,140
23739,2024-01-17 11:38:00,66,153,Alimento,8,219
23740,2024-01-17 11:39:00,93,142,Eletrônico,2,235
23741,2024-01-17 11:40:00,108,176,Móvel,4,284
23742,2024-01-17 11:41:00,52,48,Eletrônico,9,100
23743,2024-01-17 11:42:00,24,139,Eletrônico,4,163
23744,2024-01-17 11:43:00,22,66,Vestuário,3,88
23745,2024-01-17 11:44:00,30,99,Eletrônico,3,129
23746,2024-01-17 11:45:00,12,22,Alimento,4,34
23747,2024-01-17 11:46:00,108,152,Brinquedo,8,260
23748,2024-01-17 11:47:00,77,90,Eletrônico,1,167
23749,2024-01-17 11:48:00,67,129,Alimento,4,196
23750,2024-01-17 11:49:00,102,167,Brinquedo,7,269
23751,2024-01-17 11:50:00,67,104,Vestuário,8,171
23752,2024-01-17 11:51:00,36,162,Vestuário,6,198
23753,2024-01-17 11:52:00,10,173,Brinquedo,4,183
23754,2024-01-17 11:53:00,100,18,Eletrônico,9,118
23755,2024-01-17 11:54:00,57,149,Alimento,8,206
23756,2024-01-17 11:55:00,87,32,Brinquedo,8,119
23757,2024-01-17 11:56:00,44,96,Vestuário,6,140
23758,2024-01-17 11:57:00,101,99,Alimento,7,200
23759,2024-01-17 11:58:00,79,123,Vestuário,7,202
23760,2024-01-17 11:59:00,116,37,Eletrônico,7,153
23761,2024-01-17 12:00:00,95,86,Vestuário,7,181
23762,2024-01-17 12:01:00,95,43,Móvel,2,138
23763,2024-01-17 12:02:00,18,169,Móvel,8,187
23764,2024-01-17 12:03:00,71,140,Eletrônico,7,211
23765,2024-01-17 12:04:00,17,79,Vestuário,7,96
23766,2024-01-17 12:05:00,30,133,Brinquedo,3,163
23767,2024-01-17 12:06:00,13,166,Vestuário,7,179
23768,2024-01-17 12:07:00,34,136,Vestuário,6,170
23769,2024-01-17 12:08:00,56,46,Eletrônico,8,102
23770,2024-01-17 12:09:00,34,168,Alimento,8,202
23771,2024-01-17 12:10:00,13,150,Móvel,9,163
23772,2024-01-17 12:11:00,106,86,Vestuário,4,192
23773,2024-01-17 12:12:00,12,86,Alimento,7,98
23774,2024-01-17 12:13:00,101,22,Vestuário,3,123
23775,2024-01-17 12:14:00,58,12,Eletrônico,3,70
23776,2024-01-17 12:15:00,56,29,Vestuário,1,85
23777,2024-01-17 12:16:00,56,114,Brinquedo,1,170
23778,2024-01-17 12:17:00,72,48,Móvel,9,120
23779,2024-01-17 12:18:00,99,174,Alimento,5,273
23780,2024-01-17 12:19:00,78,158,Alimento,5,236
23781,2024-01-17 12:20:00,113,52,Alimento,8,165
23782,2024-01-17 12:21:00,26,119,Brinquedo,5,145
23783,2024-01-17 12:22:00,116,157,Eletrônico,3,273
23784,2024-01-17 12:23:00,18,152,Vestuário,5,170
23785,2024-01-17 12:24:00,26,149,Móvel,5,175
23786,2024-01-17 12:25:00,88,38,Brinquedo,9,126
23787,2024-01-17 12:26:00,101,169,Brinquedo,7,270
23788,2024-01-17 12:27:00,12,110,Brinquedo,8,122
23789,2024-01-17 12:28:00,94,80,Brinquedo,3,174
23790,2024-01-17 12:29:00,115,26,Eletrônico,5,141
23791,2024-01-17 12:30:00,16,177,Eletrônico,7,193
23792,2024-01-17 12:31:00,108,169,Vestuário,6,277
23793,2024-01-17 12:32:00,51,126,Brinquedo,5,177
23794,2024-01-17 12:33:00,14,98,Móvel,5,112
23795,2024-01-17 12:34:00,20,99,Móvel,4,119
23796,2024-01-17 12:35:00,75,166,Eletrônico,9,241
23797,2024-01-17 12:36:00,64,135,Brinquedo,4,199
23798,2024-01-17 12:37:00,31,117,Alimento,5,148
23799,2024-01-17 12:38:00,58,68,Vestuário,7,126
23800,2024-01-17 12:39:00,64,32,Brinquedo,1,96
23801,2024-01-17 12:40:00,74,15,Vestuário,6,89
23802,2024-01-17 12:41:00,31,43,Brinquedo,9,74
23803,2024-01-17 12:42:00,87,106,Eletrônico,2,193
23804,2024-01-17 12:43:00,119,48,Móvel,8,167
23805,2024-01-17 12:44:00,71,95,Vestuário,7,166
23806,2024-01-17 12:45:00,73,57,Brinquedo,9,130
23807,2024-01-17 12:46:00,115,155,Eletrônico,2,270
23808,2024-01-17 12:47:00,58,118,Alimento,4,176
23809,2024-01-17 12:48:00,30,177,Móvel,6,207
23810,2024-01-17 12:49:00,113,17,Móvel,7,130
23811,2024-01-17 12:50:00,90,52,Brinquedo,4,142
23812,2024-01-17 12:51:00,83,108,Alimento,2,191
23813,2024-01-17 12:52:00,31,153,Alimento,6,184
23814,2024-01-17 12:53:00,105,169,Brinquedo,9,274
23815,2024-01-17 12:54:00,85,159,Vestuário,3,244
23816,2024-01-17 12:55:00,31,156,Vestuário,2,187
23817,2024-01-17 12:56:00,52,86,Alimento,3,138
23818,2024-01-17 12:57:00,78,141,Móvel,5,219
23819,2024-01-17 12:58:00,62,79,Eletrônico,7,141
23820,2024-01-17 12:59:00,42,18,Alimento,8,60
23821,2024-01-17 13:00:00,63,14,Móvel,4,77
23822,2024-01-17 13:01:00,37,145,Alimento,5,182
23823,2024-01-17 13:02:00,91,150,Eletrônico,4,241
23824,2024-01-17 13:03:00,55,160,Brinquedo,5,215
23825,2024-01-17 13:04:00,89,80,Móvel,6,169
23826,2024-01-17 13:05:00,22,120,Eletrônico,5,142
23827,2024-01-17 13:06:00,46,62,Vestuário,4,108
23828,2024-01-17 13:07:00,70,91,Eletrônico,9,161
23829,2024-01-17 13:08:00,52,72,Vestuário,4,124
23830,2024-01-17 13:09:00,111,101,Brinquedo,9,212
23831,2024-01-17 13:10:00,112,39,Brinquedo,5,151
23832,2024-01-17 13:11:00,51,142,Móvel,8,193
23833,2024-01-17 13:12:00,20,32,Eletrônico,7,52
23834,2024-01-17 13:13:00,53,23,Brinquedo,2,76
23835,2024-01-17 13:14:00,116,166,Eletrônico,3,282
23836,2024-01-17 13:15:00,84,127,Vestuário,9,211
23837,2024-01-17 13:16:00,75,45,Vestuário,5,120
23838,2024-01-17 13:17:00,12,41,Vestuário,1,53
23839,2024-01-17 13:18:00,113,88,Móvel,4,201
23840,2024-01-17 13:19:00,40,147,Móvel,6,187
23841,2024-01-17 13:20:00,24,45,Eletrônico,9,69
23842,2024-01-17 13:21:00,117,19,Alimento,1,136
23843,2024-01-17 13:22:00,65,52,Móvel,8,117
23844,2024-01-17 13:23:00,22,139,Brinquedo,1,161
23845,2024-01-17 13:24:00,27,153,Brinquedo,9,180
23846,2024-01-17 13:25:00,115,66,Alimento,6,181
23847,2024-01-17 13:26:00,110,106,Alimento,3,216
23848,2024-01-17 13:27:00,72,171,Móvel,7,243
23849,2024-01-17 13:28:00,118,97,Brinquedo,1,215
23850,2024-01-17 13:29:00,33,103,Eletrônico,4,136
23851,2024-01-17 13:30:00,33,40,Brinquedo,3,73
23852,2024-01-17 13:31:00,119,109,Alimento,6,228
23853,2024-01-17 13:32:00,64,140,Vestuário,7,204
23854,2024-01-17 13:33:00,110,147,Eletrônico,5,257
23855,2024-01-17 13:34:00,43,131,Vestuário,1,174
23856,2024-01-17 13:35:00,117,90,Móvel,1,207
23857,2024-01-17 13:36:00,52,114,Alimento,1,166
23858,2024-01-17 13:37:00,96,101,Brinquedo,4,197
23859,2024-01-17 13:38:00,28,109,Vestuário,8,137
23860,2024-01-17 13:39:00,93,31,Vestuário,7,124
23861,2024-01-17 13:40:00,115,101,Alimento,5,216
23862,2024-01-17 13:41:00,102,94,Brinquedo,8,196
23863,2024-01-17 13:42:00,42,13,Móvel,9,55
23864,2024-01-17 13:43:00,83,90,Alimento,9,173
23865,2024-01-17 13:44:00,88,121,Alimento,1,209
23866,2024-01-17 13:45:00,35,171,Vestuário,1,206
23867,2024-01-17 13:46:00,119,35,Eletrônico,9,154
23868,2024-01-17 13:47:00,21,58,Alimento,6,79
23869,2024-01-17 13:48:00,111,85,Vestuário,9,196
23870,2024-01-17 13:49:00,77,18,Brinquedo,9,95
23871,2024-01-17 13:50:00,13,57,Vestuário,8,70
23872,2024-01-17 13:51:00,87,170,Vestuário,7,257
23873,2024-01-17 13:52:00,109,174,Alimento,7,283
23874,2024-01-17 13:53:00,82,78,Alimento,1,160
23875,2024-01-17 13:54:00,42,163,Vestuário,1,205
23876,2024-01-17 13:55:00,103,27,Eletrônico,5,130
23877,2024-01-17 13:56:00,32,168,Eletrônico,3,200
23878,2024-01-17 13:57:00,70,150,Vestuário,2,220
23879,2024-01-17 13:58:00,70,176,Móvel,8,246
23880,2024-01-17 13:59:00,83,172,Alimento,4,255
23881,2024-01-17 14:00:00,109,169,Alimento,9,278
23882,2024-01-17 14:01:00,111,56,Eletrônico,3,167
23883,2024-01-17 14:02:00,80,70,Alimento,5,150
23884,2024-01-17 14:03:00,91,79,Brinquedo,5,170
23885,2024-01-17 14:04:00,62,115,Alimento,7,177
23886,2024-01-17 14:05:00,78,146,Vestuário,7,224
23887,2024-01-17 14:06:00,49,151,Alimento,6,200
23888,2024-01-17 14:07:00,78,117,Brinquedo,5,195
23889,2024-01-17 14:08:00,101,162,Alimento,7,263
23890,2024-01-17 14:09:00,83,48,Móvel,1,131
23891,2024-01-17 14:10:00,63,117,Eletrônico,5,180
23892,2024-01-17 14:11:00,18,163,Eletrônico,1,181
23893,2024-01-17 14:12:00,30,43,Vestuário,9,73
23894,2024-01-17 14:13:00,31,39,Alimento,8,70
23895,2024-01-17 14:14:00,61,159,Alimento,6,220
23896,2024-01-17 14:15:00,88,160,Brinquedo,5,248
23897,2024-01-17 14:16:00,37,34,Alimento,7,71
23898,2024-01-17 14:17:00,58,14,Vestuário,1,72
23899,2024-01-17 14:18:00,76,15,Móvel,6,91
23900,2024-01-17 14:19:00,59,49,Brinquedo,7,108
23901,2024-01-17 14:20:00,110,164,Eletrônico,8,274
23902,2024-01-17 14:21:00,30,72,Alimento,1,102
23903,2024-01-17 14:22:00,43,33,Brinquedo,1,76
23904,2024-01-17 14:23:00,62,19,Vestuário,8,81
23905,2024-01-17 14:24:00,31,115,Brinquedo,3,146
23906,2024-01-17 14:25:00,93,108,Brinquedo,9,201
23907,2024-01-17 14:26:00,24,116,Eletrônico,6,140
23908,2024-01-17 14:27:00,107,163,Vestuário,1,270
23909,2024-01-17 14:28:00,85,179,Vestuário,5,264
23910,2024-01-17 14:29:00,41,116,Alimento,3,157
23911,2024-01-17 14:30:00,70,27,Vestuário,8,97
23912,2024-01-17 14:31:00,114,60,Alimento,4,174
23913,2024-01-17 14:32:00,101,80,Brinquedo,4,181
23914,2024-01-17 14:33:00,115,67,Eletrônico,6,182
23915,2024-01-17 14:34:00,118,79,Alimento,9,197
23916,2024-01-17 14:35:00,85,56,Vestuário,5,141
23917,2024-01-17 14:36:00,20,21,Móvel,5,41
23918,2024-01-17 14:37:00,100,46,Eletrônico,7,146
23919,2024-01-17 14:38:00,35,158,Alimento,2,193
23920,2024-01-17 14:39:00,74,51,Eletrônico,4,125
23921,2024-01-17 14:40:00,59,10,Brinquedo,4,69
23922,2024-01-17 14:41:00,56,91,Móvel,8,147
23923,2024-01-17 14:42:00,55,136,Vestuário,8,191
23924,2024-01-17 14:43:00,77,58,Brinquedo,9,135
23925,2024-01-17 14:44:00,65,31,Brinquedo,8,96
23926,2024-01-17 14:45:00,42,55,Brinquedo,6,97
23927,2024-01-17 14:46:00,112,63,Eletrônico,1,175
23928,2024-01-17 14:47:00,98,36,Brinquedo,9,134
23929,2024-01-17 14:48:00,112,157,Vestuário,5,269
23930,2024-01-17 14:49:00,46,121,Móvel,3,167
23931,2024-01-17 14:50:00,55,171,Alimento,3,226
23932,2024-01-17 14:51:00,23,102,Brinquedo,4,125
23933,2024-01-17 14:52:00,61,102,Brinquedo,9,163
23934,2024-01-17 14:53:00,91,15,Eletrônico,4,106
23935,2024-01-17 14:54:00,73,137,Móvel,9,210
23936,2024-01-17 14:55:00,85,18,Eletrônico,7,103
23937,2024-01-17 14:56:00,13,126,Eletrônico,9,139
23938,2024-01-17 14:57:00,111,105,Vestuário,9,216
23939,2024-01-17 14:58:00,61,169,Móvel,9,230
23940,2024-01-17 14:59:00,55,129,Móvel,7,184
23941,2024-01-17 15:00:00,112,166,Móvel,3,278
23942,2024-01-17 15:01:00,30,151,Brinquedo,2,181
23943,2024-01-17 15:02:00,52,78,Móvel,7,130
23944,2024-01-17 15:03:00,92,17,Vestuário,4,109
23945,2024-01-17 15:04:00,27,80,Brinquedo,8,107
23946,2024-01-17 15:05:00,26,119,Brinquedo,9,145
23947,2024-01-17 15:06:00,119,164,Brinquedo,9,283
23948,2024-01-17 15:07:00,50,110,Eletrônico,5,160
23949,2024-01-17 15:08:00,92,139,Brinquedo,1,231
23950,2024-01-17 15:09:00,50,14,Vestuário,5,64
23951,2024-01-17 15:10:00,25,122,Brinquedo,3,147
23952,2024-01-17 15:11:00,44,69,Brinquedo,9,113
23953,2024-01-17 15:12:00,48,29,Brinquedo,6,77
23954,2024-01-17 15:13:00,29,133,Móvel,4,162
23955,2024-01-17 15:14:00,96,141,Eletrônico,6,237
23956,2024-01-17 15:15:00,76,58,Eletrônico,8,134
23957,2024-01-17 15:16:00,11,146,Eletrônico,1,157
23958,2024-01-17 15:17:00,117,24,Móvel,2,141
23959,2024-01-17 15:18:00,12,13,Alimento,9,25
23960,2024-01-17 15:19:00,78,121,Vestuário,2,199
23961,2024-01-17 15:20:00,47,121,Alimento,5,168
23962,2024-01-17 15:21:00,37,61,Alimento,1,98
23963,2024-01-17 15:22:00,29,161,Brinquedo,9,190
23964,2024-01-17 15:23:00,15,63,Eletrônico,6,78
23965,2024-01-17 15:24:00,112,155,Eletrônico,5,267
23966,2024-01-17 15:25:00,108,141,Móvel,9,249
23967,2024-01-17 15:26:00,18,42,Vestuário,4,60
23968,2024-01-17 15:27:00,75,76,Brinquedo,1,151
23969,2024-01-17 15:28:00,90,48,Brinquedo,7,138
23970,2024-01-17 15:29:00,49,157,Móvel,9,206
23971,2024-01-17 15:30:00,19,155,Brinquedo,6,174
23972,2024-01-17 15:31:00,110,33,Alimento,4,143
23973,2024-01-17 15:32:00,54,139,Vestuário,7,193
23974,2024-01-17 15:33:00,105,145,Vestuário,1,250
23975,2024-01-17 15:34:00,86,31,Alimento,4,117
23976,2024-01-17 15:35:00,91,142,Alimento,7,233
23977,2024-01-17 15:36:00,58,44,Eletrônico,4,102
23978,2024-01-17 15:37:00,101,158,Vestuário,2,259
23979,2024-01-17 15:38:00,88,137,Brinquedo,7,225
23980,2024-01-17 15:39:00,82,19,Brinquedo,8,101
23981,2024-01-17 15:40:00,76,174,Móvel,2,250
23982,2024-01-17 15:41:00,75,128,Brinquedo,4,203
23983,2024-01-17 15:42:00,67,159,Eletrônico,6,226
23984,2024-01-17 15:43:00,60,29,Vestuário,5,89
23985,2024-01-17 15:44:00,62,93,Brinquedo,7,155
23986,2024-01-17 15:45:00,117,158,Alimento,7,275
23987,2024-01-17 15:46:00,73,55,Móvel,4,128
23988,2024-01-17 15:47:00,12,119,Vestuário,3,131
23989,2024-01-17 15:48:00,28,107,Vestuário,8,135
23990,2024-01-17 15:49:00,42,60,Brinquedo,1,102
23991,2024-01-17 15:50:00,61,111,Vestuário,8,172
23992,2024-01-17 15:51:00,19,101,Móvel,8,120
23993,2024-01-17 15:52:00,47,69,Eletrônico,4,116
23994,2024-01-17 15:53:00,67,74,Móvel,3,141
23995,2024-01-17 15:54:00,68,64,Vestuário,1,132
23996,2024-01-17 15:55:00,57,24,Móvel,1,81
23997,2024-01-17 15:56:00,116,179,Móvel,8,295
23998,2024-01-17 15:57:00,118,101,Móvel,1,219
23999,2024-01-17 15:58:00,86,108,Móvel,3,194
24000,2024-01-17 15:59:00,104,132,Móvel,9,236
24001,2024-01-17 16:00:00,102,137,Vestuário,8,239
24002,2024-01-17 16:01:00,17,97,Brinquedo,7,114
24003,2024-01-17 16:02:00,20,133,Alimento,8,153
24004,2024-01-17 16:03:00,100,132,Vestuário,7,232
24005,2024-01-17 16:04:00,38,137,Vestuário,7,175
24006,2024-01-17 16:05:00,23,149,Brinquedo,7,172
24007,2024-01-17 16:06:00,100,84,Alimento,7,184
24008,2024-01-17 16:07:00,65,71,Vestuário,9,136
24009,2024-01-17 16:08:00,51,177,Alimento,8,228
24010,2024-01-17 16:09:00,10,59,Alimento,4,69
24011,2024-01-17 16:10:00,68,26,Vestuário,5,94
24012,2024-01-17 16:11:00,54,29,Vestuário,1,83
24013,2024-01-17 16:12:00,85,11,Vestuário,2,96
24014,2024-01-17 16:13:00,45,36,Eletrônico,3,81
24015,2024-01-17 16:14:00,42,50,Brinquedo,8,92
24016,2024-01-17 16:15:00,25,26,Vestuário,8,51
24017,2024-01-17 16:16:00,93,163,Alimento,7,256
24018,2024-01-17 16:17:00,103,105,Móvel,4,208
24019,2024-01-17 16:18:00,76,10,Vestuário,7,86
24020,2024-01-17 16:19:00,27,155,Eletrônico,9,182
24021,2024-01-17 16:20:00,35,24,Eletrônico,1,59
24022,2024-01-17 16:21:00,98,54,Alimento,2,152
24023,2024-01-17 16:22:00,69,158,Alimento,2,227
24024,2024-01-17 16:23:00,48,75,Brinquedo,5,123
24025,2024-01-17 16:24:00,63,63,Móvel,7,126
24026,2024-01-17 16:25:00,48,174,Vestuário,3,222
24027,2024-01-17 16:26:00,100,76,Vestuário,7,176
24028,2024-01-17 16:27:00,38,28,Brinquedo,8,66
24029,2024-01-17 16:28:00,72,130,Móvel,6,202
24030,2024-01-17 16:29:00,29,159,Eletrônico,2,188
24031,2024-01-17 16:30:00,113,29,Alimento,7,142
24032,2024-01-17 16:31:00,10,39,Vestuário,4,49
24033,2024-01-17 16:32:00,65,166,Eletrônico,8,231
24034,2024-01-17 16:33:00,109,178,Alimento,2,287
24035,2024-01-17 16:34:00,23,21,Vestuário,7,44
24036,2024-01-17 16:35:00,20,78,Alimento,5,98
24037,2024-01-17 16:36:00,27,81,Móvel,5,108
24038,2024-01-17 16:37:00,14,141,Brinquedo,7,155
24039,2024-01-17 16:38:00,30,73,Eletrônico,5,103
24040,2024-01-17 16:39:00,74,13,Alimento,6,87
24041,2024-01-17 16:40:00,75,136,Brinquedo,5,211
24042,2024-01-17 16:41:00,24,106,Móvel,9,130
24043,2024-01-17 16:42:00,87,127,Alimento,6,214
24044,2024-01-17 16:43:00,26,59,Alimento,1,85
24045,2024-01-17 16:44:00,109,84,Móvel,5,193
24046,2024-01-17 16:45:00,87,120,Brinquedo,1,207
24047,2024-01-17 16:46:00,119,10,Alimento,8,129
24048,2024-01-17 16:47:00,64,141,Brinquedo,1,205
24049,2024-01-17 16:48:00,11,167,Eletrônico,3,178
24050,2024-01-17 16:49:00,98,43,Alimento,1,141
24051,2024-01-17 16:50:00,119,137,Brinquedo,1,256
24052,2024-01-17 16:51:00,24,73,Brinquedo,4,97
24053,2024-01-17 16:52:00,78,125,Brinquedo,6,203
24054,2024-01-17 16:53:00,112,107,Móvel,2,219
24055,2024-01-17 16:54:00,116,34,Vestuário,8,150
24056,2024-01-17 16:55:00,56,85,Eletrônico,7,141
24057,2024-01-17 16:56:00,17,32,Alimento,6,49
24058,2024-01-17 16:57:00,54,61,Vestuário,6,115
24059,2024-01-17 16:58:00,46,10,Alimento,3,56
24060,2024-01-17 16:59:00,74,146,Vestuário,8,220
24061,2024-01-17 17:00:00,92,127,Brinquedo,4,219
24062,2024-01-17 17:01:00,78,59,Móvel,5,137
24063,2024-01-17 17:02:00,97,98,Vestuário,3,195
24064,2024-01-17 17:03:00,108,165,Móvel,6,273
24065,2024-01-17 17:04:00,29,55,Brinquedo,1,84
24066,2024-01-17 17:05:00,109,99,Eletrônico,4,208
24067,2024-01-17 17:06:00,85,149,Móvel,5,234
24068,2024-01-17 17:07:00,44,132,Brinquedo,6,176
24069,2024-01-17 17:08:00,103,130,Vestuário,9,233
24070,2024-01-17 17:09:00,51,79,Eletrônico,3,130
24071,2024-01-17 17:10:00,22,129,Móvel,5,151
24072,2024-01-17 17:11:00,13,120,Brinquedo,3,133
24073,2024-01-17 17:12:00,86,131,Brinquedo,9,217
24074,2024-01-17 17:13:00,76,125,Eletrônico,8,201
24075,2024-01-17 17:14:00,68,40,Eletrônico,7,108
24076,2024-01-17 17:15:00,37,13,Vestuário,2,50
24077,2024-01-17 17:16:00,13,38,Brinquedo,1,51
24078,2024-01-17 17:17:00,73,151,Alimento,3,224
24079,2024-01-17 17:18:00,45,142,Vestuário,1,187
24080,2024-01-17 17:19:00,52,154,Alimento,1,206
24081,2024-01-17 17:20:00,13,17,Móvel,8,30
24082,2024-01-17 17:21:00,68,42,Eletrônico,9,110
24083,2024-01-17 17:22:00,25,148,Alimento,9,173
24084,2024-01-17 17:23:00,118,152,Eletrônico,5,270
24085,2024-01-17 17:24:00,79,90,Alimento,5,169
24086,2024-01-17 17:25:00,113,51,Brinquedo,7,164
24087,2024-01-17 17:26:00,71,87,Eletrônico,4,158
24088,2024-01-17 17:27:00,75,53,Brinquedo,4,128
24089,2024-01-17 17:28:00,116,163,Móvel,5,279
24090,2024-01-17 17:29:00,104,80,Vestuário,3,184
24091,2024-01-17 17:30:00,99,70,Vestuário,9,169
24092,2024-01-17 17:31:00,67,89,Brinquedo,2,156
24093,2024-01-17 17:32:00,67,92,Eletrônico,2,159
24094,2024-01-17 17:33:00,110,103,Brinquedo,5,213
24095,2024-01-17 17:34:00,93,109,Eletrônico,3,202
24096,2024-01-17 17:35:00,71,85,Móvel,8,156
24097,2024-01-17 17:36:00,85,67,Alimento,5,152
24098,2024-01-17 17:37:00,35,12,Móvel,4,47
24099,2024-01-17 17:38:00,72,20,Móvel,9,92
24100,2024-01-17 17:39:00,70,152,Vestuário,8,222
24101,2024-01-17 17:40:00,119,29,Alimento,7,148
24102,2024-01-17 17:41:00,76,85,Alimento,2,161
24103,2024-01-17 17:42:00,14,123,Brinquedo,5,137
24104,2024-01-17 17:43:00,34,30,Vestuário,9,64
24105,2024-01-17 17:44:00,75,32,Eletrônico,3,107
24106,2024-01-17 17:45:00,20,14,Móvel,4,34
24107,2024-01-17 17:46:00,22,173,Móvel,3,195
24108,2024-01-17 17:47:00,44,16,Móvel,2,60
24109,2024-01-17 17:48:00,103,12,Alimento,4,115
24110,2024-01-17 17:49:00,54,34,Eletrônico,4,88
24111,2024-01-17 17:50:00,81,13,Alimento,1,94
24112,2024-01-17 17:51:00,55,111,Alimento,8,166
24113,2024-01-17 17:52:00,40,28,Eletrônico,5,68
24114,2024-01-17 17:53:00,107,120,Vestuário,6,227
24115,2024-01-17 17:54:00,53,70,Alimento,2,123
24116,2024-01-17 17:55:00,51,32,Vestuário,9,83
24117,2024-01-17 17:56:00,103,34,Alimento,4,137
24118,2024-01-17 17:57:00,61,115,Móvel,9,176
24119,2024-01-17 17:58:00,15,120,Móvel,1,135
24120,2024-01-17 17:59:00,45,48,Móvel,6,93
24121,2024-01-17 18:00:00,48,117,Vestuário,5,165
24122,2024-01-17 18:01:00,74,27,Móvel,6,101
24123,2024-01-17 18:02:00,89,26,Brinquedo,6,115
24124,2024-01-17 18:03:00,25,31,Vestuário,2,56
24125,2024-01-17 18:04:00,40,143,Vestuário,4,183
24126,2024-01-17 18:05:00,23,22,Alimento,2,45
24127,2024-01-17 18:06:00,42,32,Eletrônico,7,74
24128,2024-01-17 18:07:00,99,82,Móvel,6,181
24129,2024-01-17 18:08:00,55,85,Eletrônico,3,140
24130,2024-01-17 18:09:00,80,62,Eletrônico,7,142
24131,2024-01-17 18:10:00,101,156,Eletrônico,3,257
24132,2024-01-17 18:11:00,32,132,Alimento,6,164
24133,2024-01-17 18:12:00,36,159,Móvel,3,195
24134,2024-01-17 18:13:00,92,126,Móvel,1,218
24135,2024-01-17 18:14:00,62,134,Eletrônico,6,196
24136,2024-01-17 18:15:00,34,170,Alimento,1,204
24137,2024-01-17 18:16:00,18,86,Vestuário,5,104
24138,2024-01-17 18:17:00,30,24,Alimento,2,54
24139,2024-01-17 18:18:00,69,48,Alimento,7,117
24140,2024-01-17 18:19:00,23,62,Vestuário,8,85
24141,2024-01-17 18:20:00,47,60,Eletrônico,8,107
24142,2024-01-17 18:21:00,93,43,Alimento,9,136
24143,2024-01-17 18:22:00,65,38,Vestuário,5,103
24144,2024-01-17 18:23:00,44,57,Alimento,3,101
24145,2024-01-17 18:24:00,30,51,Vestuário,4,81
24146,2024-01-17 18:25:00,86,55,Brinquedo,4,141
24147,2024-01-17 18:26:00,105,140,Brinquedo,6,245
24148,2024-01-17 18:27:00,30,132,Brinquedo,4,162
24149,2024-01-17 18:28:00,10,108,Brinquedo,2,118
24150,2024-01-17 18:29:00,117,44,Vestuário,9,161
24151,2024-01-17 18:30:00,108,121,Móvel,4,229
24152,2024-01-17 18:31:00,86,21,Móvel,9,107
24153,2024-01-17 18:32:00,67,124,Brinquedo,6,191
24154,2024-01-17 18:33:00,19,157,Brinquedo,9,176
24155,2024-01-17 18:34:00,75,79,Brinquedo,2,154
24156,2024-01-17 18:35:00,95,100,Alimento,6,195
24157,2024-01-17 18:36:00,59,152,Vestuário,4,211
24158,2024-01-17 18:37:00,113,151,Eletrônico,9,264
24159,2024-01-17 18:38:00,86,81,Móvel,5,167
24160,2024-01-17 18:39:00,61,98,Alimento,7,159
24161,2024-01-17 18:40:00,85,97,Eletrônico,1,182
24162,2024-01-17 18:41:00,51,61,Móvel,3,112
24163,2024-01-17 18:42:00,106,90,Eletrônico,6,196
24164,2024-01-17 18:43:00,47,166,Brinquedo,5,213
24165,2024-01-17 18:44:00,32,58,Eletrônico,9,90
24166,2024-01-17 18:45:00,112,145,Móvel,5,257
24167,2024-01-17 18:46:00,49,96,Móvel,5,145
24168,2024-01-17 18:47:00,114,174,Brinquedo,3,288
24169,2024-01-17 18:48:00,115,83,Brinquedo,4,198
24170,2024-01-17 18:49:00,104,14,Vestuário,7,118
24171,2024-01-17 18:50:00,83,127,Alimento,6,210
24172,2024-01-17 18:51:00,17,175,Alimento,3,192
24173,2024-01-17 18:52:00,12,99,Vestuário,7,111
24174,2024-01-17 18:53:00,80,142,Eletrônico,7,222
24175,2024-01-17 18:54:00,105,139,Brinquedo,3,244
24176,2024-01-17 18:55:00,32,112,Vestuário,9,144
24177,2024-01-17 18:56:00,31,70,Brinquedo,5,101
24178,2024-01-17 18:57:00,26,30,Móvel,1,56
24179,2024-01-17 18:58:00,80,47,Vestuário,3,127
24180,2024-01-17 18:59:00,113,123,Brinquedo,2,236
24181,2024-01-17 19:00:00,44,33,Brinquedo,8,77
24182,2024-01-17 19:01:00,56,105,Eletrônico,4,161
24183,2024-01-17 19:02:00,66,15,Eletrônico,4,81
24184,2024-01-17 19:03:00,110,70,Alimento,8,180
24185,2024-01-17 19:04:00,95,56,Eletrônico,4,151
24186,2024-01-17 19:05:00,88,150,Brinquedo,4,238
24187,2024-01-17 19:06:00,66,30,Brinquedo,1,96
24188,2024-01-17 19:07:00,66,32,Vestuário,2,98
24189,2024-01-17 19:08:00,115,158,Eletrônico,7,273
24190,2024-01-17 19:09:00,46,169,Eletrônico,5,215
24191,2024-01-17 19:10:00,41,175,Eletrônico,4,216
24192,2024-01-17 19:11:00,26,10,Alimento,2,36
24193,2024-01-17 19:12:00,50,125,Alimento,9,175
24194,2024-01-17 19:13:00,33,44,Eletrônico,3,77
24195,2024-01-17 19:14:00,78,107,Alimento,5,185
24196,2024-01-17 19:15:00,67,142,Vestuário,9,209
24197,2024-01-17 19:16:00,57,47,Vestuário,7,104
24198,2024-01-17 19:17:00,69,64,Móvel,6,133
24199,2024-01-17 19:18:00,112,142,Brinquedo,3,254
24200,2024-01-17 19:19:00,27,155,Alimento,7,182
24201,2024-01-17 19:20:00,34,46,Vestuário,5,80
24202,2024-01-17 19:21:00,38,44,Vestuário,9,82
24203,2024-01-17 19:22:00,97,52,Brinquedo,6,149
24204,2024-01-17 19:23:00,25,70,Móvel,4,95
24205,2024-01-17 19:24:00,91,106,Eletrônico,2,197
24206,2024-01-17 19:25:00,98,172,Brinquedo,7,270
24207,2024-01-17 19:26:00,11,144,Móvel,5,155
24208,2024-01-17 19:27:00,84,177,Alimento,2,261
24209,2024-01-17 19:28:00,83,58,Brinquedo,5,141
24210,2024-01-17 19:29:00,82,70,Alimento,2,152
24211,2024-01-17 19:30:00,13,56,Alimento,6,69
24212,2024-01-17 19:31:00,73,57,Brinquedo,5,130
24213,2024-01-17 19:32:00,58,115,Brinquedo,7,173
24214,2024-01-17 19:33:00,11,143,Móvel,3,154
24215,2024-01-17 19:34:00,57,105,Brinquedo,9,162
24216,2024-01-17 19:35:00,30,90,Móvel,8,120
24217,2024-01-17 19:36:00,38,49,Eletrônico,6,87
24218,2024-01-17 19:37:00,15,36,Alimento,2,51
24219,2024-01-17 19:38:00,112,68,Vestuário,8,180
24220,2024-01-17 19:39:00,64,142,Alimento,9,206
24221,2024-01-17 19:40:00,73,145,Brinquedo,9,218
24222,2024-01-17 19:41:00,92,59,Vestuário,2,151
24223,2024-01-17 19:42:00,89,162,Vestuário,3,251
24224,2024-01-17 19:43:00,12,42,Vestuário,4,54
24225,2024-01-17 19:44:00,57,55,Móvel,4,112
24226,2024-01-17 19:45:00,79,18,Brinquedo,2,97
24227,2024-01-17 19:46:00,95,27,Alimento,4,122
24228,2024-01-17 19:47:00,21,86,Alimento,7,107
24229,2024-01-17 19:48:00,63,178,Eletrônico,2,241
24230,2024-01-17 19:49:00,63,110,Alimento,1,173
24231,2024-01-17 19:50:00,42,175,Brinquedo,8,217
24232,2024-01-17 19:51:00,59,116,Brinquedo,9,175
24233,2024-01-17 19:52:00,100,168,Móvel,7,268
24234,2024-01-17 19:53:00,85,125,Alimento,7,210
24235,2024-01-17 19:54:00,83,72,Brinquedo,9,155
24236,2024-01-17 19:55:00,11,27,Alimento,3,38
24237,2024-01-17 19:56:00,106,59,Eletrônico,7,165
24238,2024-01-17 19:57:00,108,175,Alimento,9,283
24239,2024-01-17 19:58:00,44,64,Alimento,1,108
24240,2024-01-17 19:59:00,65,65,Vestuário,5,130
24241,2024-01-17 20:00:00,116,94,Alimento,6,210
24242,2024-01-17 20:01:00,74,79,Vestuário,7,153
24243,2024-01-17 20:02:00,90,52,Eletrônico,6,142
24244,2024-01-17 20:03:00,76,96,Eletrônico,3,172
24245,2024-01-17 20:04:00,109,52,Móvel,6,161
24246,2024-01-17 20:05:00,15,21,Móvel,5,36
24247,2024-01-17 20:06:00,88,58,Móvel,2,146
24248,2024-01-17 20:07:00,39,65,Brinquedo,2,104
24249,2024-01-17 20:08:00,98,45,Brinquedo,7,143
24250,2024-01-17 20:09:00,34,99,Brinquedo,6,133
24251,2024-01-17 20:10:00,22,151,Brinquedo,4,173
24252,2024-01-17 20:11:00,87,57,Vestuário,1,144
24253,2024-01-17 20:12:00,61,95,Brinquedo,7,156
24254,2024-01-17 20:13:00,53,152,Eletrônico,5,205
24255,2024-01-17 20:14:00,52,28,Alimento,5,80
24256,2024-01-17 20:15:00,37,164,Móvel,7,201
24257,2024-01-17 20:16:00,48,109,Eletrônico,9,157
24258,2024-01-17 20:17:00,53,49,Vestuário,5,102
24259,2024-01-17 20:18:00,51,139,Alimento,5,190
24260,2024-01-17 20:19:00,44,32,Móvel,7,76
24261,2024-01-17 20:20:00,36,117,Eletrônico,9,153
24262,2024-01-17 20:21:00,38,19,Brinquedo,3,57
24263,2024-01-17 20:22:00,16,140,Eletrônico,8,156
24264,2024-01-17 20:23:00,58,166,Brinquedo,3,224
24265,2024-01-17 20:24:00,114,73,Vestuário,7,187
24266,2024-01-17 20:25:00,70,145,Móvel,8,215
24267,2024-01-17 20:26:00,67,158,Brinquedo,1,225
24268,2024-01-17 20:27:00,101,27,Eletrônico,4,128
24269,2024-01-17 20:28:00,11,38,Alimento,3,49
24270,2024-01-17 20:29:00,31,145,Vestuário,4,176
24271,2024-01-17 20:30:00,97,135,Móvel,7,232
24272,2024-01-17 20:31:00,15,127,Eletrônico,1,142
24273,2024-01-17 20:32:00,98,111,Móvel,5,209
24274,2024-01-17 20:33:00,102,76,Móvel,6,178
24275,2024-01-17 20:34:00,105,121,Móvel,6,226
24276,2024-01-17 20:35:00,38,103,Vestuário,9,141
24277,2024-01-17 20:36:00,98,138,Vestuário,2,236
24278,2024-01-17 20:37:00,47,66,Vestuário,6,113
24279,2024-01-17 20:38:00,52,34,Móvel,1,86
24280,2024-01-17 20:39:00,102,120,Vestuário,7,222
24281,2024-01-17 20:40:00,18,88,Vestuário,3,106
24282,2024-01-17 20:41:00,27,153,Móvel,6,180
24283,2024-01-17 20:42:00,41,102,Eletrônico,7,143
24284,2024-01-17 20:43:00,54,116,Móvel,6,170
24285,2024-01-17 20:44:00,105,82,Móvel,5,187
24286,2024-01-17 20:45:00,27,16,Brinquedo,5,43
24287,2024-01-17 20:46:00,52,73,Móvel,8,125
24288,2024-01-17 20:47:00,76,106,Alimento,2,182
24289,2024-01-17 20:48:00,52,70,Brinquedo,8,122
24290,2024-01-17 20:49:00,118,156,Vestuário,1,274
24291,2024-01-17 20:50:00,101,153,Móvel,3,254
24292,2024-01-17 20:51:00,88,142,Alimento,7,230
24293,2024-01-17 20:52:00,75,63,Eletrônico,9,138
24294,2024-01-17 20:53:00,51,157,Vestuário,3,208
24295,2024-01-17 20:54:00,63,94,Alimento,2,157
24296,2024-01-17 20:55:00,39,97,Vestuário,7,136
24297,2024-01-17 20:56:00,72,115,Alimento,4,187
24298,2024-01-17 20:57:00,106,103,Móvel,7,209
24299,2024-01-17 20:58:00,106,134,Eletrônico,6,240
24300,2024-01-17 20:59:00,18,174,Alimento,4,192
24301,2024-01-17 21:00:00,106,108,Móvel,6,214
24302,2024-01-17 21:01:00,50,134,Eletrônico,4,184
24303,2024-01-17 21:02:00,73,160,Eletrônico,7,233
24304,2024-01-17 21:03:00,13,141,Vestuário,5,154
24305,2024-01-17 21:04:00,99,75,Alimento,1,174
24306,2024-01-17 21:05:00,62,169,Vestuário,7,231
24307,2024-01-17 21:06:00,56,118,Brinquedo,5,174
24308,2024-01-17 21:07:00,16,53,Eletrônico,1,69
24309,2024-01-17 21:08:00,45,74,Móvel,9,119
24310,2024-01-17 21:09:00,72,80,Alimento,6,152
24311,2024-01-17 21:10:00,50,32,Brinquedo,7,82
24312,2024-01-17 21:11:00,79,66,Eletrônico,8,145
24313,2024-01-17 21:12:00,89,114,Eletrônico,4,203
24314,2024-01-17 21:13:00,19,14,Alimento,4,33
24315,2024-01-17 21:14:00,80,115,Móvel,7,195
24316,2024-01-17 21:15:00,112,89,Alimento,9,201
24317,2024-01-17 21:16:00,34,72,Vestuário,4,106
24318,2024-01-17 21:17:00,34,167,Móvel,1,201
24319,2024-01-17 21:18:00,19,26,Alimento,6,45
24320,2024-01-17 21:19:00,19,122,Brinquedo,3,141
24321,2024-01-17 21:20:00,44,132,Eletrônico,3,176
24322,2024-01-17 21:21:00,62,57,Eletrônico,7,119
24323,2024-01-17 21:22:00,46,31,Vestuário,8,77
24324,2024-01-17 21:23:00,108,78,Brinquedo,6,186
24325,2024-01-17 21:24:00,118,151,Alimento,7,269
24326,2024-01-17 21:25:00,68,50,Vestuário,3,118
24327,2024-01-17 21:26:00,63,92,Brinquedo,8,155
24328,2024-01-17 21:27:00,117,52,Brinquedo,5,169
24329,2024-01-17 21:28:00,28,168,Móvel,8,196
24330,2024-01-17 21:29:00,45,137,Eletrônico,9,182
24331,2024-01-17 21:30:00,78,162,Vestuário,4,240
24332,2024-01-17 21:31:00,14,35,Eletrônico,1,49
24333,2024-01-17 21:32:00,94,81,Brinquedo,8,175
24334,2024-01-17 21:33:00,89,123,Eletrônico,1,212
24335,2024-01-17 21:34:00,76,89,Brinquedo,3,165
24336,2024-01-17 21:35:00,75,30,Móvel,3,105
24337,2024-01-17 21:36:00,81,131,Vestuário,6,212
24338,2024-01-17 21:37:00,35,68,Eletrônico,8,103
24339,2024-01-17 21:38:00,56,20,Brinquedo,2,76
24340,2024-01-17 21:39:00,13,118,Vestuário,2,131
24341,2024-01-17 21:40:00,24,36,Alimento,3,60
24342,2024-01-17 21:41:00,13,56,Vestuário,2,69
24343,2024-01-17 21:42:00,81,172,Brinquedo,5,253
24344,2024-01-17 21:43:00,101,177,Eletrônico,5,278
24345,2024-01-17 21:44:00,108,16,Alimento,6,124
24346,2024-01-17 21:45:00,90,109,Vestuário,8,199
24347,2024-01-17 21:46:00,67,73,Móvel,5,140
24348,2024-01-17 21:47:00,51,120,Vestuário,4,171
24349,2024-01-17 21:48:00,44,110,Alimento,4,154
24350,2024-01-17 21:49:00,40,157,Alimento,9,197
24351,2024-01-17 21:50:00,33,149,Móvel,1,182
24352,2024-01-17 21:51:00,65,81,Alimento,9,146
24353,2024-01-17 21:52:00,20,108,Alimento,5,128
24354,2024-01-17 21:53:00,36,152,Móvel,9,188
24355,2024-01-17 21:54:00,52,96,Móvel,9,148
24356,2024-01-17 21:55:00,14,49,Eletrônico,2,63
24357,2024-01-17 21:56:00,12,172,Eletrônico,2,184
24358,2024-01-17 21:57:00,101,63,Brinquedo,7,164
24359,2024-01-17 21:58:00,15,37,Vestuário,4,52
24360,2024-01-17 21:59:00,102,127,Eletrônico,7,229
24361,2024-01-17 22:00:00,70,170,Brinquedo,2,240
24362,2024-01-17 22:01:00,93,150,Alimento,5,243
24363,2024-01-17 22:02:00,34,148,Alimento,1,182
24364,2024-01-17 22:03:00,25,142,Vestuário,1,167
24365,2024-01-17 22:04:00,80,118,Vestuário,2,198
24366,2024-01-17 22:05:00,68,43,Móvel,5,111
24367,2024-01-17 22:06:00,115,11,Eletrônico,7,126
24368,2024-01-17 22:07:00,95,92,Vestuário,7,187
24369,2024-01-17 22:08:00,39,107,Eletrônico,9,146
24370,2024-01-17 22:09:00,11,56,Eletrônico,7,67
24371,2024-01-17 22:10:00,41,34,Brinquedo,7,75
24372,2024-01-17 22:11:00,85,112,Brinquedo,3,197
24373,2024-01-17 22:12:00,117,128,Brinquedo,2,245
24374,2024-01-17 22:13:00,74,43,Eletrônico,5,117
24375,2024-01-17 22:14:00,72,116,Alimento,5,188
24376,2024-01-17 22:15:00,89,132,Eletrônico,3,221
24377,2024-01-17 22:16:00,40,174,Brinquedo,6,214
24378,2024-01-17 22:17:00,42,57,Vestuário,2,99
24379,2024-01-17 22:18:00,51,138,Brinquedo,6,189
24380,2024-01-17 22:19:00,108,38,Alimento,5,146
24381,2024-01-17 22:20:00,84,138,Móvel,9,222
24382,2024-01-17 22:21:00,43,146,Alimento,7,189
24383,2024-01-17 22:22:00,93,172,Brinquedo,7,265
24384,2024-01-17 22:23:00,22,98,Móvel,4,120
24385,2024-01-17 22:24:00,67,61,Vestuário,7,128
24386,2024-01-17 22:25:00,54,106,Móvel,4,160
24387,2024-01-17 22:26:00,47,116,Alimento,7,163
24388,2024-01-17 22:27:00,50,169,Brinquedo,2,219
24389,2024-01-17 22:28:00,19,126,Vestuário,9,145
24390,2024-01-17 22:29:00,14,96,Vestuário,2,110
24391,2024-01-17 22:30:00,53,61,Eletrônico,9,114
24392,2024-01-17 22:31:00,112,41,Vestuário,6,153
24393,2024-01-17 22:32:00,31,72,Brinquedo,4,103
24394,2024-01-17 22:33:00,53,31,Móvel,2,84
24395,2024-01-17 22:34:00,72,136,Vestuário,2,208
24396,2024-01-17 22:35:00,87,179,Vestuário,3,266
24397,2024-01-17 22:36:00,48,113,Alimento,3,161
24398,2024-01-17 22:37:00,86,16,Brinquedo,4,102
24399,2024-01-17 22:38:00,54,152,Brinquedo,5,206
24400,2024-01-17 22:39:00,73,136,Eletrônico,3,209
24401,2024-01-17 22:40:00,119,126,Eletrônico,3,245
24402,2024-01-17 22:41:00,71,158,Alimento,2,229
24403,2024-01-17 22:42:00,116,63,Vestuário,6,179
24404,2024-01-17 22:43:00,46,102,Eletrônico,8,148
24405,2024-01-17 22:44:00,66,61,Vestuário,5,127
24406,2024-01-17 22:45:00,40,36,Vestuário,9,76
24407,2024-01-17 22:46:00,74,177,Vestuário,3,251
24408,2024-01-17 22:47:00,86,33,Brinquedo,3,119
24409,2024-01-17 22:48:00,58,43,Brinquedo,2,101
24410,2024-01-17 22:49:00,86,44,Vestuário,3,130
24411,2024-01-17 22:50:00,96,88,Móvel,4,184
24412,2024-01-17 22:51:00,49,18,Eletrônico,2,67
24413,2024-01-17 22:52:00,77,164,Eletrônico,6,241
24414,2024-01-17 22:53:00,83,138,Brinquedo,7,221
24415,2024-01-17 22:54:00,105,177,Móvel,3,282
24416,2024-01-17 22:55:00,67,111,Alimento,6,178
24417,2024-01-17 22:56:00,17,118,Eletrônico,5,135
24418,2024-01-17 22:57:00,40,56,Móvel,4,96
24419,2024-01-17 22:58:00,114,12,Vestuário,7,126
24420,2024-01-17 22:59:00,18,39,Móvel,8,57
24421,2024-01-17 23:00:00,19,117,Vestuário,4,136
24422,2024-01-17 23:01:00,13,10,Vestuário,1,23
24423,2024-01-17 23:02:00,16,179,Alimento,4,195
24424,2024-01-17 23:03:00,39,150,Móvel,9,189
24425,2024-01-17 23:04:00,17,88,Vestuário,6,105
24426,2024-01-17 23:05:00,51,140,Eletrônico,5,191
24427,2024-01-17 23:06:00,60,48,Alimento,3,108
24428,2024-01-17 23:07:00,56,51,Vestuário,9,107
24429,2024-01-17 23:08:00,117,115,Vestuário,5,232
24430,2024-01-17 23:09:00,55,173,Brinquedo,2,228
24431,2024-01-17 23:10:00,12,130,Vestuário,1,142
24432,2024-01-17 23:11:00,11,150,Brinquedo,4,161
24433,2024-01-17 23:12:00,38,46,Vestuário,6,84
24434,2024-01-17 23:13:00,48,94,Eletrônico,5,142
24435,2024-01-17 23:14:00,102,110,Vestuário,8,212
24436,2024-01-17 23:15:00,105,11,Vestuário,9,116
24437,2024-01-17 23:16:00,62,44,Vestuário,9,106
24438,2024-01-17 23:17:00,44,175,Brinquedo,5,219
24439,2024-01-17 23:18:00,66,101,Brinquedo,8,167
24440,2024-01-17 23:19:00,90,17,Móvel,7,107
24441,2024-01-17 23:20:00,53,140,Brinquedo,2,193
24442,2024-01-17 23:21:00,52,25,Alimento,2,77
24443,2024-01-17 23:22:00,35,162,Móvel,4,197
24444,2024-01-17 23:23:00,11,120,Móvel,7,131
24445,2024-01-17 23:24:00,47,170,Vestuário,8,217
24446,2024-01-17 23:25:00,40,81,Eletrônico,3,121
24447,2024-01-17 23:26:00,54,13,Móvel,1,67
24448,2024-01-17 23:27:00,99,179,Alimento,4,278
24449,2024-01-17 23:28:00,86,154,Vestuário,3,240
24450,2024-01-17 23:29:00,43,44,Vestuário,3,87
24451,2024-01-17 23:30:00,99,173,Móvel,5,272
24452,2024-01-17 23:31:00,28,13,Eletrônico,2,41
24453,2024-01-17 23:32:00,61,141,Brinquedo,3,202
24454,2024-01-17 23:33:00,15,46,Eletrônico,9,61
24455,2024-01-17 23:34:00,28,127,Móvel,4,155
24456,2024-01-17 23:35:00,27,65,Móvel,9,92
24457,2024-01-17 23:36:00,110,41,Vestuário,4,151
24458,2024-01-17 23:37:00,55,175,Brinquedo,1,230
24459,2024-01-17 23:38:00,22,51,Eletrônico,8,73
24460,2024-01-17 23:39:00,68,175,Móvel,4,243
24461,2024-01-17 23:40:00,49,47,Eletrônico,1,96
24462,2024-01-17 23:41:00,48,109,Brinquedo,6,157
24463,2024-01-17 23:42:00,18,38,Eletrônico,7,56
24464,2024-01-17 23:43:00,112,99,Eletrônico,5,211
24465,2024-01-17 23:44:00,62,43,Vestuário,2,105
24466,2024-01-17 23:45:00,49,168,Vestuário,6,217
24467,2024-01-17 23:46:00,113,145,Brinquedo,8,258
24468,2024-01-17 23:47:00,11,134,Vestuário,8,145
24469,2024-01-17 23:48:00,110,144,Móvel,6,254
24470,2024-01-17 23:49:00,26,51,Vestuário,8,77
24471,2024-01-17 23:50:00,109,152,Móvel,7,261
24472,2024-01-17 23:51:00,65,164,Brinquedo,2,229
24473,2024-01-17 23:52:00,28,173,Vestuário,1,201
24474,2024-01-17 23:53:00,104,133,Eletrônico,4,237
24475,2024-01-17 23:54:00,76,73,Vestuário,7,149
24476,2024-01-17 23:55:00,19,77,Móvel,4,96
24477,2024-01-17 23:56:00,57,56,Vestuário,2,113
24478,2024-01-17 23:57:00,33,46,Alimento,2,79
24479,2024-01-17 23:58:00,47,46,Móvel,3,93
24480,2024-01-17 23:59:00,110,38,Brinquedo,2,148
24481,2024-01-18 00:00:00,118,147,Brinquedo,2,265
24482,2024-01-18 00:01:00,64,111,Brinquedo,8,175
24483,2024-01-18 00:02:00,72,173,Brinquedo,5,245
24484,2024-01-18 00:03:00,68,79,Eletrônico,1,147
24485,2024-01-18 00:04:00,61,135,Alimento,3,196
24486,2024-01-18 00:05:00,50,44,Brinquedo,9,94
24487,2024-01-18 00:06:00,25,159,Eletrônico,2,184
24488,2024-01-18 00:07:00,78,86,Eletrônico,4,164
24489,2024-01-18 00:08:00,50,22,Brinquedo,3,72
24490,2024-01-18 00:09:00,15,141,Brinquedo,9,156
24491,2024-01-18 00:10:00,107,79,Móvel,3,186
24492,2024-01-18 00:11:00,88,89,Móvel,7,177
24493,2024-01-18 00:12:00,115,83,Móvel,1,198
24494,2024-01-18 00:13:00,62,139,Móvel,9,201
24495,2024-01-18 00:14:00,112,129,Eletrônico,8,241
24496,2024-01-18 00:15:00,98,90,Alimento,5,188
24497,2024-01-18 00:16:00,44,151,Vestuário,7,195
24498,2024-01-18 00:17:00,57,26,Alimento,4,83
24499,2024-01-18 00:18:00,20,39,Eletrônico,3,59
24500,2024-01-18 00:19:00,50,139,Móvel,2,189
24501,2024-01-18 00:20:00,79,22,Eletrônico,9,101
24502,2024-01-18 00:21:00,18,49,Brinquedo,2,67
24503,2024-01-18 00:22:00,113,24,Alimento,5,137
24504,2024-01-18 00:23:00,62,177,Brinquedo,3,239
24505,2024-01-18 00:24:00,20,54,Brinquedo,7,74
24506,2024-01-18 00:25:00,73,37,Eletrônico,7,110
24507,2024-01-18 00:26:00,60,103,Eletrônico,5,163
24508,2024-01-18 00:27:00,100,126,Móvel,6,226
24509,2024-01-18 00:28:00,113,100,Móvel,5,213
24510,2024-01-18 00:29:00,76,108,Brinquedo,4,184
24511,2024-01-18 00:30:00,25,144,Vestuário,6,169
24512,2024-01-18 00:31:00,104,11,Eletrônico,8,115
24513,2024-01-18 00:32:00,13,84,Eletrônico,3,97
24514,2024-01-18 00:33:00,24,176,Eletrônico,6,200
24515,2024-01-18 00:34:00,15,114,Vestuário,1,129
24516,2024-01-18 00:35:00,117,119,Brinquedo,8,236
24517,2024-01-18 00:36:00,23,133,Vestuário,7,156
24518,2024-01-18 00:37:00,70,133,Brinquedo,5,203
24519,2024-01-18 00:38:00,104,77,Eletrônico,2,181
24520,2024-01-18 00:39:00,96,149,Eletrônico,3,245
24521,2024-01-18 00:40:00,34,141,Alimento,7,175
24522,2024-01-18 00:41:00,41,75,Eletrônico,7,116
24523,2024-01-18 00:42:00,22,153,Eletrônico,8,175
24524,2024-01-18 00:43:00,56,34,Alimento,4,90
24525,2024-01-18 00:44:00,12,25,Vestuário,5,37
24526,2024-01-18 00:45:00,73,17,Móvel,1,90
24527,2024-01-18 00:46:00,40,14,Eletrônico,3,54
24528,2024-01-18 00:47:00,72,26,Móvel,9,98
24529,2024-01-18 00:48:00,66,24,Brinquedo,1,90
24530,2024-01-18 00:49:00,104,62,Móvel,9,166
24531,2024-01-18 00:50:00,103,47,Alimento,9,150
24532,2024-01-18 00:51:00,21,35,Eletrônico,4,56
24533,2024-01-18 00:52:00,60,53,Eletrônico,4,113
24534,2024-01-18 00:53:00,15,12,Vestuário,2,27
24535,2024-01-18 00:54:00,77,153,Alimento,5,230
24536,2024-01-18 00:55:00,54,96,Vestuário,9,150
24537,2024-01-18 00:56:00,13,54,Brinquedo,8,67
24538,2024-01-18 00:57:00,75,28,Móvel,5,103
24539,2024-01-18 00:58:00,66,82,Eletrônico,7,148
24540,2024-01-18 00:59:00,18,148,Vestuário,4,166
24541,2024-01-18 01:00:00,117,109,Móvel,4,226
24542,2024-01-18 01:01:00,87,82,Alimento,7,169
24543,2024-01-18 01:02:00,79,141,Eletrônico,4,220
24544,2024-01-18 01:03:00,30,159,Brinquedo,3,189
24545,2024-01-18 01:04:00,32,40,Brinquedo,8,72
24546,2024-01-18 01:05:00,94,11,Brinquedo,9,105
24547,2024-01-18 01:06:00,44,132,Eletrônico,6,176
24548,2024-01-18 01:07:00,71,44,Alimento,3,115
24549,2024-01-18 01:08:00,50,84,Brinquedo,6,134
24550,2024-01-18 01:09:00,90,135,Vestuário,4,225
24551,2024-01-18 01:10:00,102,46,Eletrônico,9,148
24552,2024-01-18 01:11:00,16,132,Móvel,2,148
24553,2024-01-18 01:12:00,47,125,Eletrônico,8,172
24554,2024-01-18 01:13:00,52,65,Vestuário,4,117
24555,2024-01-18 01:14:00,13,151,Brinquedo,6,164
24556,2024-01-18 01:15:00,38,177,Eletrônico,5,215
24557,2024-01-18 01:16:00,60,87,Vestuário,9,147
24558,2024-01-18 01:17:00,117,43,Brinquedo,5,160
24559,2024-01-18 01:18:00,58,49,Vestuário,2,107
24560,2024-01-18 01:19:00,95,30,Brinquedo,4,125
24561,2024-01-18 01:20:00,17,37,Vestuário,2,54
24562,2024-01-18 01:21:00,62,41,Alimento,5,103
24563,2024-01-18 01:22:00,57,16,Vestuário,9,73
24564,2024-01-18 01:23:00,119,98,Eletrônico,6,217
24565,2024-01-18 01:24:00,49,170,Vestuário,9,219
24566,2024-01-18 01:25:00,72,51,Alimento,5,123
24567,2024-01-18 01:26:00,112,76,Eletrônico,8,188
24568,2024-01-18 01:27:00,33,155,Alimento,4,188
24569,2024-01-18 01:28:00,62,12,Eletrônico,3,74
24570,2024-01-18 01:29:00,27,57,Alimento,9,84
24571,2024-01-18 01:30:00,55,140,Alimento,2,195
24572,2024-01-18 01:31:00,119,105,Eletrônico,5,224
24573,2024-01-18 01:32:00,51,64,Móvel,5,115
24574,2024-01-18 01:33:00,64,40,Móvel,6,104
24575,2024-01-18 01:34:00,76,158,Eletrônico,8,234
24576,2024-01-18 01:35:00,37,90,Eletrônico,9,127
24577,2024-01-18 01:36:00,92,98,Móvel,2,190
24578,2024-01-18 01:37:00,14,40,Eletrônico,4,54
24579,2024-01-18 01:38:00,52,174,Móvel,9,226
24580,2024-01-18 01:39:00,66,75,Vestuário,5,141
24581,2024-01-18 01:40:00,77,11,Móvel,5,88
24582,2024-01-18 01:41:00,94,121,Alimento,3,215
24583,2024-01-18 01:42:00,75,36,Alimento,1,111
24584,2024-01-18 01:43:00,57,124,Móvel,9,181
24585,2024-01-18 01:44:00,35,86,Móvel,2,121
24586,2024-01-18 01:45:00,10,145,Móvel,8,155
24587,2024-01-18 01:46:00,88,80,Eletrônico,4,168
24588,2024-01-18 01:47:00,92,175,Brinquedo,9,267
24589,2024-01-18 01:48:00,80,95,Vestuário,2,175
24590,2024-01-18 01:49:00,118,58,Vestuário,4,176
24591,2024-01-18 01:50:00,10,144,Brinquedo,8,154
24592,2024-01-18 01:51:00,25,37,Brinquedo,4,62
24593,2024-01-18 01:52:00,53,26,Eletrônico,1,79
24594,2024-01-18 01:53:00,38,93,Alimento,1,131
24595,2024-01-18 01:54:00,118,63,Móvel,4,181
24596,2024-01-18 01:55:00,16,133,Móvel,3,149
24597,2024-01-18 01:56:00,75,85,Móvel,3,160
24598,2024-01-18 01:57:00,25,170,Brinquedo,9,195
24599,2024-01-18 01:58:00,54,132,Alimento,8,186
24600,2024-01-18 01:59:00,18,21,Móvel,2,39
24601,2024-01-18 02:00:00,51,13,Alimento,5,64
24602,2024-01-18 02:01:00,50,36,Alimento,2,86
24603,2024-01-18 02:02:00,73,157,Vestuário,6,230
24604,2024-01-18 02:03:00,49,61,Brinquedo,2,110
24605,2024-01-18 02:04:00,12,171,Brinquedo,4,183
24606,2024-01-18 02:05:00,74,172,Móvel,8,246
24607,2024-01-18 02:06:00,34,118,Alimento,9,152
24608,2024-01-18 02:07:00,19,11,Móvel,7,30
24609,2024-01-18 02:08:00,17,107,Vestuário,6,124
24610,2024-01-18 02:09:00,23,64,Brinquedo,8,87
24611,2024-01-18 02:10:00,47,164,Móvel,8,211
24612,2024-01-18 02:11:00,59,101,Brinquedo,3,160
24613,2024-01-18 02:12:00,30,33,Vestuário,9,63
24614,2024-01-18 02:13:00,29,104,Vestuário,1,133
24615,2024-01-18 02:14:00,61,33,Móvel,8,94
24616,2024-01-18 02:15:00,96,74,Eletrônico,7,170
24617,2024-01-18 02:16:00,17,25,Móvel,1,42
24618,2024-01-18 02:17:00,83,37,Alimento,5,120
24619,2024-01-18 02:18:00,107,103,Brinquedo,8,210
24620,2024-01-18 02:19:00,101,77,Móvel,7,178
24621,2024-01-18 02:20:00,33,117,Alimento,7,150
24622,2024-01-18 02:21:00,71,54,Alimento,3,125
24623,2024-01-18 02:22:00,65,12,Brinquedo,7,77
24624,2024-01-18 02:23:00,17,20,Vestuário,5,37
24625,2024-01-18 02:24:00,13,107,Vestuário,6,120
24626,2024-01-18 02:25:00,100,172,Brinquedo,8,272
24627,2024-01-18 02:26:00,19,21,Eletrônico,2,40
24628,2024-01-18 02:27:00,103,162,Móvel,3,265
24629,2024-01-18 02:28:00,87,30,Móvel,1,117
24630,2024-01-18 02:29:00,93,108,Eletrônico,4,201
24631,2024-01-18 02:30:00,91,119,Brinquedo,9,210
24632,2024-01-18 02:31:00,23,51,Eletrônico,1,74
24633,2024-01-18 02:32:00,60,129,Eletrônico,1,189
24634,2024-01-18 02:33:00,21,81,Vestuário,1,102
24635,2024-01-18 02:34:00,117,148,Alimento,1,265
24636,2024-01-18 02:35:00,77,149,Eletrônico,1,226
24637,2024-01-18 02:36:00,49,66,Brinquedo,7,115
24638,2024-01-18 02:37:00,42,176,Brinquedo,2,218
24639,2024-01-18 02:38:00,66,163,Brinquedo,3,229
24640,2024-01-18 02:39:00,10,177,Eletrônico,3,187
24641,2024-01-18 02:40:00,75,163,Alimento,2,238
24642,2024-01-18 02:41:00,17,12,Eletrônico,1,29
24643,2024-01-18 02:42:00,111,115,Brinquedo,7,226
24644,2024-01-18 02:43:00,61,89,Brinquedo,4,150
24645,2024-01-18 02:44:00,101,161,Alimento,3,262
24646,2024-01-18 02:45:00,99,68,Eletrônico,7,167
24647,2024-01-18 02:46:00,68,38,Eletrônico,2,106
24648,2024-01-18 02:47:00,82,161,Brinquedo,7,243
24649,2024-01-18 02:48:00,111,113,Móvel,4,224
24650,2024-01-18 02:49:00,42,56,Vestuário,9,98
24651,2024-01-18 02:50:00,71,74,Alimento,3,145
24652,2024-01-18 02:51:00,109,106,Móvel,9,215
24653,2024-01-18 02:52:00,11,117,Brinquedo,5,128
24654,2024-01-18 02:53:00,46,84,Vestuário,5,130
24655,2024-01-18 02:54:00,66,158,Vestuário,3,224
24656,2024-01-18 02:55:00,82,147,Vestuário,5,229
24657,2024-01-18 02:56:00,40,17,Alimento,5,57
24658,2024-01-18 02:57:00,92,110,Vestuário,3,202
24659,2024-01-18 02:58:00,14,118,Vestuário,8,132
24660,2024-01-18 02:59:00,11,127,Móvel,4,138
24661,2024-01-18 03:00:00,39,150,Alimento,2,189
24662,2024-01-18 03:01:00,37,120,Vestuário,4,157
24663,2024-01-18 03:02:00,103,56,Eletrônico,3,159
24664,2024-01-18 03:03:00,57,55,Brinquedo,8,112
24665,2024-01-18 03:04:00,36,146,Vestuário,6,182
24666,2024-01-18 03:05:00,65,60,Brinquedo,4,125
24667,2024-01-18 03:06:00,15,52,Alimento,4,67
24668,2024-01-18 03:07:00,21,10,Vestuário,9,31
24669,2024-01-18 03:08:00,51,130,Alimento,9,181
24670,2024-01-18 03:09:00,49,143,Móvel,7,192
24671,2024-01-18 03:10:00,86,155,Eletrônico,7,241
24672,2024-01-18 03:11:00,95,81,Vestuário,6,176
24673,2024-01-18 03:12:00,46,148,Vestuário,5,194
24674,2024-01-18 03:13:00,101,76,Vestuário,3,177
24675,2024-01-18 03:14:00,18,162,Vestuário,8,180
24676,2024-01-18 03:15:00,86,37,Móvel,2,123
24677,2024-01-18 03:16:00,21,106,Alimento,8,127
24678,2024-01-18 03:17:00,87,93,Brinquedo,6,180
24679,2024-01-18 03:18:00,36,151,Brinquedo,4,187
24680,2024-01-18 03:19:00,68,36,Vestuário,1,104
24681,2024-01-18 03:20:00,70,54,Móvel,4,124
24682,2024-01-18 03:21:00,110,12,Alimento,4,122
24683,2024-01-18 03:22:00,77,30,Móvel,9,107
24684,2024-01-18 03:23:00,109,71,Móvel,2,180
24685,2024-01-18 03:24:00,26,120,Móvel,6,146
24686,2024-01-18 03:25:00,87,35,Vestuário,4,122
24687,2024-01-18 03:26:00,26,51,Brinquedo,7,77
24688,2024-01-18 03:27:00,83,30,Eletrônico,6,113
24689,2024-01-18 03:28:00,69,174,Alimento,6,243
24690,2024-01-18 03:29:00,13,43,Brinquedo,5,56
24691,2024-01-18 03:30:00,27,175,Móvel,1,202
24692,2024-01-18 03:31:00,110,177,Brinquedo,1,287
24693,2024-01-18 03:32:00,67,41,Alimento,6,108
24694,2024-01-18 03:33:00,22,73,Eletrônico,9,95
24695,2024-01-18 03:34:00,75,61,Eletrônico,2,136
24696,2024-01-18 03:35:00,84,101,Vestuário,8,185
24697,2024-01-18 03:36:00,48,17,Vestuário,6,65
24698,2024-01-18 03:37:00,113,25,Móvel,7,138
24699,2024-01-18 03:38:00,75,157,Alimento,5,232
24700,2024-01-18 03:39:00,99,170,Móvel,8,269
24701,2024-01-18 03:40:00,40,21,Alimento,6,61
24702,2024-01-18 03:41:00,93,167,Móvel,5,260
24703,2024-01-18 03:42:00,87,28,Vestuário,2,115
24704,2024-01-18 03:43:00,103,152,Móvel,2,255
24705,2024-01-18 03:44:00,79,18,Alimento,2,97
24706,2024-01-18 03:45:00,11,94,Brinquedo,6,105
24707,2024-01-18 03:46:00,73,177,Alimento,3,250
24708,2024-01-18 03:47:00,107,111,Alimento,8,218
24709,2024-01-18 03:48:00,96,55,Alimento,6,151
24710,2024-01-18 03:49:00,104,93,Brinquedo,9,197
24711,2024-01-18 03:50:00,69,114,Vestuário,6,183
24712,2024-01-18 03:51:00,72,118,Eletrônico,9,190
24713,2024-01-18 03:52:00,32,68,Brinquedo,6,100
24714,2024-01-18 03:53:00,14,93,Eletrônico,3,107
24715,2024-01-18 03:54:00,45,151,Eletrônico,6,196
24716,2024-01-18 03:55:00,51,24,Brinquedo,9,75
24717,2024-01-18 03:56:00,44,19,Vestuário,5,63
24718,2024-01-18 03:57:00,31,90,Vestuário,3,121
24719,2024-01-18 03:58:00,92,179,Móvel,6,271
24720,2024-01-18 03:59:00,83,132,Alimento,5,215
24721,2024-01-18 04:00:00,99,143,Vestuário,3,242
24722,2024-01-18 04:01:00,88,50,Eletrônico,3,138
24723,2024-01-18 04:02:00,101,47,Brinquedo,4,148
24724,2024-01-18 04:03:00,42,173,Brinquedo,9,215
24725,2024-01-18 04:04:00,48,88,Alimento,8,136
24726,2024-01-18 04:05:00,27,92,Móvel,6,119
24727,2024-01-18 04:06:00,54,42,Vestuário,6,96
24728,2024-01-18 04:07:00,118,175,Alimento,4,293
24729,2024-01-18 04:08:00,65,121,Alimento,1,186
24730,2024-01-18 04:09:00,113,13,Eletrônico,7,126
24731,2024-01-18 04:10:00,61,15,Alimento,3,76
24732,2024-01-18 04:11:00,25,98,Vestuário,7,123
24733,2024-01-18 04:12:00,59,34,Brinquedo,8,93
24734,2024-01-18 04:13:00,94,156,Móvel,2,250
24735,2024-01-18 04:14:00,58,10,Vestuário,4,68
24736,2024-01-18 04:15:00,84,111,Móvel,2,195
24737,2024-01-18 04:16:00,84,154,Móvel,4,238
24738,2024-01-18 04:17:00,78,17,Eletrônico,8,95
24739,2024-01-18 04:18:00,45,67,Vestuário,7,112
24740,2024-01-18 04:19:00,43,24,Vestuário,7,67
24741,2024-01-18 04:20:00,52,67,Eletrônico,9,119
24742,2024-01-18 04:21:00,110,75,Eletrônico,5,185
24743,2024-01-18 04:22:00,39,62,Alimento,2,101
24744,2024-01-18 04:23:00,87,96,Eletrônico,8,183
24745,2024-01-18 04:24:00,25,179,Vestuário,8,204
24746,2024-01-18 04:25:00,60,56,Vestuário,2,116
24747,2024-01-18 04:26:00,86,178,Alimento,5,264
24748,2024-01-18 04:27:00,94,74,Móvel,1,168
24749,2024-01-18 04:28:00,56,170,Brinquedo,9,226
24750,2024-01-18 04:29:00,16,17,Brinquedo,5,33
24751,2024-01-18 04:30:00,93,62,Vestuário,6,155
24752,2024-01-18 04:31:00,84,155,Eletrônico,7,239
24753,2024-01-18 04:32:00,111,44,Brinquedo,9,155
24754,2024-01-18 04:33:00,51,120,Eletrônico,2,171
24755,2024-01-18 04:34:00,46,166,Brinquedo,1,212
24756,2024-01-18 04:35:00,90,49,Eletrônico,8,139
24757,2024-01-18 04:36:00,115,67,Móvel,5,182
24758,2024-01-18 04:37:00,25,77,Móvel,2,102
24759,2024-01-18 04:38:00,57,43,Brinquedo,6,100
24760,2024-01-18 04:39:00,117,56,Alimento,2,173
24761,2024-01-18 04:40:00,97,46,Móvel,7,143
24762,2024-01-18 04:41:00,108,161,Móvel,4,269
24763,2024-01-18 04:42:00,72,89,Alimento,3,161
24764,2024-01-18 04:43:00,108,109,Móvel,3,217
24765,2024-01-18 04:44:00,111,33,Vestuário,6,144
24766,2024-01-18 04:45:00,41,162,Alimento,6,203
24767,2024-01-18 04:46:00,104,21,Móvel,3,125
24768,2024-01-18 04:47:00,54,114,Brinquedo,9,168
24769,2024-01-18 04:48:00,102,143,Alimento,4,245
24770,2024-01-18 04:49:00,76,150,Brinquedo,5,226
24771,2024-01-18 04:50:00,65,167,Eletrônico,5,232
24772,2024-01-18 04:51:00,118,111,Móvel,8,229
24773,2024-01-18 04:52:00,77,31,Móvel,6,108
24774,2024-01-18 04:53:00,50,45,Vestuário,9,95
24775,2024-01-18 04:54:00,49,37,Brinquedo,3,86
24776,2024-01-18 04:55:00,55,25,Vestuário,5,80
24777,2024-01-18 04:56:00,119,65,Eletrônico,4,184
24778,2024-01-18 04:57:00,91,162,Eletrônico,3,253
24779,2024-01-18 04:58:00,65,66,Alimento,6,131
24780,2024-01-18 04:59:00,91,167,Brinquedo,1,258
24781,2024-01-18 05:00:00,83,53,Móvel,1,136
24782,2024-01-18 05:01:00,31,107,Brinquedo,4,138
24783,2024-01-18 05:02:00,90,90,Eletrônico,8,180
24784,2024-01-18 05:03:00,74,29,Móvel,2,103
24785,2024-01-18 05:04:00,35,31,Móvel,4,66
24786,2024-01-18 05:05:00,41,155,Brinquedo,9,196
24787,2024-01-18 05:06:00,38,144,Eletrônico,3,182
24788,2024-01-18 05:07:00,67,178,Móvel,2,245
24789,2024-01-18 05:08:00,70,43,Brinquedo,1,113
24790,2024-01-18 05:09:00,17,23,Brinquedo,6,40
24791,2024-01-18 05:10:00,110,154,Brinquedo,5,264
24792,2024-01-18 05:11:00,96,140,Vestuário,3,236
24793,2024-01-18 05:12:00,29,91,Brinquedo,4,120
24794,2024-01-18 05:13:00,31,79,Eletrônico,8,110
24795,2024-01-18 05:14:00,77,133,Brinquedo,9,210
24796,2024-01-18 05:15:00,42,65,Brinquedo,9,107
24797,2024-01-18 05:16:00,50,97,Brinquedo,8,147
24798,2024-01-18 05:17:00,97,102,Eletrônico,8,199
24799,2024-01-18 05:18:00,18,38,Eletrônico,4,56
24800,2024-01-18 05:19:00,36,120,Vestuário,7,156
24801,2024-01-18 05:20:00,116,10,Eletrônico,5,126
24802,2024-01-18 05:21:00,83,136,Móvel,3,219
24803,2024-01-18 05:22:00,115,110,Brinquedo,2,225
24804,2024-01-18 05:23:00,70,53,Móvel,6,123
24805,2024-01-18 05:24:00,114,106,Alimento,5,220
24806,2024-01-18 05:25:00,24,176,Eletrônico,2,200
24807,2024-01-18 05:26:00,22,156,Brinquedo,2,178
24808,2024-01-18 05:27:00,97,146,Vestuário,7,243
24809,2024-01-18 05:28:00,26,148,Vestuário,3,174
24810,2024-01-18 05:29:00,101,29,Vestuário,7,130
24811,2024-01-18 05:30:00,20,40,Alimento,9,60
24812,2024-01-18 05:31:00,101,139,Brinquedo,8,240
24813,2024-01-18 05:32:00,95,101,Vestuário,2,196
24814,2024-01-18 05:33:00,56,62,Brinquedo,3,118
24815,2024-01-18 05:34:00,72,59,Alimento,5,131
24816,2024-01-18 05:35:00,33,127,Alimento,8,160
24817,2024-01-18 05:36:00,86,50,Brinquedo,8,136
24818,2024-01-18 05:37:00,69,153,Alimento,3,222
24819,2024-01-18 05:38:00,95,17,Vestuário,8,112
24820,2024-01-18 05:39:00,89,51,Eletrônico,6,140
24821,2024-01-18 05:40:00,37,46,Alimento,6,83
24822,2024-01-18 05:41:00,92,28,Alimento,3,120
24823,2024-01-18 05:42:00,66,139,Vestuário,3,205
24824,2024-01-18 05:43:00,82,164,Vestuário,6,246
24825,2024-01-18 05:44:00,67,25,Eletrônico,7,92
24826,2024-01-18 05:45:00,95,50,Alimento,1,145
24827,2024-01-18 05:46:00,92,10,Eletrônico,6,102
24828,2024-01-18 05:47:00,34,154,Brinquedo,4,188
24829,2024-01-18 05:48:00,98,38,Móvel,9,136
24830,2024-01-18 05:49:00,55,176,Alimento,3,231
24831,2024-01-18 05:50:00,51,29,Eletrônico,1,80
24832,2024-01-18 05:51:00,49,175,Alimento,7,224
24833,2024-01-18 05:52:00,89,42,Eletrônico,8,131
24834,2024-01-18 05:53:00,18,115,Alimento,6,133
24835,2024-01-18 05:54:00,93,28,Alimento,5,121
24836,2024-01-18 05:55:00,29,84,Móvel,1,113
24837,2024-01-18 05:56:00,42,15,Alimento,7,57
24838,2024-01-18 05:57:00,12,107,Móvel,8,119
24839,2024-01-18 05:58:00,55,125,Vestuário,1,180
24840,2024-01-18 05:59:00,76,118,Alimento,2,194
24841,2024-01-18 06:00:00,55,94,Móvel,9,149
24842,2024-01-18 06:01:00,13,105,Vestuário,5,118
24843,2024-01-18 06:02:00,12,167,Alimento,2,179
24844,2024-01-18 06:03:00,83,163,Móvel,2,246
24845,2024-01-18 06:04:00,109,56,Eletrônico,3,165
24846,2024-01-18 06:05:00,35,69,Brinquedo,5,104
24847,2024-01-18 06:06:00,51,102,Brinquedo,9,153
24848,2024-01-18 06:07:00,70,159,Brinquedo,3,229
24849,2024-01-18 06:08:00,34,101,Eletrônico,7,135
24850,2024-01-18 06:09:00,41,154,Vestuário,3,195
24851,2024-01-18 06:10:00,108,109,Brinquedo,2,217
24852,2024-01-18 06:11:00,101,96,Móvel,1,197
24853,2024-01-18 06:12:00,71,109,Eletrônico,8,180
24854,2024-01-18 06:13:00,85,50,Alimento,8,135
24855,2024-01-18 06:14:00,107,81,Alimento,6,188
24856,2024-01-18 06:15:00,26,54,Eletrônico,2,80
24857,2024-01-18 06:16:00,105,46,Móvel,6,151
24858,2024-01-18 06:17:00,92,157,Brinquedo,6,249
24859,2024-01-18 06:18:00,111,148,Brinquedo,3,259
24860,2024-01-18 06:19:00,51,91,Brinquedo,5,142
24861,2024-01-18 06:20:00,74,161,Alimento,2,235
24862,2024-01-18 06:21:00,27,103,Móvel,4,130
24863,2024-01-18 06:22:00,54,87,Alimento,5,141
24864,2024-01-18 06:23:00,29,76,Móvel,8,105
24865,2024-01-18 06:24:00,113,175,Eletrônico,6,288
24866,2024-01-18 06:25:00,11,61,Móvel,5,72
24867,2024-01-18 06:26:00,107,147,Vestuário,2,254
24868,2024-01-18 06:27:00,93,98,Móvel,1,191
24869,2024-01-18 06:28:00,78,24,Vestuário,2,102
24870,2024-01-18 06:29:00,12,69,Alimento,5,81
24871,2024-01-18 06:30:00,49,124,Alimento,1,173
24872,2024-01-18 06:31:00,88,111,Eletrônico,5,199
24873,2024-01-18 06:32:00,58,21,Vestuário,4,79
24874,2024-01-18 06:33:00,26,73,Alimento,8,99
24875,2024-01-18 06:34:00,53,17,Móvel,7,70
24876,2024-01-18 06:35:00,104,96,Alimento,5,200
24877,2024-01-18 06:36:00,65,67,Alimento,3,132
24878,2024-01-18 06:37:00,96,68,Alimento,5,164
24879,2024-01-18 06:38:00,64,71,Vestuário,6,135
24880,2024-01-18 06:39:00,37,91,Eletrônico,5,128
24881,2024-01-18 06:40:00,31,140,Brinquedo,2,171
24882,2024-01-18 06:41:00,45,54,Alimento,8,99
24883,2024-01-18 06:42:00,113,164,Brinquedo,9,277
24884,2024-01-18 06:43:00,65,57,Vestuário,1,122
24885,2024-01-18 06:44:00,27,117,Móvel,7,144
24886,2024-01-18 06:45:00,55,172,Brinquedo,9,227
24887,2024-01-18 06:46:00,44,164,Eletrônico,5,208
24888,2024-01-18 06:47:00,86,130,Brinquedo,7,216
24889,2024-01-18 06:48:00,89,36,Vestuário,8,125
24890,2024-01-18 06:49:00,74,123,Vestuário,9,197
24891,2024-01-18 06:50:00,88,149,Vestuário,9,237
24892,2024-01-18 06:51:00,101,95,Brinquedo,9,196
24893,2024-01-18 06:52:00,25,140,Alimento,3,165
24894,2024-01-18 06:53:00,18,52,Eletrônico,6,70
24895,2024-01-18 06:54:00,24,96,Eletrônico,2,120
24896,2024-01-18 06:55:00,112,99,Móvel,9,211
24897,2024-01-18 06:56:00,47,129,Vestuário,5,176
24898,2024-01-18 06:57:00,14,170,Brinquedo,1,184
24899,2024-01-18 06:58:00,69,54,Móvel,6,123
24900,2024-01-18 06:59:00,66,151,Móvel,3,217
24901,2024-01-18 07:00:00,90,159,Vestuário,9,249
24902,2024-01-18 07:01:00,31,130,Móvel,3,161
24903,2024-01-18 07:02:00,24,90,Móvel,5,114
24904,2024-01-18 07:03:00,57,26,Vestuário,4,83
24905,2024-01-18 07:04:00,57,41,Brinquedo,6,98
24906,2024-01-18 07:05:00,105,148,Eletrônico,4,253
24907,2024-01-18 07:06:00,11,12,Móvel,7,23
24908,2024-01-18 07:07:00,33,67,Vestuário,6,100
24909,2024-01-18 07:08:00,24,144,Brinquedo,8,168
24910,2024-01-18 07:09:00,107,77,Vestuário,9,184
24911,2024-01-18 07:10:00,106,118,Eletrônico,6,224
24912,2024-01-18 07:11:00,63,77,Alimento,1,140
24913,2024-01-18 07:12:00,58,29,Móvel,8,87
24914,2024-01-18 07:13:00,10,179,Vestuário,7,189
24915,2024-01-18 07:14:00,13,122,Eletrônico,7,135
24916,2024-01-18 07:15:00,114,68,Móvel,1,182
24917,2024-01-18 07:16:00,77,176,Alimento,9,253
24918,2024-01-18 07:17:00,12,173,Brinquedo,6,185
24919,2024-01-18 07:18:00,92,136,Eletrônico,9,228
24920,2024-01-18 07:19:00,86,70,Vestuário,2,156
24921,2024-01-18 07:20:00,63,104,Eletrônico,6,167
24922,2024-01-18 07:21:00,47,153,Eletrônico,8,200
24923,2024-01-18 07:22:00,114,148,Eletrônico,6,262
24924,2024-01-18 07:23:00,62,152,Alimento,4,214
24925,2024-01-18 07:24:00,10,10,Vestuário,2,20
24926,2024-01-18 07:25:00,85,164,Eletrônico,8,249
24927,2024-01-18 07:26:00,113,147,Eletrônico,1,260
24928,2024-01-18 07:27:00,18,21,Brinquedo,9,39
24929,2024-01-18 07:28:00,54,85,Eletrônico,9,139
24930,2024-01-18 07:29:00,106,178,Móvel,5,284
24931,2024-01-18 07:30:00,75,78,Eletrônico,2,153
24932,2024-01-18 07:31:00,14,151,Móvel,8,165
24933,2024-01-18 07:32:00,112,76,Vestuário,5,188
24934,2024-01-18 07:33:00,48,169,Vestuário,2,217
24935,2024-01-18 07:34:00,94,146,Brinquedo,6,240
24936,2024-01-18 07:35:00,104,26,Alimento,8,130
24937,2024-01-18 07:36:00,44,17,Alimento,9,61
24938,2024-01-18 07:37:00,100,151,Brinquedo,4,251
24939,2024-01-18 07:38:00,46,60,Brinquedo,3,106
24940,2024-01-18 07:39:00,110,157,Vestuário,9,267
24941,2024-01-18 07:40:00,63,83,Alimento,2,146
24942,2024-01-18 07:41:00,115,136,Alimento,7,251
24943,2024-01-18 07:42:00,42,146,Brinquedo,4,188
24944,2024-01-18 07:43:00,89,164,Eletrônico,4,253
24945,2024-01-18 07:44:00,16,34,Alimento,2,50
24946,2024-01-18 07:45:00,73,103,Eletrônico,3,176
24947,2024-01-18 07:46:00,81,43,Móvel,3,124
24948,2024-01-18 07:47:00,38,110,Brinquedo,9,148
24949,2024-01-18 07:48:00,31,179,Alimento,8,210
24950,2024-01-18 07:49:00,80,158,Vestuário,7,238
24951,2024-01-18 07:50:00,117,116,Vestuário,7,233
24952,2024-01-18 07:51:00,115,120,Alimento,3,235
24953,2024-01-18 07:52:00,74,14,Móvel,2,88
24954,2024-01-18 07:53:00,90,16,Eletrônico,4,106
24955,2024-01-18 07:54:00,50,113,Brinquedo,8,163
24956,2024-01-18 07:55:00,65,20,Vestuário,6,85
24957,2024-01-18 07:56:00,74,114,Vestuário,8,188
24958,2024-01-18 07:57:00,59,28,Móvel,9,87
24959,2024-01-18 07:58:00,29,152,Eletrônico,1,181
24960,2024-01-18 07:59:00,42,14,Alimento,5,56
24961,2024-01-18 08:00:00,104,118,Alimento,1,222
24962,2024-01-18 08:01:00,19,101,Vestuário,5,120
24963,2024-01-18 08:02:00,43,170,Brinquedo,3,213
24964,2024-01-18 08:03:00,116,64,Móvel,9,180
24965,2024-01-18 08:04:00,26,18,Brinquedo,6,44
24966,2024-01-18 08:05:00,58,111,Brinquedo,1,169
24967,2024-01-18 08:06:00,119,25,Vestuário,8,144
24968,2024-01-18 08:07:00,21,170,Alimento,7,191
24969,2024-01-18 08:08:00,67,64,Brinquedo,5,131
24970,2024-01-18 08:09:00,70,32,Alimento,9,102
24971,2024-01-18 08:10:00,51,49,Vestuário,7,100
24972,2024-01-18 08:11:00,94,24,Vestuário,9,118
24973,2024-01-18 08:12:00,35,125,Brinquedo,7,160
24974,2024-01-18 08:13:00,77,10,Móvel,3,87
24975,2024-01-18 08:14:00,64,120,Móvel,6,184
24976,2024-01-18 08:15:00,15,131,Brinquedo,4,146
24977,2024-01-18 08:16:00,24,51,Vestuário,5,75
24978,2024-01-18 08:17:00,90,153,Alimento,9,243
24979,2024-01-18 08:18:00,101,20,Móvel,4,121
24980,2024-01-18 08:19:00,24,103,Eletrônico,3,127
24981,2024-01-18 08:20:00,69,85,Alimento,4,154
24982,2024-01-18 08:21:00,43,75,Brinquedo,2,118
24983,2024-01-18 08:22:00,85,36,Eletrônico,3,121
24984,2024-01-18 08:23:00,65,55,Eletrônico,8,120
24985,2024-01-18 08:24:00,19,138,Brinquedo,9,157
24986,2024-01-18 08:25:00,63,27,Eletrônico,2,90
24987,2024-01-18 08:26:00,68,86,Alimento,8,154
24988,2024-01-18 08:27:00,74,77,Móvel,5,151
24989,2024-01-18 08:28:00,53,53,Vestuário,3,106
24990,2024-01-18 08:29:00,53,89,Vestuário,1,142
24991,2024-01-18 08:30:00,88,76,Brinquedo,1,164
24992,2024-01-18 08:31:00,78,122,Móvel,9,200
24993,2024-01-18 08:32:00,107,59,Eletrônico,7,166
24994,2024-01-18 08:33:00,20,34,Vestuário,8,54
24995,2024-01-18 08:34:00,115,118,Móvel,7,233
24996,2024-01-18 08:35:00,116,63,Alimento,9,179
24997,2024-01-18 08:36:00,58,18,Eletrônico,8,76
24998,2024-01-18 08:37:00,20,53,Brinquedo,6,73
24999,2024-01-18 08:38:00,111,54,Alimento,3,165
25000,2024-01-18 08:39:00,15,161,Alimento,8,176
25001,2024-01-18 08:40:00,106,177,Brinquedo,5,283
25002,2024-01-18 08:41:00,39,117,Brinquedo,5,156
25003,2024-01-18 08:42:00,47,135,Móvel,6,182
25004,2024-01-18 08:43:00,88,34,Móvel,4,122
25005,2024-01-18 08:44:00,105,165,Alimento,8,270
25006,2024-01-18 08:45:00,72,17,Eletrônico,1,89
25007,2024-01-18 08:46:00,116,61,Brinquedo,4,177
25008,2024-01-18 08:47:00,49,42,Móvel,8,91
25009,2024-01-18 08:48:00,104,28,Vestuário,3,132
25010,2024-01-18 08:49:00,58,171,Móvel,3,229
25011,2024-01-18 08:50:00,17,38,Vestuário,7,55
25012,2024-01-18 08:51:00,114,75,Brinquedo,1,189
25013,2024-01-18 08:52:00,70,153,Móvel,6,223
25014,2024-01-18 08:53:00,28,158,Vestuário,5,186
25015,2024-01-18 08:54:00,13,38,Vestuário,1,51
25016,2024-01-18 08:55:00,39,70,Eletrônico,1,109
25017,2024-01-18 08:56:00,17,175,Vestuário,4,192
25018,2024-01-18 08:57:00,77,82,Alimento,6,159
25019,2024-01-18 08:58:00,26,16,Alimento,6,42
25020,2024-01-18 08:59:00,114,18,Eletrônico,7,132
25021,2024-01-18 09:00:00,58,170,Eletrônico,9,228
25022,2024-01-18 09:01:00,98,85,Móvel,1,183
25023,2024-01-18 09:02:00,73,111,Brinquedo,7,184
25024,2024-01-18 09:03:00,41,90,Eletrônico,4,131
25025,2024-01-18 09:04:00,62,32,Móvel,7,94
25026,2024-01-18 09:05:00,116,28,Móvel,4,144
25027,2024-01-18 09:06:00,43,151,Brinquedo,8,194
25028,2024-01-18 09:07:00,30,92,Móvel,9,122
25029,2024-01-18 09:08:00,38,47,Alimento,3,85
25030,2024-01-18 09:09:00,81,64,Móvel,8,145
25031,2024-01-18 09:10:00,66,157,Eletrônico,3,223
25032,2024-01-18 09:11:00,11,175,Alimento,7,186
25033,2024-01-18 09:12:00,83,54,Vestuário,4,137
25034,2024-01-18 09:13:00,28,86,Móvel,2,114
25035,2024-01-18 09:14:00,97,33,Móvel,7,130
25036,2024-01-18 09:15:00,86,92,Alimento,9,178
25037,2024-01-18 09:16:00,81,97,Alimento,8,178
25038,2024-01-18 09:17:00,64,27,Alimento,1,91
25039,2024-01-18 09:18:00,29,88,Alimento,8,117
25040,2024-01-18 09:19:00,19,21,Eletrônico,9,40
25041,2024-01-18 09:20:00,19,143,Vestuário,1,162
25042,2024-01-18 09:21:00,53,124,Brinquedo,6,177
25043,2024-01-18 09:22:00,65,111,Alimento,7,176
25044,2024-01-18 09:23:00,11,51,Brinquedo,3,62
25045,2024-01-18 09:24:00,65,140,Móvel,7,205
25046,2024-01-18 09:25:00,39,93,Brinquedo,8,132
25047,2024-01-18 09:26:00,50,71,Brinquedo,6,121
25048,2024-01-18 09:27:00,35,102,Alimento,6,137
25049,2024-01-18 09:28:00,24,57,Alimento,1,81
25050,2024-01-18 09:29:00,28,177,Alimento,2,205
25051,2024-01-18 09:30:00,42,137,Vestuário,1,179
25052,2024-01-18 09:31:00,77,22,Móvel,2,99
25053,2024-01-18 09:32:00,60,89,Brinquedo,3,149
25054,2024-01-18 09:33:00,109,98,Móvel,4,207
25055,2024-01-18 09:34:00,20,91,Eletrônico,6,111
25056,2024-01-18 09:35:00,49,168,Brinquedo,9,217
25057,2024-01-18 09:36:00,32,125,Brinquedo,2,157
25058,2024-01-18 09:37:00,108,10,Alimento,9,118
25059,2024-01-18 09:38:00,84,175,Móvel,5,259
25060,2024-01-18 09:39:00,116,168,Vestuário,3,284
25061,2024-01-18 09:40:00,113,10,Alimento,8,123
25062,2024-01-18 09:41:00,113,89,Alimento,9,202
25063,2024-01-18 09:42:00,84,173,Brinquedo,6,257
25064,2024-01-18 09:43:00,56,74,Móvel,6,130
25065,2024-01-18 09:44:00,63,144,Vestuário,6,207
25066,2024-01-18 09:45:00,89,28,Eletrônico,1,117
25067,2024-01-18 09:46:00,44,55,Alimento,7,99
25068,2024-01-18 09:47:00,39,111,Brinquedo,3,150
25069,2024-01-18 09:48:00,84,177,Móvel,3,261
25070,2024-01-18 09:49:00,18,149,Móvel,5,167
25071,2024-01-18 09:50:00,104,40,Vestuário,2,144
25072,2024-01-18 09:51:00,100,158,Móvel,9,258
25073,2024-01-18 09:52:00,15,177,Vestuário,2,192
25074,2024-01-18 09:53:00,32,156,Alimento,1,188
25075,2024-01-18 09:54:00,94,176,Eletrônico,7,270
25076,2024-01-18 09:55:00,27,67,Vestuário,8,94
25077,2024-01-18 09:56:00,61,64,Alimento,4,125
25078,2024-01-18 09:57:00,77,73,Móvel,1,150
25079,2024-01-18 09:58:00,46,66,Móvel,3,112
25080,2024-01-18 09:59:00,81,101,Eletrônico,8,182
25081,2024-01-18 10:00:00,67,135,Brinquedo,7,202
25082,2024-01-18 10:01:00,118,28,Alimento,4,146
25083,2024-01-18 10:02:00,12,144,Móvel,4,156
25084,2024-01-18 10:03:00,23,11,Alimento,6,34
25085,2024-01-18 10:04:00,98,67,Vestuário,1,165
25086,2024-01-18 10:05:00,61,62,Alimento,5,123
25087,2024-01-18 10:06:00,16,43,Eletrônico,1,59
25088,2024-01-18 10:07:00,15,165,Alimento,7,180
25089,2024-01-18 10:08:00,31,101,Alimento,7,132
25090,2024-01-18 10:09:00,100,126,Vestuário,5,226
25091,2024-01-18 10:10:00,37,132,Eletrônico,9,169
25092,2024-01-18 10:11:00,21,107,Alimento,8,128
25093,2024-01-18 10:12:00,72,147,Brinquedo,9,219
25094,2024-01-18 10:13:00,11,171,Móvel,6,182
25095,2024-01-18 10:14:00,25,122,Móvel,2,147
25096,2024-01-18 10:15:00,69,110,Eletrônico,9,179
25097,2024-01-18 10:16:00,110,166,Brinquedo,2,276
25098,2024-01-18 10:17:00,101,32,Móvel,8,133
25099,2024-01-18 10:18:00,70,168,Alimento,7,238
25100,2024-01-18 10:19:00,76,177,Alimento,7,253
25101,2024-01-18 10:20:00,90,46,Eletrônico,1,136
25102,2024-01-18 10:21:00,110,164,Brinquedo,8,274
25103,2024-01-18 10:22:00,97,139,Alimento,8,236
25104,2024-01-18 10:23:00,27,70,Móvel,9,97
25105,2024-01-18 10:24:00,30,129,Vestuário,6,159
25106,2024-01-18 10:25:00,93,175,Móvel,3,268
25107,2024-01-18 10:26:00,54,18,Brinquedo,7,72
25108,2024-01-18 10:27:00,23,179,Alimento,4,202
25109,2024-01-18 10:28:00,33,154,Vestuário,7,187
25110,2024-01-18 10:29:00,81,53,Vestuário,7,134
25111,2024-01-18 10:30:00,42,20,Brinquedo,4,62
25112,2024-01-18 10:31:00,74,97,Eletrônico,9,171
25113,2024-01-18 10:32:00,66,113,Alimento,8,179
25114,2024-01-18 10:33:00,48,166,Alimento,3,214
25115,2024-01-18 10:34:00,67,161,Brinquedo,1,228
25116,2024-01-18 10:35:00,72,124,Alimento,5,196
25117,2024-01-18 10:36:00,16,16,Vestuário,1,32
25118,2024-01-18 10:37:00,12,122,Vestuário,3,134
25119,2024-01-18 10:38:00,66,29,Brinquedo,9,95
25120,2024-01-18 10:39:00,34,96,Eletrônico,1,130
25121,2024-01-18 10:40:00,89,141,Eletrônico,7,230
25122,2024-01-18 10:41:00,17,94,Vestuário,8,111
25123,2024-01-18 10:42:00,37,116,Eletrônico,3,153
25124,2024-01-18 10:43:00,110,53,Vestuário,2,163
25125,2024-01-18 10:44:00,117,47,Vestuário,4,164
25126,2024-01-18 10:45:00,90,112,Alimento,4,202
25127,2024-01-18 10:46:00,75,129,Eletrônico,7,204
25128,2024-01-18 10:47:00,49,150,Brinquedo,8,199
25129,2024-01-18 10:48:00,70,35,Móvel,3,105
25130,2024-01-18 10:49:00,87,39,Eletrônico,1,126
25131,2024-01-18 10:50:00,65,57,Vestuário,3,122
25132,2024-01-18 10:51:00,68,148,Eletrônico,6,216
25133,2024-01-18 10:52:00,21,150,Vestuário,1,171
25134,2024-01-18 10:53:00,40,96,Brinquedo,4,136
25135,2024-01-18 10:54:00,71,47,Eletrônico,5,118
25136,2024-01-18 10:55:00,103,152,Móvel,7,255
25137,2024-01-18 10:56:00,61,84,Brinquedo,8,145
25138,2024-01-18 10:57:00,44,66,Eletrônico,9,110
25139,2024-01-18 10:58:00,108,55,Móvel,9,163
25140,2024-01-18 10:59:00,31,50,Alimento,1,81
25141,2024-01-18 11:00:00,85,48,Alimento,7,133
25142,2024-01-18 11:01:00,13,80,Móvel,6,93
25143,2024-01-18 11:02:00,72,31,Eletrônico,4,103
25144,2024-01-18 11:03:00,28,11,Alimento,4,39
25145,2024-01-18 11:04:00,95,159,Móvel,2,254
25146,2024-01-18 11:05:00,52,110,Móvel,6,162
25147,2024-01-18 11:06:00,103,152,Brinquedo,8,255
25148,2024-01-18 11:07:00,104,88,Alimento,9,192
25149,2024-01-18 11:08:00,45,17,Brinquedo,8,62
25150,2024-01-18 11:09:00,84,164,Brinquedo,3,248
25151,2024-01-18 11:10:00,29,175,Eletrônico,4,204
25152,2024-01-18 11:11:00,86,122,Vestuário,2,208
25153,2024-01-18 11:12:00,93,120,Alimento,2,213
25154,2024-01-18 11:13:00,68,56,Vestuário,9,124
25155,2024-01-18 11:14:00,12,116,Móvel,7,128
25156,2024-01-18 11:15:00,55,85,Brinquedo,3,140
25157,2024-01-18 11:16:00,98,145,Alimento,3,243
25158,2024-01-18 11:17:00,99,173,Brinquedo,8,272
25159,2024-01-18 11:18:00,106,109,Alimento,1,215
25160,2024-01-18 11:19:00,33,63,Móvel,8,96
25161,2024-01-18 11:20:00,113,73,Vestuário,2,186
25162,2024-01-18 11:21:00,53,61,Alimento,1,114
25163,2024-01-18 11:22:00,81,177,Alimento,7,258
25164,2024-01-18 11:23:00,59,70,Móvel,4,129
25165,2024-01-18 11:24:00,19,137,Brinquedo,8,156
25166,2024-01-18 11:25:00,36,53,Brinquedo,2,89
25167,2024-01-18 11:26:00,13,144,Vestuário,1,157
25168,2024-01-18 11:27:00,10,34,Móvel,3,44
25169,2024-01-18 11:28:00,25,84,Eletrônico,3,109
25170,2024-01-18 11:29:00,33,50,Móvel,1,83
25171,2024-01-18 11:30:00,69,87,Eletrônico,9,156
25172,2024-01-18 11:31:00,78,135,Eletrônico,7,213
25173,2024-01-18 11:32:00,119,141,Vestuário,5,260
25174,2024-01-18 11:33:00,119,135,Eletrônico,8,254
25175,2024-01-18 11:34:00,27,130,Móvel,5,157
25176,2024-01-18 11:35:00,70,120,Brinquedo,1,190
25177,2024-01-18 11:36:00,118,66,Eletrônico,1,184
25178,2024-01-18 11:37:00,34,64,Vestuário,4,98
25179,2024-01-18 11:38:00,18,92,Eletrônico,4,110
25180,2024-01-18 11:39:00,100,30,Alimento,3,130
25181,2024-01-18 11:40:00,113,24,Vestuário,8,137
25182,2024-01-18 11:41:00,61,76,Vestuário,3,137
25183,2024-01-18 11:42:00,44,82,Brinquedo,1,126
25184,2024-01-18 11:43:00,64,113,Alimento,7,177
25185,2024-01-18 11:44:00,112,72,Eletrônico,6,184
25186,2024-01-18 11:45:00,48,86,Brinquedo,3,134
25187,2024-01-18 11:46:00,71,53,Eletrônico,4,124
25188,2024-01-18 11:47:00,63,138,Móvel,2,201
25189,2024-01-18 11:48:00,101,54,Vestuário,1,155
25190,2024-01-18 11:49:00,113,37,Vestuário,9,150
25191,2024-01-18 11:50:00,61,82,Alimento,1,143
25192,2024-01-18 11:51:00,25,47,Brinquedo,8,72
25193,2024-01-18 11:52:00,26,133,Eletrônico,5,159
25194,2024-01-18 11:53:00,81,60,Eletrônico,6,141
25195,2024-01-18 11:54:00,34,95,Brinquedo,2,129
25196,2024-01-18 11:55:00,54,120,Brinquedo,8,174
25197,2024-01-18 11:56:00,28,72,Vestuário,3,100
25198,2024-01-18 11:57:00,103,42,Móvel,4,145
25199,2024-01-18 11:58:00,21,60,Móvel,8,81
25200,2024-01-18 11:59:00,48,95,Alimento,3,143
25201,2024-01-18 12:00:00,34,166,Alimento,4,200
25202,2024-01-18 12:01:00,59,179,Vestuário,7,238
25203,2024-01-18 12:02:00,56,119,Brinquedo,9,175
25204,2024-01-18 12:03:00,92,49,Móvel,2,141
25205,2024-01-18 12:04:00,100,87,Vestuário,3,187
25206,2024-01-18 12:05:00,119,92,Eletrônico,6,211
25207,2024-01-18 12:06:00,38,73,Móvel,2,111
25208,2024-01-18 12:07:00,31,133,Brinquedo,9,164
25209,2024-01-18 12:08:00,41,72,Vestuário,1,113
25210,2024-01-18 12:09:00,22,43,Alimento,7,65
25211,2024-01-18 12:10:00,67,96,Vestuário,2,163
25212,2024-01-18 12:11:00,32,143,Vestuário,6,175
25213,2024-01-18 12:12:00,67,30,Vestuário,6,97
25214,2024-01-18 12:13:00,26,11,Eletrônico,5,37
25215,2024-01-18 12:14:00,62,95,Brinquedo,4,157
25216,2024-01-18 12:15:00,70,27,Alimento,3,97
25217,2024-01-18 12:16:00,79,33,Eletrônico,2,112
25218,2024-01-18 12:17:00,99,62,Eletrônico,1,161
25219,2024-01-18 12:18:00,92,50,Vestuário,7,142
25220,2024-01-18 12:19:00,113,14,Brinquedo,4,127
25221,2024-01-18 12:20:00,37,36,Alimento,9,73
25222,2024-01-18 12:21:00,40,152,Vestuário,1,192
25223,2024-01-18 12:22:00,49,136,Móvel,8,185
25224,2024-01-18 12:23:00,87,122,Alimento,6,209
25225,2024-01-18 12:24:00,13,43,Vestuário,4,56
25226,2024-01-18 12:25:00,82,99,Vestuário,3,181
25227,2024-01-18 12:26:00,106,64,Brinquedo,8,170
25228,2024-01-18 12:27:00,113,38,Eletrônico,7,151
25229,2024-01-18 12:28:00,28,144,Vestuário,4,172
25230,2024-01-18 12:29:00,56,121,Móvel,7,177
25231,2024-01-18 12:30:00,96,74,Brinquedo,1,170
25232,2024-01-18 12:31:00,54,150,Eletrônico,5,204
25233,2024-01-18 12:32:00,17,125,Móvel,1,142
25234,2024-01-18 12:33:00,82,153,Eletrônico,3,235
25235,2024-01-18 12:34:00,35,93,Vestuário,2,128
25236,2024-01-18 12:35:00,116,23,Brinquedo,7,139
25237,2024-01-18 12:36:00,11,142,Brinquedo,4,153
25238,2024-01-18 12:37:00,44,100,Alimento,8,144
25239,2024-01-18 12:38:00,59,24,Eletrônico,5,83
25240,2024-01-18 12:39:00,15,87,Brinquedo,9,102
25241,2024-01-18 12:40:00,39,143,Eletrônico,6,182
25242,2024-01-18 12:41:00,17,101,Vestuário,9,118
25243,2024-01-18 12:42:00,39,47,Vestuário,5,86
25244,2024-01-18 12:43:00,103,84,Vestuário,8,187
25245,2024-01-18 12:44:00,78,98,Móvel,3,176
25246,2024-01-18 12:45:00,111,49,Eletrônico,1,160
25247,2024-01-18 12:46:00,39,44,Brinquedo,8,83
25248,2024-01-18 12:47:00,98,22,Alimento,8,120
25249,2024-01-18 12:48:00,10,67,Móvel,7,77
25250,2024-01-18 12:49:00,50,12,Alimento,6,62
25251,2024-01-18 12:50:00,32,112,Vestuário,2,144
25252,2024-01-18 12:51:00,14,147,Vestuário,3,161
25253,2024-01-18 12:52:00,35,117,Vestuário,5,152
25254,2024-01-18 12:53:00,15,145,Móvel,3,160
25255,2024-01-18 12:54:00,87,149,Brinquedo,2,236
25256,2024-01-18 12:55:00,73,67,Brinquedo,5,140
25257,2024-01-18 12:56:00,42,39,Eletrônico,9,81
25258,2024-01-18 12:57:00,76,115,Eletrônico,9,191
25259,2024-01-18 12:58:00,13,116,Vestuário,7,129
25260,2024-01-18 12:59:00,13,147,Eletrônico,2,160
25261,2024-01-18 13:00:00,70,69,Móvel,4,139
25262,2024-01-18 13:01:00,79,153,Alimento,7,232
25263,2024-01-18 13:02:00,52,21,Vestuário,5,73
25264,2024-01-18 13:03:00,85,133,Brinquedo,4,218
25265,2024-01-18 13:04:00,31,83,Eletrônico,2,114
25266,2024-01-18 13:05:00,76,27,Alimento,3,103
25267,2024-01-18 13:06:00,31,36,Alimento,8,67
25268,2024-01-18 13:07:00,26,132,Alimento,1,158
25269,2024-01-18 13:08:00,50,123,Vestuário,1,173
25270,2024-01-18 13:09:00,62,42,Móvel,5,104
25271,2024-01-18 13:10:00,87,110,Móvel,2,197
25272,2024-01-18 13:11:00,24,20,Alimento,8,44
25273,2024-01-18 13:12:00,36,122,Brinquedo,9,158
25274,2024-01-18 13:13:00,14,87,Móvel,5,101
25275,2024-01-18 13:14:00,111,33,Vestuário,2,144
25276,2024-01-18 13:15:00,45,68,Alimento,1,113
25277,2024-01-18 13:16:00,16,105,Alimento,3,121
25278,2024-01-18 13:17:00,108,94,Vestuário,7,202
25279,2024-01-18 13:18:00,116,145,Alimento,6,261
25280,2024-01-18 13:19:00,86,149,Eletrônico,7,235
25281,2024-01-18 13:20:00,20,46,Eletrônico,4,66
25282,2024-01-18 13:21:00,91,32,Vestuário,5,123
25283,2024-01-18 13:22:00,45,108,Alimento,3,153
25284,2024-01-18 13:23:00,116,175,Eletrônico,6,291
25285,2024-01-18 13:24:00,16,22,Vestuário,4,38
25286,2024-01-18 13:25:00,17,66,Vestuário,4,83
25287,2024-01-18 13:26:00,95,87,Eletrônico,5,182
25288,2024-01-18 13:27:00,14,116,Brinquedo,9,130
25289,2024-01-18 13:28:00,43,62,Móvel,5,105
25290,2024-01-18 13:29:00,116,109,Brinquedo,7,225
25291,2024-01-18 13:30:00,114,13,Eletrônico,8,127
25292,2024-01-18 13:31:00,22,176,Vestuário,7,198
25293,2024-01-18 13:32:00,56,14,Vestuário,1,70
25294,2024-01-18 13:33:00,73,133,Móvel,8,206
25295,2024-01-18 13:34:00,72,38,Brinquedo,8,110
25296,2024-01-18 13:35:00,16,151,Vestuário,3,167
25297,2024-01-18 13:36:00,60,29,Eletrônico,2,89
25298,2024-01-18 13:37:00,20,96,Alimento,3,116
25299,2024-01-18 13:38:00,88,95,Vestuário,2,183
25300,2024-01-18 13:39:00,112,119,Brinquedo,7,231
25301,2024-01-18 13:40:00,116,157,Brinquedo,7,273
25302,2024-01-18 13:41:00,34,179,Móvel,3,213
25303,2024-01-18 13:42:00,107,21,Móvel,6,128
25304,2024-01-18 13:43:00,109,86,Brinquedo,4,195
25305,2024-01-18 13:44:00,82,111,Vestuário,8,193
25306,2024-01-18 13:45:00,112,154,Alimento,2,266
25307,2024-01-18 13:46:00,81,82,Eletrônico,1,163
25308,2024-01-18 13:47:00,80,102,Eletrônico,6,182
25309,2024-01-18 13:48:00,81,60,Móvel,8,141
25310,2024-01-18 13:49:00,85,116,Vestuário,7,201
25311,2024-01-18 13:50:00,39,141,Brinquedo,3,180
25312,2024-01-18 13:51:00,105,86,Alimento,5,191
25313,2024-01-18 13:52:00,46,159,Eletrônico,5,205
25314,2024-01-18 13:53:00,86,11,Alimento,2,97
25315,2024-01-18 13:54:00,16,134,Eletrônico,6,150
25316,2024-01-18 13:55:00,99,106,Móvel,4,205
25317,2024-01-18 13:56:00,47,109,Alimento,6,156
25318,2024-01-18 13:57:00,79,89,Móvel,1,168
25319,2024-01-18 13:58:00,38,37,Móvel,4,75
25320,2024-01-18 13:59:00,87,106,Alimento,5,193
25321,2024-01-18 14:00:00,80,41,Alimento,9,121
25322,2024-01-18 14:01:00,46,78,Eletrônico,9,124
25323,2024-01-18 14:02:00,15,112,Eletrônico,2,127
25324,2024-01-18 14:03:00,87,36,Eletrônico,1,123
25325,2024-01-18 14:04:00,14,152,Eletrônico,7,166
25326,2024-01-18 14:05:00,13,58,Vestuário,4,71
25327,2024-01-18 14:06:00,65,158,Vestuário,1,223
25328,2024-01-18 14:07:00,35,28,Alimento,6,63
25329,2024-01-18 14:08:00,67,160,Vestuário,6,227
25330,2024-01-18 14:09:00,111,67,Brinquedo,6,178
25331,2024-01-18 14:10:00,91,163,Móvel,3,254
25332,2024-01-18 14:11:00,100,146,Vestuário,5,246
25333,2024-01-18 14:12:00,93,79,Móvel,6,172
25334,2024-01-18 14:13:00,100,110,Vestuário,7,210
25335,2024-01-18 14:14:00,85,76,Móvel,4,161
25336,2024-01-18 14:15:00,26,71,Eletrônico,3,97
25337,2024-01-18 14:16:00,24,13,Alimento,8,37
25338,2024-01-18 14:17:00,41,163,Vestuário,2,204
25339,2024-01-18 14:18:00,114,85,Brinquedo,9,199
25340,2024-01-18 14:19:00,103,16,Vestuário,7,119
25341,2024-01-18 14:20:00,100,56,Eletrônico,4,156
25342,2024-01-18 14:21:00,45,31,Brinquedo,7,76
25343,2024-01-18 14:22:00,108,36,Vestuário,9,144
25344,2024-01-18 14:23:00,84,164,Alimento,3,248
25345,2024-01-18 14:24:00,96,61,Brinquedo,9,157
25346,2024-01-18 14:25:00,87,152,Móvel,3,239
25347,2024-01-18 14:26:00,20,19,Alimento,7,39
25348,2024-01-18 14:27:00,72,136,Vestuário,3,208
25349,2024-01-18 14:28:00,116,169,Brinquedo,5,285
25350,2024-01-18 14:29:00,44,137,Móvel,8,181
25351,2024-01-18 14:30:00,43,86,Eletrônico,8,129
25352,2024-01-18 14:31:00,110,83,Brinquedo,1,193
25353,2024-01-18 14:32:00,97,79,Eletrônico,1,176
25354,2024-01-18 14:33:00,49,75,Eletrônico,5,124
25355,2024-01-18 14:34:00,105,65,Vestuário,1,170
25356,2024-01-18 14:35:00,107,110,Eletrônico,3,217
25357,2024-01-18 14:36:00,52,82,Vestuário,4,134
25358,2024-01-18 14:37:00,75,175,Alimento,6,250
25359,2024-01-18 14:38:00,52,115,Móvel,8,167
25360,2024-01-18 14:39:00,114,140,Eletrônico,1,254
25361,2024-01-18 14:40:00,33,56,Vestuário,2,89
25362,2024-01-18 14:41:00,40,103,Vestuário,4,143
25363,2024-01-18 14:42:00,41,25,Móvel,6,66
25364,2024-01-18 14:43:00,93,49,Vestuário,5,142
25365,2024-01-18 14:44:00,16,42,Vestuário,6,58
25366,2024-01-18 14:45:00,81,173,Brinquedo,6,254
25367,2024-01-18 14:46:00,34,41,Móvel,3,75
25368,2024-01-18 14:47:00,38,105,Brinquedo,8,143
25369,2024-01-18 14:48:00,48,92,Vestuário,7,140
25370,2024-01-18 14:49:00,90,172,Móvel,1,262
25371,2024-01-18 14:50:00,33,137,Móvel,3,170
25372,2024-01-18 14:51:00,85,132,Brinquedo,1,217
25373,2024-01-18 14:52:00,108,137,Móvel,1,245
25374,2024-01-18 14:53:00,50,79,Brinquedo,4,129
25375,2024-01-18 14:54:00,21,19,Móvel,3,40
25376,2024-01-18 14:55:00,109,128,Brinquedo,6,237
25377,2024-01-18 14:56:00,55,164,Vestuário,9,219
25378,2024-01-18 14:57:00,61,64,Alimento,3,125
25379,2024-01-18 14:58:00,31,161,Eletrônico,1,192
25380,2024-01-18 14:59:00,105,104,Móvel,9,209
25381,2024-01-18 15:00:00,64,166,Eletrônico,7,230
25382,2024-01-18 15:01:00,50,104,Brinquedo,6,154
25383,2024-01-18 15:02:00,47,73,Móvel,6,120
25384,2024-01-18 15:03:00,78,14,Eletrônico,5,92
25385,2024-01-18 15:04:00,22,76,Alimento,6,98
25386,2024-01-18 15:05:00,80,30,Móvel,9,110
25387,2024-01-18 15:06:00,52,43,Brinquedo,1,95
25388,2024-01-18 15:07:00,24,94,Móvel,3,118
25389,2024-01-18 15:08:00,109,140,Vestuário,2,249
25390,2024-01-18 15:09:00,40,154,Móvel,4,194
25391,2024-01-18 15:10:00,19,167,Vestuário,8,186
25392,2024-01-18 15:11:00,41,33,Móvel,7,74
25393,2024-01-18 15:12:00,114,147,Vestuário,3,261
25394,2024-01-18 15:13:00,108,37,Eletrônico,3,145
25395,2024-01-18 15:14:00,79,48,Móvel,5,127
25396,2024-01-18 15:15:00,94,80,Vestuário,5,174
25397,2024-01-18 15:16:00,60,59,Vestuário,2,119
25398,2024-01-18 15:17:00,117,108,Brinquedo,7,225
25399,2024-01-18 15:18:00,42,13,Vestuário,6,55
25400,2024-01-18 15:19:00,40,155,Alimento,1,195
25401,2024-01-18 15:20:00,50,90,Alimento,9,140
25402,2024-01-18 15:21:00,21,30,Móvel,4,51
25403,2024-01-18 15:22:00,41,145,Vestuário,5,186
25404,2024-01-18 15:23:00,14,48,Eletrônico,9,62
25405,2024-01-18 15:24:00,17,126,Vestuário,6,143
25406,2024-01-18 15:25:00,99,152,Brinquedo,7,251
25407,2024-01-18 15:26:00,92,112,Brinquedo,8,204
25408,2024-01-18 15:27:00,107,61,Eletrônico,9,168
25409,2024-01-18 15:28:00,86,179,Eletrônico,7,265
25410,2024-01-18 15:29:00,42,26,Vestuário,6,68
25411,2024-01-18 15:30:00,100,16,Brinquedo,4,116
25412,2024-01-18 15:31:00,80,159,Eletrônico,6,239
25413,2024-01-18 15:32:00,21,140,Vestuário,4,161
25414,2024-01-18 15:33:00,29,13,Alimento,1,42
25415,2024-01-18 15:34:00,17,147,Alimento,9,164
25416,2024-01-18 15:35:00,29,71,Brinquedo,9,100
25417,2024-01-18 15:36:00,57,102,Eletrônico,1,159
25418,2024-01-18 15:37:00,92,167,Vestuário,6,259
25419,2024-01-18 15:38:00,13,39,Brinquedo,6,52
25420,2024-01-18 15:39:00,94,101,Eletrônico,6,195
25421,2024-01-18 15:40:00,54,54,Alimento,9,108
25422,2024-01-18 15:41:00,36,69,Eletrônico,7,105
25423,2024-01-18 15:42:00,32,166,Eletrônico,2,198
25424,2024-01-18 15:43:00,16,77,Brinquedo,2,93
25425,2024-01-18 15:44:00,10,49,Eletrônico,7,59
25426,2024-01-18 15:45:00,36,18,Eletrônico,5,54
25427,2024-01-18 15:46:00,118,49,Brinquedo,8,167
25428,2024-01-18 15:47:00,119,91,Móvel,3,210
25429,2024-01-18 15:48:00,59,124,Móvel,6,183
25430,2024-01-18 15:49:00,72,120,Eletrônico,3,192
25431,2024-01-18 15:50:00,104,61,Alimento,5,165
25432,2024-01-18 15:51:00,58,44,Eletrônico,3,102
25433,2024-01-18 15:52:00,98,51,Eletrônico,8,149
25434,2024-01-18 15:53:00,85,129,Alimento,3,214
25435,2024-01-18 15:54:00,102,25,Eletrônico,7,127
25436,2024-01-18 15:55:00,33,142,Eletrônico,4,175
25437,2024-01-18 15:56:00,32,76,Vestuário,8,108
25438,2024-01-18 15:57:00,57,12,Vestuário,3,69
25439,2024-01-18 15:58:00,112,118,Vestuário,8,230
25440,2024-01-18 15:59:00,34,95,Alimento,7,129
25441,2024-01-18 16:00:00,19,29,Alimento,1,48
25442,2024-01-18 16:01:00,111,156,Eletrônico,8,267
25443,2024-01-18 16:02:00,114,176,Móvel,2,290
25444,2024-01-18 16:03:00,48,129,Vestuário,3,177
25445,2024-01-18 16:04:00,100,72,Vestuário,8,172
25446,2024-01-18 16:05:00,18,65,Eletrônico,3,83
25447,2024-01-18 16:06:00,109,72,Eletrônico,4,181
25448,2024-01-18 16:07:00,67,165,Eletrônico,7,232
25449,2024-01-18 16:08:00,40,19,Brinquedo,1,59
25450,2024-01-18 16:09:00,31,171,Brinquedo,1,202
25451,2024-01-18 16:10:00,118,151,Eletrônico,1,269
25452,2024-01-18 16:11:00,115,48,Vestuário,6,163
25453,2024-01-18 16:12:00,20,49,Brinquedo,4,69
25454,2024-01-18 16:13:00,20,29,Alimento,5,49
25455,2024-01-18 16:14:00,118,46,Vestuário,1,164
25456,2024-01-18 16:15:00,22,115,Eletrônico,1,137
25457,2024-01-18 16:16:00,36,168,Brinquedo,9,204
25458,2024-01-18 16:17:00,111,33,Alimento,2,144
25459,2024-01-18 16:18:00,116,40,Eletrônico,9,156
25460,2024-01-18 16:19:00,53,76,Móvel,5,129
25461,2024-01-18 16:20:00,32,11,Brinquedo,3,43
25462,2024-01-18 16:21:00,112,42,Alimento,3,154
25463,2024-01-18 16:22:00,87,134,Brinquedo,9,221
25464,2024-01-18 16:23:00,34,127,Vestuário,3,161
25465,2024-01-18 16:24:00,70,178,Móvel,1,248
25466,2024-01-18 16:25:00,96,169,Eletrônico,7,265
25467,2024-01-18 16:26:00,99,144,Alimento,8,243
25468,2024-01-18 16:27:00,58,96,Alimento,6,154
25469,2024-01-18 16:28:00,22,100,Brinquedo,9,122
25470,2024-01-18 16:29:00,39,132,Móvel,9,171
25471,2024-01-18 16:30:00,60,40,Brinquedo,1,100
25472,2024-01-18 16:31:00,36,19,Vestuário,6,55
25473,2024-01-18 16:32:00,102,174,Vestuário,3,276
25474,2024-01-18 16:33:00,101,49,Eletrônico,8,150
25475,2024-01-18 16:34:00,50,30,Vestuário,3,80
25476,2024-01-18 16:35:00,16,115,Brinquedo,1,131
25477,2024-01-18 16:36:00,114,162,Eletrônico,6,276
25478,2024-01-18 16:37:00,70,82,Brinquedo,9,152
25479,2024-01-18 16:38:00,87,155,Alimento,1,242
25480,2024-01-18 16:39:00,38,123,Móvel,9,161
25481,2024-01-18 16:40:00,23,88,Alimento,7,111
25482,2024-01-18 16:41:00,63,139,Móvel,2,202
25483,2024-01-18 16:42:00,75,22,Móvel,4,97
25484,2024-01-18 16:43:00,24,130,Vestuário,7,154
25485,2024-01-18 16:44:00,22,134,Brinquedo,3,156
25486,2024-01-18 16:45:00,109,110,Brinquedo,4,219
25487,2024-01-18 16:46:00,84,83,Brinquedo,7,167
25488,2024-01-18 16:47:00,25,145,Vestuário,8,170
25489,2024-01-18 16:48:00,18,165,Alimento,8,183
25490,2024-01-18 16:49:00,73,60,Móvel,9,133
25491,2024-01-18 16:50:00,104,43,Eletrônico,9,147
25492,2024-01-18 16:51:00,99,87,Brinquedo,9,186
25493,2024-01-18 16:52:00,77,30,Móvel,3,107
25494,2024-01-18 16:53:00,68,113,Alimento,2,181
25495,2024-01-18 16:54:00,66,111,Vestuário,7,177
25496,2024-01-18 16:55:00,10,172,Móvel,8,182
25497,2024-01-18 16:56:00,103,124,Móvel,5,227
25498,2024-01-18 16:57:00,13,23,Vestuário,1,36
25499,2024-01-18 16:58:00,77,55,Eletrônico,6,132
25500,2024-01-18 16:59:00,99,118,Vestuário,8,217
25501,2024-01-18 17:00:00,39,12,Alimento,4,51
25502,2024-01-18 17:01:00,110,99,Eletrônico,2,209
25503,2024-01-18 17:02:00,55,178,Vestuário,7,233
25504,2024-01-18 17:03:00,116,56,Brinquedo,3,172
25505,2024-01-18 17:04:00,106,126,Eletrônico,5,232
25506,2024-01-18 17:05:00,71,163,Eletrônico,1,234
25507,2024-01-18 17:06:00,51,45,Vestuário,5,96
25508,2024-01-18 17:07:00,58,50,Vestuário,6,108
25509,2024-01-18 17:08:00,54,157,Alimento,9,211
25510,2024-01-18 17:09:00,73,140,Vestuário,1,213
25511,2024-01-18 17:10:00,63,21,Eletrônico,3,84
25512,2024-01-18 17:11:00,84,105,Alimento,4,189
25513,2024-01-18 17:12:00,54,129,Brinquedo,6,183
25514,2024-01-18 17:13:00,68,25,Brinquedo,6,93
25515,2024-01-18 17:14:00,85,17,Alimento,4,102
25516,2024-01-18 17:15:00,104,21,Vestuário,4,125
25517,2024-01-18 17:16:00,20,134,Vestuário,3,154
25518,2024-01-18 17:17:00,15,152,Eletrônico,7,167
25519,2024-01-18 17:18:00,13,164,Brinquedo,4,177
25520,2024-01-18 17:19:00,17,76,Brinquedo,7,93
25521,2024-01-18 17:20:00,28,16,Vestuário,1,44
25522,2024-01-18 17:21:00,56,14,Eletrônico,4,70
25523,2024-01-18 17:22:00,63,165,Eletrônico,8,228
25524,2024-01-18 17:23:00,118,14,Móvel,9,132
25525,2024-01-18 17:24:00,36,147,Brinquedo,6,183
25526,2024-01-18 17:25:00,10,45,Brinquedo,1,55
25527,2024-01-18 17:26:00,108,158,Brinquedo,5,266
25528,2024-01-18 17:27:00,52,49,Móvel,5,101
25529,2024-01-18 17:28:00,16,41,Móvel,1,57
25530,2024-01-18 17:29:00,10,42,Vestuário,1,52
25531,2024-01-18 17:30:00,18,120,Eletrônico,6,138
25532,2024-01-18 17:31:00,59,83,Móvel,3,142
25533,2024-01-18 17:32:00,62,154,Brinquedo,4,216
25534,2024-01-18 17:33:00,49,142,Brinquedo,3,191
25535,2024-01-18 17:34:00,20,165,Alimento,4,185
25536,2024-01-18 17:35:00,21,47,Vestuário,6,68
25537,2024-01-18 17:36:00,40,115,Vestuário,2,155
25538,2024-01-18 17:37:00,17,166,Vestuário,8,183
25539,2024-01-18 17:38:00,44,128,Brinquedo,6,172
25540,2024-01-18 17:39:00,70,30,Alimento,4,100
25541,2024-01-18 17:40:00,87,56,Móvel,5,143
25542,2024-01-18 17:41:00,18,79,Eletrônico,3,97
25543,2024-01-18 17:42:00,51,108,Brinquedo,9,159
25544,2024-01-18 17:43:00,16,91,Eletrônico,1,107
25545,2024-01-18 17:44:00,40,110,Móvel,5,150
25546,2024-01-18 17:45:00,63,102,Eletrônico,9,165
25547,2024-01-18 17:46:00,116,132,Vestuário,7,248
25548,2024-01-18 17:47:00,65,109,Alimento,7,174
25549,2024-01-18 17:48:00,87,26,Vestuário,6,113
25550,2024-01-18 17:49:00,45,71,Vestuário,9,116
25551,2024-01-18 17:50:00,77,94,Vestuário,8,171
25552,2024-01-18 17:51:00,72,168,Eletrônico,5,240
25553,2024-01-18 17:52:00,29,92,Vestuário,9,121
25554,2024-01-18 17:53:00,18,39,Vestuário,2,57
25555,2024-01-18 17:54:00,21,66,Brinquedo,3,87
25556,2024-01-18 17:55:00,53,150,Eletrônico,3,203
25557,2024-01-18 17:56:00,107,133,Eletrônico,4,240
25558,2024-01-18 17:57:00,77,129,Brinquedo,1,206
25559,2024-01-18 17:58:00,85,19,Vestuário,5,104
25560,2024-01-18 17:59:00,91,171,Móvel,5,262
25561,2024-01-18 18:00:00,26,149,Eletrônico,7,175
25562,2024-01-18 18:01:00,18,143,Alimento,2,161
25563,2024-01-18 18:02:00,15,56,Brinquedo,6,71
25564,2024-01-18 18:03:00,22,162,Móvel,5,184
25565,2024-01-18 18:04:00,50,134,Alimento,5,184
25566,2024-01-18 18:05:00,23,111,Eletrônico,4,134
25567,2024-01-18 18:06:00,40,122,Eletrônico,8,162
25568,2024-01-18 18:07:00,106,82,Eletrônico,2,188
25569,2024-01-18 18:08:00,70,100,Brinquedo,4,170
25570,2024-01-18 18:09:00,61,150,Alimento,4,211
25571,2024-01-18 18:10:00,18,99,Brinquedo,6,117
25572,2024-01-18 18:11:00,99,53,Brinquedo,5,152
25573,2024-01-18 18:12:00,109,56,Vestuário,3,165
25574,2024-01-18 18:13:00,92,24,Móvel,9,116
25575,2024-01-18 18:14:00,44,135,Vestuário,2,179
25576,2024-01-18 18:15:00,61,165,Alimento,2,226
25577,2024-01-18 18:16:00,105,25,Vestuário,6,130
25578,2024-01-18 18:17:00,52,25,Vestuário,7,77
25579,2024-01-18 18:18:00,109,62,Eletrônico,2,171
25580,2024-01-18 18:19:00,39,56,Eletrônico,9,95
25581,2024-01-18 18:20:00,117,108,Alimento,3,225
25582,2024-01-18 18:21:00,18,51,Alimento,9,69
25583,2024-01-18 18:22:00,115,68,Eletrônico,3,183
25584,2024-01-18 18:23:00,107,148,Eletrônico,3,255
25585,2024-01-18 18:24:00,18,47,Móvel,5,65
25586,2024-01-18 18:25:00,115,38,Vestuário,4,153
25587,2024-01-18 18:26:00,112,78,Vestuário,7,190
25588,2024-01-18 18:27:00,21,24,Alimento,3,45
25589,2024-01-18 18:28:00,14,90,Alimento,6,104
25590,2024-01-18 18:29:00,99,176,Móvel,4,275
25591,2024-01-18 18:30:00,51,176,Móvel,6,227
25592,2024-01-18 18:31:00,26,160,Vestuário,2,186
25593,2024-01-18 18:32:00,72,55,Brinquedo,3,127
25594,2024-01-18 18:33:00,23,107,Móvel,2,130
25595,2024-01-18 18:34:00,31,144,Móvel,3,175
25596,2024-01-18 18:35:00,41,81,Vestuário,6,122
25597,2024-01-18 18:36:00,80,69,Móvel,4,149
25598,2024-01-18 18:37:00,105,36,Brinquedo,4,141
25599,2024-01-18 18:38:00,46,175,Eletrônico,2,221
25600,2024-01-18 18:39:00,18,13,Brinquedo,6,31
25601,2024-01-18 18:40:00,18,168,Eletrônico,9,186
25602,2024-01-18 18:41:00,63,54,Alimento,7,117
25603,2024-01-18 18:42:00,74,59,Alimento,2,133
25604,2024-01-18 18:43:00,102,100,Móvel,3,202
25605,2024-01-18 18:44:00,33,169,Brinquedo,7,202
25606,2024-01-18 18:45:00,54,56,Brinquedo,8,110
25607,2024-01-18 18:46:00,42,144,Brinquedo,7,186
25608,2024-01-18 18:47:00,28,56,Eletrônico,3,84
25609,2024-01-18 18:48:00,58,16,Vestuário,8,74
25610,2024-01-18 18:49:00,111,109,Móvel,1,220
25611,2024-01-18 18:50:00,35,149,Eletrônico,8,184
25612,2024-01-18 18:51:00,35,177,Eletrônico,3,212
25613,2024-01-18 18:52:00,92,17,Brinquedo,4,109
25614,2024-01-18 18:53:00,78,157,Brinquedo,9,235
25615,2024-01-18 18:54:00,12,156,Eletrônico,5,168
25616,2024-01-18 18:55:00,11,67,Eletrônico,6,78
25617,2024-01-18 18:56:00,10,72,Móvel,9,82
25618,2024-01-18 18:57:00,41,32,Alimento,2,73
25619,2024-01-18 18:58:00,94,83,Eletrônico,1,177
25620,2024-01-18 18:59:00,18,153,Brinquedo,6,171
25621,2024-01-18 19:00:00,68,120,Vestuário,3,188
25622,2024-01-18 19:01:00,27,108,Eletrônico,7,135
25623,2024-01-18 19:02:00,57,127,Eletrônico,9,184
25624,2024-01-18 19:03:00,45,140,Alimento,1,185
25625,2024-01-18 19:04:00,116,26,Alimento,3,142
25626,2024-01-18 19:05:00,11,126,Vestuário,9,137
25627,2024-01-18 19:06:00,70,11,Brinquedo,5,81
25628,2024-01-18 19:07:00,66,46,Vestuário,5,112
25629,2024-01-18 19:08:00,15,143,Móvel,6,158
25630,2024-01-18 19:09:00,41,177,Brinquedo,4,218
25631,2024-01-18 19:10:00,42,166,Brinquedo,9,208
25632,2024-01-18 19:11:00,21,139,Eletrônico,4,160
25633,2024-01-18 19:12:00,76,129,Eletrônico,6,205
25634,2024-01-18 19:13:00,108,171,Alimento,2,279
25635,2024-01-18 19:14:00,94,69,Vestuário,9,163
25636,2024-01-18 19:15:00,70,127,Eletrônico,2,197
25637,2024-01-18 19:16:00,38,17,Móvel,6,55
25638,2024-01-18 19:17:00,85,77,Vestuário,2,162
25639,2024-01-18 19:18:00,33,33,Eletrônico,1,66
25640,2024-01-18 19:19:00,70,116,Eletrônico,1,186
25641,2024-01-18 19:20:00,26,136,Vestuário,7,162
25642,2024-01-18 19:21:00,103,169,Móvel,7,272
25643,2024-01-18 19:22:00,50,129,Brinquedo,8,179
25644,2024-01-18 19:23:00,57,171,Brinquedo,5,228
25645,2024-01-18 19:24:00,40,51,Brinquedo,8,91
25646,2024-01-18 19:25:00,107,142,Móvel,6,249
25647,2024-01-18 19:26:00,67,119,Brinquedo,3,186
25648,2024-01-18 19:27:00,57,140,Brinquedo,4,197
25649,2024-01-18 19:28:00,51,16,Vestuário,2,67
25650,2024-01-18 19:29:00,99,108,Móvel,4,207
25651,2024-01-18 19:30:00,96,66,Eletrônico,8,162
25652,2024-01-18 19:31:00,78,34,Brinquedo,3,112
25653,2024-01-18 19:32:00,57,79,Alimento,8,136
25654,2024-01-18 19:33:00,63,99,Alimento,9,162
25655,2024-01-18 19:34:00,62,114,Vestuário,1,176
25656,2024-01-18 19:35:00,79,63,Móvel,7,142
25657,2024-01-18 19:36:00,117,34,Alimento,3,151
25658,2024-01-18 19:37:00,80,148,Brinquedo,9,228
25659,2024-01-18 19:38:00,91,105,Vestuário,2,196
25660,2024-01-18 19:39:00,26,49,Alimento,8,75
25661,2024-01-18 19:40:00,77,42,Eletrônico,8,119
25662,2024-01-18 19:41:00,60,89,Eletrônico,4,149
25663,2024-01-18 19:42:00,72,24,Eletrônico,5,96
25664,2024-01-18 19:43:00,51,75,Vestuário,2,126
25665,2024-01-18 19:44:00,85,72,Eletrônico,5,157
25666,2024-01-18 19:45:00,83,78,Eletrônico,2,161
25667,2024-01-18 19:46:00,89,98,Alimento,9,187
25668,2024-01-18 19:47:00,59,157,Vestuário,1,216
25669,2024-01-18 19:48:00,116,133,Brinquedo,2,249
25670,2024-01-18 19:49:00,11,55,Brinquedo,2,66
25671,2024-01-18 19:50:00,66,123,Vestuário,2,189
25672,2024-01-18 19:51:00,15,140,Vestuário,8,155
25673,2024-01-18 19:52:00,119,85,Móvel,4,204
25674,2024-01-18 19:53:00,55,107,Vestuário,4,162
25675,2024-01-18 19:54:00,115,51,Vestuário,2,166
25676,2024-01-18 19:55:00,60,148,Alimento,8,208
25677,2024-01-18 19:56:00,108,103,Vestuário,3,211
25678,2024-01-18 19:57:00,85,160,Móvel,7,245
25679,2024-01-18 19:58:00,60,52,Alimento,1,112
25680,2024-01-18 19:59:00,85,153,Brinquedo,6,238
25681,2024-01-18 20:00:00,99,107,Brinquedo,9,206
25682,2024-01-18 20:01:00,69,168,Eletrônico,7,237
25683,2024-01-18 20:02:00,59,125,Móvel,4,184
25684,2024-01-18 20:03:00,13,144,Móvel,8,157
25685,2024-01-18 20:04:00,73,130,Brinquedo,9,203
25686,2024-01-18 20:05:00,97,123,Alimento,9,220
25687,2024-01-18 20:06:00,100,67,Vestuário,4,167
25688,2024-01-18 20:07:00,21,20,Móvel,2,41
25689,2024-01-18 20:08:00,36,82,Alimento,7,118
25690,2024-01-18 20:09:00,76,105,Eletrônico,8,181
25691,2024-01-18 20:10:00,23,142,Vestuário,3,165
25692,2024-01-18 20:11:00,111,24,Eletrônico,7,135
25693,2024-01-18 20:12:00,19,115,Alimento,5,134
25694,2024-01-18 20:13:00,49,50,Alimento,4,99
25695,2024-01-18 20:14:00,77,51,Brinquedo,1,128
25696,2024-01-18 20:15:00,46,156,Vestuário,4,202
25697,2024-01-18 20:16:00,16,37,Brinquedo,2,53
25698,2024-01-18 20:17:00,106,55,Eletrônico,3,161
25699,2024-01-18 20:18:00,41,55,Vestuário,4,96
25700,2024-01-18 20:19:00,27,82,Brinquedo,7,109
25701,2024-01-18 20:20:00,105,16,Brinquedo,3,121
25702,2024-01-18 20:21:00,46,106,Eletrônico,3,152
25703,2024-01-18 20:22:00,74,80,Vestuário,3,154
25704,2024-01-18 20:23:00,97,44,Eletrônico,8,141
25705,2024-01-18 20:24:00,25,10,Móvel,8,35
25706,2024-01-18 20:25:00,38,122,Eletrônico,2,160
25707,2024-01-18 20:26:00,119,21,Eletrônico,5,140
25708,2024-01-18 20:27:00,97,115,Vestuário,1,212
25709,2024-01-18 20:28:00,18,167,Vestuário,4,185
25710,2024-01-18 20:29:00,65,60,Eletrônico,1,125
25711,2024-01-18 20:30:00,43,144,Alimento,9,187
25712,2024-01-18 20:31:00,92,39,Vestuário,3,131
25713,2024-01-18 20:32:00,95,68,Brinquedo,2,163
25714,2024-01-18 20:33:00,22,20,Alimento,1,42
25715,2024-01-18 20:34:00,78,88,Brinquedo,9,166
25716,2024-01-18 20:35:00,51,65,Eletrônico,5,116
25717,2024-01-18 20:36:00,96,64,Eletrônico,7,160
25718,2024-01-18 20:37:00,82,62,Eletrônico,3,144
25719,2024-01-18 20:38:00,56,56,Alimento,4,112
25720,2024-01-18 20:39:00,115,51,Vestuário,1,166
25721,2024-01-18 20:40:00,30,134,Móvel,7,164
25722,2024-01-18 20:41:00,87,70,Eletrônico,5,157
25723,2024-01-18 20:42:00,109,21,Móvel,7,130
25724,2024-01-18 20:43:00,15,15,Alimento,6,30
25725,2024-01-18 20:44:00,74,166,Eletrônico,7,240
25726,2024-01-18 20:45:00,42,16,Brinquedo,7,58
25727,2024-01-18 20:46:00,34,104,Eletrônico,1,138
25728,2024-01-18 20:47:00,98,45,Vestuário,2,143
25729,2024-01-18 20:48:00,67,124,Alimento,1,191
25730,2024-01-18 20:49:00,82,72,Móvel,6,154
25731,2024-01-18 20:50:00,88,134,Móvel,7,222
25732,2024-01-18 20:51:00,115,24,Brinquedo,2,139
25733,2024-01-18 20:52:00,48,24,Eletrônico,1,72
25734,2024-01-18 20:53:00,10,168,Eletrônico,6,178
25735,2024-01-18 20:54:00,88,135,Alimento,8,223
25736,2024-01-18 20:55:00,47,166,Brinquedo,3,213
25737,2024-01-18 20:56:00,80,83,Eletrônico,4,163
25738,2024-01-18 20:57:00,116,35,Brinquedo,2,151
25739,2024-01-18 20:58:00,82,16,Vestuário,5,98
25740,2024-01-18 20:59:00,103,145,Alimento,8,248
25741,2024-01-18 21:00:00,26,146,Móvel,9,172
25742,2024-01-18 21:01:00,54,115,Brinquedo,9,169
25743,2024-01-18 21:02:00,78,113,Alimento,2,191
25744,2024-01-18 21:03:00,13,55,Vestuário,9,68
25745,2024-01-18 21:04:00,14,34,Alimento,8,48
25746,2024-01-18 21:05:00,79,45,Brinquedo,6,124
25747,2024-01-18 21:06:00,103,16,Vestuário,4,119
25748,2024-01-18 21:07:00,115,25,Móvel,1,140
25749,2024-01-18 21:08:00,22,98,Eletrônico,8,120
25750,2024-01-18 21:09:00,96,63,Vestuário,5,159
25751,2024-01-18 21:10:00,108,146,Móvel,1,254
25752,2024-01-18 21:11:00,19,25,Brinquedo,7,44
25753,2024-01-18 21:12:00,72,16,Eletrônico,8,88
25754,2024-01-18 21:13:00,89,40,Alimento,3,129
25755,2024-01-18 21:14:00,117,32,Vestuário,7,149
25756,2024-01-18 21:15:00,44,47,Brinquedo,6,91
25757,2024-01-18 21:16:00,99,101,Vestuário,3,200
25758,2024-01-18 21:17:00,85,43,Alimento,7,128
25759,2024-01-18 21:18:00,115,47,Vestuário,8,162
25760,2024-01-18 21:19:00,93,161,Alimento,7,254
25761,2024-01-18 21:20:00,70,66,Alimento,3,136
25762,2024-01-18 21:21:00,16,70,Brinquedo,4,86
25763,2024-01-18 21:22:00,58,113,Vestuário,9,171
25764,2024-01-18 21:23:00,111,43,Vestuário,4,154
25765,2024-01-18 21:24:00,46,151,Alimento,8,197
25766,2024-01-18 21:25:00,62,23,Alimento,7,85
25767,2024-01-18 21:26:00,61,50,Eletrônico,7,111
25768,2024-01-18 21:27:00,38,148,Vestuário,6,186
25769,2024-01-18 21:28:00,50,135,Eletrônico,7,185
25770,2024-01-18 21:29:00,110,166,Eletrônico,7,276
25771,2024-01-18 21:30:00,61,66,Brinquedo,3,127
25772,2024-01-18 21:31:00,35,122,Alimento,7,157
25773,2024-01-18 21:32:00,17,150,Eletrônico,4,167
25774,2024-01-18 21:33:00,25,126,Vestuário,2,151
25775,2024-01-18 21:34:00,17,153,Alimento,8,170
25776,2024-01-18 21:35:00,64,76,Eletrônico,2,140
25777,2024-01-18 21:36:00,82,20,Eletrônico,4,102
25778,2024-01-18 21:37:00,94,19,Brinquedo,2,113
25779,2024-01-18 21:38:00,96,73,Alimento,9,169
25780,2024-01-18 21:39:00,79,163,Móvel,7,242
25781,2024-01-18 21:40:00,75,38,Alimento,2,113
25782,2024-01-18 21:41:00,116,92,Alimento,2,208
25783,2024-01-18 21:42:00,119,81,Brinquedo,4,200
25784,2024-01-18 21:43:00,89,178,Vestuário,5,267
25785,2024-01-18 21:44:00,90,93,Móvel,9,183
25786,2024-01-18 21:45:00,56,73,Alimento,6,129
25787,2024-01-18 21:46:00,94,137,Brinquedo,4,231
25788,2024-01-18 21:47:00,36,129,Alimento,6,165
25789,2024-01-18 21:48:00,71,103,Eletrônico,8,174
25790,2024-01-18 21:49:00,19,71,Móvel,6,90
25791,2024-01-18 21:50:00,47,50,Eletrônico,1,97
25792,2024-01-18 21:51:00,91,109,Eletrônico,2,200
25793,2024-01-18 21:52:00,34,126,Alimento,5,160
25794,2024-01-18 21:53:00,29,72,Vestuário,5,101
25795,2024-01-18 21:54:00,102,33,Vestuário,1,135
25796,2024-01-18 21:55:00,32,80,Brinquedo,2,112
25797,2024-01-18 21:56:00,113,179,Móvel,5,292
25798,2024-01-18 21:57:00,104,97,Móvel,5,201
25799,2024-01-18 21:58:00,86,89,Móvel,9,175
25800,2024-01-18 21:59:00,26,46,Móvel,3,72
25801,2024-01-18 22:00:00,66,35,Vestuário,2,101
25802,2024-01-18 22:01:00,89,142,Alimento,9,231
25803,2024-01-18 22:02:00,20,50,Vestuário,6,70
25804,2024-01-18 22:03:00,107,113,Eletrônico,3,220
25805,2024-01-18 22:04:00,113,170,Brinquedo,5,283
25806,2024-01-18 22:05:00,53,76,Móvel,9,129
25807,2024-01-18 22:06:00,49,172,Alimento,6,221
25808,2024-01-18 22:07:00,33,125,Vestuário,7,158
25809,2024-01-18 22:08:00,50,118,Móvel,6,168
25810,2024-01-18 22:09:00,34,105,Vestuário,6,139
25811,2024-01-18 22:10:00,57,162,Eletrônico,1,219
25812,2024-01-18 22:11:00,103,20,Móvel,3,123
25813,2024-01-18 22:12:00,62,95,Alimento,9,157
25814,2024-01-18 22:13:00,97,38,Vestuário,4,135
25815,2024-01-18 22:14:00,15,77,Móvel,9,92
25816,2024-01-18 22:15:00,61,159,Móvel,8,220
25817,2024-01-18 22:16:00,76,159,Alimento,4,235
25818,2024-01-18 22:17:00,31,64,Eletrônico,8,95
25819,2024-01-18 22:18:00,39,128,Alimento,2,167
25820,2024-01-18 22:19:00,54,13,Vestuário,3,67
25821,2024-01-18 22:20:00,52,82,Móvel,7,134
25822,2024-01-18 22:21:00,52,161,Vestuário,1,213
25823,2024-01-18 22:22:00,55,41,Vestuário,8,96
25824,2024-01-18 22:23:00,98,168,Eletrônico,7,266
25825,2024-01-18 22:24:00,39,61,Vestuário,5,100
25826,2024-01-18 22:25:00,89,121,Vestuário,1,210
25827,2024-01-18 22:26:00,96,28,Brinquedo,4,124
25828,2024-01-18 22:27:00,91,12,Brinquedo,6,103
25829,2024-01-18 22:28:00,28,139,Eletrônico,2,167
25830,2024-01-18 22:29:00,114,61,Brinquedo,8,175
25831,2024-01-18 22:30:00,26,65,Brinquedo,3,91
25832,2024-01-18 22:31:00,94,144,Móvel,1,238
25833,2024-01-18 22:32:00,61,170,Vestuário,2,231
25834,2024-01-18 22:33:00,54,155,Alimento,6,209
25835,2024-01-18 22:34:00,15,114,Móvel,7,129
25836,2024-01-18 22:35:00,29,175,Alimento,1,204
25837,2024-01-18 22:36:00,57,154,Eletrônico,9,211
25838,2024-01-18 22:37:00,107,167,Móvel,1,274
25839,2024-01-18 22:38:00,106,123,Eletrônico,7,229
25840,2024-01-18 22:39:00,75,53,Eletrônico,6,128
25841,2024-01-18 22:40:00,21,162,Brinquedo,6,183
25842,2024-01-18 22:41:00,86,134,Brinquedo,8,220
25843,2024-01-18 22:42:00,96,95,Alimento,3,191
25844,2024-01-18 22:43:00,43,135,Alimento,1,178
25845,2024-01-18 22:44:00,65,52,Vestuário,6,117
25846,2024-01-18 22:45:00,118,39,Eletrônico,5,157
25847,2024-01-18 22:46:00,20,103,Móvel,9,123
25848,2024-01-18 22:47:00,25,43,Vestuário,1,68
25849,2024-01-18 22:48:00,73,125,Alimento,6,198
25850,2024-01-18 22:49:00,58,100,Móvel,6,158
25851,2024-01-18 22:50:00,31,96,Brinquedo,9,127
25852,2024-01-18 22:51:00,81,167,Alimento,8,248
25853,2024-01-18 22:52:00,18,89,Eletrônico,2,107
25854,2024-01-18 22:53:00,82,161,Brinquedo,7,243
25855,2024-01-18 22:54:00,64,136,Móvel,3,200
25856,2024-01-18 22:55:00,28,20,Móvel,9,48
25857,2024-01-18 22:56:00,32,57,Vestuário,2,89
25858,2024-01-18 22:57:00,35,148,Brinquedo,6,183
25859,2024-01-18 22:58:00,52,137,Vestuário,8,189
25860,2024-01-18 22:59:00,21,118,Móvel,1,139
25861,2024-01-18 23:00:00,102,23,Brinquedo,2,125
25862,2024-01-18 23:01:00,32,162,Alimento,4,194
25863,2024-01-18 23:02:00,44,67,Brinquedo,7,111
25864,2024-01-18 23:03:00,40,179,Móvel,9,219
25865,2024-01-18 23:04:00,67,57,Móvel,9,124
25866,2024-01-18 23:05:00,75,153,Brinquedo,9,228
25867,2024-01-18 23:06:00,64,75,Eletrônico,3,139
25868,2024-01-18 23:07:00,94,150,Móvel,9,244
25869,2024-01-18 23:08:00,15,126,Alimento,7,141
25870,2024-01-18 23:09:00,32,67,Vestuário,7,99
25871,2024-01-18 23:10:00,39,30,Brinquedo,3,69
25872,2024-01-18 23:11:00,80,90,Eletrônico,2,170
25873,2024-01-18 23:12:00,115,70,Alimento,3,185
25874,2024-01-18 23:13:00,119,23,Alimento,9,142
25875,2024-01-18 23:14:00,45,92,Alimento,9,137
25876,2024-01-18 23:15:00,42,50,Vestuário,8,92
25877,2024-01-18 23:16:00,108,66,Móvel,2,174
25878,2024-01-18 23:17:00,63,124,Alimento,1,187
25879,2024-01-18 23:18:00,25,111,Eletrônico,1,136
25880,2024-01-18 23:19:00,95,46,Alimento,1,141
25881,2024-01-18 23:20:00,106,109,Móvel,3,215
25882,2024-01-18 23:21:00,20,137,Móvel,6,157
25883,2024-01-18 23:22:00,23,62,Vestuário,8,85
25884,2024-01-18 23:23:00,89,164,Brinquedo,6,253
25885,2024-01-18 23:24:00,31,133,Móvel,8,164
25886,2024-01-18 23:25:00,69,123,Vestuário,7,192
25887,2024-01-18 23:26:00,96,165,Eletrônico,5,261
25888,2024-01-18 23:27:00,82,91,Alimento,8,173
25889,2024-01-18 23:28:00,86,136,Vestuário,3,222
25890,2024-01-18 23:29:00,87,25,Brinquedo,3,112
25891,2024-01-18 23:30:00,13,92,Móvel,5,105
25892,2024-01-18 23:31:00,70,131,Vestuário,1,201
25893,2024-01-18 23:32:00,33,83,Vestuário,2,116
25894,2024-01-18 23:33:00,63,30,Brinquedo,7,93
25895,2024-01-18 23:34:00,80,52,Vestuário,5,132
25896,2024-01-18 23:35:00,17,165,Vestuário,9,182
25897,2024-01-18 23:36:00,51,80,Brinquedo,3,131
25898,2024-01-18 23:37:00,25,67,Brinquedo,7,92
25899,2024-01-18 23:38:00,52,30,Brinquedo,8,82
25900,2024-01-18 23:39:00,24,110,Alimento,5,134
25901,2024-01-18 23:40:00,20,55,Brinquedo,1,75
25902,2024-01-18 23:41:00,36,99,Brinquedo,9,135
25903,2024-01-18 23:42:00,57,178,Eletrônico,4,235
25904,2024-01-18 23:43:00,38,119,Móvel,9,157
25905,2024-01-18 23:44:00,85,149,Móvel,1,234
25906,2024-01-18 23:45:00,75,41,Eletrônico,1,116
25907,2024-01-18 23:46:00,64,75,Alimento,7,139
25908,2024-01-18 23:47:00,34,139,Alimento,7,173
25909,2024-01-18 23:48:00,38,30,Móvel,8,68
25910,2024-01-18 23:49:00,42,170,Alimento,3,212
25911,2024-01-18 23:50:00,116,31,Alimento,8,147
25912,2024-01-18 23:51:00,56,31,Eletrônico,1,87
25913,2024-01-18 23:52:00,38,46,Móvel,5,84
25914,2024-01-18 23:53:00,82,112,Alimento,3,194
25915,2024-01-18 23:54:00,19,165,Eletrônico,7,184
25916,2024-01-18 23:55:00,27,34,Alimento,9,61
25917,2024-01-18 23:56:00,94,175,Vestuário,9,269
25918,2024-01-18 23:57:00,90,168,Alimento,3,258
25919,2024-01-18 23:58:00,68,50,Alimento,5,118
25920,2024-01-18 23:59:00,61,110,Móvel,5,171
25921,2024-01-19 00:00:00,110,168,Brinquedo,4,278
25922,2024-01-19 00:01:00,36,150,Móvel,5,186
25923,2024-01-19 00:02:00,79,19,Móvel,5,98
25924,2024-01-19 00:03:00,78,95,Móvel,4,173
25925,2024-01-19 00:04:00,17,104,Vestuário,1,121
25926,2024-01-19 00:05:00,104,93,Móvel,2,197
25927,2024-01-19 00:06:00,82,157,Alimento,9,239
25928,2024-01-19 00:07:00,37,150,Móvel,8,187
25929,2024-01-19 00:08:00,17,19,Móvel,1,36
25930,2024-01-19 00:09:00,92,150,Eletrônico,4,242
25931,2024-01-19 00:10:00,54,98,Brinquedo,2,152
25932,2024-01-19 00:11:00,14,140,Móvel,2,154
25933,2024-01-19 00:12:00,88,12,Eletrônico,1,100
25934,2024-01-19 00:13:00,37,168,Eletrônico,4,205
25935,2024-01-19 00:14:00,103,48,Alimento,4,151
25936,2024-01-19 00:15:00,85,162,Móvel,3,247
25937,2024-01-19 00:16:00,47,119,Brinquedo,1,166
25938,2024-01-19 00:17:00,41,61,Móvel,9,102
25939,2024-01-19 00:18:00,101,31,Eletrônico,4,132
25940,2024-01-19 00:19:00,38,171,Brinquedo,1,209
25941,2024-01-19 00:20:00,27,91,Brinquedo,7,118
25942,2024-01-19 00:21:00,112,36,Alimento,7,148
25943,2024-01-19 00:22:00,26,109,Brinquedo,5,135
25944,2024-01-19 00:23:00,16,145,Brinquedo,5,161
25945,2024-01-19 00:24:00,100,130,Vestuário,5,230
25946,2024-01-19 00:25:00,60,134,Brinquedo,3,194
25947,2024-01-19 00:26:00,81,98,Vestuário,7,179
25948,2024-01-19 00:27:00,113,58,Vestuário,1,171
25949,2024-01-19 00:28:00,103,131,Brinquedo,9,234
25950,2024-01-19 00:29:00,75,135,Móvel,9,210
25951,2024-01-19 00:30:00,24,18,Brinquedo,6,42
25952,2024-01-19 00:31:00,49,53,Brinquedo,7,102
25953,2024-01-19 00:32:00,26,62,Alimento,4,88
25954,2024-01-19 00:33:00,82,87,Eletrônico,1,169
25955,2024-01-19 00:34:00,34,166,Alimento,3,200
25956,2024-01-19 00:35:00,109,33,Vestuário,2,142
25957,2024-01-19 00:36:00,57,178,Alimento,8,235
25958,2024-01-19 00:37:00,42,134,Alimento,9,176
25959,2024-01-19 00:38:00,33,167,Móvel,2,200
25960,2024-01-19 00:39:00,32,157,Brinquedo,2,189
25961,2024-01-19 00:40:00,94,95,Móvel,2,189
25962,2024-01-19 00:41:00,61,30,Alimento,2,91
25963,2024-01-19 00:42:00,77,13,Móvel,5,90
25964,2024-01-19 00:43:00,50,115,Vestuário,7,165
25965,2024-01-19 00:44:00,113,93,Alimento,3,206
25966,2024-01-19 00:45:00,64,106,Vestuário,1,170
25967,2024-01-19 00:46:00,64,167,Eletrônico,1,231
25968,2024-01-19 00:47:00,29,35,Brinquedo,2,64
25969,2024-01-19 00:48:00,110,107,Eletrônico,9,217
25970,2024-01-19 00:49:00,75,146,Eletrônico,9,221
25971,2024-01-19 00:50:00,24,77,Brinquedo,9,101
25972,2024-01-19 00:51:00,109,102,Eletrônico,9,211
25973,2024-01-19 00:52:00,118,24,Alimento,7,142
25974,2024-01-19 00:53:00,84,79,Alimento,3,163
25975,2024-01-19 00:54:00,77,178,Móvel,9,255
25976,2024-01-19 00:55:00,82,122,Eletrônico,8,204
25977,2024-01-19 00:56:00,10,15,Móvel,4,25
25978,2024-01-19 00:57:00,38,157,Alimento,2,195
25979,2024-01-19 00:58:00,43,148,Alimento,1,191
25980,2024-01-19 00:59:00,46,104,Vestuário,8,150
25981,2024-01-19 01:00:00,40,70,Alimento,5,110
25982,2024-01-19 01:01:00,55,70,Móvel,5,125
25983,2024-01-19 01:02:00,79,131,Alimento,4,210
25984,2024-01-19 01:03:00,76,15,Móvel,9,91
25985,2024-01-19 01:04:00,80,43,Brinquedo,5,123
25986,2024-01-19 01:05:00,93,98,Eletrônico,5,191
25987,2024-01-19 01:06:00,114,15,Brinquedo,7,129
25988,2024-01-19 01:07:00,98,26,Brinquedo,1,124
25989,2024-01-19 01:08:00,103,50,Brinquedo,3,153
25990,2024-01-19 01:09:00,42,69,Alimento,4,111
25991,2024-01-19 01:10:00,62,15,Móvel,7,77
25992,2024-01-19 01:11:00,66,136,Eletrônico,5,202
25993,2024-01-19 01:12:00,45,177,Vestuário,3,222
25994,2024-01-19 01:13:00,110,67,Alimento,5,177
25995,2024-01-19 01:14:00,56,17,Vestuário,8,73
25996,2024-01-19 01:15:00,85,158,Vestuário,7,243
25997,2024-01-19 01:16:00,26,117,Brinquedo,7,143
25998,2024-01-19 01:17:00,98,50,Vestuário,4,148
25999,2024-01-19 01:18:00,17,154,Eletrônico,2,171
26000,2024-01-19 01:19:00,86,84,Alimento,6,170
26001,2024-01-19 01:20:00,33,152,Brinquedo,4,185
26002,2024-01-19 01:21:00,80,161,Brinquedo,5,241
26003,2024-01-19 01:22:00,15,45,Móvel,5,60
26004,2024-01-19 01:23:00,10,157,Alimento,5,167
26005,2024-01-19 01:24:00,31,144,Móvel,1,175
26006,2024-01-19 01:25:00,119,112,Eletrônico,9,231
26007,2024-01-19 01:26:00,74,40,Móvel,9,114
26008,2024-01-19 01:27:00,50,104,Alimento,4,154
26009,2024-01-19 01:28:00,99,61,Vestuário,2,160
26010,2024-01-19 01:29:00,34,135,Móvel,5,169
26011,2024-01-19 01:30:00,38,146,Eletrônico,3,184
26012,2024-01-19 01:31:00,14,92,Eletrônico,8,106
26013,2024-01-19 01:32:00,105,103,Móvel,9,208
26014,2024-01-19 01:33:00,90,107,Vestuário,8,197
26015,2024-01-19 01:34:00,114,46,Vestuário,4,160
26016,2024-01-19 01:35:00,52,72,Brinquedo,4,124
26017,2024-01-19 01:36:00,51,124,Alimento,2,175
26018,2024-01-19 01:37:00,42,43,Móvel,2,85
26019,2024-01-19 01:38:00,95,105,Eletrônico,2,200
26020,2024-01-19 01:39:00,116,128,Alimento,2,244
26021,2024-01-19 01:40:00,116,171,Eletrônico,1,287
26022,2024-01-19 01:41:00,84,111,Móvel,9,195
26023,2024-01-19 01:42:00,52,89,Móvel,9,141
26024,2024-01-19 01:43:00,57,132,Brinquedo,5,189
26025,2024-01-19 01:44:00,94,15,Brinquedo,1,109
26026,2024-01-19 01:45:00,90,47,Móvel,3,137
26027,2024-01-19 01:46:00,60,14,Brinquedo,2,74
26028,2024-01-19 01:47:00,91,131,Brinquedo,2,222
26029,2024-01-19 01:48:00,77,178,Brinquedo,9,255
26030,2024-01-19 01:49:00,69,167,Eletrônico,2,236
26031,2024-01-19 01:50:00,88,157,Eletrônico,1,245
26032,2024-01-19 01:51:00,80,73,Alimento,4,153
26033,2024-01-19 01:52:00,63,116,Eletrônico,6,179
26034,2024-01-19 01:53:00,12,121,Móvel,2,133
26035,2024-01-19 01:54:00,118,175,Brinquedo,8,293
26036,2024-01-19 01:55:00,41,108,Vestuário,2,149
26037,2024-01-19 01:56:00,51,60,Vestuário,6,111
26038,2024-01-19 01:57:00,83,126,Alimento,9,209
26039,2024-01-19 01:58:00,98,70,Móvel,2,168
26040,2024-01-19 01:59:00,105,63,Vestuário,2,168
26041,2024-01-19 02:00:00,104,147,Alimento,3,251
26042,2024-01-19 02:01:00,19,34,Eletrônico,9,53
26043,2024-01-19 02:02:00,30,11,Eletrônico,3,41
26044,2024-01-19 02:03:00,117,93,Vestuário,2,210
26045,2024-01-19 02:04:00,112,39,Brinquedo,1,151
26046,2024-01-19 02:05:00,109,69,Brinquedo,4,178
26047,2024-01-19 02:06:00,54,153,Brinquedo,2,207
26048,2024-01-19 02:07:00,45,130,Móvel,4,175
26049,2024-01-19 02:08:00,18,156,Móvel,6,174
26050,2024-01-19 02:09:00,35,38,Alimento,6,73
26051,2024-01-19 02:10:00,26,35,Vestuário,6,61
26052,2024-01-19 02:11:00,39,13,Móvel,7,52
26053,2024-01-19 02:12:00,89,25,Alimento,6,114
26054,2024-01-19 02:13:00,16,98,Brinquedo,6,114
26055,2024-01-19 02:14:00,15,171,Móvel,5,186
26056,2024-01-19 02:15:00,12,38,Alimento,5,50
26057,2024-01-19 02:16:00,16,175,Alimento,2,191
26058,2024-01-19 02:17:00,21,151,Eletrônico,9,172
26059,2024-01-19 02:18:00,79,173,Alimento,8,252
26060,2024-01-19 02:19:00,15,125,Alimento,9,140
26061,2024-01-19 02:20:00,76,148,Alimento,6,224
26062,2024-01-19 02:21:00,25,78,Móvel,6,103
26063,2024-01-19 02:22:00,15,24,Brinquedo,1,39
26064,2024-01-19 02:23:00,86,26,Eletrônico,4,112
26065,2024-01-19 02:24:00,94,177,Eletrônico,7,271
26066,2024-01-19 02:25:00,99,18,Brinquedo,7,117
26067,2024-01-19 02:26:00,119,40,Vestuário,2,159
26068,2024-01-19 02:27:00,11,11,Brinquedo,6,22
26069,2024-01-19 02:28:00,29,151,Alimento,4,180
26070,2024-01-19 02:29:00,70,133,Móvel,9,203
26071,2024-01-19 02:30:00,112,147,Brinquedo,6,259
26072,2024-01-19 02:31:00,119,132,Alimento,9,251
26073,2024-01-19 02:32:00,48,43,Alimento,3,91
26074,2024-01-19 02:33:00,17,123,Móvel,1,140
26075,2024-01-19 02:34:00,56,98,Alimento,2,154
26076,2024-01-19 02:35:00,107,143,Alimento,7,250
26077,2024-01-19 02:36:00,31,38,Alimento,5,69
26078,2024-01-19 02:37:00,51,65,Alimento,3,116
26079,2024-01-19 02:38:00,74,17,Alimento,9,91
26080,2024-01-19 02:39:00,70,11,Eletrônico,6,81
26081,2024-01-19 02:40:00,83,77,Alimento,5,160
26082,2024-01-19 02:41:00,25,69,Vestuário,2,94
26083,2024-01-19 02:42:00,116,50,Brinquedo,3,166
26084,2024-01-19 02:43:00,89,96,Brinquedo,7,185
26085,2024-01-19 02:44:00,36,132,Alimento,7,168
26086,2024-01-19 02:45:00,103,74,Vestuário,3,177
26087,2024-01-19 02:46:00,11,155,Alimento,9,166
26088,2024-01-19 02:47:00,119,23,Móvel,6,142
26089,2024-01-19 02:48:00,52,100,Alimento,2,152
26090,2024-01-19 02:49:00,110,100,Móvel,9,210
26091,2024-01-19 02:50:00,87,103,Vestuário,9,190
26092,2024-01-19 02:51:00,109,165,Alimento,7,274
26093,2024-01-19 02:52:00,69,149,Brinquedo,8,218
26094,2024-01-19 02:53:00,80,134,Alimento,2,214
26095,2024-01-19 02:54:00,32,83,Brinquedo,5,115
26096,2024-01-19 02:55:00,41,139,Brinquedo,7,180
26097,2024-01-19 02:56:00,107,52,Vestuário,3,159
26098,2024-01-19 02:57:00,74,132,Eletrônico,6,206
26099,2024-01-19 02:58:00,29,91,Brinquedo,9,120
26100,2024-01-19 02:59:00,47,122,Brinquedo,6,169
26101,2024-01-19 03:00:00,20,142,Eletrônico,6,162
26102,2024-01-19 03:01:00,85,50,Móvel,7,135
26103,2024-01-19 03:02:00,104,76,Vestuário,6,180
26104,2024-01-19 03:03:00,31,118,Alimento,3,149
26105,2024-01-19 03:04:00,72,154,Alimento,7,226
26106,2024-01-19 03:05:00,90,149,Brinquedo,5,239
26107,2024-01-19 03:06:00,76,13,Eletrônico,3,89
26108,2024-01-19 03:07:00,19,113,Brinquedo,1,132
26109,2024-01-19 03:08:00,34,86,Móvel,1,120
26110,2024-01-19 03:09:00,62,147,Alimento,6,209
26111,2024-01-19 03:10:00,75,147,Alimento,1,222
26112,2024-01-19 03:11:00,38,65,Alimento,6,103
26113,2024-01-19 03:12:00,72,100,Alimento,4,172
26114,2024-01-19 03:13:00,39,37,Vestuário,7,76
26115,2024-01-19 03:14:00,80,174,Brinquedo,1,254
26116,2024-01-19 03:15:00,99,82,Alimento,4,181
26117,2024-01-19 03:16:00,109,138,Eletrônico,2,247
26118,2024-01-19 03:17:00,79,104,Alimento,9,183
26119,2024-01-19 03:18:00,104,30,Vestuário,7,134
26120,2024-01-19 03:19:00,59,122,Alimento,8,181
26121,2024-01-19 03:20:00,85,43,Brinquedo,3,128
26122,2024-01-19 03:21:00,86,49,Eletrônico,8,135
26123,2024-01-19 03:22:00,45,127,Eletrônico,3,172
26124,2024-01-19 03:23:00,16,71,Brinquedo,3,87
26125,2024-01-19 03:24:00,18,94,Móvel,4,112
26126,2024-01-19 03:25:00,50,179,Eletrônico,8,229
26127,2024-01-19 03:26:00,78,155,Brinquedo,6,233
26128,2024-01-19 03:27:00,103,82,Vestuário,5,185
26129,2024-01-19 03:28:00,15,160,Eletrônico,8,175
26130,2024-01-19 03:29:00,15,112,Vestuário,6,127
26131,2024-01-19 03:30:00,95,128,Alimento,8,223
26132,2024-01-19 03:31:00,61,179,Móvel,3,240
26133,2024-01-19 03:32:00,73,14,Vestuário,8,87
26134,2024-01-19 03:33:00,100,110,Alimento,4,210
26135,2024-01-19 03:34:00,15,99,Eletrônico,3,114
26136,2024-01-19 03:35:00,48,141,Alimento,7,189
26137,2024-01-19 03:36:00,96,174,Brinquedo,1,270
26138,2024-01-19 03:37:00,61,11,Eletrônico,8,72
26139,2024-01-19 03:38:00,27,144,Vestuário,9,171
26140,2024-01-19 03:39:00,73,137,Alimento,7,210
26141,2024-01-19 03:40:00,93,83,Móvel,3,176
26142,2024-01-19 03:41:00,116,163,Brinquedo,4,279
26143,2024-01-19 03:42:00,56,123,Vestuário,6,179
26144,2024-01-19 03:43:00,41,37,Brinquedo,5,78
26145,2024-01-19 03:44:00,57,49,Vestuário,7,106
26146,2024-01-19 03:45:00,35,172,Brinquedo,2,207
26147,2024-01-19 03:46:00,115,98,Vestuário,7,213
26148,2024-01-19 03:47:00,103,24,Brinquedo,9,127
26149,2024-01-19 03:48:00,114,100,Móvel,9,214
26150,2024-01-19 03:49:00,71,27,Móvel,9,98
26151,2024-01-19 03:50:00,119,146,Eletrônico,5,265
26152,2024-01-19 03:51:00,94,128,Vestuário,3,222
26153,2024-01-19 03:52:00,75,40,Móvel,5,115
26154,2024-01-19 03:53:00,21,113,Alimento,3,134
26155,2024-01-19 03:54:00,101,77,Alimento,6,178
26156,2024-01-19 03:55:00,74,169,Eletrônico,6,243
26157,2024-01-19 03:56:00,71,117,Brinquedo,7,188
26158,2024-01-19 03:57:00,25,178,Vestuário,7,203
26159,2024-01-19 03:58:00,77,52,Eletrônico,4,129
26160,2024-01-19 03:59:00,11,154,Alimento,5,165
26161,2024-01-19 04:00:00,38,135,Eletrônico,5,173
26162,2024-01-19 04:01:00,63,132,Móvel,5,195
26163,2024-01-19 04:02:00,62,117,Vestuário,7,179
26164,2024-01-19 04:03:00,51,143,Vestuário,7,194
26165,2024-01-19 04:04:00,70,110,Eletrônico,8,180
26166,2024-01-19 04:05:00,15,119,Alimento,2,134
26167,2024-01-19 04:06:00,107,157,Brinquedo,8,264
26168,2024-01-19 04:07:00,98,103,Brinquedo,2,201
26169,2024-01-19 04:08:00,43,78,Vestuário,4,121
26170,2024-01-19 04:09:00,34,151,Alimento,1,185
26171,2024-01-19 04:10:00,13,76,Alimento,6,89
26172,2024-01-19 04:11:00,90,115,Vestuário,4,205
26173,2024-01-19 04:12:00,103,46,Vestuário,9,149
26174,2024-01-19 04:13:00,109,126,Eletrônico,2,235
26175,2024-01-19 04:14:00,93,128,Eletrônico,5,221
26176,2024-01-19 04:15:00,71,70,Brinquedo,3,141
26177,2024-01-19 04:16:00,86,82,Brinquedo,1,168
26178,2024-01-19 04:17:00,115,101,Vestuário,1,216
26179,2024-01-19 04:18:00,42,134,Alimento,4,176
26180,2024-01-19 04:19:00,67,174,Móvel,5,241
26181,2024-01-19 04:20:00,10,142,Vestuário,8,152
26182,2024-01-19 04:21:00,72,109,Eletrônico,3,181
26183,2024-01-19 04:22:00,109,142,Alimento,3,251
26184,2024-01-19 04:23:00,13,39,Alimento,5,52
26185,2024-01-19 04:24:00,108,133,Móvel,2,241
26186,2024-01-19 04:25:00,63,84,Eletrônico,8,147
26187,2024-01-19 04:26:00,111,42,Vestuário,2,153
26188,2024-01-19 04:27:00,43,30,Brinquedo,7,73
26189,2024-01-19 04:28:00,13,78,Brinquedo,1,91
26190,2024-01-19 04:29:00,80,45,Móvel,7,125
26191,2024-01-19 04:30:00,70,59,Vestuário,7,129
26192,2024-01-19 04:31:00,29,68,Vestuário,3,97
26193,2024-01-19 04:32:00,82,90,Brinquedo,5,172
26194,2024-01-19 04:33:00,27,89,Brinquedo,1,116
26195,2024-01-19 04:34:00,77,78,Alimento,8,155
26196,2024-01-19 04:35:00,117,179,Vestuário,9,296
26197,2024-01-19 04:36:00,38,49,Alimento,9,87
26198,2024-01-19 04:37:00,67,91,Brinquedo,6,158
26199,2024-01-19 04:38:00,71,79,Vestuário,4,150
26200,2024-01-19 04:39:00,97,176,Brinquedo,7,273
26201,2024-01-19 04:40:00,25,83,Brinquedo,8,108
26202,2024-01-19 04:41:00,85,135,Vestuário,4,220
26203,2024-01-19 04:42:00,85,41,Vestuário,7,126
26204,2024-01-19 04:43:00,76,100,Brinquedo,9,176
26205,2024-01-19 04:44:00,66,60,Brinquedo,7,126
26206,2024-01-19 04:45:00,40,63,Eletrônico,6,103
26207,2024-01-19 04:46:00,10,50,Vestuário,9,60
26208,2024-01-19 04:47:00,106,157,Brinquedo,5,263
26209,2024-01-19 04:48:00,117,102,Eletrônico,5,219
26210,2024-01-19 04:49:00,103,126,Brinquedo,2,229
26211,2024-01-19 04:50:00,75,72,Eletrônico,8,147
26212,2024-01-19 04:51:00,77,70,Alimento,4,147
26213,2024-01-19 04:52:00,118,58,Alimento,3,176
26214,2024-01-19 04:53:00,103,166,Alimento,3,269
26215,2024-01-19 04:54:00,42,45,Vestuário,9,87
26216,2024-01-19 04:55:00,64,150,Vestuário,4,214
26217,2024-01-19 04:56:00,36,101,Brinquedo,7,137
26218,2024-01-19 04:57:00,99,131,Alimento,3,230
26219,2024-01-19 04:58:00,48,94,Móvel,2,142
26220,2024-01-19 04:59:00,33,68,Brinquedo,4,101
26221,2024-01-19 05:00:00,100,33,Alimento,6,133
26222,2024-01-19 05:01:00,85,176,Eletrônico,1,261
26223,2024-01-19 05:02:00,87,37,Eletrônico,9,124
26224,2024-01-19 05:03:00,45,150,Brinquedo,9,195
26225,2024-01-19 05:04:00,48,110,Móvel,8,158
26226,2024-01-19 05:05:00,29,94,Vestuário,7,123
26227,2024-01-19 05:06:00,114,161,Vestuário,1,275
26228,2024-01-19 05:07:00,14,96,Eletrônico,7,110
26229,2024-01-19 05:08:00,72,162,Alimento,9,234
26230,2024-01-19 05:09:00,109,46,Eletrônico,8,155
26231,2024-01-19 05:10:00,105,114,Vestuário,8,219
26232,2024-01-19 05:11:00,77,63,Brinquedo,7,140
26233,2024-01-19 05:12:00,106,124,Móvel,7,230
26234,2024-01-19 05:13:00,52,72,Eletrônico,1,124
26235,2024-01-19 05:14:00,18,64,Alimento,6,82
26236,2024-01-19 05:15:00,24,14,Vestuário,6,38
26237,2024-01-19 05:16:00,26,162,Alimento,8,188
26238,2024-01-19 05:17:00,86,67,Vestuário,4,153
26239,2024-01-19 05:18:00,16,156,Alimento,3,172
26240,2024-01-19 05:19:00,17,117,Alimento,6,134
26241,2024-01-19 05:20:00,49,153,Vestuário,3,202
26242,2024-01-19 05:21:00,97,10,Vestuário,6,107
26243,2024-01-19 05:22:00,64,94,Móvel,1,158
26244,2024-01-19 05:23:00,65,161,Brinquedo,3,226
26245,2024-01-19 05:24:00,71,110,Alimento,6,181
26246,2024-01-19 05:25:00,114,100,Móvel,2,214
26247,2024-01-19 05:26:00,111,28,Móvel,7,139
26248,2024-01-19 05:27:00,111,161,Eletrônico,7,272
26249,2024-01-19 05:28:00,46,160,Vestuário,6,206
26250,2024-01-19 05:29:00,55,139,Brinquedo,5,194
26251,2024-01-19 05:30:00,84,173,Eletrônico,6,257
26252,2024-01-19 05:31:00,33,162,Eletrônico,1,195
26253,2024-01-19 05:32:00,68,38,Vestuário,6,106
26254,2024-01-19 05:33:00,62,167,Eletrônico,3,229
26255,2024-01-19 05:34:00,42,55,Móvel,4,97
26256,2024-01-19 05:35:00,94,155,Eletrônico,5,249
26257,2024-01-19 05:36:00,102,52,Brinquedo,1,154
26258,2024-01-19 05:37:00,54,36,Alimento,5,90
26259,2024-01-19 05:38:00,34,173,Móvel,1,207
26260,2024-01-19 05:39:00,48,35,Brinquedo,6,83
26261,2024-01-19 05:40:00,108,148,Eletrônico,4,256
26262,2024-01-19 05:41:00,76,85,Brinquedo,4,161
26263,2024-01-19 05:42:00,14,31,Vestuário,3,45
26264,2024-01-19 05:43:00,96,43,Vestuário,4,139
26265,2024-01-19 05:44:00,102,128,Vestuário,5,230
26266,2024-01-19 05:45:00,14,96,Alimento,9,110
26267,2024-01-19 05:46:00,32,155,Alimento,9,187
26268,2024-01-19 05:47:00,96,123,Eletrônico,5,219
26269,2024-01-19 05:48:00,30,149,Eletrônico,7,179
26270,2024-01-19 05:49:00,83,149,Alimento,1,232
26271,2024-01-19 05:50:00,73,140,Brinquedo,9,213
26272,2024-01-19 05:51:00,101,108,Alimento,5,209
26273,2024-01-19 05:52:00,96,99,Brinquedo,8,195
26274,2024-01-19 05:53:00,67,46,Eletrônico,1,113
26275,2024-01-19 05:54:00,56,68,Eletrônico,9,124
26276,2024-01-19 05:55:00,66,55,Alimento,9,121
26277,2024-01-19 05:56:00,31,145,Vestuário,7,176
26278,2024-01-19 05:57:00,39,139,Vestuário,5,178
26279,2024-01-19 05:58:00,57,87,Alimento,4,144
26280,2024-01-19 05:59:00,77,173,Vestuário,8,250
26281,2024-01-19 06:00:00,117,145,Móvel,6,262
26282,2024-01-19 06:01:00,112,51,Alimento,2,163
26283,2024-01-19 06:02:00,91,38,Alimento,4,129
26284,2024-01-19 06:03:00,18,109,Eletrônico,8,127
26285,2024-01-19 06:04:00,10,111,Brinquedo,2,121
26286,2024-01-19 06:05:00,63,67,Móvel,8,130
26287,2024-01-19 06:06:00,13,77,Eletrônico,4,90
26288,2024-01-19 06:07:00,38,104,Vestuário,6,142
26289,2024-01-19 06:08:00,42,90,Vestuário,5,132
26290,2024-01-19 06:09:00,19,120,Vestuário,3,139
26291,2024-01-19 06:10:00,54,16,Móvel,6,70
26292,2024-01-19 06:11:00,50,40,Vestuário,8,90
26293,2024-01-19 06:12:00,119,21,Brinquedo,7,140
26294,2024-01-19 06:13:00,78,100,Vestuário,4,178
26295,2024-01-19 06:14:00,42,142,Brinquedo,5,184
26296,2024-01-19 06:15:00,95,83,Eletrônico,9,178
26297,2024-01-19 06:16:00,100,134,Eletrônico,5,234
26298,2024-01-19 06:17:00,32,70,Alimento,7,102
26299,2024-01-19 06:18:00,51,73,Alimento,9,124
26300,2024-01-19 06:19:00,58,28,Vestuário,2,86
26301,2024-01-19 06:20:00,63,112,Eletrônico,6,175
26302,2024-01-19 06:21:00,102,137,Móvel,2,239
26303,2024-01-19 06:22:00,38,37,Alimento,4,75
26304,2024-01-19 06:23:00,39,161,Alimento,3,200
26305,2024-01-19 06:24:00,91,27,Brinquedo,9,118
26306,2024-01-19 06:25:00,22,48,Vestuário,9,70
26307,2024-01-19 06:26:00,104,15,Móvel,2,119
26308,2024-01-19 06:27:00,27,179,Alimento,1,206
26309,2024-01-19 06:28:00,48,102,Eletrônico,1,150
26310,2024-01-19 06:29:00,73,174,Alimento,6,247
26311,2024-01-19 06:30:00,99,160,Alimento,8,259
26312,2024-01-19 06:31:00,106,82,Vestuário,2,188
26313,2024-01-19 06:32:00,76,150,Eletrônico,5,226
26314,2024-01-19 06:33:00,29,74,Alimento,3,103
26315,2024-01-19 06:34:00,55,160,Móvel,4,215
26316,2024-01-19 06:35:00,44,62,Móvel,8,106
26317,2024-01-19 06:36:00,68,42,Vestuário,5,110
26318,2024-01-19 06:37:00,119,66,Brinquedo,3,185
26319,2024-01-19 06:38:00,101,111,Brinquedo,7,212
26320,2024-01-19 06:39:00,59,85,Alimento,1,144
26321,2024-01-19 06:40:00,109,145,Brinquedo,4,254
26322,2024-01-19 06:41:00,22,162,Móvel,5,184
26323,2024-01-19 06:42:00,31,171,Móvel,5,202
26324,2024-01-19 06:43:00,63,134,Vestuário,3,197
26325,2024-01-19 06:44:00,83,89,Alimento,8,172
26326,2024-01-19 06:45:00,117,89,Eletrônico,7,206
26327,2024-01-19 06:46:00,101,73,Brinquedo,4,174
26328,2024-01-19 06:47:00,15,124,Eletrônico,1,139
26329,2024-01-19 06:48:00,12,70,Vestuário,8,82
26330,2024-01-19 06:49:00,65,79,Eletrônico,2,144
26331,2024-01-19 06:50:00,21,125,Móvel,3,146
26332,2024-01-19 06:51:00,34,113,Eletrônico,5,147
26333,2024-01-19 06:52:00,10,26,Alimento,6,36
26334,2024-01-19 06:53:00,27,34,Vestuário,8,61
26335,2024-01-19 06:54:00,115,161,Alimento,7,276
26336,2024-01-19 06:55:00,74,85,Eletrônico,9,159
26337,2024-01-19 06:56:00,40,139,Alimento,6,179
26338,2024-01-19 06:57:00,28,167,Alimento,3,195
26339,2024-01-19 06:58:00,94,27,Alimento,4,121
26340,2024-01-19 06:59:00,71,64,Móvel,6,135
26341,2024-01-19 07:00:00,17,144,Móvel,9,161
26342,2024-01-19 07:01:00,117,101,Alimento,5,218
26343,2024-01-19 07:02:00,65,55,Brinquedo,7,120
26344,2024-01-19 07:03:00,26,87,Alimento,8,113
26345,2024-01-19 07:04:00,11,46,Brinquedo,6,57
26346,2024-01-19 07:05:00,22,97,Vestuário,1,119
26347,2024-01-19 07:06:00,60,155,Alimento,6,215
26348,2024-01-19 07:07:00,102,67,Brinquedo,5,169
26349,2024-01-19 07:08:00,73,16,Alimento,6,89
26350,2024-01-19 07:09:00,32,29,Alimento,3,61
26351,2024-01-19 07:10:00,39,146,Brinquedo,1,185
26352,2024-01-19 07:11:00,86,32,Vestuário,7,118
26353,2024-01-19 07:12:00,92,59,Brinquedo,7,151
26354,2024-01-19 07:13:00,109,80,Brinquedo,3,189
26355,2024-01-19 07:14:00,95,56,Vestuário,3,151
26356,2024-01-19 07:15:00,83,144,Eletrônico,6,227
26357,2024-01-19 07:16:00,34,148,Móvel,9,182
26358,2024-01-19 07:17:00,36,174,Alimento,7,210
26359,2024-01-19 07:18:00,53,80,Alimento,9,133
26360,2024-01-19 07:19:00,56,128,Vestuário,7,184
26361,2024-01-19 07:20:00,113,68,Eletrônico,2,181
26362,2024-01-19 07:21:00,109,99,Brinquedo,8,208
26363,2024-01-19 07:22:00,22,89,Móvel,3,111
26364,2024-01-19 07:23:00,20,153,Móvel,6,173
26365,2024-01-19 07:24:00,59,23,Brinquedo,9,82
26366,2024-01-19 07:25:00,118,167,Eletrônico,6,285
26367,2024-01-19 07:26:00,34,169,Alimento,8,203
26368,2024-01-19 07:27:00,107,150,Vestuário,6,257
26369,2024-01-19 07:28:00,117,153,Móvel,9,270
26370,2024-01-19 07:29:00,93,83,Alimento,3,176
26371,2024-01-19 07:30:00,72,25,Vestuário,2,97
26372,2024-01-19 07:31:00,13,66,Móvel,9,79
26373,2024-01-19 07:32:00,92,118,Alimento,4,210
26374,2024-01-19 07:33:00,66,177,Eletrônico,9,243
26375,2024-01-19 07:34:00,33,136,Móvel,1,169
26376,2024-01-19 07:35:00,95,30,Móvel,7,125
26377,2024-01-19 07:36:00,101,156,Alimento,4,257
26378,2024-01-19 07:37:00,63,94,Eletrônico,7,157
26379,2024-01-19 07:38:00,68,66,Eletrônico,7,134
26380,2024-01-19 07:39:00,115,12,Alimento,9,127
26381,2024-01-19 07:40:00,56,161,Vestuário,4,217
26382,2024-01-19 07:41:00,73,45,Brinquedo,7,118
26383,2024-01-19 07:42:00,119,158,Móvel,7,277
26384,2024-01-19 07:43:00,44,133,Vestuário,8,177
26385,2024-01-19 07:44:00,81,67,Brinquedo,1,148
26386,2024-01-19 07:45:00,47,154,Eletrônico,6,201
26387,2024-01-19 07:46:00,99,55,Móvel,2,154
26388,2024-01-19 07:47:00,114,35,Vestuário,7,149
26389,2024-01-19 07:48:00,63,159,Vestuário,8,222
26390,2024-01-19 07:49:00,41,55,Vestuário,6,96
26391,2024-01-19 07:50:00,72,157,Móvel,5,229
26392,2024-01-19 07:51:00,111,12,Móvel,1,123
26393,2024-01-19 07:52:00,118,115,Alimento,8,233
26394,2024-01-19 07:53:00,49,81,Vestuário,8,130
26395,2024-01-19 07:54:00,74,132,Vestuário,1,206
26396,2024-01-19 07:55:00,77,174,Brinquedo,3,251
26397,2024-01-19 07:56:00,46,102,Brinquedo,7,148
26398,2024-01-19 07:57:00,31,54,Brinquedo,1,85
26399,2024-01-19 07:58:00,119,73,Brinquedo,1,192
26400,2024-01-19 07:59:00,87,12,Brinquedo,5,99
26401,2024-01-19 08:00:00,18,151,Alimento,7,169
26402,2024-01-19 08:01:00,116,46,Brinquedo,5,162
26403,2024-01-19 08:02:00,115,144,Eletrônico,1,259
26404,2024-01-19 08:03:00,83,72,Eletrônico,4,155
26405,2024-01-19 08:04:00,119,16,Brinquedo,5,135
26406,2024-01-19 08:05:00,116,166,Alimento,9,282
26407,2024-01-19 08:06:00,40,132,Móvel,5,172
26408,2024-01-19 08:07:00,41,114,Eletrônico,1,155
26409,2024-01-19 08:08:00,17,16,Eletrônico,7,33
26410,2024-01-19 08:09:00,81,172,Vestuário,6,253
26411,2024-01-19 08:10:00,86,121,Eletrônico,9,207
26412,2024-01-19 08:11:00,58,142,Móvel,6,200
26413,2024-01-19 08:12:00,73,34,Móvel,2,107
26414,2024-01-19 08:13:00,33,46,Eletrônico,1,79
26415,2024-01-19 08:14:00,57,20,Brinquedo,9,77
26416,2024-01-19 08:15:00,60,127,Eletrônico,4,187
26417,2024-01-19 08:16:00,118,50,Alimento,2,168
26418,2024-01-19 08:17:00,109,159,Móvel,2,268
26419,2024-01-19 08:18:00,25,53,Vestuário,1,78
26420,2024-01-19 08:19:00,96,113,Vestuário,5,209
26421,2024-01-19 08:20:00,107,80,Brinquedo,3,187
26422,2024-01-19 08:21:00,20,174,Alimento,1,194
26423,2024-01-19 08:22:00,34,99,Vestuário,3,133
26424,2024-01-19 08:23:00,35,85,Brinquedo,5,120
26425,2024-01-19 08:24:00,11,20,Eletrônico,2,31
26426,2024-01-19 08:25:00,119,129,Alimento,4,248
26427,2024-01-19 08:26:00,99,147,Vestuário,8,246
26428,2024-01-19 08:27:00,99,98,Brinquedo,6,197
26429,2024-01-19 08:28:00,56,88,Vestuário,4,144
26430,2024-01-19 08:29:00,12,42,Vestuário,6,54
26431,2024-01-19 08:30:00,51,92,Brinquedo,1,143
26432,2024-01-19 08:31:00,27,133,Alimento,1,160
26433,2024-01-19 08:32:00,66,18,Alimento,4,84
26434,2024-01-19 08:33:00,54,70,Brinquedo,4,124
26435,2024-01-19 08:34:00,55,91,Brinquedo,2,146
26436,2024-01-19 08:35:00,96,42,Brinquedo,6,138
26437,2024-01-19 08:36:00,29,39,Móvel,5,68
26438,2024-01-19 08:37:00,107,131,Vestuário,8,238
26439,2024-01-19 08:38:00,89,103,Móvel,4,192
26440,2024-01-19 08:39:00,91,94,Alimento,3,185
26441,2024-01-19 08:40:00,10,12,Eletrônico,3,22
26442,2024-01-19 08:41:00,58,179,Alimento,3,237
26443,2024-01-19 08:42:00,59,34,Móvel,2,93
26444,2024-01-19 08:43:00,11,157,Vestuário,5,168
26445,2024-01-19 08:44:00,111,15,Alimento,2,126
26446,2024-01-19 08:45:00,55,137,Eletrônico,6,192
26447,2024-01-19 08:46:00,67,168,Eletrônico,4,235
26448,2024-01-19 08:47:00,51,104,Brinquedo,7,155
26449,2024-01-19 08:48:00,65,47,Móvel,5,112
26450,2024-01-19 08:49:00,90,79,Eletrônico,4,169
26451,2024-01-19 08:50:00,88,47,Brinquedo,9,135
26452,2024-01-19 08:51:00,111,70,Alimento,4,181
26453,2024-01-19 08:52:00,105,12,Alimento,7,117
26454,2024-01-19 08:53:00,83,120,Eletrônico,7,203
26455,2024-01-19 08:54:00,81,158,Móvel,2,239
26456,2024-01-19 08:55:00,19,140,Vestuário,3,159
26457,2024-01-19 08:56:00,12,94,Móvel,5,106
26458,2024-01-19 08:57:00,105,153,Alimento,7,258
26459,2024-01-19 08:58:00,78,41,Brinquedo,3,119
26460,2024-01-19 08:59:00,47,83,Vestuário,3,130
26461,2024-01-19 09:00:00,92,88,Eletrônico,3,180
26462,2024-01-19 09:01:00,98,148,Alimento,8,246
26463,2024-01-19 09:02:00,105,95,Vestuário,3,200
26464,2024-01-19 09:03:00,46,138,Vestuário,6,184
26465,2024-01-19 09:04:00,47,120,Eletrônico,4,167
26466,2024-01-19 09:05:00,103,58,Alimento,2,161
26467,2024-01-19 09:06:00,112,20,Móvel,5,132
26468,2024-01-19 09:07:00,10,153,Brinquedo,7,163
26469,2024-01-19 09:08:00,67,36,Móvel,8,103
26470,2024-01-19 09:09:00,43,26,Alimento,8,69
26471,2024-01-19 09:10:00,104,59,Vestuário,4,163
26472,2024-01-19 09:11:00,59,103,Móvel,9,162
26473,2024-01-19 09:12:00,68,170,Eletrônico,1,238
26474,2024-01-19 09:13:00,69,39,Móvel,2,108
26475,2024-01-19 09:14:00,84,160,Móvel,1,244
26476,2024-01-19 09:15:00,25,64,Eletrônico,1,89
26477,2024-01-19 09:16:00,93,98,Vestuário,2,191
26478,2024-01-19 09:17:00,37,56,Eletrônico,9,93
26479,2024-01-19 09:18:00,56,117,Alimento,8,173
26480,2024-01-19 09:19:00,71,40,Alimento,4,111
26481,2024-01-19 09:20:00,64,66,Vestuário,7,130
26482,2024-01-19 09:21:00,81,55,Brinquedo,4,136
26483,2024-01-19 09:22:00,24,147,Móvel,9,171
26484,2024-01-19 09:23:00,62,119,Vestuário,1,181
26485,2024-01-19 09:24:00,23,114,Alimento,3,137
26486,2024-01-19 09:25:00,42,31,Brinquedo,2,73
26487,2024-01-19 09:26:00,26,168,Eletrônico,7,194
26488,2024-01-19 09:27:00,105,141,Alimento,6,246
26489,2024-01-19 09:28:00,93,165,Móvel,2,258
26490,2024-01-19 09:29:00,105,127,Brinquedo,7,232
26491,2024-01-19 09:30:00,94,158,Móvel,6,252
26492,2024-01-19 09:31:00,29,106,Brinquedo,8,135
26493,2024-01-19 09:32:00,18,108,Brinquedo,8,126
26494,2024-01-19 09:33:00,44,119,Alimento,4,163
26495,2024-01-19 09:34:00,92,50,Vestuário,5,142
26496,2024-01-19 09:35:00,43,132,Alimento,2,175
26497,2024-01-19 09:36:00,13,36,Brinquedo,8,49
26498,2024-01-19 09:37:00,91,45,Móvel,5,136
26499,2024-01-19 09:38:00,22,113,Alimento,1,135
26500,2024-01-19 09:39:00,111,27,Brinquedo,2,138
26501,2024-01-19 09:40:00,51,108,Vestuário,3,159
26502,2024-01-19 09:41:00,118,117,Vestuário,4,235
26503,2024-01-19 09:42:00,104,165,Brinquedo,5,269
26504,2024-01-19 09:43:00,114,54,Eletrônico,8,168
26505,2024-01-19 09:44:00,59,20,Eletrônico,5,79
26506,2024-01-19 09:45:00,119,16,Brinquedo,5,135
26507,2024-01-19 09:46:00,111,126,Brinquedo,5,237
26508,2024-01-19 09:47:00,106,56,Móvel,8,162
26509,2024-01-19 09:48:00,34,105,Eletrônico,3,139
26510,2024-01-19 09:49:00,119,108,Alimento,1,227
26511,2024-01-19 09:50:00,86,28,Alimento,5,114
26512,2024-01-19 09:51:00,18,56,Alimento,7,74
26513,2024-01-19 09:52:00,58,95,Brinquedo,2,153
26514,2024-01-19 09:53:00,80,149,Brinquedo,6,229
26515,2024-01-19 09:54:00,114,88,Brinquedo,3,202
26516,2024-01-19 09:55:00,115,47,Alimento,6,162
26517,2024-01-19 09:56:00,115,147,Alimento,9,262
26518,2024-01-19 09:57:00,114,71,Brinquedo,1,185
26519,2024-01-19 09:58:00,84,75,Alimento,5,159
26520,2024-01-19 09:59:00,85,90,Brinquedo,9,175
26521,2024-01-19 10:00:00,116,86,Alimento,6,202
26522,2024-01-19 10:01:00,95,104,Alimento,4,199
26523,2024-01-19 10:02:00,12,53,Vestuário,6,65
26524,2024-01-19 10:03:00,55,165,Alimento,2,220
26525,2024-01-19 10:04:00,67,177,Eletrônico,8,244
26526,2024-01-19 10:05:00,100,132,Móvel,2,232
26527,2024-01-19 10:06:00,119,176,Móvel,2,295
26528,2024-01-19 10:07:00,27,39,Vestuário,3,66
26529,2024-01-19 10:08:00,85,168,Vestuário,7,253
26530,2024-01-19 10:09:00,66,44,Móvel,7,110
26531,2024-01-19 10:10:00,74,23,Móvel,7,97
26532,2024-01-19 10:11:00,26,130,Brinquedo,7,156
26533,2024-01-19 10:12:00,15,65,Vestuário,2,80
26534,2024-01-19 10:13:00,44,71,Alimento,1,115
26535,2024-01-19 10:14:00,95,61,Móvel,1,156
26536,2024-01-19 10:15:00,51,65,Móvel,5,116
26537,2024-01-19 10:16:00,105,55,Vestuário,7,160
26538,2024-01-19 10:17:00,86,76,Móvel,3,162
26539,2024-01-19 10:18:00,29,76,Eletrônico,8,105
26540,2024-01-19 10:19:00,93,58,Brinquedo,2,151
26541,2024-01-19 10:20:00,97,43,Móvel,4,140
26542,2024-01-19 10:21:00,90,19,Vestuário,9,109
26543,2024-01-19 10:22:00,29,118,Móvel,6,147
26544,2024-01-19 10:23:00,90,150,Eletrônico,2,240
26545,2024-01-19 10:24:00,56,162,Alimento,7,218
26546,2024-01-19 10:25:00,86,39,Móvel,1,125
26547,2024-01-19 10:26:00,86,57,Móvel,7,143
26548,2024-01-19 10:27:00,102,113,Vestuário,6,215
26549,2024-01-19 10:28:00,58,23,Alimento,3,81
26550,2024-01-19 10:29:00,17,113,Brinquedo,4,130
26551,2024-01-19 10:30:00,37,23,Brinquedo,5,60
26552,2024-01-19 10:31:00,21,77,Brinquedo,3,98
26553,2024-01-19 10:32:00,98,112,Móvel,2,210
26554,2024-01-19 10:33:00,104,99,Vestuário,2,203
26555,2024-01-19 10:34:00,67,79,Alimento,7,146
26556,2024-01-19 10:35:00,106,125,Alimento,3,231
26557,2024-01-19 10:36:00,13,130,Brinquedo,6,143
26558,2024-01-19 10:37:00,110,136,Brinquedo,2,246
26559,2024-01-19 10:38:00,60,67,Brinquedo,3,127
26560,2024-01-19 10:39:00,69,24,Alimento,4,93
26561,2024-01-19 10:40:00,96,130,Vestuário,4,226
26562,2024-01-19 10:41:00,12,90,Vestuário,6,102
26563,2024-01-19 10:42:00,63,110,Brinquedo,5,173
26564,2024-01-19 10:43:00,84,52,Alimento,7,136
26565,2024-01-19 10:44:00,88,18,Alimento,9,106
26566,2024-01-19 10:45:00,75,45,Vestuário,8,120
26567,2024-01-19 10:46:00,97,38,Vestuário,4,135
26568,2024-01-19 10:47:00,62,21,Móvel,2,83
26569,2024-01-19 10:48:00,72,94,Móvel,8,166
26570,2024-01-19 10:49:00,85,22,Móvel,3,107
26571,2024-01-19 10:50:00,18,172,Eletrônico,9,190
26572,2024-01-19 10:51:00,98,165,Brinquedo,1,263
26573,2024-01-19 10:52:00,35,150,Alimento,4,185
26574,2024-01-19 10:53:00,47,168,Vestuário,1,215
26575,2024-01-19 10:54:00,24,10,Eletrônico,2,34
26576,2024-01-19 10:55:00,86,122,Brinquedo,6,208
26577,2024-01-19 10:56:00,113,95,Vestuário,5,208
26578,2024-01-19 10:57:00,75,152,Brinquedo,9,227
26579,2024-01-19 10:58:00,32,110,Brinquedo,9,142
26580,2024-01-19 10:59:00,41,72,Brinquedo,8,113
26581,2024-01-19 11:00:00,42,129,Eletrônico,7,171
26582,2024-01-19 11:01:00,108,146,Eletrônico,1,254
26583,2024-01-19 11:02:00,61,107,Móvel,4,168
26584,2024-01-19 11:03:00,93,62,Vestuário,7,155
26585,2024-01-19 11:04:00,76,146,Móvel,1,222
26586,2024-01-19 11:05:00,14,16,Brinquedo,2,30
26587,2024-01-19 11:06:00,99,127,Eletrônico,3,226
26588,2024-01-19 11:07:00,51,31,Eletrônico,2,82
26589,2024-01-19 11:08:00,51,161,Alimento,8,212
26590,2024-01-19 11:09:00,108,104,Móvel,8,212
26591,2024-01-19 11:10:00,34,63,Alimento,2,97
26592,2024-01-19 11:11:00,62,134,Vestuário,2,196
26593,2024-01-19 11:12:00,81,39,Eletrônico,3,120
26594,2024-01-19 11:13:00,32,167,Eletrônico,7,199
26595,2024-01-19 11:14:00,31,52,Vestuário,8,83
26596,2024-01-19 11:15:00,108,156,Eletrônico,5,264
26597,2024-01-19 11:16:00,50,103,Eletrônico,5,153
26598,2024-01-19 11:17:00,89,145,Alimento,1,234
26599,2024-01-19 11:18:00,58,125,Móvel,2,183
26600,2024-01-19 11:19:00,28,114,Vestuário,5,142
26601,2024-01-19 11:20:00,36,144,Eletrônico,4,180
26602,2024-01-19 11:21:00,81,62,Brinquedo,1,143
26603,2024-01-19 11:22:00,35,27,Eletrônico,5,62
26604,2024-01-19 11:23:00,89,60,Eletrônico,2,149
26605,2024-01-19 11:24:00,36,62,Móvel,8,98
26606,2024-01-19 11:25:00,39,127,Brinquedo,8,166
26607,2024-01-19 11:26:00,91,145,Brinquedo,4,236
26608,2024-01-19 11:27:00,90,75,Alimento,4,165
26609,2024-01-19 11:28:00,42,59,Brinquedo,2,101
26610,2024-01-19 11:29:00,66,160,Móvel,9,226
26611,2024-01-19 11:30:00,41,123,Móvel,5,164
26612,2024-01-19 11:31:00,38,155,Eletrônico,4,193
26613,2024-01-19 11:32:00,16,13,Vestuário,6,29
26614,2024-01-19 11:33:00,44,57,Vestuário,1,101
26615,2024-01-19 11:34:00,32,41,Vestuário,6,73
26616,2024-01-19 11:35:00,37,76,Brinquedo,9,113
26617,2024-01-19 11:36:00,55,30,Eletrônico,8,85
26618,2024-01-19 11:37:00,28,164,Eletrônico,2,192
26619,2024-01-19 11:38:00,55,141,Vestuário,7,196
26620,2024-01-19 11:39:00,61,41,Móvel,4,102
26621,2024-01-19 11:40:00,74,168,Alimento,6,242
26622,2024-01-19 11:41:00,57,75,Móvel,7,132
26623,2024-01-19 11:42:00,41,80,Móvel,3,121
26624,2024-01-19 11:43:00,48,57,Móvel,6,105
26625,2024-01-19 11:44:00,22,91,Eletrônico,7,113
26626,2024-01-19 11:45:00,48,137,Eletrônico,4,185
26627,2024-01-19 11:46:00,112,159,Alimento,8,271
26628,2024-01-19 11:47:00,111,107,Brinquedo,3,218
26629,2024-01-19 11:48:00,65,168,Eletrônico,6,233
26630,2024-01-19 11:49:00,61,80,Alimento,1,141
26631,2024-01-19 11:50:00,65,28,Eletrônico,4,93
26632,2024-01-19 11:51:00,80,99,Vestuário,3,179
26633,2024-01-19 11:52:00,89,70,Móvel,7,159
26634,2024-01-19 11:53:00,75,102,Eletrônico,1,177
26635,2024-01-19 11:54:00,94,103,Vestuário,4,197
26636,2024-01-19 11:55:00,12,46,Eletrônico,8,58
26637,2024-01-19 11:56:00,114,95,Alimento,8,209
26638,2024-01-19 11:57:00,39,18,Móvel,8,57
26639,2024-01-19 11:58:00,11,85,Móvel,4,96
26640,2024-01-19 11:59:00,51,169,Móvel,3,220
26641,2024-01-19 12:00:00,60,47,Brinquedo,9,107
26642,2024-01-19 12:01:00,25,23,Móvel,9,48
26643,2024-01-19 12:02:00,103,101,Alimento,5,204
26644,2024-01-19 12:03:00,42,87,Alimento,7,129
26645,2024-01-19 12:04:00,32,125,Alimento,6,157
26646,2024-01-19 12:05:00,20,43,Móvel,5,63
26647,2024-01-19 12:06:00,89,96,Alimento,4,185
26648,2024-01-19 12:07:00,103,82,Alimento,6,185
26649,2024-01-19 12:08:00,90,161,Brinquedo,6,251
26650,2024-01-19 12:09:00,76,174,Vestuário,6,250
26651,2024-01-19 12:10:00,44,51,Móvel,9,95
26652,2024-01-19 12:11:00,22,154,Vestuário,3,176
26653,2024-01-19 12:12:00,30,141,Brinquedo,6,171
26654,2024-01-19 12:13:00,56,90,Brinquedo,3,146
26655,2024-01-19 12:14:00,62,42,Alimento,2,104
26656,2024-01-19 12:15:00,84,105,Alimento,2,189
26657,2024-01-19 12:16:00,110,173,Brinquedo,4,283
26658,2024-01-19 12:17:00,61,132,Móvel,5,193
26659,2024-01-19 12:18:00,34,75,Alimento,2,109
26660,2024-01-19 12:19:00,101,141,Eletrônico,2,242
26661,2024-01-19 12:20:00,91,104,Eletrônico,8,195
26662,2024-01-19 12:21:00,63,33,Brinquedo,1,96
26663,2024-01-19 12:22:00,115,81,Móvel,5,196
26664,2024-01-19 12:23:00,54,157,Vestuário,9,211
26665,2024-01-19 12:24:00,113,98,Alimento,7,211
26666,2024-01-19 12:25:00,53,157,Vestuário,6,210
26667,2024-01-19 12:26:00,54,97,Móvel,4,151
26668,2024-01-19 12:27:00,51,153,Móvel,5,204
26669,2024-01-19 12:28:00,91,58,Vestuário,8,149
26670,2024-01-19 12:29:00,101,160,Eletrônico,5,261
26671,2024-01-19 12:30:00,32,135,Brinquedo,2,167
26672,2024-01-19 12:31:00,16,146,Alimento,1,162
26673,2024-01-19 12:32:00,91,40,Alimento,1,131
26674,2024-01-19 12:33:00,39,28,Móvel,7,67
26675,2024-01-19 12:34:00,10,85,Vestuário,5,95
26676,2024-01-19 12:35:00,64,31,Vestuário,6,95
26677,2024-01-19 12:36:00,54,74,Vestuário,9,128
26678,2024-01-19 12:37:00,87,75,Vestuário,9,162
26679,2024-01-19 12:38:00,89,113,Móvel,1,202
26680,2024-01-19 12:39:00,47,118,Móvel,2,165
26681,2024-01-19 12:40:00,79,174,Vestuário,2,253
26682,2024-01-19 12:41:00,73,115,Vestuário,1,188
26683,2024-01-19 12:42:00,21,144,Vestuário,3,165
26684,2024-01-19 12:43:00,14,39,Alimento,5,53
26685,2024-01-19 12:44:00,97,45,Eletrônico,8,142
26686,2024-01-19 12:45:00,11,116,Móvel,1,127
26687,2024-01-19 12:46:00,31,58,Vestuário,9,89
26688,2024-01-19 12:47:00,109,85,Vestuário,1,194
26689,2024-01-19 12:48:00,47,106,Vestuário,5,153
26690,2024-01-19 12:49:00,34,159,Eletrônico,5,193
26691,2024-01-19 12:50:00,119,116,Vestuário,7,235
26692,2024-01-19 12:51:00,119,179,Eletrônico,3,298
26693,2024-01-19 12:52:00,104,19,Alimento,1,123
26694,2024-01-19 12:53:00,92,84,Alimento,4,176
26695,2024-01-19 12:54:00,39,170,Alimento,8,209
26696,2024-01-19 12:55:00,114,35,Brinquedo,3,149
26697,2024-01-19 12:56:00,104,175,Eletrônico,5,279
26698,2024-01-19 12:57:00,67,61,Alimento,6,128
26699,2024-01-19 12:58:00,66,33,Móvel,2,99
26700,2024-01-19 12:59:00,106,59,Móvel,7,165
26701,2024-01-19 13:00:00,47,108,Brinquedo,2,155
26702,2024-01-19 13:01:00,118,133,Móvel,7,251
26703,2024-01-19 13:02:00,108,41,Alimento,8,149
26704,2024-01-19 13:03:00,69,89,Vestuário,8,158
26705,2024-01-19 13:04:00,112,45,Eletrônico,7,157
26706,2024-01-19 13:05:00,100,117,Eletrônico,6,217
26707,2024-01-19 13:06:00,118,171,Vestuário,3,289
26708,2024-01-19 13:07:00,111,65,Brinquedo,9,176
26709,2024-01-19 13:08:00,87,162,Vestuário,6,249
26710,2024-01-19 13:09:00,101,30,Eletrônico,3,131
26711,2024-01-19 13:10:00,25,119,Eletrônico,6,144
26712,2024-01-19 13:11:00,66,39,Eletrônico,2,105
26713,2024-01-19 13:12:00,34,42,Móvel,2,76
26714,2024-01-19 13:13:00,98,100,Alimento,2,198
26715,2024-01-19 13:14:00,14,69,Móvel,2,83
26716,2024-01-19 13:15:00,95,124,Eletrônico,9,219
26717,2024-01-19 13:16:00,28,21,Brinquedo,2,49
26718,2024-01-19 13:17:00,101,127,Brinquedo,3,228
26719,2024-01-19 13:18:00,10,13,Vestuário,5,23
26720,2024-01-19 13:19:00,55,16,Alimento,7,71
26721,2024-01-19 13:20:00,69,35,Alimento,1,104
26722,2024-01-19 13:21:00,85,75,Eletrônico,6,160
26723,2024-01-19 13:22:00,64,113,Alimento,1,177
26724,2024-01-19 13:23:00,108,172,Brinquedo,6,280
26725,2024-01-19 13:24:00,44,88,Brinquedo,4,132
26726,2024-01-19 13:25:00,30,96,Eletrônico,8,126
26727,2024-01-19 13:26:00,116,10,Alimento,6,126
26728,2024-01-19 13:27:00,96,101,Brinquedo,7,197
26729,2024-01-19 13:28:00,15,101,Móvel,1,116
26730,2024-01-19 13:29:00,97,138,Alimento,1,235
26731,2024-01-19 13:30:00,11,49,Eletrônico,3,60
26732,2024-01-19 13:31:00,46,50,Brinquedo,4,96
26733,2024-01-19 13:32:00,70,60,Alimento,8,130
26734,2024-01-19 13:33:00,46,151,Móvel,8,197
26735,2024-01-19 13:34:00,19,47,Vestuário,3,66
26736,2024-01-19 13:35:00,75,138,Brinquedo,2,213
26737,2024-01-19 13:36:00,44,58,Brinquedo,9,102
26738,2024-01-19 13:37:00,52,38,Eletrônico,2,90
26739,2024-01-19 13:38:00,64,15,Vestuário,3,79
26740,2024-01-19 13:39:00,65,128,Brinquedo,4,193
26741,2024-01-19 13:40:00,48,139,Eletrônico,5,187
26742,2024-01-19 13:41:00,108,39,Vestuário,6,147
26743,2024-01-19 13:42:00,22,147,Vestuário,9,169
26744,2024-01-19 13:43:00,107,83,Brinquedo,8,190
26745,2024-01-19 13:44:00,83,118,Alimento,4,201
26746,2024-01-19 13:45:00,41,116,Vestuário,6,157
26747,2024-01-19 13:46:00,37,123,Alimento,9,160
26748,2024-01-19 13:47:00,23,142,Móvel,5,165
26749,2024-01-19 13:48:00,63,145,Alimento,1,208
26750,2024-01-19 13:49:00,11,58,Brinquedo,8,69
26751,2024-01-19 13:50:00,110,16,Eletrônico,7,126
26752,2024-01-19 13:51:00,116,175,Móvel,8,291
26753,2024-01-19 13:52:00,13,31,Móvel,7,44
26754,2024-01-19 13:53:00,89,78,Alimento,3,167
26755,2024-01-19 13:54:00,107,18,Eletrônico,5,125
26756,2024-01-19 13:55:00,63,35,Brinquedo,8,98
26757,2024-01-19 13:56:00,108,30,Vestuário,6,138
26758,2024-01-19 13:57:00,27,179,Eletrônico,1,206
26759,2024-01-19 13:58:00,27,46,Móvel,7,73
26760,2024-01-19 13:59:00,95,106,Vestuário,9,201
26761,2024-01-19 14:00:00,83,126,Vestuário,7,209
26762,2024-01-19 14:01:00,23,91,Móvel,4,114
26763,2024-01-19 14:02:00,111,67,Alimento,3,178
26764,2024-01-19 14:03:00,36,124,Vestuário,2,160
26765,2024-01-19 14:04:00,79,15,Eletrônico,2,94
26766,2024-01-19 14:05:00,61,152,Móvel,4,213
26767,2024-01-19 14:06:00,118,83,Eletrônico,1,201
26768,2024-01-19 14:07:00,80,20,Brinquedo,7,100
26769,2024-01-19 14:08:00,59,177,Brinquedo,3,236
26770,2024-01-19 14:09:00,74,44,Móvel,5,118
26771,2024-01-19 14:10:00,82,38,Alimento,5,120
26772,2024-01-19 14:11:00,12,145,Alimento,7,157
26773,2024-01-19 14:12:00,73,59,Brinquedo,1,132
26774,2024-01-19 14:13:00,34,50,Brinquedo,4,84
26775,2024-01-19 14:14:00,20,33,Eletrônico,1,53
26776,2024-01-19 14:15:00,97,98,Alimento,2,195
26777,2024-01-19 14:16:00,31,158,Móvel,2,189
26778,2024-01-19 14:17:00,86,137,Vestuário,3,223
26779,2024-01-19 14:18:00,75,104,Móvel,2,179
26780,2024-01-19 14:19:00,12,59,Alimento,1,71
26781,2024-01-19 14:20:00,108,105,Brinquedo,1,213
26782,2024-01-19 14:21:00,11,30,Eletrônico,8,41
26783,2024-01-19 14:22:00,119,97,Eletrônico,1,216
26784,2024-01-19 14:23:00,24,103,Móvel,2,127
26785,2024-01-19 14:24:00,60,61,Brinquedo,8,121
26786,2024-01-19 14:25:00,86,18,Vestuário,8,104
26787,2024-01-19 14:26:00,105,54,Vestuário,9,159
26788,2024-01-19 14:27:00,73,165,Brinquedo,5,238
26789,2024-01-19 14:28:00,97,123,Vestuário,8,220
26790,2024-01-19 14:29:00,111,37,Alimento,4,148
26791,2024-01-19 14:30:00,59,111,Eletrônico,7,170
26792,2024-01-19 14:31:00,69,71,Vestuário,9,140
26793,2024-01-19 14:32:00,43,107,Vestuário,2,150
26794,2024-01-19 14:33:00,52,164,Eletrônico,7,216
26795,2024-01-19 14:34:00,71,121,Brinquedo,6,192
26796,2024-01-19 14:35:00,84,60,Eletrônico,1,144
26797,2024-01-19 14:36:00,27,104,Eletrônico,2,131
26798,2024-01-19 14:37:00,108,106,Brinquedo,9,214
26799,2024-01-19 14:38:00,100,125,Brinquedo,2,225
26800,2024-01-19 14:39:00,101,176,Vestuário,9,277
26801,2024-01-19 14:40:00,90,179,Brinquedo,5,269
26802,2024-01-19 14:41:00,62,118,Vestuário,3,180
26803,2024-01-19 14:42:00,16,144,Móvel,2,160
26804,2024-01-19 14:43:00,112,142,Brinquedo,5,254
26805,2024-01-19 14:44:00,64,129,Eletrônico,1,193
26806,2024-01-19 14:45:00,77,86,Eletrônico,2,163
26807,2024-01-19 14:46:00,37,75,Eletrônico,9,112
26808,2024-01-19 14:47:00,110,131,Vestuário,5,241
26809,2024-01-19 14:48:00,62,49,Eletrônico,6,111
26810,2024-01-19 14:49:00,23,98,Móvel,2,121
26811,2024-01-19 14:50:00,33,122,Brinquedo,7,155
26812,2024-01-19 14:51:00,28,74,Brinquedo,3,102
26813,2024-01-19 14:52:00,42,128,Vestuário,7,170
26814,2024-01-19 14:53:00,26,163,Eletrônico,7,189
26815,2024-01-19 14:54:00,19,73,Brinquedo,2,92
26816,2024-01-19 14:55:00,43,69,Brinquedo,9,112
26817,2024-01-19 14:56:00,19,117,Móvel,9,136
26818,2024-01-19 14:57:00,100,27,Móvel,2,127
26819,2024-01-19 14:58:00,37,19,Vestuário,2,56
26820,2024-01-19 14:59:00,44,69,Móvel,8,113
26821,2024-01-19 15:00:00,53,64,Alimento,2,117
26822,2024-01-19 15:01:00,34,164,Móvel,2,198
26823,2024-01-19 15:02:00,40,90,Móvel,9,130
26824,2024-01-19 15:03:00,105,69,Eletrônico,5,174
26825,2024-01-19 15:04:00,66,39,Móvel,2,105
26826,2024-01-19 15:05:00,29,10,Móvel,5,39
26827,2024-01-19 15:06:00,101,18,Eletrônico,5,119
26828,2024-01-19 15:07:00,106,36,Vestuário,8,142
26829,2024-01-19 15:08:00,32,72,Vestuário,8,104
26830,2024-01-19 15:09:00,110,97,Alimento,4,207
26831,2024-01-19 15:10:00,38,172,Alimento,5,210
26832,2024-01-19 15:11:00,34,174,Brinquedo,8,208
26833,2024-01-19 15:12:00,71,93,Vestuário,4,164
26834,2024-01-19 15:13:00,72,30,Brinquedo,7,102
26835,2024-01-19 15:14:00,60,139,Móvel,3,199
26836,2024-01-19 15:15:00,108,114,Brinquedo,3,222
26837,2024-01-19 15:16:00,76,58,Brinquedo,9,134
26838,2024-01-19 15:17:00,51,30,Alimento,8,81
26839,2024-01-19 15:18:00,101,80,Vestuário,4,181
26840,2024-01-19 15:19:00,111,151,Eletrônico,5,262
26841,2024-01-19 15:20:00,30,101,Vestuário,1,131
26842,2024-01-19 15:21:00,114,31,Eletrônico,4,145
26843,2024-01-19 15:22:00,91,59,Brinquedo,5,150
26844,2024-01-19 15:23:00,83,160,Brinquedo,8,243
26845,2024-01-19 15:24:00,46,85,Brinquedo,3,131
26846,2024-01-19 15:25:00,67,44,Eletrônico,9,111
26847,2024-01-19 15:26:00,22,149,Vestuário,2,171
26848,2024-01-19 15:27:00,119,75,Alimento,6,194
26849,2024-01-19 15:28:00,64,167,Móvel,8,231
26850,2024-01-19 15:29:00,84,67,Alimento,6,151
26851,2024-01-19 15:30:00,72,114,Móvel,5,186
26852,2024-01-19 15:31:00,37,56,Vestuário,9,93
26853,2024-01-19 15:32:00,113,74,Vestuário,1,187
26854,2024-01-19 15:33:00,14,78,Alimento,6,92
26855,2024-01-19 15:34:00,36,49,Eletrônico,9,85
26856,2024-01-19 15:35:00,113,95,Brinquedo,3,208
26857,2024-01-19 15:36:00,45,16,Móvel,6,61
26858,2024-01-19 15:37:00,102,93,Eletrônico,2,195
26859,2024-01-19 15:38:00,18,147,Móvel,6,165
26860,2024-01-19 15:39:00,47,159,Eletrônico,8,206
26861,2024-01-19 15:40:00,101,149,Vestuário,4,250
26862,2024-01-19 15:41:00,29,177,Brinquedo,3,206
26863,2024-01-19 15:42:00,76,103,Eletrônico,1,179
26864,2024-01-19 15:43:00,28,126,Alimento,6,154
26865,2024-01-19 15:44:00,90,113,Eletrônico,3,203
26866,2024-01-19 15:45:00,41,121,Móvel,5,162
26867,2024-01-19 15:46:00,107,125,Eletrônico,8,232
26868,2024-01-19 15:47:00,107,55,Móvel,6,162
26869,2024-01-19 15:48:00,94,151,Brinquedo,5,245
26870,2024-01-19 15:49:00,98,41,Alimento,9,139
26871,2024-01-19 15:50:00,103,115,Brinquedo,1,218
26872,2024-01-19 15:51:00,81,42,Brinquedo,3,123
26873,2024-01-19 15:52:00,112,152,Eletrônico,6,264
26874,2024-01-19 15:53:00,66,174,Eletrônico,7,240
26875,2024-01-19 15:54:00,96,116,Móvel,8,212
26876,2024-01-19 15:55:00,24,75,Eletrônico,7,99
26877,2024-01-19 15:56:00,88,159,Eletrônico,1,247
26878,2024-01-19 15:57:00,39,105,Móvel,3,144
26879,2024-01-19 15:58:00,52,104,Eletrônico,4,156
26880,2024-01-19 15:59:00,97,155,Brinquedo,2,252
26881,2024-01-19 16:00:00,97,165,Móvel,3,262
26882,2024-01-19 16:01:00,44,22,Vestuário,9,66
26883,2024-01-19 16:02:00,78,100,Brinquedo,6,178
26884,2024-01-19 16:03:00,18,95,Eletrônico,2,113
26885,2024-01-19 16:04:00,53,48,Eletrônico,1,101
26886,2024-01-19 16:05:00,30,122,Alimento,7,152
26887,2024-01-19 16:06:00,98,69,Alimento,5,167
26888,2024-01-19 16:07:00,119,111,Eletrônico,4,230
26889,2024-01-19 16:08:00,67,85,Brinquedo,2,152
26890,2024-01-19 16:09:00,81,161,Brinquedo,3,242
26891,2024-01-19 16:10:00,97,120,Alimento,4,217
26892,2024-01-19 16:11:00,106,88,Móvel,1,194
26893,2024-01-19 16:12:00,83,78,Alimento,5,161
26894,2024-01-19 16:13:00,21,128,Móvel,6,149
26895,2024-01-19 16:14:00,12,165,Vestuário,3,177
26896,2024-01-19 16:15:00,32,58,Brinquedo,7,90
26897,2024-01-19 16:16:00,47,91,Eletrônico,4,138
26898,2024-01-19 16:17:00,21,57,Alimento,1,78
26899,2024-01-19 16:18:00,33,57,Eletrônico,5,90
26900,2024-01-19 16:19:00,36,140,Brinquedo,9,176
26901,2024-01-19 16:20:00,61,29,Vestuário,2,90
26902,2024-01-19 16:21:00,55,94,Alimento,2,149
26903,2024-01-19 16:22:00,116,13,Móvel,9,129
26904,2024-01-19 16:23:00,28,173,Brinquedo,6,201
26905,2024-01-19 16:24:00,112,172,Móvel,9,284
26906,2024-01-19 16:25:00,62,121,Alimento,2,183
26907,2024-01-19 16:26:00,97,179,Brinquedo,5,276
26908,2024-01-19 16:27:00,68,115,Eletrônico,6,183
26909,2024-01-19 16:28:00,58,68,Alimento,7,126
26910,2024-01-19 16:29:00,45,44,Alimento,5,89
26911,2024-01-19 16:30:00,37,16,Vestuário,5,53
26912,2024-01-19 16:31:00,94,18,Vestuário,8,112
26913,2024-01-19 16:32:00,74,156,Móvel,9,230
26914,2024-01-19 16:33:00,11,146,Alimento,1,157
26915,2024-01-19 16:34:00,103,146,Vestuário,5,249
26916,2024-01-19 16:35:00,19,77,Eletrônico,5,96
26917,2024-01-19 16:36:00,84,76,Alimento,3,160
26918,2024-01-19 16:37:00,107,29,Alimento,2,136
26919,2024-01-19 16:38:00,52,97,Alimento,5,149
26920,2024-01-19 16:39:00,95,140,Eletrônico,5,235
26921,2024-01-19 16:40:00,117,98,Vestuário,7,215
26922,2024-01-19 16:41:00,95,54,Móvel,7,149
26923,2024-01-19 16:42:00,76,42,Alimento,2,118
26924,2024-01-19 16:43:00,33,175,Vestuário,9,208
26925,2024-01-19 16:44:00,33,92,Móvel,9,125
26926,2024-01-19 16:45:00,115,134,Eletrônico,9,249
26927,2024-01-19 16:46:00,48,14,Eletrônico,4,62
26928,2024-01-19 16:47:00,112,131,Eletrônico,2,243
26929,2024-01-19 16:48:00,74,163,Vestuário,2,237
26930,2024-01-19 16:49:00,64,72,Eletrônico,8,136
26931,2024-01-19 16:50:00,39,53,Brinquedo,3,92
26932,2024-01-19 16:51:00,86,149,Brinquedo,6,235
26933,2024-01-19 16:52:00,111,51,Brinquedo,4,162
26934,2024-01-19 16:53:00,32,71,Alimento,3,103
26935,2024-01-19 16:54:00,36,10,Vestuário,5,46
26936,2024-01-19 16:55:00,113,34,Alimento,4,147
26937,2024-01-19 16:56:00,100,152,Eletrônico,9,252
26938,2024-01-19 16:57:00,48,158,Vestuário,8,206
26939,2024-01-19 16:58:00,113,120,Móvel,5,233
26940,2024-01-19 16:59:00,107,70,Móvel,3,177
26941,2024-01-19 17:00:00,75,148,Brinquedo,5,223
26942,2024-01-19 17:01:00,31,107,Brinquedo,4,138
26943,2024-01-19 17:02:00,107,87,Brinquedo,5,194
26944,2024-01-19 17:03:00,119,146,Eletrônico,2,265
26945,2024-01-19 17:04:00,65,140,Alimento,9,205
26946,2024-01-19 17:05:00,29,112,Alimento,8,141
26947,2024-01-19 17:06:00,108,10,Vestuário,3,118
26948,2024-01-19 17:07:00,17,92,Alimento,6,109
26949,2024-01-19 17:08:00,89,141,Brinquedo,7,230
26950,2024-01-19 17:09:00,116,56,Móvel,2,172
26951,2024-01-19 17:10:00,64,37,Brinquedo,7,101
26952,2024-01-19 17:11:00,27,36,Vestuário,9,63
26953,2024-01-19 17:12:00,83,140,Alimento,3,223
26954,2024-01-19 17:13:00,50,57,Vestuário,1,107
26955,2024-01-19 17:14:00,50,117,Eletrônico,6,167
26956,2024-01-19 17:15:00,106,112,Vestuário,4,218
26957,2024-01-19 17:16:00,76,159,Eletrônico,8,235
26958,2024-01-19 17:17:00,24,120,Eletrônico,9,144
26959,2024-01-19 17:18:00,114,24,Eletrônico,6,138
26960,2024-01-19 17:19:00,70,36,Móvel,1,106
26961,2024-01-19 17:20:00,27,158,Móvel,2,185
26962,2024-01-19 17:21:00,92,177,Vestuário,6,269
26963,2024-01-19 17:22:00,85,85,Brinquedo,3,170
26964,2024-01-19 17:23:00,92,121,Eletrônico,7,213
26965,2024-01-19 17:24:00,82,24,Brinquedo,6,106
26966,2024-01-19 17:25:00,22,84,Móvel,1,106
26967,2024-01-19 17:26:00,54,14,Brinquedo,7,68
26968,2024-01-19 17:27:00,65,99,Alimento,4,164
26969,2024-01-19 17:28:00,59,87,Móvel,2,146
26970,2024-01-19 17:29:00,12,137,Alimento,9,149
26971,2024-01-19 17:30:00,53,33,Móvel,7,86
26972,2024-01-19 17:31:00,71,158,Eletrônico,9,229
26973,2024-01-19 17:32:00,23,98,Vestuário,6,121
26974,2024-01-19 17:33:00,83,104,Eletrônico,2,187
26975,2024-01-19 17:34:00,13,33,Vestuário,4,46
26976,2024-01-19 17:35:00,19,87,Móvel,2,106
26977,2024-01-19 17:36:00,53,48,Brinquedo,9,101
26978,2024-01-19 17:37:00,18,149,Alimento,3,167
26979,2024-01-19 17:38:00,24,58,Brinquedo,7,82
26980,2024-01-19 17:39:00,69,24,Vestuário,6,93
26981,2024-01-19 17:40:00,30,80,Móvel,2,110
26982,2024-01-19 17:41:00,22,49,Alimento,7,71
26983,2024-01-19 17:42:00,49,105,Alimento,6,154
26984,2024-01-19 17:43:00,15,46,Alimento,6,61
26985,2024-01-19 17:44:00,64,61,Brinquedo,1,125
26986,2024-01-19 17:45:00,39,72,Eletrônico,8,111
26987,2024-01-19 17:46:00,30,52,Brinquedo,4,82
26988,2024-01-19 17:47:00,71,102,Eletrônico,5,173
26989,2024-01-19 17:48:00,25,142,Brinquedo,2,167
26990,2024-01-19 17:49:00,34,165,Móvel,1,199
26991,2024-01-19 17:50:00,83,92,Brinquedo,1,175
26992,2024-01-19 17:51:00,75,106,Brinquedo,7,181
26993,2024-01-19 17:52:00,78,146,Vestuário,3,224
26994,2024-01-19 17:53:00,37,34,Eletrônico,4,71
26995,2024-01-19 17:54:00,107,151,Móvel,9,258
26996,2024-01-19 17:55:00,47,39,Vestuário,7,86
26997,2024-01-19 17:56:00,104,95,Alimento,7,199
26998,2024-01-19 17:57:00,111,79,Brinquedo,3,190
26999,2024-01-19 17:58:00,62,158,Alimento,7,220
27000,2024-01-19 17:59:00,84,37,Eletrônico,9,121
27001,2024-01-19 18:00:00,13,132,Móvel,8,145
27002,2024-01-19 18:01:00,27,54,Brinquedo,3,81
27003,2024-01-19 18:02:00,61,140,Vestuário,2,201
27004,2024-01-19 18:03:00,78,100,Eletrônico,9,178
27005,2024-01-19 18:04:00,112,101,Móvel,9,213
27006,2024-01-19 18:05:00,15,37,Móvel,2,52
27007,2024-01-19 18:06:00,106,136,Móvel,2,242
27008,2024-01-19 18:07:00,33,38,Vestuário,7,71
27009,2024-01-19 18:08:00,86,171,Móvel,5,257
27010,2024-01-19 18:09:00,63,84,Eletrônico,2,147
27011,2024-01-19 18:10:00,76,12,Alimento,1,88
27012,2024-01-19 18:11:00,20,70,Brinquedo,2,90
27013,2024-01-19 18:12:00,72,179,Vestuário,9,251
27014,2024-01-19 18:13:00,99,90,Alimento,9,189
27015,2024-01-19 18:14:00,100,124,Eletrônico,6,224
27016,2024-01-19 18:15:00,108,37,Brinquedo,6,145
27017,2024-01-19 18:16:00,97,70,Alimento,8,167
27018,2024-01-19 18:17:00,23,60,Alimento,5,83
27019,2024-01-19 18:18:00,21,24,Móvel,1,45
27020,2024-01-19 18:19:00,115,32,Móvel,2,147
27021,2024-01-19 18:20:00,29,12,Eletrônico,7,41
27022,2024-01-19 18:21:00,41,59,Móvel,8,100
27023,2024-01-19 18:22:00,91,15,Vestuário,5,106
27024,2024-01-19 18:23:00,94,175,Alimento,5,269
27025,2024-01-19 18:24:00,65,76,Eletrônico,4,141
27026,2024-01-19 18:25:00,14,148,Brinquedo,6,162
27027,2024-01-19 18:26:00,73,58,Brinquedo,3,131
27028,2024-01-19 18:27:00,93,30,Brinquedo,3,123
27029,2024-01-19 18:28:00,43,48,Móvel,2,91
27030,2024-01-19 18:29:00,110,26,Brinquedo,1,136
27031,2024-01-19 18:30:00,102,131,Móvel,3,233
27032,2024-01-19 18:31:00,43,115,Vestuário,5,158
27033,2024-01-19 18:32:00,99,144,Eletrônico,6,243
27034,2024-01-19 18:33:00,15,63,Alimento,7,78
27035,2024-01-19 18:34:00,27,14,Eletrônico,9,41
27036,2024-01-19 18:35:00,112,105,Vestuário,7,217
27037,2024-01-19 18:36:00,20,170,Alimento,3,190
27038,2024-01-19 18:37:00,45,166,Alimento,9,211
27039,2024-01-19 18:38:00,39,159,Eletrônico,9,198
27040,2024-01-19 18:39:00,10,92,Brinquedo,7,102
27041,2024-01-19 18:40:00,94,171,Alimento,9,265
27042,2024-01-19 18:41:00,106,167,Brinquedo,2,273
27043,2024-01-19 18:42:00,102,128,Eletrônico,1,230
27044,2024-01-19 18:43:00,102,55,Vestuário,1,157
27045,2024-01-19 18:44:00,70,78,Vestuário,1,148
27046,2024-01-19 18:45:00,65,57,Brinquedo,8,122
27047,2024-01-19 18:46:00,64,63,Alimento,5,127
27048,2024-01-19 18:47:00,20,159,Alimento,7,179
27049,2024-01-19 18:48:00,10,170,Móvel,7,180
27050,2024-01-19 18:49:00,72,111,Brinquedo,7,183
27051,2024-01-19 18:50:00,38,59,Brinquedo,1,97
27052,2024-01-19 18:51:00,36,52,Brinquedo,4,88
27053,2024-01-19 18:52:00,61,59,Vestuário,9,120
27054,2024-01-19 18:53:00,69,129,Eletrônico,8,198
27055,2024-01-19 18:54:00,108,14,Alimento,6,122
27056,2024-01-19 18:55:00,35,16,Brinquedo,4,51
27057,2024-01-19 18:56:00,31,145,Brinquedo,9,176
27058,2024-01-19 18:57:00,39,36,Brinquedo,9,75
27059,2024-01-19 18:58:00,69,89,Brinquedo,3,158
27060,2024-01-19 18:59:00,28,80,Móvel,3,108
27061,2024-01-19 19:00:00,79,53,Móvel,1,132
27062,2024-01-19 19:01:00,88,117,Alimento,1,205
27063,2024-01-19 19:02:00,54,141,Brinquedo,3,195
27064,2024-01-19 19:03:00,10,23,Alimento,2,33
27065,2024-01-19 19:04:00,87,39,Alimento,1,126
27066,2024-01-19 19:05:00,109,134,Brinquedo,6,243
27067,2024-01-19 19:06:00,107,112,Vestuário,1,219
27068,2024-01-19 19:07:00,38,79,Alimento,1,117
27069,2024-01-19 19:08:00,28,178,Eletrônico,7,206
27070,2024-01-19 19:09:00,94,123,Vestuário,9,217
27071,2024-01-19 19:10:00,33,58,Eletrônico,7,91
27072,2024-01-19 19:11:00,24,133,Vestuário,2,157
27073,2024-01-19 19:12:00,27,132,Alimento,7,159
27074,2024-01-19 19:13:00,24,32,Vestuário,5,56
27075,2024-01-19 19:14:00,116,130,Vestuário,4,246
27076,2024-01-19 19:15:00,33,152,Móvel,9,185
27077,2024-01-19 19:16:00,64,74,Eletrônico,8,138
27078,2024-01-19 19:17:00,100,114,Alimento,4,214
27079,2024-01-19 19:18:00,70,25,Vestuário,5,95
27080,2024-01-19 19:19:00,84,66,Alimento,1,150
27081,2024-01-19 19:20:00,49,89,Brinquedo,7,138
27082,2024-01-19 19:21:00,71,126,Eletrônico,3,197
27083,2024-01-19 19:22:00,13,42,Vestuário,7,55
27084,2024-01-19 19:23:00,60,160,Vestuário,7,220
27085,2024-01-19 19:24:00,15,15,Eletrônico,7,30
27086,2024-01-19 19:25:00,15,88,Alimento,4,103
27087,2024-01-19 19:26:00,34,12,Alimento,1,46
27088,2024-01-19 19:27:00,78,149,Móvel,5,227
27089,2024-01-19 19:28:00,69,69,Brinquedo,8,138
27090,2024-01-19 19:29:00,47,74,Brinquedo,1,121
27091,2024-01-19 19:30:00,49,54,Móvel,4,103
27092,2024-01-19 19:31:00,89,123,Vestuário,7,212
27093,2024-01-19 19:32:00,101,82,Brinquedo,9,183
27094,2024-01-19 19:33:00,21,19,Vestuário,7,40
27095,2024-01-19 19:34:00,85,176,Eletrônico,1,261
27096,2024-01-19 19:35:00,108,114,Móvel,5,222
27097,2024-01-19 19:36:00,92,113,Brinquedo,9,205
27098,2024-01-19 19:37:00,16,133,Vestuário,5,149
27099,2024-01-19 19:38:00,57,140,Vestuário,5,197
27100,2024-01-19 19:39:00,72,38,Brinquedo,2,110
27101,2024-01-19 19:40:00,104,84,Eletrônico,2,188
27102,2024-01-19 19:41:00,75,61,Alimento,8,136
27103,2024-01-19 19:42:00,20,34,Eletrônico,6,54
27104,2024-01-19 19:43:00,20,33,Vestuário,7,53
27105,2024-01-19 19:44:00,69,110,Vestuário,7,179
27106,2024-01-19 19:45:00,73,36,Vestuário,3,109
27107,2024-01-19 19:46:00,36,14,Alimento,2,50
27108,2024-01-19 19:47:00,91,97,Vestuário,2,188
27109,2024-01-19 19:48:00,60,133,Alimento,2,193
27110,2024-01-19 19:49:00,78,170,Brinquedo,7,248
27111,2024-01-19 19:50:00,25,92,Brinquedo,9,117
27112,2024-01-19 19:51:00,91,60,Alimento,3,151
27113,2024-01-19 19:52:00,45,103,Alimento,2,148
27114,2024-01-19 19:53:00,83,48,Brinquedo,2,131
27115,2024-01-19 19:54:00,82,156,Alimento,8,238
27116,2024-01-19 19:55:00,80,45,Eletrônico,6,125
27117,2024-01-19 19:56:00,100,37,Móvel,4,137
27118,2024-01-19 19:57:00,68,100,Eletrônico,9,168
27119,2024-01-19 19:58:00,69,83,Móvel,9,152
27120,2024-01-19 19:59:00,40,159,Eletrônico,9,199
27121,2024-01-19 20:00:00,83,147,Eletrônico,1,230
27122,2024-01-19 20:01:00,34,95,Móvel,2,129
27123,2024-01-19 20:02:00,86,45,Brinquedo,3,131
27124,2024-01-19 20:03:00,106,150,Eletrônico,1,256
27125,2024-01-19 20:04:00,16,150,Brinquedo,4,166
27126,2024-01-19 20:05:00,103,42,Móvel,3,145
27127,2024-01-19 20:06:00,50,45,Móvel,3,95
27128,2024-01-19 20:07:00,30,115,Brinquedo,4,145
27129,2024-01-19 20:08:00,35,78,Vestuário,9,113
27130,2024-01-19 20:09:00,34,77,Vestuário,1,111
27131,2024-01-19 20:10:00,21,77,Brinquedo,4,98
27132,2024-01-19 20:11:00,119,40,Brinquedo,2,159
27133,2024-01-19 20:12:00,14,57,Brinquedo,4,71
27134,2024-01-19 20:13:00,73,61,Alimento,9,134
27135,2024-01-19 20:14:00,76,152,Vestuário,1,228
27136,2024-01-19 20:15:00,77,12,Brinquedo,3,89
27137,2024-01-19 20:16:00,85,49,Brinquedo,4,134
27138,2024-01-19 20:17:00,108,149,Brinquedo,3,257
27139,2024-01-19 20:18:00,118,29,Eletrônico,8,147
27140,2024-01-19 20:19:00,23,59,Vestuário,1,82
27141,2024-01-19 20:20:00,117,134,Brinquedo,5,251
27142,2024-01-19 20:21:00,88,169,Alimento,1,257
27143,2024-01-19 20:22:00,26,89,Alimento,9,115
27144,2024-01-19 20:23:00,68,23,Eletrônico,9,91
27145,2024-01-19 20:24:00,23,36,Alimento,9,59
27146,2024-01-19 20:25:00,38,21,Móvel,8,59
27147,2024-01-19 20:26:00,113,52,Alimento,6,165
27148,2024-01-19 20:27:00,34,174,Brinquedo,2,208
27149,2024-01-19 20:28:00,83,144,Brinquedo,5,227
27150,2024-01-19 20:29:00,58,73,Móvel,3,131
27151,2024-01-19 20:30:00,42,18,Eletrônico,8,60
27152,2024-01-19 20:31:00,55,21,Alimento,3,76
27153,2024-01-19 20:32:00,50,98,Brinquedo,6,148
27154,2024-01-19 20:33:00,90,133,Vestuário,8,223
27155,2024-01-19 20:34:00,103,10,Brinquedo,8,113
27156,2024-01-19 20:35:00,116,147,Brinquedo,6,263
27157,2024-01-19 20:36:00,53,75,Eletrônico,5,128
27158,2024-01-19 20:37:00,28,61,Alimento,9,89
27159,2024-01-19 20:38:00,62,42,Brinquedo,1,104
27160,2024-01-19 20:39:00,53,128,Móvel,3,181
27161,2024-01-19 20:40:00,119,23,Alimento,9,142
27162,2024-01-19 20:41:00,52,131,Eletrônico,3,183
27163,2024-01-19 20:42:00,71,11,Eletrônico,9,82
27164,2024-01-19 20:43:00,96,72,Alimento,6,168
27165,2024-01-19 20:44:00,92,15,Alimento,7,107
27166,2024-01-19 20:45:00,24,148,Brinquedo,8,172
27167,2024-01-19 20:46:00,32,96,Eletrônico,3,128
27168,2024-01-19 20:47:00,77,62,Vestuário,5,139
27169,2024-01-19 20:48:00,49,79,Eletrônico,6,128
27170,2024-01-19 20:49:00,110,99,Brinquedo,2,209
27171,2024-01-19 20:50:00,25,40,Vestuário,9,65
27172,2024-01-19 20:51:00,52,146,Eletrônico,4,198
27173,2024-01-19 20:52:00,41,37,Eletrônico,2,78
27174,2024-01-19 20:53:00,74,51,Vestuário,3,125
27175,2024-01-19 20:54:00,31,163,Eletrônico,2,194
27176,2024-01-19 20:55:00,112,121,Vestuário,8,233
27177,2024-01-19 20:56:00,74,51,Eletrônico,7,125
27178,2024-01-19 20:57:00,50,101,Eletrônico,5,151
27179,2024-01-19 20:58:00,65,38,Vestuário,7,103
27180,2024-01-19 20:59:00,42,122,Brinquedo,2,164
27181,2024-01-19 21:00:00,76,94,Móvel,6,170
27182,2024-01-19 21:01:00,16,65,Alimento,3,81
27183,2024-01-19 21:02:00,104,166,Alimento,3,270
27184,2024-01-19 21:03:00,95,176,Alimento,5,271
27185,2024-01-19 21:04:00,36,42,Eletrônico,3,78
27186,2024-01-19 21:05:00,93,103,Eletrônico,2,196
27187,2024-01-19 21:06:00,87,73,Alimento,5,160
27188,2024-01-19 21:07:00,35,38,Eletrônico,7,73
27189,2024-01-19 21:08:00,11,163,Alimento,9,174
27190,2024-01-19 21:09:00,104,69,Móvel,8,173
27191,2024-01-19 21:10:00,88,146,Brinquedo,2,234
27192,2024-01-19 21:11:00,69,12,Vestuário,9,81
27193,2024-01-19 21:12:00,27,19,Vestuário,4,46
27194,2024-01-19 21:13:00,57,97,Eletrônico,6,154
27195,2024-01-19 21:14:00,50,66,Vestuário,9,116
27196,2024-01-19 21:15:00,49,159,Brinquedo,5,208
27197,2024-01-19 21:16:00,116,38,Eletrônico,6,154
27198,2024-01-19 21:17:00,41,81,Alimento,9,122
27199,2024-01-19 21:18:00,80,76,Eletrônico,5,156
27200,2024-01-19 21:19:00,50,69,Brinquedo,2,119
27201,2024-01-19 21:20:00,60,167,Eletrônico,7,227
27202,2024-01-19 21:21:00,98,160,Brinquedo,6,258
27203,2024-01-19 21:22:00,40,175,Brinquedo,7,215
27204,2024-01-19 21:23:00,93,42,Brinquedo,3,135
27205,2024-01-19 21:24:00,83,32,Alimento,1,115
27206,2024-01-19 21:25:00,82,176,Vestuário,3,258
27207,2024-01-19 21:26:00,65,25,Brinquedo,5,90
27208,2024-01-19 21:27:00,10,102,Vestuário,9,112
27209,2024-01-19 21:28:00,75,129,Móvel,5,204
27210,2024-01-19 21:29:00,30,135,Móvel,8,165
27211,2024-01-19 21:30:00,32,154,Eletrônico,9,186
27212,2024-01-19 21:31:00,64,127,Alimento,1,191
27213,2024-01-19 21:32:00,33,179,Vestuário,6,212
27214,2024-01-19 21:33:00,70,162,Eletrônico,1,232
27215,2024-01-19 21:34:00,35,43,Vestuário,1,78
27216,2024-01-19 21:35:00,32,81,Móvel,9,113
27217,2024-01-19 21:36:00,19,90,Alimento,6,109
27218,2024-01-19 21:37:00,99,29,Vestuário,9,128
27219,2024-01-19 21:38:00,104,50,Brinquedo,7,154
27220,2024-01-19 21:39:00,55,144,Alimento,8,199
27221,2024-01-19 21:40:00,94,120,Vestuário,7,214
27222,2024-01-19 21:41:00,11,54,Alimento,6,65
27223,2024-01-19 21:42:00,40,68,Eletrônico,3,108
27224,2024-01-19 21:43:00,10,75,Eletrônico,3,85
27225,2024-01-19 21:44:00,108,100,Eletrônico,9,208
27226,2024-01-19 21:45:00,60,138,Eletrônico,3,198
27227,2024-01-19 21:46:00,43,66,Móvel,1,109
27228,2024-01-19 21:47:00,67,32,Móvel,2,99
27229,2024-01-19 21:48:00,15,62,Alimento,3,77
27230,2024-01-19 21:49:00,54,173,Alimento,4,227
27231,2024-01-19 21:50:00,93,107,Eletrônico,6,200
27232,2024-01-19 21:51:00,53,144,Alimento,3,197
27233,2024-01-19 21:52:00,65,146,Alimento,8,211
27234,2024-01-19 21:53:00,78,136,Brinquedo,2,214
27235,2024-01-19 21:54:00,19,19,Alimento,9,38
27236,2024-01-19 21:55:00,10,116,Brinquedo,3,126
27237,2024-01-19 21:56:00,96,17,Móvel,9,113
27238,2024-01-19 21:57:00,45,128,Alimento,5,173
27239,2024-01-19 21:58:00,92,73,Eletrônico,5,165
27240,2024-01-19 21:59:00,25,149,Vestuário,7,174
27241,2024-01-19 22:00:00,19,172,Brinquedo,6,191
27242,2024-01-19 22:01:00,77,117,Alimento,9,194
27243,2024-01-19 22:02:00,37,170,Eletrônico,5,207
27244,2024-01-19 22:03:00,25,86,Alimento,1,111
27245,2024-01-19 22:04:00,104,17,Móvel,5,121
27246,2024-01-19 22:05:00,40,52,Vestuário,7,92
27247,2024-01-19 22:06:00,89,45,Brinquedo,5,134
27248,2024-01-19 22:07:00,39,35,Vestuário,7,74
27249,2024-01-19 22:08:00,100,170,Eletrônico,8,270
27250,2024-01-19 22:09:00,20,91,Eletrônico,7,111
27251,2024-01-19 22:10:00,71,178,Alimento,6,249
27252,2024-01-19 22:11:00,27,32,Móvel,8,59
27253,2024-01-19 22:12:00,27,22,Alimento,3,49
27254,2024-01-19 22:13:00,114,119,Móvel,4,233
27255,2024-01-19 22:14:00,59,149,Alimento,1,208
27256,2024-01-19 22:15:00,109,68,Eletrônico,1,177
27257,2024-01-19 22:16:00,35,69,Vestuário,2,104
27258,2024-01-19 22:17:00,94,87,Móvel,6,181
27259,2024-01-19 22:18:00,65,84,Móvel,4,149
27260,2024-01-19 22:19:00,76,147,Eletrônico,3,223
27261,2024-01-19 22:20:00,35,39,Móvel,4,74
27262,2024-01-19 22:21:00,95,27,Móvel,7,122
27263,2024-01-19 22:22:00,39,56,Eletrônico,9,95
27264,2024-01-19 22:23:00,116,90,Móvel,4,206
27265,2024-01-19 22:24:00,10,177,Brinquedo,2,187
27266,2024-01-19 22:25:00,37,35,Brinquedo,5,72
27267,2024-01-19 22:26:00,107,32,Vestuário,5,139
27268,2024-01-19 22:27:00,26,174,Móvel,7,200
27269,2024-01-19 22:28:00,42,36,Alimento,4,78
27270,2024-01-19 22:29:00,88,68,Móvel,2,156
27271,2024-01-19 22:30:00,81,143,Eletrônico,3,224
27272,2024-01-19 22:31:00,116,52,Vestuário,3,168
27273,2024-01-19 22:32:00,39,134,Móvel,5,173
27274,2024-01-19 22:33:00,57,65,Eletrônico,7,122
27275,2024-01-19 22:34:00,43,88,Móvel,9,131
27276,2024-01-19 22:35:00,111,158,Eletrônico,6,269
27277,2024-01-19 22:36:00,86,149,Móvel,7,235
27278,2024-01-19 22:37:00,119,96,Alimento,6,215
27279,2024-01-19 22:38:00,41,13,Alimento,8,54
27280,2024-01-19 22:39:00,54,172,Brinquedo,7,226
27281,2024-01-19 22:40:00,45,85,Móvel,5,130
27282,2024-01-19 22:41:00,74,31,Vestuário,7,105
27283,2024-01-19 22:42:00,93,148,Móvel,5,241
27284,2024-01-19 22:43:00,55,168,Móvel,1,223
27285,2024-01-19 22:44:00,39,151,Eletrônico,3,190
27286,2024-01-19 22:45:00,100,70,Vestuário,7,170
27287,2024-01-19 22:46:00,81,131,Brinquedo,3,212
27288,2024-01-19 22:47:00,99,41,Eletrônico,3,140
27289,2024-01-19 22:48:00,43,52,Eletrônico,3,95
27290,2024-01-19 22:49:00,44,126,Eletrônico,2,170
27291,2024-01-19 22:50:00,97,113,Brinquedo,9,210
27292,2024-01-19 22:51:00,30,154,Eletrônico,5,184
27293,2024-01-19 22:52:00,94,92,Brinquedo,2,186
27294,2024-01-19 22:53:00,72,106,Vestuário,6,178
27295,2024-01-19 22:54:00,76,120,Alimento,3,196
27296,2024-01-19 22:55:00,39,19,Brinquedo,3,58
27297,2024-01-19 22:56:00,23,132,Brinquedo,7,155
27298,2024-01-19 22:57:00,111,97,Vestuário,3,208
27299,2024-01-19 22:58:00,92,79,Móvel,6,171
27300,2024-01-19 22:59:00,110,37,Eletrônico,5,147
27301,2024-01-19 23:00:00,40,26,Vestuário,2,66
27302,2024-01-19 23:01:00,84,173,Eletrônico,1,257
27303,2024-01-19 23:02:00,36,44,Brinquedo,6,80
27304,2024-01-19 23:03:00,83,127,Brinquedo,8,210
27305,2024-01-19 23:04:00,36,162,Móvel,9,198
27306,2024-01-19 23:05:00,28,42,Vestuário,1,70
27307,2024-01-19 23:06:00,98,103,Brinquedo,2,201
27308,2024-01-19 23:07:00,80,87,Móvel,2,167
27309,2024-01-19 23:08:00,13,173,Brinquedo,7,186
27310,2024-01-19 23:09:00,103,92,Brinquedo,5,195
27311,2024-01-19 23:10:00,104,106,Alimento,4,210
27312,2024-01-19 23:11:00,24,128,Alimento,8,152
27313,2024-01-19 23:12:00,82,67,Eletrônico,4,149
27314,2024-01-19 23:13:00,13,134,Eletrônico,2,147
27315,2024-01-19 23:14:00,39,174,Eletrônico,1,213
27316,2024-01-19 23:15:00,59,91,Vestuário,4,150
27317,2024-01-19 23:16:00,29,174,Eletrônico,5,203
27318,2024-01-19 23:17:00,86,160,Eletrônico,2,246
27319,2024-01-19 23:18:00,54,142,Vestuário,3,196
27320,2024-01-19 23:19:00,115,141,Móvel,8,256
27321,2024-01-19 23:20:00,116,173,Alimento,6,289
27322,2024-01-19 23:21:00,16,19,Eletrônico,7,35
27323,2024-01-19 23:22:00,63,47,Móvel,4,110
27324,2024-01-19 23:23:00,77,58,Móvel,3,135
27325,2024-01-19 23:24:00,105,110,Eletrônico,4,215
27326,2024-01-19 23:25:00,40,18,Alimento,8,58
27327,2024-01-19 23:26:00,98,56,Eletrônico,5,154
27328,2024-01-19 23:27:00,39,147,Brinquedo,5,186
27329,2024-01-19 23:28:00,77,123,Eletrônico,2,200
27330,2024-01-19 23:29:00,59,121,Brinquedo,3,180
27331,2024-01-19 23:30:00,117,120,Eletrônico,7,237
27332,2024-01-19 23:31:00,13,147,Vestuário,2,160
27333,2024-01-19 23:32:00,95,93,Móvel,8,188
27334,2024-01-19 23:33:00,51,31,Eletrônico,6,82
27335,2024-01-19 23:34:00,15,160,Vestuário,9,175
27336,2024-01-19 23:35:00,28,43,Brinquedo,1,71
27337,2024-01-19 23:36:00,57,109,Alimento,8,166
27338,2024-01-19 23:37:00,57,68,Eletrônico,3,125
27339,2024-01-19 23:38:00,42,17,Móvel,5,59
27340,2024-01-19 23:39:00,45,93,Móvel,7,138
27341,2024-01-19 23:40:00,28,35,Móvel,1,63
27342,2024-01-19 23:41:00,75,128,Móvel,6,203
27343,2024-01-19 23:42:00,71,93,Vestuário,7,164
27344,2024-01-19 23:43:00,94,70,Vestuário,8,164
27345,2024-01-19 23:44:00,10,71,Móvel,2,81
27346,2024-01-19 23:45:00,32,137,Brinquedo,1,169
27347,2024-01-19 23:46:00,56,87,Vestuário,8,143
27348,2024-01-19 23:47:00,119,23,Alimento,7,142
27349,2024-01-19 23:48:00,41,141,Alimento,8,182
27350,2024-01-19 23:49:00,114,59,Alimento,6,173
27351,2024-01-19 23:50:00,70,46,Móvel,9,116
27352,2024-01-19 23:51:00,37,93,Alimento,1,130
27353,2024-01-19 23:52:00,106,85,Alimento,9,191
27354,2024-01-19 23:53:00,107,21,Alimento,5,128
27355,2024-01-19 23:54:00,49,173,Brinquedo,9,222
27356,2024-01-19 23:55:00,24,52,Vestuário,4,76
27357,2024-01-19 23:56:00,44,79,Móvel,5,123
27358,2024-01-19 23:57:00,83,176,Alimento,9,259
27359,2024-01-19 23:58:00,36,42,Alimento,4,78
27360,2024-01-19 23:59:00,38,50,Eletrônico,5,88
27361,2024-01-20 00:00:00,93,52,Móvel,4,145
27362,2024-01-20 00:01:00,25,92,Móvel,3,117
27363,2024-01-20 00:02:00,30,174,Móvel,8,204
27364,2024-01-20 00:03:00,74,80,Brinquedo,8,154
27365,2024-01-20 00:04:00,18,88,Móvel,6,106
27366,2024-01-20 00:05:00,69,19,Eletrônico,8,88
27367,2024-01-20 00:06:00,98,31,Alimento,9,129
27368,2024-01-20 00:07:00,88,64,Alimento,2,152
27369,2024-01-20 00:08:00,50,89,Brinquedo,4,139
27370,2024-01-20 00:09:00,62,151,Vestuário,1,213
27371,2024-01-20 00:10:00,20,45,Alimento,3,65
27372,2024-01-20 00:11:00,112,46,Eletrônico,1,158
27373,2024-01-20 00:12:00,115,20,Vestuário,7,135
27374,2024-01-20 00:13:00,94,21,Brinquedo,9,115
27375,2024-01-20 00:14:00,13,45,Vestuário,6,58
27376,2024-01-20 00:15:00,52,153,Vestuário,4,205
27377,2024-01-20 00:16:00,116,133,Brinquedo,9,249
27378,2024-01-20 00:17:00,19,145,Eletrônico,5,164
27379,2024-01-20 00:18:00,92,22,Alimento,6,114
27380,2024-01-20 00:19:00,98,76,Vestuário,2,174
27381,2024-01-20 00:20:00,20,24,Brinquedo,9,44
27382,2024-01-20 00:21:00,56,141,Vestuário,5,197
27383,2024-01-20 00:22:00,27,74,Móvel,3,101
27384,2024-01-20 00:23:00,30,63,Alimento,4,93
27385,2024-01-20 00:24:00,26,156,Vestuário,4,182
27386,2024-01-20 00:25:00,27,176,Móvel,5,203
27387,2024-01-20 00:26:00,77,94,Brinquedo,3,171
27388,2024-01-20 00:27:00,109,136,Alimento,1,245
27389,2024-01-20 00:28:00,75,170,Alimento,5,245
27390,2024-01-20 00:29:00,50,175,Brinquedo,4,225
27391,2024-01-20 00:30:00,42,43,Eletrônico,5,85
27392,2024-01-20 00:31:00,108,100,Vestuário,2,208
27393,2024-01-20 00:32:00,36,68,Eletrônico,4,104
27394,2024-01-20 00:33:00,87,88,Móvel,4,175
27395,2024-01-20 00:34:00,24,142,Eletrônico,3,166
27396,2024-01-20 00:35:00,62,91,Eletrônico,5,153
27397,2024-01-20 00:36:00,98,30,Vestuário,7,128
27398,2024-01-20 00:37:00,96,33,Eletrônico,5,129
27399,2024-01-20 00:38:00,93,172,Móvel,7,265
27400,2024-01-20 00:39:00,50,138,Alimento,9,188
27401,2024-01-20 00:40:00,67,118,Móvel,8,185
27402,2024-01-20 00:41:00,50,76,Alimento,3,126
27403,2024-01-20 00:42:00,94,158,Eletrônico,9,252
27404,2024-01-20 00:43:00,87,86,Móvel,5,173
27405,2024-01-20 00:44:00,46,87,Alimento,5,133
27406,2024-01-20 00:45:00,50,166,Vestuário,9,216
27407,2024-01-20 00:46:00,89,59,Móvel,2,148
27408,2024-01-20 00:47:00,98,121,Alimento,5,219
27409,2024-01-20 00:48:00,96,109,Móvel,7,205
27410,2024-01-20 00:49:00,43,81,Alimento,6,124
27411,2024-01-20 00:50:00,93,100,Móvel,9,193
27412,2024-01-20 00:51:00,112,144,Vestuário,4,256
27413,2024-01-20 00:52:00,86,73,Alimento,4,159
27414,2024-01-20 00:53:00,64,145,Alimento,7,209
27415,2024-01-20 00:54:00,95,153,Alimento,7,248
27416,2024-01-20 00:55:00,94,94,Eletrônico,5,188
27417,2024-01-20 00:56:00,83,119,Alimento,5,202
27418,2024-01-20 00:57:00,61,136,Vestuário,1,197
27419,2024-01-20 00:58:00,112,104,Alimento,3,216
27420,2024-01-20 00:59:00,41,48,Brinquedo,7,89
27421,2024-01-20 01:00:00,37,162,Vestuário,3,199
27422,2024-01-20 01:01:00,83,113,Móvel,7,196
27423,2024-01-20 01:02:00,22,87,Móvel,1,109
27424,2024-01-20 01:03:00,33,104,Brinquedo,2,137
27425,2024-01-20 01:04:00,49,65,Eletrônico,9,114
27426,2024-01-20 01:05:00,17,157,Alimento,6,174
27427,2024-01-20 01:06:00,44,63,Eletrônico,8,107
27428,2024-01-20 01:07:00,56,62,Móvel,1,118
27429,2024-01-20 01:08:00,43,141,Brinquedo,5,184
27430,2024-01-20 01:09:00,66,154,Móvel,9,220
27431,2024-01-20 01:10:00,44,77,Móvel,4,121
27432,2024-01-20 01:11:00,98,55,Eletrônico,1,153
27433,2024-01-20 01:12:00,82,63,Brinquedo,7,145
27434,2024-01-20 01:13:00,50,43,Brinquedo,4,93
27435,2024-01-20 01:14:00,99,71,Brinquedo,5,170
27436,2024-01-20 01:15:00,22,56,Alimento,2,78
27437,2024-01-20 01:16:00,91,160,Vestuário,9,251
27438,2024-01-20 01:17:00,52,157,Eletrônico,5,209
27439,2024-01-20 01:18:00,111,177,Eletrônico,2,288
27440,2024-01-20 01:19:00,105,65,Móvel,7,170
27441,2024-01-20 01:20:00,36,77,Eletrônico,7,113
27442,2024-01-20 01:21:00,110,31,Móvel,1,141
27443,2024-01-20 01:22:00,59,153,Vestuário,5,212
27444,2024-01-20 01:23:00,67,156,Móvel,9,223
27445,2024-01-20 01:24:00,114,118,Alimento,7,232
27446,2024-01-20 01:25:00,95,93,Brinquedo,6,188
27447,2024-01-20 01:26:00,38,112,Móvel,3,150
27448,2024-01-20 01:27:00,78,136,Brinquedo,1,214
27449,2024-01-20 01:28:00,113,17,Móvel,7,130
27450,2024-01-20 01:29:00,88,68,Brinquedo,8,156
27451,2024-01-20 01:30:00,60,22,Vestuário,7,82
27452,2024-01-20 01:31:00,69,100,Eletrônico,7,169
27453,2024-01-20 01:32:00,96,54,Alimento,1,150
27454,2024-01-20 01:33:00,117,33,Móvel,3,150
27455,2024-01-20 01:34:00,19,177,Vestuário,7,196
27456,2024-01-20 01:35:00,109,173,Alimento,5,282
27457,2024-01-20 01:36:00,112,42,Brinquedo,9,154
27458,2024-01-20 01:37:00,18,93,Alimento,5,111
27459,2024-01-20 01:38:00,86,172,Eletrônico,6,258
27460,2024-01-20 01:39:00,119,27,Vestuário,6,146
27461,2024-01-20 01:40:00,21,102,Móvel,7,123
27462,2024-01-20 01:41:00,64,131,Alimento,4,195
27463,2024-01-20 01:42:00,87,111,Móvel,5,198
27464,2024-01-20 01:43:00,71,16,Eletrônico,6,87
27465,2024-01-20 01:44:00,66,106,Móvel,4,172
27466,2024-01-20 01:45:00,111,119,Alimento,7,230
27467,2024-01-20 01:46:00,62,49,Móvel,1,111
27468,2024-01-20 01:47:00,119,74,Vestuário,4,193
27469,2024-01-20 01:48:00,26,27,Vestuário,8,53
27470,2024-01-20 01:49:00,81,123,Vestuário,2,204
27471,2024-01-20 01:50:00,113,96,Alimento,3,209
27472,2024-01-20 01:51:00,106,42,Eletrônico,6,148
27473,2024-01-20 01:52:00,59,129,Brinquedo,1,188
27474,2024-01-20 01:53:00,111,138,Vestuário,3,249
27475,2024-01-20 01:54:00,27,66,Brinquedo,9,93
27476,2024-01-20 01:55:00,110,145,Eletrônico,4,255
27477,2024-01-20 01:56:00,93,146,Eletrônico,4,239
27478,2024-01-20 01:57:00,60,34,Móvel,8,94
27479,2024-01-20 01:58:00,58,84,Vestuário,4,142
27480,2024-01-20 01:59:00,24,167,Brinquedo,5,191
27481,2024-01-20 02:00:00,80,46,Eletrônico,9,126
27482,2024-01-20 02:01:00,75,26,Eletrônico,4,101
27483,2024-01-20 02:02:00,66,36,Vestuário,9,102
27484,2024-01-20 02:03:00,96,64,Móvel,1,160
27485,2024-01-20 02:04:00,106,49,Vestuário,3,155
27486,2024-01-20 02:05:00,90,128,Móvel,3,218
27487,2024-01-20 02:06:00,77,11,Móvel,9,88
27488,2024-01-20 02:07:00,97,126,Alimento,8,223
27489,2024-01-20 02:08:00,33,56,Brinquedo,1,89
27490,2024-01-20 02:09:00,71,172,Alimento,2,243
27491,2024-01-20 02:10:00,101,175,Móvel,8,276
27492,2024-01-20 02:11:00,33,35,Vestuário,1,68
27493,2024-01-20 02:12:00,72,105,Vestuário,1,177
27494,2024-01-20 02:13:00,28,144,Brinquedo,6,172
27495,2024-01-20 02:14:00,11,100,Alimento,8,111
27496,2024-01-20 02:15:00,17,104,Vestuário,2,121
27497,2024-01-20 02:16:00,97,98,Eletrônico,3,195
27498,2024-01-20 02:17:00,59,76,Eletrônico,9,135
27499,2024-01-20 02:18:00,65,165,Móvel,2,230
27500,2024-01-20 02:19:00,33,138,Vestuário,2,171
27501,2024-01-20 02:20:00,36,71,Alimento,4,107
27502,2024-01-20 02:21:00,93,123,Móvel,3,216
27503,2024-01-20 02:22:00,58,20,Alimento,9,78
27504,2024-01-20 02:23:00,96,73,Alimento,3,169
27505,2024-01-20 02:24:00,36,28,Brinquedo,1,64
27506,2024-01-20 02:25:00,110,126,Móvel,6,236
27507,2024-01-20 02:26:00,17,70,Vestuário,1,87
27508,2024-01-20 02:27:00,25,137,Móvel,9,162
27509,2024-01-20 02:28:00,64,78,Brinquedo,4,142
27510,2024-01-20 02:29:00,98,15,Vestuário,4,113
27511,2024-01-20 02:30:00,108,41,Eletrônico,3,149
27512,2024-01-20 02:31:00,20,85,Alimento,7,105
27513,2024-01-20 02:32:00,119,137,Brinquedo,8,256
27514,2024-01-20 02:33:00,70,126,Alimento,9,196
27515,2024-01-20 02:34:00,115,115,Eletrônico,9,230
27516,2024-01-20 02:35:00,28,144,Vestuário,3,172
27517,2024-01-20 02:36:00,95,134,Brinquedo,2,229
27518,2024-01-20 02:37:00,84,82,Eletrônico,1,166
27519,2024-01-20 02:38:00,76,158,Brinquedo,1,234
27520,2024-01-20 02:39:00,67,168,Vestuário,6,235
27521,2024-01-20 02:40:00,23,108,Alimento,5,131
27522,2024-01-20 02:41:00,37,103,Brinquedo,8,140
27523,2024-01-20 02:42:00,13,71,Vestuário,8,84
27524,2024-01-20 02:43:00,119,61,Móvel,3,180
27525,2024-01-20 02:44:00,112,165,Alimento,2,277
27526,2024-01-20 02:45:00,21,39,Móvel,2,60
27527,2024-01-20 02:46:00,101,144,Alimento,7,245
27528,2024-01-20 02:47:00,99,41,Vestuário,7,140
27529,2024-01-20 02:48:00,70,94,Vestuário,2,164
27530,2024-01-20 02:49:00,22,15,Vestuário,2,37
27531,2024-01-20 02:50:00,70,97,Eletrônico,2,167
27532,2024-01-20 02:51:00,116,170,Móvel,2,286
27533,2024-01-20 02:52:00,10,29,Brinquedo,7,39
27534,2024-01-20 02:53:00,72,143,Eletrônico,3,215
27535,2024-01-20 02:54:00,106,153,Móvel,1,259
27536,2024-01-20 02:55:00,90,170,Móvel,8,260
27537,2024-01-20 02:56:00,34,120,Alimento,1,154
27538,2024-01-20 02:57:00,65,156,Móvel,2,221
27539,2024-01-20 02:58:00,39,121,Brinquedo,2,160
27540,2024-01-20 02:59:00,76,57,Brinquedo,8,133
27541,2024-01-20 03:00:00,63,157,Móvel,7,220
27542,2024-01-20 03:01:00,34,79,Vestuário,5,113
27543,2024-01-20 03:02:00,119,72,Brinquedo,3,191
27544,2024-01-20 03:03:00,93,73,Móvel,8,166
27545,2024-01-20 03:04:00,40,38,Brinquedo,7,78
27546,2024-01-20 03:05:00,107,77,Móvel,6,184
27547,2024-01-20 03:06:00,29,28,Alimento,1,57
27548,2024-01-20 03:07:00,60,115,Brinquedo,4,175
27549,2024-01-20 03:08:00,70,38,Alimento,8,108
27550,2024-01-20 03:09:00,103,101,Brinquedo,6,204
27551,2024-01-20 03:10:00,79,50,Vestuário,2,129
27552,2024-01-20 03:11:00,77,50,Móvel,6,127
27553,2024-01-20 03:12:00,68,138,Eletrônico,8,206
27554,2024-01-20 03:13:00,112,21,Brinquedo,1,133
27555,2024-01-20 03:14:00,21,152,Brinquedo,7,173
27556,2024-01-20 03:15:00,87,16,Móvel,2,103
27557,2024-01-20 03:16:00,115,75,Brinquedo,3,190
27558,2024-01-20 03:17:00,88,92,Alimento,7,180
27559,2024-01-20 03:18:00,14,154,Alimento,7,168
27560,2024-01-20 03:19:00,63,107,Móvel,8,170
27561,2024-01-20 03:20:00,111,102,Vestuário,6,213
27562,2024-01-20 03:21:00,86,149,Eletrônico,4,235
27563,2024-01-20 03:22:00,14,136,Brinquedo,9,150
27564,2024-01-20 03:23:00,65,131,Brinquedo,9,196
27565,2024-01-20 03:24:00,61,129,Alimento,9,190
27566,2024-01-20 03:25:00,37,88,Brinquedo,5,125
27567,2024-01-20 03:26:00,49,73,Alimento,1,122
27568,2024-01-20 03:27:00,97,19,Eletrônico,8,116
27569,2024-01-20 03:28:00,116,12,Móvel,9,128
27570,2024-01-20 03:29:00,41,167,Eletrônico,2,208
27571,2024-01-20 03:30:00,33,154,Eletrônico,1,187
27572,2024-01-20 03:31:00,48,76,Vestuário,4,124
27573,2024-01-20 03:32:00,51,133,Móvel,5,184
27574,2024-01-20 03:33:00,68,28,Móvel,4,96
27575,2024-01-20 03:34:00,65,109,Móvel,6,174
27576,2024-01-20 03:35:00,98,138,Eletrônico,3,236
27577,2024-01-20 03:36:00,19,152,Eletrônico,2,171
27578,2024-01-20 03:37:00,55,39,Eletrônico,6,94
27579,2024-01-20 03:38:00,67,44,Alimento,8,111
27580,2024-01-20 03:39:00,85,145,Brinquedo,4,230
27581,2024-01-20 03:40:00,117,152,Vestuário,4,269
27582,2024-01-20 03:41:00,28,143,Alimento,2,171
27583,2024-01-20 03:42:00,22,65,Alimento,7,87
27584,2024-01-20 03:43:00,110,33,Eletrônico,9,143
27585,2024-01-20 03:44:00,94,63,Móvel,3,157
27586,2024-01-20 03:45:00,79,100,Brinquedo,1,179
27587,2024-01-20 03:46:00,70,102,Vestuário,7,172
27588,2024-01-20 03:47:00,10,25,Móvel,2,35
27589,2024-01-20 03:48:00,86,27,Alimento,9,113
27590,2024-01-20 03:49:00,57,26,Eletrônico,4,83
27591,2024-01-20 03:50:00,51,137,Brinquedo,6,188
27592,2024-01-20 03:51:00,13,155,Móvel,2,168
27593,2024-01-20 03:52:00,19,47,Brinquedo,4,66
27594,2024-01-20 03:53:00,40,34,Brinquedo,2,74
27595,2024-01-20 03:54:00,39,126,Móvel,9,165
27596,2024-01-20 03:55:00,32,143,Móvel,8,175
27597,2024-01-20 03:56:00,67,21,Móvel,3,88
27598,2024-01-20 03:57:00,68,128,Móvel,8,196
27599,2024-01-20 03:58:00,60,71,Alimento,1,131
27600,2024-01-20 03:59:00,77,70,Brinquedo,5,147
27601,2024-01-20 04:00:00,12,133,Eletrônico,7,145
27602,2024-01-20 04:01:00,95,41,Vestuário,5,136
27603,2024-01-20 04:02:00,115,176,Vestuário,7,291
27604,2024-01-20 04:03:00,64,101,Móvel,7,165
27605,2024-01-20 04:04:00,95,154,Brinquedo,3,249
27606,2024-01-20 04:05:00,79,136,Eletrônico,8,215
27607,2024-01-20 04:06:00,48,101,Eletrônico,9,149
27608,2024-01-20 04:07:00,102,23,Eletrônico,8,125
27609,2024-01-20 04:08:00,68,71,Vestuário,2,139
27610,2024-01-20 04:09:00,64,156,Vestuário,7,220
27611,2024-01-20 04:10:00,82,42,Vestuário,6,124
27612,2024-01-20 04:11:00,29,92,Eletrônico,5,121
27613,2024-01-20 04:12:00,21,124,Vestuário,8,145
27614,2024-01-20 04:13:00,18,129,Eletrônico,7,147
27615,2024-01-20 04:14:00,78,56,Eletrônico,9,134
27616,2024-01-20 04:15:00,45,139,Vestuário,1,184
27617,2024-01-20 04:16:00,15,15,Alimento,8,30
27618,2024-01-20 04:17:00,113,153,Alimento,4,266
27619,2024-01-20 04:18:00,76,41,Móvel,9,117
27620,2024-01-20 04:19:00,71,10,Móvel,1,81
27621,2024-01-20 04:20:00,38,68,Brinquedo,4,106
27622,2024-01-20 04:21:00,58,129,Vestuário,7,187
27623,2024-01-20 04:22:00,33,99,Brinquedo,3,132
27624,2024-01-20 04:23:00,21,14,Móvel,7,35
27625,2024-01-20 04:24:00,45,98,Vestuário,5,143
27626,2024-01-20 04:25:00,96,99,Alimento,8,195
27627,2024-01-20 04:26:00,115,34,Móvel,6,149
27628,2024-01-20 04:27:00,37,23,Alimento,6,60
27629,2024-01-20 04:28:00,11,53,Móvel,9,64
27630,2024-01-20 04:29:00,107,45,Vestuário,5,152
27631,2024-01-20 04:30:00,21,17,Móvel,9,38
27632,2024-01-20 04:31:00,80,92,Brinquedo,9,172
27633,2024-01-20 04:32:00,12,143,Móvel,6,155
27634,2024-01-20 04:33:00,58,43,Alimento,3,101
27635,2024-01-20 04:34:00,66,71,Móvel,5,137
27636,2024-01-20 04:35:00,44,86,Brinquedo,2,130
27637,2024-01-20 04:36:00,100,55,Eletrônico,3,155
27638,2024-01-20 04:37:00,47,99,Brinquedo,8,146
27639,2024-01-20 04:38:00,45,133,Eletrônico,9,178
27640,2024-01-20 04:39:00,112,64,Móvel,4,176
27641,2024-01-20 04:40:00,13,145,Vestuário,8,158
27642,2024-01-20 04:41:00,83,58,Eletrônico,2,141
27643,2024-01-20 04:42:00,112,86,Brinquedo,4,198
27644,2024-01-20 04:43:00,53,71,Eletrônico,2,124
27645,2024-01-20 04:44:00,117,38,Vestuário,2,155
27646,2024-01-20 04:45:00,100,14,Vestuário,2,114
27647,2024-01-20 04:46:00,54,95,Eletrônico,2,149
27648,2024-01-20 04:47:00,82,66,Brinquedo,6,148
27649,2024-01-20 04:48:00,78,41,Vestuário,4,119
27650,2024-01-20 04:49:00,15,38,Eletrônico,2,53
27651,2024-01-20 04:50:00,89,102,Móvel,4,191
27652,2024-01-20 04:51:00,68,87,Móvel,6,155
27653,2024-01-20 04:52:00,72,164,Alimento,3,236
27654,2024-01-20 04:53:00,111,14,Móvel,2,125
27655,2024-01-20 04:54:00,43,32,Eletrônico,9,75
27656,2024-01-20 04:55:00,72,89,Brinquedo,3,161
27657,2024-01-20 04:56:00,107,23,Móvel,7,130
27658,2024-01-20 04:57:00,64,137,Eletrônico,7,201
27659,2024-01-20 04:58:00,17,174,Alimento,7,191
27660,2024-01-20 04:59:00,97,36,Vestuário,5,133
27661,2024-01-20 05:00:00,73,160,Brinquedo,4,233
27662,2024-01-20 05:01:00,81,86,Móvel,7,167
27663,2024-01-20 05:02:00,108,12,Móvel,9,120
27664,2024-01-20 05:03:00,97,152,Eletrônico,1,249
27665,2024-01-20 05:04:00,18,27,Alimento,9,45
27666,2024-01-20 05:05:00,74,95,Eletrônico,5,169
27667,2024-01-20 05:06:00,22,11,Brinquedo,6,33
27668,2024-01-20 05:07:00,73,105,Brinquedo,7,178
27669,2024-01-20 05:08:00,42,103,Alimento,1,145
27670,2024-01-20 05:09:00,16,17,Brinquedo,5,33
27671,2024-01-20 05:10:00,75,138,Brinquedo,9,213
27672,2024-01-20 05:11:00,103,93,Eletrônico,2,196
27673,2024-01-20 05:12:00,85,105,Eletrônico,2,190
27674,2024-01-20 05:13:00,108,141,Móvel,9,249
27675,2024-01-20 05:14:00,52,134,Vestuário,9,186
27676,2024-01-20 05:15:00,67,177,Alimento,2,244
27677,2024-01-20 05:16:00,13,102,Eletrônico,6,115
27678,2024-01-20 05:17:00,119,45,Vestuário,2,164
27679,2024-01-20 05:18:00,52,176,Eletrônico,9,228
27680,2024-01-20 05:19:00,27,30,Móvel,8,57
27681,2024-01-20 05:20:00,88,128,Vestuário,9,216
27682,2024-01-20 05:21:00,51,169,Vestuário,4,220
27683,2024-01-20 05:22:00,99,130,Móvel,5,229
27684,2024-01-20 05:23:00,100,155,Eletrônico,9,255
27685,2024-01-20 05:24:00,44,70,Móvel,7,114
27686,2024-01-20 05:25:00,50,46,Vestuário,3,96
27687,2024-01-20 05:26:00,57,163,Brinquedo,8,220
27688,2024-01-20 05:27:00,10,161,Brinquedo,6,171
27689,2024-01-20 05:28:00,80,19,Brinquedo,7,99
27690,2024-01-20 05:29:00,100,33,Móvel,4,133
27691,2024-01-20 05:30:00,47,156,Móvel,2,203
27692,2024-01-20 05:31:00,45,133,Vestuário,1,178
27693,2024-01-20 05:32:00,70,120,Móvel,5,190
27694,2024-01-20 05:33:00,46,99,Brinquedo,6,145
27695,2024-01-20 05:34:00,108,33,Vestuário,2,141
27696,2024-01-20 05:35:00,35,75,Alimento,5,110
27697,2024-01-20 05:36:00,28,79,Alimento,8,107
27698,2024-01-20 05:37:00,102,147,Brinquedo,2,249
27699,2024-01-20 05:38:00,33,10,Vestuário,6,43
27700,2024-01-20 05:39:00,64,173,Móvel,7,237
27701,2024-01-20 05:40:00,112,119,Vestuário,7,231
27702,2024-01-20 05:41:00,77,75,Brinquedo,5,152
27703,2024-01-20 05:42:00,109,25,Brinquedo,6,134
27704,2024-01-20 05:43:00,21,41,Móvel,2,62
27705,2024-01-20 05:44:00,56,92,Brinquedo,3,148
27706,2024-01-20 05:45:00,61,29,Móvel,2,90
27707,2024-01-20 05:46:00,102,15,Eletrônico,6,117
27708,2024-01-20 05:47:00,94,98,Brinquedo,2,192
27709,2024-01-20 05:48:00,56,42,Móvel,2,98
27710,2024-01-20 05:49:00,17,58,Alimento,1,75
27711,2024-01-20 05:50:00,15,171,Alimento,1,186
27712,2024-01-20 05:51:00,113,138,Eletrônico,5,251
27713,2024-01-20 05:52:00,13,65,Brinquedo,3,78
27714,2024-01-20 05:53:00,72,25,Brinquedo,2,97
27715,2024-01-20 05:54:00,60,62,Móvel,1,122
27716,2024-01-20 05:55:00,31,71,Eletrônico,9,102
27717,2024-01-20 05:56:00,59,25,Alimento,5,84
27718,2024-01-20 05:57:00,94,80,Alimento,3,174
27719,2024-01-20 05:58:00,44,57,Vestuário,1,101
27720,2024-01-20 05:59:00,16,48,Vestuário,4,64
27721,2024-01-20 06:00:00,84,81,Brinquedo,4,165
27722,2024-01-20 06:01:00,117,51,Brinquedo,9,168
27723,2024-01-20 06:02:00,38,84,Alimento,8,122
27724,2024-01-20 06:03:00,31,45,Alimento,2,76
27725,2024-01-20 06:04:00,71,137,Móvel,9,208
27726,2024-01-20 06:05:00,16,51,Vestuário,7,67
27727,2024-01-20 06:06:00,27,36,Alimento,5,63
27728,2024-01-20 06:07:00,45,153,Vestuário,6,198
27729,2024-01-20 06:08:00,37,57,Brinquedo,4,94
27730,2024-01-20 06:09:00,75,17,Alimento,3,92
27731,2024-01-20 06:10:00,11,151,Móvel,6,162
27732,2024-01-20 06:11:00,96,105,Vestuário,7,201
27733,2024-01-20 06:12:00,92,109,Alimento,3,201
27734,2024-01-20 06:13:00,11,56,Brinquedo,2,67
27735,2024-01-20 06:14:00,39,64,Alimento,1,103
27736,2024-01-20 06:15:00,108,104,Brinquedo,6,212
27737,2024-01-20 06:16:00,70,41,Brinquedo,4,111
27738,2024-01-20 06:17:00,71,102,Brinquedo,9,173
27739,2024-01-20 06:18:00,103,11,Brinquedo,8,114
27740,2024-01-20 06:19:00,119,114,Brinquedo,7,233
27741,2024-01-20 06:20:00,32,81,Alimento,7,113
27742,2024-01-20 06:21:00,99,135,Eletrônico,3,234
27743,2024-01-20 06:22:00,11,14,Móvel,8,25
27744,2024-01-20 06:23:00,31,10,Vestuário,9,41
27745,2024-01-20 06:24:00,19,141,Vestuário,3,160
27746,2024-01-20 06:25:00,65,171,Vestuário,5,236
27747,2024-01-20 06:26:00,45,47,Eletrônico,1,92
27748,2024-01-20 06:27:00,51,89,Vestuário,5,140
27749,2024-01-20 06:28:00,76,103,Móvel,4,179
27750,2024-01-20 06:29:00,92,153,Eletrônico,7,245
27751,2024-01-20 06:30:00,82,75,Alimento,3,157
27752,2024-01-20 06:31:00,59,33,Alimento,8,92
27753,2024-01-20 06:32:00,64,151,Móvel,6,215
27754,2024-01-20 06:33:00,101,46,Eletrônico,9,147
27755,2024-01-20 06:34:00,112,35,Brinquedo,4,147
27756,2024-01-20 06:35:00,18,151,Vestuário,5,169
27757,2024-01-20 06:36:00,17,123,Vestuário,4,140
27758,2024-01-20 06:37:00,24,46,Móvel,7,70
27759,2024-01-20 06:38:00,61,90,Brinquedo,6,151
27760,2024-01-20 06:39:00,114,63,Vestuário,9,177
27761,2024-01-20 06:40:00,102,158,Brinquedo,5,260
27762,2024-01-20 06:41:00,16,15,Brinquedo,4,31
27763,2024-01-20 06:42:00,54,109,Vestuário,6,163
27764,2024-01-20 06:43:00,110,174,Vestuário,6,284
27765,2024-01-20 06:44:00,82,84,Móvel,1,166
27766,2024-01-20 06:45:00,17,69,Brinquedo,8,86
27767,2024-01-20 06:46:00,38,50,Vestuário,9,88
27768,2024-01-20 06:47:00,37,83,Brinquedo,2,120
27769,2024-01-20 06:48:00,73,159,Brinquedo,7,232
27770,2024-01-20 06:49:00,43,109,Vestuário,9,152
27771,2024-01-20 06:50:00,62,129,Vestuário,8,191
27772,2024-01-20 06:51:00,20,26,Alimento,7,46
27773,2024-01-20 06:52:00,113,155,Alimento,5,268
27774,2024-01-20 06:53:00,105,104,Vestuário,9,209
27775,2024-01-20 06:54:00,98,141,Vestuário,2,239
27776,2024-01-20 06:55:00,92,20,Vestuário,8,112
27777,2024-01-20 06:56:00,39,24,Vestuário,4,63
27778,2024-01-20 06:57:00,91,104,Alimento,8,195
27779,2024-01-20 06:58:00,84,58,Alimento,2,142
27780,2024-01-20 06:59:00,113,166,Eletrônico,7,279
27781,2024-01-20 07:00:00,38,13,Móvel,2,51
27782,2024-01-20 07:01:00,94,52,Alimento,3,146
27783,2024-01-20 07:02:00,98,140,Eletrônico,9,238
27784,2024-01-20 07:03:00,90,135,Vestuário,9,225
27785,2024-01-20 07:04:00,76,127,Móvel,4,203
27786,2024-01-20 07:05:00,45,160,Alimento,7,205
27787,2024-01-20 07:06:00,21,155,Vestuário,7,176
27788,2024-01-20 07:07:00,28,108,Alimento,1,136
27789,2024-01-20 07:08:00,38,23,Alimento,8,61
27790,2024-01-20 07:09:00,86,76,Vestuário,6,162
27791,2024-01-20 07:10:00,76,159,Vestuário,2,235
27792,2024-01-20 07:11:00,22,134,Brinquedo,6,156
27793,2024-01-20 07:12:00,101,153,Vestuário,5,254
27794,2024-01-20 07:13:00,89,40,Alimento,3,129
27795,2024-01-20 07:14:00,97,165,Alimento,6,262
27796,2024-01-20 07:15:00,105,128,Alimento,4,233
27797,2024-01-20 07:16:00,21,97,Brinquedo,6,118
27798,2024-01-20 07:17:00,89,141,Eletrônico,7,230
27799,2024-01-20 07:18:00,86,108,Alimento,4,194
27800,2024-01-20 07:19:00,111,148,Eletrônico,8,259
27801,2024-01-20 07:20:00,42,131,Eletrônico,5,173
27802,2024-01-20 07:21:00,30,129,Móvel,4,159
27803,2024-01-20 07:22:00,118,50,Vestuário,6,168
27804,2024-01-20 07:23:00,68,163,Móvel,2,231
27805,2024-01-20 07:24:00,63,160,Brinquedo,5,223
27806,2024-01-20 07:25:00,20,78,Brinquedo,4,98
27807,2024-01-20 07:26:00,75,151,Eletrônico,4,226
27808,2024-01-20 07:27:00,116,58,Brinquedo,2,174
27809,2024-01-20 07:28:00,99,72,Eletrônico,4,171
27810,2024-01-20 07:29:00,110,100,Eletrônico,6,210
27811,2024-01-20 07:30:00,106,76,Eletrônico,6,182
27812,2024-01-20 07:31:00,82,163,Eletrônico,6,245
27813,2024-01-20 07:32:00,83,30,Vestuário,4,113
27814,2024-01-20 07:33:00,43,137,Eletrônico,3,180
27815,2024-01-20 07:34:00,103,57,Móvel,4,160
27816,2024-01-20 07:35:00,108,154,Eletrônico,9,262
27817,2024-01-20 07:36:00,42,82,Alimento,2,124
27818,2024-01-20 07:37:00,42,109,Brinquedo,5,151
27819,2024-01-20 07:38:00,86,158,Vestuário,7,244
27820,2024-01-20 07:39:00,29,170,Móvel,9,199
27821,2024-01-20 07:40:00,69,62,Móvel,9,131
27822,2024-01-20 07:41:00,87,52,Brinquedo,9,139
27823,2024-01-20 07:42:00,29,40,Vestuário,6,69
27824,2024-01-20 07:43:00,88,34,Alimento,8,122
27825,2024-01-20 07:44:00,85,73,Vestuário,4,158
27826,2024-01-20 07:45:00,65,149,Vestuário,1,214
27827,2024-01-20 07:46:00,115,10,Vestuário,1,125
27828,2024-01-20 07:47:00,50,134,Brinquedo,5,184
27829,2024-01-20 07:48:00,70,81,Eletrônico,2,151
27830,2024-01-20 07:49:00,88,109,Móvel,9,197
27831,2024-01-20 07:50:00,72,121,Eletrônico,8,193
27832,2024-01-20 07:51:00,96,144,Alimento,5,240
27833,2024-01-20 07:52:00,66,71,Brinquedo,3,137
27834,2024-01-20 07:53:00,47,119,Vestuário,2,166
27835,2024-01-20 07:54:00,79,144,Brinquedo,7,223
27836,2024-01-20 07:55:00,78,86,Vestuário,7,164
27837,2024-01-20 07:56:00,109,41,Móvel,2,150
27838,2024-01-20 07:57:00,27,81,Eletrônico,1,108
27839,2024-01-20 07:58:00,64,26,Móvel,8,90
27840,2024-01-20 07:59:00,69,74,Alimento,2,143
27841,2024-01-20 08:00:00,71,28,Vestuário,7,99
27842,2024-01-20 08:01:00,29,19,Eletrônico,8,48
27843,2024-01-20 08:02:00,65,46,Alimento,4,111
27844,2024-01-20 08:03:00,74,93,Vestuário,6,167
27845,2024-01-20 08:04:00,112,123,Alimento,5,235
27846,2024-01-20 08:05:00,46,151,Alimento,6,197
27847,2024-01-20 08:06:00,18,43,Vestuário,8,61
27848,2024-01-20 08:07:00,110,146,Vestuário,5,256
27849,2024-01-20 08:08:00,109,51,Alimento,1,160
27850,2024-01-20 08:09:00,88,74,Brinquedo,9,162
27851,2024-01-20 08:10:00,73,21,Alimento,7,94
27852,2024-01-20 08:11:00,34,132,Eletrônico,7,166
27853,2024-01-20 08:12:00,97,87,Brinquedo,1,184
27854,2024-01-20 08:13:00,34,163,Eletrônico,7,197
27855,2024-01-20 08:14:00,54,78,Brinquedo,2,132
27856,2024-01-20 08:15:00,88,104,Eletrônico,8,192
27857,2024-01-20 08:16:00,81,13,Brinquedo,9,94
27858,2024-01-20 08:17:00,23,109,Brinquedo,8,132
27859,2024-01-20 08:18:00,116,57,Eletrônico,3,173
27860,2024-01-20 08:19:00,29,129,Alimento,9,158
27861,2024-01-20 08:20:00,34,139,Móvel,4,173
27862,2024-01-20 08:21:00,112,12,Móvel,6,124
27863,2024-01-20 08:22:00,81,158,Vestuário,9,239
27864,2024-01-20 08:23:00,72,106,Eletrônico,5,178
27865,2024-01-20 08:24:00,26,88,Vestuário,7,114
27866,2024-01-20 08:25:00,16,60,Vestuário,3,76
27867,2024-01-20 08:26:00,82,56,Alimento,1,138
27868,2024-01-20 08:27:00,35,174,Alimento,4,209
27869,2024-01-20 08:28:00,66,139,Brinquedo,2,205
27870,2024-01-20 08:29:00,77,35,Móvel,5,112
27871,2024-01-20 08:30:00,96,84,Brinquedo,1,180
27872,2024-01-20 08:31:00,117,167,Móvel,6,284
27873,2024-01-20 08:32:00,67,178,Vestuário,9,245
27874,2024-01-20 08:33:00,90,56,Eletrônico,7,146
27875,2024-01-20 08:34:00,26,74,Vestuário,3,100
27876,2024-01-20 08:35:00,113,135,Alimento,9,248
27877,2024-01-20 08:36:00,117,112,Eletrônico,8,229
27878,2024-01-20 08:37:00,43,74,Móvel,1,117
27879,2024-01-20 08:38:00,89,174,Móvel,8,263
27880,2024-01-20 08:39:00,71,32,Brinquedo,4,103
27881,2024-01-20 08:40:00,116,87,Brinquedo,4,203
27882,2024-01-20 08:41:00,17,62,Brinquedo,9,79
27883,2024-01-20 08:42:00,116,15,Brinquedo,3,131
27884,2024-01-20 08:43:00,110,84,Móvel,6,194
27885,2024-01-20 08:44:00,34,37,Eletrônico,7,71
27886,2024-01-20 08:45:00,25,47,Eletrônico,3,72
27887,2024-01-20 08:46:00,53,89,Vestuário,6,142
27888,2024-01-20 08:47:00,48,117,Vestuário,8,165
27889,2024-01-20 08:48:00,103,108,Móvel,9,211
27890,2024-01-20 08:49:00,12,14,Eletrônico,2,26
27891,2024-01-20 08:50:00,56,104,Brinquedo,1,160
27892,2024-01-20 08:51:00,84,106,Vestuário,4,190
27893,2024-01-20 08:52:00,82,47,Vestuário,7,129
27894,2024-01-20 08:53:00,61,129,Eletrônico,7,190
27895,2024-01-20 08:54:00,17,121,Eletrônico,4,138
27896,2024-01-20 08:55:00,117,90,Móvel,7,207
27897,2024-01-20 08:56:00,90,33,Brinquedo,6,123
27898,2024-01-20 08:57:00,43,79,Móvel,9,122
27899,2024-01-20 08:58:00,97,157,Alimento,1,254
27900,2024-01-20 08:59:00,25,34,Alimento,7,59
27901,2024-01-20 09:00:00,17,101,Móvel,8,118
27902,2024-01-20 09:01:00,35,179,Móvel,8,214
27903,2024-01-20 09:02:00,84,109,Vestuário,2,193
27904,2024-01-20 09:03:00,89,26,Móvel,1,115
27905,2024-01-20 09:04:00,81,104,Brinquedo,1,185
27906,2024-01-20 09:05:00,46,135,Alimento,9,181
27907,2024-01-20 09:06:00,103,26,Vestuário,4,129
27908,2024-01-20 09:07:00,114,86,Vestuário,2,200
27909,2024-01-20 09:08:00,31,165,Vestuário,5,196
27910,2024-01-20 09:09:00,99,145,Alimento,9,244
27911,2024-01-20 09:10:00,68,33,Vestuário,9,101
27912,2024-01-20 09:11:00,66,41,Vestuário,7,107
27913,2024-01-20 09:12:00,85,80,Vestuário,1,165
27914,2024-01-20 09:13:00,34,49,Eletrônico,6,83
27915,2024-01-20 09:14:00,102,174,Vestuário,8,276
27916,2024-01-20 09:15:00,94,108,Eletrônico,4,202
27917,2024-01-20 09:16:00,98,82,Eletrônico,2,180
27918,2024-01-20 09:17:00,98,94,Vestuário,5,192
27919,2024-01-20 09:18:00,73,155,Móvel,4,228
27920,2024-01-20 09:19:00,43,126,Alimento,7,169
27921,2024-01-20 09:20:00,74,110,Vestuário,8,184
27922,2024-01-20 09:21:00,82,108,Móvel,7,190
27923,2024-01-20 09:22:00,34,50,Eletrônico,3,84
27924,2024-01-20 09:23:00,85,65,Móvel,2,150
27925,2024-01-20 09:24:00,72,136,Eletrônico,9,208
27926,2024-01-20 09:25:00,110,45,Brinquedo,3,155
27927,2024-01-20 09:26:00,81,80,Alimento,4,161
27928,2024-01-20 09:27:00,119,160,Vestuário,1,279
27929,2024-01-20 09:28:00,66,76,Móvel,6,142
27930,2024-01-20 09:29:00,29,16,Vestuário,6,45
27931,2024-01-20 09:30:00,76,76,Móvel,4,152
27932,2024-01-20 09:31:00,111,134,Móvel,3,245
27933,2024-01-20 09:32:00,18,11,Móvel,2,29
27934,2024-01-20 09:33:00,37,58,Móvel,5,95
27935,2024-01-20 09:34:00,42,44,Vestuário,4,86
27936,2024-01-20 09:35:00,50,57,Brinquedo,9,107
27937,2024-01-20 09:36:00,47,17,Vestuário,5,64
27938,2024-01-20 09:37:00,70,173,Eletrônico,4,243
27939,2024-01-20 09:38:00,13,141,Eletrônico,3,154
27940,2024-01-20 09:39:00,53,26,Brinquedo,3,79
27941,2024-01-20 09:40:00,106,170,Alimento,4,276
27942,2024-01-20 09:41:00,33,101,Móvel,1,134
27943,2024-01-20 09:42:00,91,38,Eletrônico,9,129
27944,2024-01-20 09:43:00,91,99,Eletrônico,1,190
27945,2024-01-20 09:44:00,114,58,Vestuário,3,172
27946,2024-01-20 09:45:00,56,84,Brinquedo,1,140
27947,2024-01-20 09:46:00,56,158,Brinquedo,8,214
27948,2024-01-20 09:47:00,18,156,Brinquedo,8,174
27949,2024-01-20 09:48:00,26,71,Eletrônico,4,97
27950,2024-01-20 09:49:00,32,73,Alimento,4,105
27951,2024-01-20 09:50:00,45,15,Alimento,5,60
27952,2024-01-20 09:51:00,106,55,Alimento,7,161
27953,2024-01-20 09:52:00,99,75,Brinquedo,8,174
27954,2024-01-20 09:53:00,32,177,Alimento,4,209
27955,2024-01-20 09:54:00,54,158,Alimento,4,212
27956,2024-01-20 09:55:00,103,140,Alimento,4,243
27957,2024-01-20 09:56:00,31,32,Brinquedo,6,63
27958,2024-01-20 09:57:00,41,49,Eletrônico,9,90
27959,2024-01-20 09:58:00,33,82,Eletrônico,5,115
27960,2024-01-20 09:59:00,70,138,Eletrônico,6,208
27961,2024-01-20 10:00:00,45,107,Vestuário,2,152
27962,2024-01-20 10:01:00,35,159,Eletrônico,1,194
27963,2024-01-20 10:02:00,82,39,Alimento,2,121
27964,2024-01-20 10:03:00,119,127,Móvel,6,246
27965,2024-01-20 10:04:00,43,27,Alimento,2,70
27966,2024-01-20 10:05:00,101,116,Vestuário,9,217
27967,2024-01-20 10:06:00,108,76,Eletrônico,3,184
27968,2024-01-20 10:07:00,115,134,Vestuário,8,249
27969,2024-01-20 10:08:00,56,100,Móvel,7,156
27970,2024-01-20 10:09:00,22,35,Eletrônico,7,57
27971,2024-01-20 10:10:00,30,169,Alimento,6,199
27972,2024-01-20 10:11:00,71,160,Vestuário,9,231
27973,2024-01-20 10:12:00,98,152,Vestuário,4,250
27974,2024-01-20 10:13:00,100,58,Eletrônico,3,158
27975,2024-01-20 10:14:00,42,109,Brinquedo,7,151
27976,2024-01-20 10:15:00,22,169,Móvel,1,191
27977,2024-01-20 10:16:00,94,170,Móvel,1,264
27978,2024-01-20 10:17:00,99,99,Eletrônico,9,198
27979,2024-01-20 10:18:00,114,76,Eletrônico,9,190
27980,2024-01-20 10:19:00,86,62,Brinquedo,6,148
27981,2024-01-20 10:20:00,36,68,Eletrônico,7,104
27982,2024-01-20 10:21:00,116,11,Alimento,7,127
27983,2024-01-20 10:22:00,19,17,Alimento,1,36
27984,2024-01-20 10:23:00,107,135,Brinquedo,3,242
27985,2024-01-20 10:24:00,118,133,Brinquedo,4,251
27986,2024-01-20 10:25:00,77,175,Eletrônico,8,252
27987,2024-01-20 10:26:00,88,111,Vestuário,5,199
27988,2024-01-20 10:27:00,115,135,Alimento,5,250
27989,2024-01-20 10:28:00,50,66,Móvel,5,116
27990,2024-01-20 10:29:00,112,142,Móvel,6,254
27991,2024-01-20 10:30:00,51,172,Vestuário,5,223
27992,2024-01-20 10:31:00,88,172,Vestuário,7,260
27993,2024-01-20 10:32:00,98,159,Vestuário,7,257
27994,2024-01-20 10:33:00,64,74,Alimento,3,138
27995,2024-01-20 10:34:00,54,168,Eletrônico,4,222
27996,2024-01-20 10:35:00,28,39,Eletrônico,4,67
27997,2024-01-20 10:36:00,96,24,Móvel,1,120
27998,2024-01-20 10:37:00,44,31,Eletrônico,9,75
27999,2024-01-20 10:38:00,89,61,Vestuário,2,150
28000,2024-01-20 10:39:00,37,113,Eletrônico,1,150
28001,2024-01-20 10:40:00,73,105,Eletrônico,9,178
28002,2024-01-20 10:41:00,74,17,Vestuário,4,91
28003,2024-01-20 10:42:00,17,164,Vestuário,5,181
28004,2024-01-20 10:43:00,71,26,Móvel,8,97
28005,2024-01-20 10:44:00,65,133,Eletrônico,3,198
28006,2024-01-20 10:45:00,23,105,Vestuário,2,128
28007,2024-01-20 10:46:00,28,31,Móvel,1,59
28008,2024-01-20 10:47:00,29,166,Alimento,7,195
28009,2024-01-20 10:48:00,45,105,Eletrônico,6,150
28010,2024-01-20 10:49:00,94,85,Móvel,6,179
28011,2024-01-20 10:50:00,102,47,Eletrônico,1,149
28012,2024-01-20 10:51:00,74,80,Alimento,4,154
28013,2024-01-20 10:52:00,105,26,Brinquedo,4,131
28014,2024-01-20 10:53:00,106,46,Eletrônico,7,152
28015,2024-01-20 10:54:00,19,14,Eletrônico,8,33
28016,2024-01-20 10:55:00,104,118,Móvel,6,222
28017,2024-01-20 10:56:00,82,44,Brinquedo,7,126
28018,2024-01-20 10:57:00,107,36,Móvel,4,143
28019,2024-01-20 10:58:00,38,115,Eletrônico,6,153
28020,2024-01-20 10:59:00,56,27,Móvel,5,83
28021,2024-01-20 11:00:00,43,72,Móvel,1,115
28022,2024-01-20 11:01:00,111,69,Alimento,1,180
28023,2024-01-20 11:02:00,55,24,Eletrônico,7,79
28024,2024-01-20 11:03:00,62,110,Alimento,7,172
28025,2024-01-20 11:04:00,114,18,Alimento,7,132
28026,2024-01-20 11:05:00,41,84,Vestuário,8,125
28027,2024-01-20 11:06:00,64,122,Móvel,7,186
28028,2024-01-20 11:07:00,27,72,Eletrônico,5,99
28029,2024-01-20 11:08:00,33,24,Alimento,9,57
28030,2024-01-20 11:09:00,96,24,Eletrônico,2,120
28031,2024-01-20 11:10:00,20,41,Brinquedo,1,61
28032,2024-01-20 11:11:00,79,115,Vestuário,8,194
28033,2024-01-20 11:12:00,61,167,Alimento,9,228
28034,2024-01-20 11:13:00,92,16,Brinquedo,7,108
28035,2024-01-20 11:14:00,18,178,Eletrônico,4,196
28036,2024-01-20 11:15:00,48,107,Alimento,1,155
28037,2024-01-20 11:16:00,105,111,Eletrônico,9,216
28038,2024-01-20 11:17:00,32,144,Brinquedo,4,176
28039,2024-01-20 11:18:00,32,156,Eletrônico,3,188
28040,2024-01-20 11:19:00,33,81,Brinquedo,6,114
28041,2024-01-20 11:20:00,35,106,Móvel,3,141
28042,2024-01-20 11:21:00,78,133,Eletrônico,8,211
28043,2024-01-20 11:22:00,105,66,Vestuário,8,171
28044,2024-01-20 11:23:00,74,134,Vestuário,3,208
28045,2024-01-20 11:24:00,113,113,Brinquedo,5,226
28046,2024-01-20 11:25:00,57,160,Vestuário,2,217
28047,2024-01-20 11:26:00,111,37,Brinquedo,1,148
28048,2024-01-20 11:27:00,70,78,Brinquedo,2,148
28049,2024-01-20 11:28:00,84,83,Móvel,7,167
28050,2024-01-20 11:29:00,65,26,Vestuário,6,91
28051,2024-01-20 11:30:00,118,17,Eletrônico,4,135
28052,2024-01-20 11:31:00,58,167,Alimento,8,225
28053,2024-01-20 11:32:00,52,63,Alimento,3,115
28054,2024-01-20 11:33:00,58,95,Móvel,9,153
28055,2024-01-20 11:34:00,28,32,Eletrônico,3,60
28056,2024-01-20 11:35:00,86,168,Alimento,8,254
28057,2024-01-20 11:36:00,61,100,Brinquedo,9,161
28058,2024-01-20 11:37:00,74,12,Vestuário,5,86
28059,2024-01-20 11:38:00,57,27,Móvel,1,84
28060,2024-01-20 11:39:00,13,19,Alimento,1,32
28061,2024-01-20 11:40:00,62,131,Eletrônico,9,193
28062,2024-01-20 11:41:00,83,174,Vestuário,2,257
28063,2024-01-20 11:42:00,113,171,Vestuário,8,284
28064,2024-01-20 11:43:00,28,73,Eletrônico,3,101
28065,2024-01-20 11:44:00,41,20,Móvel,3,61
28066,2024-01-20 11:45:00,75,147,Alimento,5,222
28067,2024-01-20 11:46:00,26,80,Vestuário,8,106
28068,2024-01-20 11:47:00,66,24,Brinquedo,6,90
28069,2024-01-20 11:48:00,103,166,Alimento,5,269
28070,2024-01-20 11:49:00,11,17,Alimento,9,28
28071,2024-01-20 11:50:00,86,136,Móvel,8,222
28072,2024-01-20 11:51:00,19,120,Vestuário,2,139
28073,2024-01-20 11:52:00,53,115,Alimento,2,168
28074,2024-01-20 11:53:00,59,16,Vestuário,3,75
28075,2024-01-20 11:54:00,61,117,Móvel,3,178
28076,2024-01-20 11:55:00,32,37,Alimento,4,69
28077,2024-01-20 11:56:00,23,167,Vestuário,3,190
28078,2024-01-20 11:57:00,118,52,Alimento,9,170
28079,2024-01-20 11:58:00,97,87,Eletrônico,2,184
28080,2024-01-20 11:59:00,32,174,Móvel,4,206
28081,2024-01-20 12:00:00,50,103,Móvel,9,153
28082,2024-01-20 12:01:00,29,13,Brinquedo,9,42
28083,2024-01-20 12:02:00,102,29,Brinquedo,6,131
28084,2024-01-20 12:03:00,43,178,Alimento,2,221
28085,2024-01-20 12:04:00,96,141,Vestuário,4,237
28086,2024-01-20 12:05:00,14,141,Brinquedo,3,155
28087,2024-01-20 12:06:00,108,55,Eletrônico,8,163
28088,2024-01-20 12:07:00,117,93,Móvel,3,210
28089,2024-01-20 12:08:00,75,24,Eletrônico,4,99
28090,2024-01-20 12:09:00,73,151,Brinquedo,8,224
28091,2024-01-20 12:10:00,24,24,Brinquedo,4,48
28092,2024-01-20 12:11:00,16,43,Vestuário,3,59
28093,2024-01-20 12:12:00,46,169,Brinquedo,9,215
28094,2024-01-20 12:13:00,57,92,Eletrônico,9,149
28095,2024-01-20 12:14:00,65,93,Eletrônico,8,158
28096,2024-01-20 12:15:00,57,37,Móvel,1,94
28097,2024-01-20 12:16:00,103,14,Alimento,1,117
28098,2024-01-20 12:17:00,91,63,Alimento,4,154
28099,2024-01-20 12:18:00,40,157,Brinquedo,2,197
28100,2024-01-20 12:19:00,37,95,Eletrônico,6,132
28101,2024-01-20 12:20:00,102,49,Alimento,1,151
28102,2024-01-20 12:21:00,88,139,Eletrônico,4,227
28103,2024-01-20 12:22:00,16,71,Móvel,7,87
28104,2024-01-20 12:23:00,113,158,Brinquedo,2,271
28105,2024-01-20 12:24:00,32,45,Móvel,1,77
28106,2024-01-20 12:25:00,97,109,Alimento,1,206
28107,2024-01-20 12:26:00,18,160,Alimento,6,178
28108,2024-01-20 12:27:00,35,69,Eletrônico,9,104
28109,2024-01-20 12:28:00,31,53,Móvel,6,84
28110,2024-01-20 12:29:00,100,172,Alimento,6,272
28111,2024-01-20 12:30:00,66,55,Alimento,5,121
28112,2024-01-20 12:31:00,53,174,Alimento,3,227
28113,2024-01-20 12:32:00,98,159,Vestuário,1,257
28114,2024-01-20 12:33:00,21,121,Brinquedo,4,142
28115,2024-01-20 12:34:00,27,93,Vestuário,7,120
28116,2024-01-20 12:35:00,33,136,Vestuário,4,169
28117,2024-01-20 12:36:00,18,158,Vestuário,5,176
28118,2024-01-20 12:37:00,56,139,Brinquedo,3,195
28119,2024-01-20 12:38:00,49,86,Eletrônico,6,135
28120,2024-01-20 12:39:00,94,150,Brinquedo,7,244
28121,2024-01-20 12:40:00,42,102,Brinquedo,2,144
28122,2024-01-20 12:41:00,41,165,Eletrônico,9,206
28123,2024-01-20 12:42:00,39,104,Móvel,5,143
28124,2024-01-20 12:43:00,95,119,Vestuário,6,214
28125,2024-01-20 12:44:00,43,50,Vestuário,2,93
28126,2024-01-20 12:45:00,114,10,Vestuário,5,124
28127,2024-01-20 12:46:00,119,118,Móvel,4,237
28128,2024-01-20 12:47:00,31,138,Eletrônico,1,169
28129,2024-01-20 12:48:00,55,82,Vestuário,3,137
28130,2024-01-20 12:49:00,67,173,Alimento,4,240
28131,2024-01-20 12:50:00,45,97,Brinquedo,2,142
28132,2024-01-20 12:51:00,49,31,Eletrônico,7,80
28133,2024-01-20 12:52:00,57,148,Alimento,9,205
28134,2024-01-20 12:53:00,59,136,Vestuário,3,195
28135,2024-01-20 12:54:00,95,94,Brinquedo,3,189
28136,2024-01-20 12:55:00,114,88,Móvel,5,202
28137,2024-01-20 12:56:00,109,42,Móvel,6,151
28138,2024-01-20 12:57:00,90,152,Móvel,4,242
28139,2024-01-20 12:58:00,95,119,Alimento,1,214
28140,2024-01-20 12:59:00,116,51,Móvel,6,167
28141,2024-01-20 13:00:00,96,13,Alimento,5,109
28142,2024-01-20 13:01:00,18,10,Eletrônico,3,28
28143,2024-01-20 13:02:00,46,54,Vestuário,1,100
28144,2024-01-20 13:03:00,99,169,Brinquedo,5,268
28145,2024-01-20 13:04:00,28,152,Vestuário,4,180
28146,2024-01-20 13:05:00,34,13,Móvel,2,47
28147,2024-01-20 13:06:00,18,68,Vestuário,7,86
28148,2024-01-20 13:07:00,27,21,Eletrônico,6,48
28149,2024-01-20 13:08:00,25,88,Eletrônico,7,113
28150,2024-01-20 13:09:00,119,166,Alimento,3,285
28151,2024-01-20 13:10:00,108,115,Vestuário,6,223
28152,2024-01-20 13:11:00,41,68,Móvel,8,109
28153,2024-01-20 13:12:00,42,123,Eletrônico,7,165
28154,2024-01-20 13:13:00,25,88,Alimento,2,113
28155,2024-01-20 13:14:00,102,55,Móvel,7,157
28156,2024-01-20 13:15:00,84,162,Móvel,4,246
28157,2024-01-20 13:16:00,73,82,Brinquedo,1,155
28158,2024-01-20 13:17:00,35,153,Vestuário,7,188
28159,2024-01-20 13:18:00,23,170,Brinquedo,4,193
28160,2024-01-20 13:19:00,17,112,Móvel,5,129
28161,2024-01-20 13:20:00,94,46,Vestuário,3,140
28162,2024-01-20 13:21:00,51,163,Eletrônico,8,214
28163,2024-01-20 13:22:00,113,174,Eletrônico,3,287
28164,2024-01-20 13:23:00,59,33,Alimento,1,92
28165,2024-01-20 13:24:00,21,53,Eletrônico,2,74
28166,2024-01-20 13:25:00,30,150,Vestuário,3,180
28167,2024-01-20 13:26:00,70,124,Móvel,3,194
28168,2024-01-20 13:27:00,78,108,Móvel,1,186
28169,2024-01-20 13:28:00,41,132,Brinquedo,3,173
28170,2024-01-20 13:29:00,27,65,Brinquedo,7,92
28171,2024-01-20 13:30:00,79,90,Eletrônico,2,169
28172,2024-01-20 13:31:00,110,143,Vestuário,9,253
28173,2024-01-20 13:32:00,108,132,Vestuário,3,240
28174,2024-01-20 13:33:00,107,68,Móvel,8,175
28175,2024-01-20 13:34:00,11,173,Brinquedo,8,184
28176,2024-01-20 13:35:00,54,73,Vestuário,3,127
28177,2024-01-20 13:36:00,22,12,Vestuário,3,34
28178,2024-01-20 13:37:00,101,15,Alimento,3,116
28179,2024-01-20 13:38:00,93,164,Móvel,8,257
28180,2024-01-20 13:39:00,93,44,Brinquedo,4,137
28181,2024-01-20 13:40:00,77,168,Móvel,6,245
28182,2024-01-20 13:41:00,39,94,Alimento,1,133
28183,2024-01-20 13:42:00,103,169,Alimento,9,272
28184,2024-01-20 13:43:00,26,25,Brinquedo,2,51
28185,2024-01-20 13:44:00,74,124,Brinquedo,8,198
28186,2024-01-20 13:45:00,56,135,Eletrônico,4,191
28187,2024-01-20 13:46:00,101,13,Alimento,2,114
28188,2024-01-20 13:47:00,60,176,Brinquedo,2,236
28189,2024-01-20 13:48:00,99,38,Brinquedo,2,137
28190,2024-01-20 13:49:00,97,147,Móvel,2,244
28191,2024-01-20 13:50:00,63,171,Brinquedo,1,234
28192,2024-01-20 13:51:00,62,153,Móvel,5,215
28193,2024-01-20 13:52:00,32,15,Brinquedo,8,47
28194,2024-01-20 13:53:00,108,39,Eletrônico,5,147
28195,2024-01-20 13:54:00,80,12,Vestuário,1,92
28196,2024-01-20 13:55:00,64,102,Brinquedo,2,166
28197,2024-01-20 13:56:00,34,37,Eletrônico,5,71
28198,2024-01-20 13:57:00,61,10,Móvel,1,71
28199,2024-01-20 13:58:00,88,62,Eletrônico,2,150
28200,2024-01-20 13:59:00,112,139,Móvel,7,251
28201,2024-01-20 14:00:00,77,151,Eletrônico,3,228
28202,2024-01-20 14:01:00,107,129,Vestuário,2,236
28203,2024-01-20 14:02:00,49,145,Vestuário,2,194
28204,2024-01-20 14:03:00,94,157,Vestuário,7,251
28205,2024-01-20 14:04:00,14,130,Móvel,7,144
28206,2024-01-20 14:05:00,60,104,Brinquedo,4,164
28207,2024-01-20 14:06:00,42,162,Eletrônico,6,204
28208,2024-01-20 14:07:00,99,144,Eletrônico,8,243
28209,2024-01-20 14:08:00,34,45,Alimento,5,79
28210,2024-01-20 14:09:00,18,120,Eletrônico,9,138
28211,2024-01-20 14:10:00,38,67,Eletrônico,6,105
28212,2024-01-20 14:11:00,105,16,Brinquedo,4,121
28213,2024-01-20 14:12:00,37,179,Eletrônico,8,216
28214,2024-01-20 14:13:00,77,71,Brinquedo,3,148
28215,2024-01-20 14:14:00,77,165,Vestuário,1,242
28216,2024-01-20 14:15:00,99,126,Brinquedo,9,225
28217,2024-01-20 14:16:00,72,64,Eletrônico,3,136
28218,2024-01-20 14:17:00,20,85,Vestuário,6,105
28219,2024-01-20 14:18:00,38,134,Alimento,4,172
28220,2024-01-20 14:19:00,66,136,Eletrônico,6,202
28221,2024-01-20 14:20:00,80,84,Móvel,6,164
28222,2024-01-20 14:21:00,87,155,Brinquedo,5,242
28223,2024-01-20 14:22:00,22,52,Móvel,8,74
28224,2024-01-20 14:23:00,14,172,Alimento,8,186
28225,2024-01-20 14:24:00,39,48,Vestuário,8,87
28226,2024-01-20 14:25:00,62,138,Vestuário,7,200
28227,2024-01-20 14:26:00,108,75,Eletrônico,5,183
28228,2024-01-20 14:27:00,76,14,Brinquedo,7,90
28229,2024-01-20 14:28:00,83,96,Vestuário,7,179
28230,2024-01-20 14:29:00,18,81,Brinquedo,7,99
28231,2024-01-20 14:30:00,31,113,Brinquedo,2,144
28232,2024-01-20 14:31:00,76,97,Brinquedo,9,173
28233,2024-01-20 14:32:00,23,43,Eletrônico,9,66
28234,2024-01-20 14:33:00,77,34,Brinquedo,7,111
28235,2024-01-20 14:34:00,119,103,Brinquedo,2,222
28236,2024-01-20 14:35:00,95,53,Eletrônico,1,148
28237,2024-01-20 14:36:00,100,31,Móvel,1,131
28238,2024-01-20 14:37:00,51,161,Vestuário,9,212
28239,2024-01-20 14:38:00,42,159,Eletrônico,5,201
28240,2024-01-20 14:39:00,35,115,Brinquedo,3,150
28241,2024-01-20 14:40:00,93,163,Alimento,6,256
28242,2024-01-20 14:41:00,80,168,Eletrônico,9,248
28243,2024-01-20 14:42:00,50,124,Vestuário,7,174
28244,2024-01-20 14:43:00,29,23,Móvel,2,52
28245,2024-01-20 14:44:00,37,39,Alimento,5,76
28246,2024-01-20 14:45:00,38,145,Vestuário,9,183
28247,2024-01-20 14:46:00,85,12,Eletrônico,5,97
28248,2024-01-20 14:47:00,96,19,Móvel,9,115
28249,2024-01-20 14:48:00,85,169,Eletrônico,2,254
28250,2024-01-20 14:49:00,71,117,Vestuário,9,188
28251,2024-01-20 14:50:00,68,87,Móvel,1,155
28252,2024-01-20 14:51:00,106,149,Alimento,8,255
28253,2024-01-20 14:52:00,24,170,Eletrônico,4,194
28254,2024-01-20 14:53:00,89,131,Alimento,6,220
28255,2024-01-20 14:54:00,106,140,Vestuário,8,246
28256,2024-01-20 14:55:00,12,155,Brinquedo,5,167
28257,2024-01-20 14:56:00,89,123,Brinquedo,1,212
28258,2024-01-20 14:57:00,68,24,Eletrônico,6,92
28259,2024-01-20 14:58:00,11,95,Brinquedo,3,106
28260,2024-01-20 14:59:00,112,79,Eletrônico,9,191
28261,2024-01-20 15:00:00,38,87,Brinquedo,5,125
28262,2024-01-20 15:01:00,11,120,Eletrônico,2,131
28263,2024-01-20 15:02:00,10,130,Eletrônico,9,140
28264,2024-01-20 15:03:00,42,119,Alimento,8,161
28265,2024-01-20 15:04:00,24,58,Eletrônico,7,82
28266,2024-01-20 15:05:00,38,41,Eletrônico,4,79
28267,2024-01-20 15:06:00,115,21,Alimento,6,136
28268,2024-01-20 15:07:00,88,137,Eletrônico,5,225
28269,2024-01-20 15:08:00,114,153,Brinquedo,8,267
28270,2024-01-20 15:09:00,72,127,Móvel,7,199
28271,2024-01-20 15:10:00,13,12,Vestuário,2,25
28272,2024-01-20 15:11:00,21,32,Eletrônico,8,53
28273,2024-01-20 15:12:00,72,33,Vestuário,3,105
28274,2024-01-20 15:13:00,95,95,Brinquedo,5,190
28275,2024-01-20 15:14:00,49,28,Alimento,2,77
28276,2024-01-20 15:15:00,32,21,Eletrônico,4,53
28277,2024-01-20 15:16:00,56,151,Móvel,9,207
28278,2024-01-20 15:17:00,105,141,Vestuário,2,246
28279,2024-01-20 15:18:00,50,50,Alimento,8,100
28280,2024-01-20 15:19:00,91,122,Eletrônico,5,213
28281,2024-01-20 15:20:00,72,89,Alimento,9,161
28282,2024-01-20 15:21:00,22,174,Brinquedo,6,196
28283,2024-01-20 15:22:00,119,91,Vestuário,9,210
28284,2024-01-20 15:23:00,29,91,Vestuário,8,120
28285,2024-01-20 15:24:00,81,138,Eletrônico,8,219
28286,2024-01-20 15:25:00,64,121,Móvel,8,185
28287,2024-01-20 15:26:00,92,89,Brinquedo,5,181
28288,2024-01-20 15:27:00,86,171,Alimento,8,257
28289,2024-01-20 15:28:00,65,67,Alimento,5,132
28290,2024-01-20 15:29:00,23,80,Alimento,2,103
28291,2024-01-20 15:30:00,10,82,Vestuário,3,92
28292,2024-01-20 15:31:00,38,85,Brinquedo,6,123
28293,2024-01-20 15:32:00,19,171,Vestuário,2,190
28294,2024-01-20 15:33:00,24,74,Alimento,9,98
28295,2024-01-20 15:34:00,84,23,Eletrônico,2,107
28296,2024-01-20 15:35:00,70,38,Eletrônico,9,108
28297,2024-01-20 15:36:00,71,88,Vestuário,9,159
28298,2024-01-20 15:37:00,119,74,Brinquedo,1,193
28299,2024-01-20 15:38:00,70,176,Móvel,9,246
28300,2024-01-20 15:39:00,90,45,Brinquedo,7,135
28301,2024-01-20 15:40:00,70,39,Brinquedo,3,109
28302,2024-01-20 15:41:00,63,75,Eletrônico,9,138
28303,2024-01-20 15:42:00,107,168,Móvel,1,275
28304,2024-01-20 15:43:00,22,146,Vestuário,9,168
28305,2024-01-20 15:44:00,51,92,Móvel,7,143
28306,2024-01-20 15:45:00,33,135,Vestuário,9,168
28307,2024-01-20 15:46:00,25,15,Eletrônico,3,40
28308,2024-01-20 15:47:00,40,134,Brinquedo,4,174
28309,2024-01-20 15:48:00,17,176,Brinquedo,2,193
28310,2024-01-20 15:49:00,68,28,Alimento,3,96
28311,2024-01-20 15:50:00,78,126,Alimento,8,204
28312,2024-01-20 15:51:00,92,83,Brinquedo,2,175
28313,2024-01-20 15:52:00,91,140,Alimento,2,231
28314,2024-01-20 15:53:00,86,127,Brinquedo,3,213
28315,2024-01-20 15:54:00,55,58,Vestuário,9,113
28316,2024-01-20 15:55:00,72,114,Móvel,6,186
28317,2024-01-20 15:56:00,73,75,Brinquedo,8,148
28318,2024-01-20 15:57:00,19,35,Alimento,2,54
28319,2024-01-20 15:58:00,27,14,Móvel,8,41
28320,2024-01-20 15:59:00,102,34,Eletrônico,8,136
28321,2024-01-20 16:00:00,48,26,Vestuário,2,74
28322,2024-01-20 16:01:00,15,92,Móvel,3,107
28323,2024-01-20 16:02:00,26,153,Brinquedo,1,179
28324,2024-01-20 16:03:00,18,60,Vestuário,7,78
28325,2024-01-20 16:04:00,71,10,Brinquedo,1,81
28326,2024-01-20 16:05:00,38,17,Vestuário,3,55
28327,2024-01-20 16:06:00,107,157,Vestuário,5,264
28328,2024-01-20 16:07:00,14,129,Alimento,1,143
28329,2024-01-20 16:08:00,80,115,Alimento,5,195
28330,2024-01-20 16:09:00,58,131,Eletrônico,8,189
28331,2024-01-20 16:10:00,117,88,Móvel,6,205
28332,2024-01-20 16:11:00,33,102,Móvel,8,135
28333,2024-01-20 16:12:00,102,31,Vestuário,9,133
28334,2024-01-20 16:13:00,38,15,Brinquedo,5,53
28335,2024-01-20 16:14:00,64,80,Eletrônico,4,144
28336,2024-01-20 16:15:00,93,15,Alimento,9,108
28337,2024-01-20 16:16:00,62,66,Eletrônico,6,128
28338,2024-01-20 16:17:00,41,155,Móvel,8,196
28339,2024-01-20 16:18:00,103,61,Brinquedo,2,164
28340,2024-01-20 16:19:00,111,19,Brinquedo,5,130
28341,2024-01-20 16:20:00,54,107,Brinquedo,5,161
28342,2024-01-20 16:21:00,35,30,Brinquedo,9,65
28343,2024-01-20 16:22:00,69,91,Brinquedo,3,160
28344,2024-01-20 16:23:00,111,129,Brinquedo,2,240
28345,2024-01-20 16:24:00,91,92,Vestuário,5,183
28346,2024-01-20 16:25:00,27,142,Alimento,9,169
28347,2024-01-20 16:26:00,42,154,Brinquedo,9,196
28348,2024-01-20 16:27:00,79,103,Eletrônico,3,182
28349,2024-01-20 16:28:00,84,37,Eletrônico,9,121
28350,2024-01-20 16:29:00,73,20,Vestuário,4,93
28351,2024-01-20 16:30:00,95,43,Vestuário,3,138
28352,2024-01-20 16:31:00,92,172,Móvel,1,264
28353,2024-01-20 16:32:00,89,134,Eletrônico,7,223
28354,2024-01-20 16:33:00,93,75,Eletrônico,4,168
28355,2024-01-20 16:34:00,116,58,Alimento,5,174
28356,2024-01-20 16:35:00,53,58,Vestuário,8,111
28357,2024-01-20 16:36:00,10,42,Eletrônico,1,52
28358,2024-01-20 16:37:00,26,112,Brinquedo,6,138
28359,2024-01-20 16:38:00,99,127,Brinquedo,4,226
28360,2024-01-20 16:39:00,40,23,Móvel,4,63
28361,2024-01-20 16:40:00,21,171,Vestuário,2,192
28362,2024-01-20 16:41:00,50,124,Alimento,1,174
28363,2024-01-20 16:42:00,69,164,Móvel,2,233
28364,2024-01-20 16:43:00,80,20,Móvel,6,100
28365,2024-01-20 16:44:00,36,80,Móvel,5,116
28366,2024-01-20 16:45:00,99,69,Eletrônico,8,168
28367,2024-01-20 16:46:00,18,29,Móvel,9,47
28368,2024-01-20 16:47:00,83,110,Brinquedo,4,193
28369,2024-01-20 16:48:00,112,27,Brinquedo,2,139
28370,2024-01-20 16:49:00,45,151,Alimento,6,196
28371,2024-01-20 16:50:00,111,39,Brinquedo,9,150
28372,2024-01-20 16:51:00,55,167,Alimento,5,222
28373,2024-01-20 16:52:00,55,109,Alimento,2,164
28374,2024-01-20 16:53:00,44,39,Vestuário,8,83
28375,2024-01-20 16:54:00,37,47,Vestuário,1,84
28376,2024-01-20 16:55:00,24,118,Brinquedo,8,142
28377,2024-01-20 16:56:00,70,177,Brinquedo,4,247
28378,2024-01-20 16:57:00,85,92,Móvel,9,177
28379,2024-01-20 16:58:00,30,112,Alimento,7,142
28380,2024-01-20 16:59:00,66,91,Eletrônico,5,157
28381,2024-01-20 17:00:00,65,22,Eletrônico,8,87
28382,2024-01-20 17:01:00,16,170,Móvel,4,186
28383,2024-01-20 17:02:00,31,19,Vestuário,8,50
28384,2024-01-20 17:03:00,65,41,Móvel,6,106
28385,2024-01-20 17:04:00,106,138,Vestuário,2,244
28386,2024-01-20 17:05:00,107,33,Eletrônico,6,140
28387,2024-01-20 17:06:00,77,88,Eletrônico,1,165
28388,2024-01-20 17:07:00,97,164,Vestuário,9,261
28389,2024-01-20 17:08:00,14,89,Eletrônico,5,103
28390,2024-01-20 17:09:00,52,45,Vestuário,3,97
28391,2024-01-20 17:10:00,24,16,Móvel,4,40
28392,2024-01-20 17:11:00,90,137,Alimento,1,227
28393,2024-01-20 17:12:00,106,69,Móvel,4,175
28394,2024-01-20 17:13:00,99,112,Móvel,5,211
28395,2024-01-20 17:14:00,24,94,Móvel,2,118
28396,2024-01-20 17:15:00,110,143,Vestuário,6,253
28397,2024-01-20 17:16:00,49,82,Móvel,5,131
28398,2024-01-20 17:17:00,91,157,Brinquedo,6,248
28399,2024-01-20 17:18:00,115,27,Móvel,3,142
28400,2024-01-20 17:19:00,118,176,Brinquedo,7,294
28401,2024-01-20 17:20:00,40,108,Alimento,1,148
28402,2024-01-20 17:21:00,51,95,Eletrônico,5,146
28403,2024-01-20 17:22:00,75,93,Eletrônico,2,168
28404,2024-01-20 17:23:00,46,49,Móvel,1,95
28405,2024-01-20 17:24:00,27,27,Vestuário,9,54
28406,2024-01-20 17:25:00,52,45,Eletrônico,5,97
28407,2024-01-20 17:26:00,47,115,Móvel,4,162
28408,2024-01-20 17:27:00,109,167,Móvel,9,276
28409,2024-01-20 17:28:00,13,150,Alimento,5,163
28410,2024-01-20 17:29:00,82,43,Brinquedo,1,125
28411,2024-01-20 17:30:00,106,29,Brinquedo,1,135
28412,2024-01-20 17:31:00,87,143,Vestuário,6,230
28413,2024-01-20 17:32:00,64,80,Móvel,3,144
28414,2024-01-20 17:33:00,73,79,Vestuário,4,152
28415,2024-01-20 17:34:00,106,27,Vestuário,2,133
28416,2024-01-20 17:35:00,113,150,Vestuário,4,263
28417,2024-01-20 17:36:00,53,151,Vestuário,7,204
28418,2024-01-20 17:37:00,114,129,Móvel,8,243
28419,2024-01-20 17:38:00,90,108,Brinquedo,3,198
28420,2024-01-20 17:39:00,104,43,Móvel,7,147
28421,2024-01-20 17:40:00,59,140,Brinquedo,6,199
28422,2024-01-20 17:41:00,30,110,Eletrônico,5,140
28423,2024-01-20 17:42:00,62,144,Eletrônico,4,206
28424,2024-01-20 17:43:00,97,76,Eletrônico,7,173
28425,2024-01-20 17:44:00,39,104,Vestuário,5,143
28426,2024-01-20 17:45:00,62,167,Alimento,3,229
28427,2024-01-20 17:46:00,115,113,Móvel,4,228
28428,2024-01-20 17:47:00,36,36,Brinquedo,1,72
28429,2024-01-20 17:48:00,18,22,Eletrônico,6,40
28430,2024-01-20 17:49:00,91,95,Vestuário,7,186
28431,2024-01-20 17:50:00,37,123,Móvel,8,160
28432,2024-01-20 17:51:00,51,73,Brinquedo,8,124
28433,2024-01-20 17:52:00,45,105,Alimento,9,150
28434,2024-01-20 17:53:00,55,150,Móvel,9,205
28435,2024-01-20 17:54:00,18,146,Alimento,6,164
28436,2024-01-20 17:55:00,63,120,Brinquedo,9,183
28437,2024-01-20 17:56:00,45,19,Alimento,9,64
28438,2024-01-20 17:57:00,39,97,Brinquedo,5,136
28439,2024-01-20 17:58:00,96,112,Vestuário,7,208
28440,2024-01-20 17:59:00,78,60,Alimento,7,138
28441,2024-01-20 18:00:00,30,65,Móvel,1,95
28442,2024-01-20 18:01:00,24,85,Móvel,8,109
28443,2024-01-20 18:02:00,78,60,Eletrônico,6,138
28444,2024-01-20 18:03:00,86,21,Eletrônico,2,107
28445,2024-01-20 18:04:00,112,132,Vestuário,6,244
28446,2024-01-20 18:05:00,22,52,Brinquedo,4,74
28447,2024-01-20 18:06:00,109,175,Brinquedo,4,284
28448,2024-01-20 18:07:00,24,62,Alimento,4,86
28449,2024-01-20 18:08:00,66,143,Eletrônico,3,209
28450,2024-01-20 18:09:00,113,89,Brinquedo,8,202
28451,2024-01-20 18:10:00,35,112,Móvel,6,147
28452,2024-01-20 18:11:00,15,93,Alimento,6,108
28453,2024-01-20 18:12:00,87,23,Móvel,8,110
28454,2024-01-20 18:13:00,67,120,Móvel,2,187
28455,2024-01-20 18:14:00,13,145,Alimento,6,158
28456,2024-01-20 18:15:00,106,153,Eletrônico,7,259
28457,2024-01-20 18:16:00,45,26,Móvel,5,71
28458,2024-01-20 18:17:00,41,109,Vestuário,1,150
28459,2024-01-20 18:18:00,111,13,Vestuário,4,124
28460,2024-01-20 18:19:00,106,73,Vestuário,9,179
28461,2024-01-20 18:20:00,32,178,Móvel,3,210
28462,2024-01-20 18:21:00,70,174,Brinquedo,7,244
28463,2024-01-20 18:22:00,90,64,Vestuário,5,154
28464,2024-01-20 18:23:00,71,33,Alimento,5,104
28465,2024-01-20 18:24:00,49,73,Eletrônico,4,122
28466,2024-01-20 18:25:00,20,100,Alimento,7,120
28467,2024-01-20 18:26:00,109,33,Vestuário,8,142
28468,2024-01-20 18:27:00,84,131,Móvel,1,215
28469,2024-01-20 18:28:00,21,149,Móvel,1,170
28470,2024-01-20 18:29:00,82,150,Vestuário,4,232
28471,2024-01-20 18:30:00,75,145,Brinquedo,1,220
28472,2024-01-20 18:31:00,102,148,Brinquedo,3,250
28473,2024-01-20 18:32:00,37,24,Alimento,9,61
28474,2024-01-20 18:33:00,101,61,Brinquedo,3,162
28475,2024-01-20 18:34:00,82,142,Móvel,8,224
28476,2024-01-20 18:35:00,39,86,Eletrônico,5,125
28477,2024-01-20 18:36:00,22,67,Móvel,8,89
28478,2024-01-20 18:37:00,45,88,Eletrônico,6,133
28479,2024-01-20 18:38:00,119,86,Alimento,6,205
28480,2024-01-20 18:39:00,21,15,Brinquedo,1,36
28481,2024-01-20 18:40:00,58,138,Móvel,3,196
28482,2024-01-20 18:41:00,96,83,Vestuário,1,179
28483,2024-01-20 18:42:00,93,105,Eletrônico,5,198
28484,2024-01-20 18:43:00,57,172,Vestuário,6,229
28485,2024-01-20 18:44:00,48,172,Alimento,8,220
28486,2024-01-20 18:45:00,71,86,Brinquedo,6,157
28487,2024-01-20 18:46:00,101,33,Eletrônico,1,134
28488,2024-01-20 18:47:00,35,116,Alimento,3,151
28489,2024-01-20 18:48:00,118,105,Móvel,7,223
28490,2024-01-20 18:49:00,52,34,Móvel,9,86
28491,2024-01-20 18:50:00,20,170,Alimento,5,190
28492,2024-01-20 18:51:00,61,68,Alimento,7,129
28493,2024-01-20 18:52:00,60,112,Brinquedo,4,172
28494,2024-01-20 18:53:00,107,14,Vestuário,5,121
28495,2024-01-20 18:54:00,118,63,Móvel,1,181
28496,2024-01-20 18:55:00,26,114,Vestuário,4,140
28497,2024-01-20 18:56:00,64,83,Alimento,5,147
28498,2024-01-20 18:57:00,82,10,Alimento,9,92
28499,2024-01-20 18:58:00,109,132,Eletrônico,5,241
28500,2024-01-20 18:59:00,95,119,Vestuário,7,214
28501,2024-01-20 19:00:00,34,38,Móvel,3,72
28502,2024-01-20 19:01:00,33,57,Brinquedo,7,90
28503,2024-01-20 19:02:00,33,40,Vestuário,9,73
28504,2024-01-20 19:03:00,92,98,Vestuário,7,190
28505,2024-01-20 19:04:00,113,69,Eletrônico,3,182
28506,2024-01-20 19:05:00,35,37,Eletrônico,7,72
28507,2024-01-20 19:06:00,37,93,Móvel,9,130
28508,2024-01-20 19:07:00,47,22,Eletrônico,9,69
28509,2024-01-20 19:08:00,22,102,Eletrônico,7,124
28510,2024-01-20 19:09:00,56,90,Móvel,4,146
28511,2024-01-20 19:10:00,80,54,Móvel,5,134
28512,2024-01-20 19:11:00,56,29,Brinquedo,2,85
28513,2024-01-20 19:12:00,73,142,Eletrônico,4,215
28514,2024-01-20 19:13:00,84,85,Brinquedo,3,169
28515,2024-01-20 19:14:00,61,107,Alimento,6,168
28516,2024-01-20 19:15:00,54,127,Vestuário,3,181
28517,2024-01-20 19:16:00,28,14,Móvel,8,42
28518,2024-01-20 19:17:00,73,59,Brinquedo,4,132
28519,2024-01-20 19:18:00,81,175,Móvel,2,256
28520,2024-01-20 19:19:00,68,19,Alimento,4,87
28521,2024-01-20 19:20:00,93,128,Vestuário,9,221
28522,2024-01-20 19:21:00,79,17,Móvel,5,96
28523,2024-01-20 19:22:00,85,122,Alimento,3,207
28524,2024-01-20 19:23:00,15,160,Vestuário,1,175
28525,2024-01-20 19:24:00,79,71,Alimento,8,150
28526,2024-01-20 19:25:00,38,16,Alimento,1,54
28527,2024-01-20 19:26:00,119,177,Alimento,5,296
28528,2024-01-20 19:27:00,60,55,Alimento,1,115
28529,2024-01-20 19:28:00,91,150,Vestuário,5,241
28530,2024-01-20 19:29:00,114,41,Eletrônico,9,155
28531,2024-01-20 19:30:00,55,80,Móvel,6,135
28532,2024-01-20 19:31:00,99,97,Eletrônico,5,196
28533,2024-01-20 19:32:00,92,58,Móvel,8,150
28534,2024-01-20 19:33:00,53,49,Móvel,3,102
28535,2024-01-20 19:34:00,94,80,Alimento,6,174
28536,2024-01-20 19:35:00,19,107,Eletrônico,2,126
28537,2024-01-20 19:36:00,97,87,Vestuário,8,184
28538,2024-01-20 19:37:00,30,127,Móvel,3,157
28539,2024-01-20 19:38:00,115,61,Móvel,7,176
28540,2024-01-20 19:39:00,66,100,Móvel,1,166
28541,2024-01-20 19:40:00,19,92,Eletrônico,2,111
28542,2024-01-20 19:41:00,20,156,Móvel,3,176
28543,2024-01-20 19:42:00,67,93,Alimento,4,160
28544,2024-01-20 19:43:00,86,42,Alimento,5,128
28545,2024-01-20 19:44:00,76,107,Móvel,7,183
28546,2024-01-20 19:45:00,55,85,Eletrônico,4,140
28547,2024-01-20 19:46:00,51,105,Vestuário,5,156
28548,2024-01-20 19:47:00,105,57,Alimento,7,162
28549,2024-01-20 19:48:00,27,150,Eletrônico,6,177
28550,2024-01-20 19:49:00,107,176,Brinquedo,8,283
28551,2024-01-20 19:50:00,75,26,Móvel,3,101
28552,2024-01-20 19:51:00,108,82,Alimento,5,190
28553,2024-01-20 19:52:00,89,12,Brinquedo,8,101
28554,2024-01-20 19:53:00,23,126,Brinquedo,5,149
28555,2024-01-20 19:54:00,29,54,Alimento,8,83
28556,2024-01-20 19:55:00,74,81,Brinquedo,7,155
28557,2024-01-20 19:56:00,118,136,Eletrônico,3,254
28558,2024-01-20 19:57:00,32,68,Vestuário,9,100
28559,2024-01-20 19:58:00,14,74,Eletrônico,4,88
28560,2024-01-20 19:59:00,46,76,Móvel,2,122
28561,2024-01-20 20:00:00,39,61,Brinquedo,8,100
28562,2024-01-20 20:01:00,106,150,Vestuário,6,256
28563,2024-01-20 20:02:00,54,28,Vestuário,4,82
28564,2024-01-20 20:03:00,51,108,Brinquedo,9,159
28565,2024-01-20 20:04:00,82,102,Alimento,3,184
28566,2024-01-20 20:05:00,37,167,Vestuário,2,204
28567,2024-01-20 20:06:00,115,18,Brinquedo,8,133
28568,2024-01-20 20:07:00,87,38,Alimento,7,125
28569,2024-01-20 20:08:00,40,161,Eletrônico,6,201
28570,2024-01-20 20:09:00,59,131,Alimento,9,190
28571,2024-01-20 20:10:00,97,140,Móvel,5,237
28572,2024-01-20 20:11:00,47,74,Móvel,1,121
28573,2024-01-20 20:12:00,106,146,Eletrônico,5,252
28574,2024-01-20 20:13:00,117,128,Eletrônico,1,245
28575,2024-01-20 20:14:00,107,19,Alimento,5,126
28576,2024-01-20 20:15:00,84,82,Alimento,5,166
28577,2024-01-20 20:16:00,96,87,Eletrônico,8,183
28578,2024-01-20 20:17:00,40,119,Alimento,8,159
28579,2024-01-20 20:18:00,22,64,Vestuário,5,86
28580,2024-01-20 20:19:00,84,23,Alimento,1,107
28581,2024-01-20 20:20:00,95,144,Móvel,8,239
28582,2024-01-20 20:21:00,63,107,Brinquedo,8,170
28583,2024-01-20 20:22:00,91,178,Móvel,8,269
28584,2024-01-20 20:23:00,17,81,Alimento,9,98
28585,2024-01-20 20:24:00,11,85,Alimento,2,96
28586,2024-01-20 20:25:00,84,34,Vestuário,2,118
28587,2024-01-20 20:26:00,19,73,Móvel,8,92
28588,2024-01-20 20:27:00,52,121,Vestuário,7,173
28589,2024-01-20 20:28:00,76,104,Móvel,1,180
28590,2024-01-20 20:29:00,69,81,Alimento,8,150
28591,2024-01-20 20:30:00,117,157,Vestuário,6,274
28592,2024-01-20 20:31:00,20,100,Vestuário,5,120
28593,2024-01-20 20:32:00,78,148,Brinquedo,1,226
28594,2024-01-20 20:33:00,14,133,Brinquedo,2,147
28595,2024-01-20 20:34:00,77,13,Eletrônico,8,90
28596,2024-01-20 20:35:00,33,49,Móvel,5,82
28597,2024-01-20 20:36:00,65,110,Alimento,8,175
28598,2024-01-20 20:37:00,64,36,Eletrônico,3,100
28599,2024-01-20 20:38:00,11,73,Alimento,2,84
28600,2024-01-20 20:39:00,93,94,Eletrônico,3,187
28601,2024-01-20 20:40:00,56,78,Vestuário,2,134
28602,2024-01-20 20:41:00,117,37,Alimento,8,154
28603,2024-01-20 20:42:00,14,175,Eletrônico,4,189
28604,2024-01-20 20:43:00,113,149,Eletrônico,6,262
28605,2024-01-20 20:44:00,27,151,Vestuário,8,178
28606,2024-01-20 20:45:00,27,37,Móvel,3,64
28607,2024-01-20 20:46:00,12,169,Eletrônico,7,181
28608,2024-01-20 20:47:00,64,105,Brinquedo,1,169
28609,2024-01-20 20:48:00,95,50,Brinquedo,6,145
28610,2024-01-20 20:49:00,16,179,Vestuário,9,195
28611,2024-01-20 20:50:00,94,10,Vestuário,6,104
28612,2024-01-20 20:51:00,102,140,Móvel,5,242
28613,2024-01-20 20:52:00,76,174,Móvel,2,250
28614,2024-01-20 20:53:00,60,87,Eletrônico,7,147
28615,2024-01-20 20:54:00,71,107,Móvel,9,178
28616,2024-01-20 20:55:00,110,153,Móvel,4,263
28617,2024-01-20 20:56:00,76,12,Brinquedo,1,88
28618,2024-01-20 20:57:00,79,84,Alimento,3,163
28619,2024-01-20 20:58:00,26,14,Vestuário,9,40
28620,2024-01-20 20:59:00,107,46,Vestuário,2,153
28621,2024-01-20 21:00:00,61,34,Eletrônico,5,95
28622,2024-01-20 21:01:00,114,159,Brinquedo,4,273
28623,2024-01-20 21:02:00,60,84,Brinquedo,9,144
28624,2024-01-20 21:03:00,72,91,Vestuário,3,163
28625,2024-01-20 21:04:00,71,57,Alimento,2,128
28626,2024-01-20 21:05:00,114,75,Eletrônico,3,189
28627,2024-01-20 21:06:00,41,147,Alimento,9,188
28628,2024-01-20 21:07:00,112,165,Alimento,2,277
28629,2024-01-20 21:08:00,71,31,Móvel,3,102
28630,2024-01-20 21:09:00,74,170,Móvel,8,244
28631,2024-01-20 21:10:00,18,46,Eletrônico,5,64
28632,2024-01-20 21:11:00,79,106,Vestuário,2,185
28633,2024-01-20 21:12:00,116,15,Móvel,4,131
28634,2024-01-20 21:13:00,57,176,Alimento,2,233
28635,2024-01-20 21:14:00,58,124,Vestuário,3,182
28636,2024-01-20 21:15:00,107,133,Brinquedo,2,240
28637,2024-01-20 21:16:00,87,12,Eletrônico,8,99
28638,2024-01-20 21:17:00,72,140,Alimento,9,212
28639,2024-01-20 21:18:00,43,23,Brinquedo,8,66
28640,2024-01-20 21:19:00,13,179,Eletrônico,1,192
28641,2024-01-20 21:20:00,42,179,Alimento,2,221
28642,2024-01-20 21:21:00,19,151,Alimento,1,170
28643,2024-01-20 21:22:00,77,36,Eletrônico,8,113
28644,2024-01-20 21:23:00,26,117,Móvel,2,143
28645,2024-01-20 21:24:00,40,105,Alimento,8,145
28646,2024-01-20 21:25:00,38,73,Brinquedo,6,111
28647,2024-01-20 21:26:00,57,94,Vestuário,4,151
28648,2024-01-20 21:27:00,20,152,Brinquedo,2,172
28649,2024-01-20 21:28:00,77,114,Vestuário,3,191
28650,2024-01-20 21:29:00,104,115,Eletrônico,3,219
28651,2024-01-20 21:30:00,55,85,Móvel,8,140
28652,2024-01-20 21:31:00,60,110,Alimento,2,170
28653,2024-01-20 21:32:00,45,98,Vestuário,6,143
28654,2024-01-20 21:33:00,19,154,Móvel,8,173
28655,2024-01-20 21:34:00,46,163,Eletrônico,4,209
28656,2024-01-20 21:35:00,41,129,Vestuário,4,170
28657,2024-01-20 21:36:00,20,71,Alimento,7,91
28658,2024-01-20 21:37:00,107,31,Alimento,1,138
28659,2024-01-20 21:38:00,85,144,Móvel,1,229
28660,2024-01-20 21:39:00,35,179,Móvel,7,214
28661,2024-01-20 21:40:00,94,53,Móvel,1,147
28662,2024-01-20 21:41:00,19,18,Eletrônico,4,37
28663,2024-01-20 21:42:00,40,135,Móvel,7,175
28664,2024-01-20 21:43:00,110,179,Vestuário,7,289
28665,2024-01-20 21:44:00,30,118,Alimento,6,148
28666,2024-01-20 21:45:00,85,82,Alimento,3,167
28667,2024-01-20 21:46:00,93,143,Móvel,1,236
28668,2024-01-20 21:47:00,116,84,Brinquedo,6,200
28669,2024-01-20 21:48:00,60,109,Brinquedo,3,169
28670,2024-01-20 21:49:00,30,106,Alimento,9,136
28671,2024-01-20 21:50:00,40,16,Alimento,6,56
28672,2024-01-20 21:51:00,91,101,Eletrônico,8,192
28673,2024-01-20 21:52:00,39,157,Alimento,7,196
28674,2024-01-20 21:53:00,44,39,Vestuário,5,83
28675,2024-01-20 21:54:00,65,24,Eletrônico,9,89
28676,2024-01-20 21:55:00,63,98,Eletrônico,6,161
28677,2024-01-20 21:56:00,100,102,Brinquedo,4,202
28678,2024-01-20 21:57:00,26,80,Eletrônico,7,106
28679,2024-01-20 21:58:00,21,33,Móvel,3,54
28680,2024-01-20 21:59:00,57,75,Alimento,8,132
28681,2024-01-20 22:00:00,47,169,Vestuário,5,216
28682,2024-01-20 22:01:00,68,85,Brinquedo,1,153
28683,2024-01-20 22:02:00,24,22,Eletrônico,6,46
28684,2024-01-20 22:03:00,29,125,Eletrônico,3,154
28685,2024-01-20 22:04:00,14,74,Brinquedo,2,88
28686,2024-01-20 22:05:00,10,47,Vestuário,9,57
28687,2024-01-20 22:06:00,90,27,Móvel,9,117
28688,2024-01-20 22:07:00,41,91,Móvel,3,132
28689,2024-01-20 22:08:00,20,111,Vestuário,8,131
28690,2024-01-20 22:09:00,46,52,Alimento,8,98
28691,2024-01-20 22:10:00,44,98,Brinquedo,3,142
28692,2024-01-20 22:11:00,95,176,Alimento,9,271
28693,2024-01-20 22:12:00,98,38,Eletrônico,2,136
28694,2024-01-20 22:13:00,76,80,Brinquedo,2,156
28695,2024-01-20 22:14:00,86,153,Móvel,1,239
28696,2024-01-20 22:15:00,41,81,Brinquedo,3,122
28697,2024-01-20 22:16:00,29,64,Eletrônico,8,93
28698,2024-01-20 22:17:00,50,23,Alimento,6,73
28699,2024-01-20 22:18:00,31,143,Vestuário,7,174
28700,2024-01-20 22:19:00,65,29,Eletrônico,6,94
28701,2024-01-20 22:20:00,11,17,Brinquedo,4,28
28702,2024-01-20 22:21:00,58,117,Móvel,9,175
28703,2024-01-20 22:22:00,45,19,Vestuário,8,64
28704,2024-01-20 22:23:00,106,38,Vestuário,1,144
28705,2024-01-20 22:24:00,86,47,Móvel,2,133
28706,2024-01-20 22:25:00,48,47,Vestuário,9,95
28707,2024-01-20 22:26:00,12,83,Alimento,6,95
28708,2024-01-20 22:27:00,108,163,Móvel,9,271
28709,2024-01-20 22:28:00,36,58,Brinquedo,3,94
28710,2024-01-20 22:29:00,67,127,Móvel,2,194
28711,2024-01-20 22:30:00,68,24,Móvel,2,92
28712,2024-01-20 22:31:00,99,101,Alimento,5,200
28713,2024-01-20 22:32:00,93,11,Brinquedo,7,104
28714,2024-01-20 22:33:00,45,167,Vestuário,3,212
28715,2024-01-20 22:34:00,73,49,Alimento,4,122
28716,2024-01-20 22:35:00,115,94,Brinquedo,3,209
28717,2024-01-20 22:36:00,70,119,Eletrônico,1,189
28718,2024-01-20 22:37:00,51,93,Brinquedo,7,144
28719,2024-01-20 22:38:00,111,81,Vestuário,9,192
28720,2024-01-20 22:39:00,107,157,Móvel,7,264
28721,2024-01-20 22:40:00,42,144,Alimento,7,186
28722,2024-01-20 22:41:00,82,146,Eletrônico,8,228
28723,2024-01-20 22:42:00,72,120,Eletrônico,8,192
28724,2024-01-20 22:43:00,96,122,Brinquedo,2,218
28725,2024-01-20 22:44:00,106,155,Móvel,8,261
28726,2024-01-20 22:45:00,10,81,Móvel,1,91
28727,2024-01-20 22:46:00,19,23,Eletrônico,3,42
28728,2024-01-20 22:47:00,31,19,Móvel,7,50
28729,2024-01-20 22:48:00,112,145,Alimento,4,257
28730,2024-01-20 22:49:00,21,18,Vestuário,9,39
28731,2024-01-20 22:50:00,99,80,Brinquedo,2,179
28732,2024-01-20 22:51:00,115,95,Eletrônico,7,210
28733,2024-01-20 22:52:00,119,56,Vestuário,4,175
28734,2024-01-20 22:53:00,38,61,Eletrônico,1,99
28735,2024-01-20 22:54:00,11,159,Móvel,7,170
28736,2024-01-20 22:55:00,119,135,Brinquedo,9,254
28737,2024-01-20 22:56:00,71,60,Alimento,2,131
28738,2024-01-20 22:57:00,85,143,Vestuário,1,228
28739,2024-01-20 22:58:00,16,161,Brinquedo,7,177
28740,2024-01-20 22:59:00,91,132,Eletrônico,4,223
28741,2024-01-20 23:00:00,92,54,Alimento,1,146
28742,2024-01-20 23:01:00,25,47,Eletrônico,7,72
28743,2024-01-20 23:02:00,105,171,Vestuário,3,276
28744,2024-01-20 23:03:00,83,166,Vestuário,4,249
28745,2024-01-20 23:04:00,53,81,Alimento,4,134
28746,2024-01-20 23:05:00,81,38,Vestuário,1,119
28747,2024-01-20 23:06:00,33,158,Móvel,6,191
28748,2024-01-20 23:07:00,72,128,Vestuário,3,200
28749,2024-01-20 23:08:00,38,142,Eletrônico,9,180
28750,2024-01-20 23:09:00,101,92,Móvel,3,193
28751,2024-01-20 23:10:00,47,109,Vestuário,3,156
28752,2024-01-20 23:11:00,88,166,Móvel,7,254
28753,2024-01-20 23:12:00,117,134,Eletrônico,1,251
28754,2024-01-20 23:13:00,85,29,Móvel,2,114
28755,2024-01-20 23:14:00,59,170,Eletrônico,9,229
28756,2024-01-20 23:15:00,56,54,Móvel,7,110
28757,2024-01-20 23:16:00,53,168,Eletrônico,8,221
28758,2024-01-20 23:17:00,99,68,Brinquedo,8,167
28759,2024-01-20 23:18:00,118,81,Brinquedo,9,199
28760,2024-01-20 23:19:00,28,91,Vestuário,3,119
28761,2024-01-20 23:20:00,90,34,Brinquedo,4,124
28762,2024-01-20 23:21:00,88,67,Vestuário,7,155
28763,2024-01-20 23:22:00,98,55,Eletrônico,7,153
28764,2024-01-20 23:23:00,37,19,Eletrônico,2,56
28765,2024-01-20 23:24:00,76,45,Vestuário,2,121
28766,2024-01-20 23:25:00,31,143,Móvel,7,174
28767,2024-01-20 23:26:00,102,164,Eletrônico,1,266
28768,2024-01-20 23:27:00,53,157,Brinquedo,8,210
28769,2024-01-20 23:28:00,57,108,Eletrônico,3,165
28770,2024-01-20 23:29:00,116,129,Eletrônico,7,245
28771,2024-01-20 23:30:00,18,115,Móvel,5,133
28772,2024-01-20 23:31:00,51,65,Brinquedo,9,116
28773,2024-01-20 23:32:00,81,26,Móvel,7,107
28774,2024-01-20 23:33:00,31,67,Vestuário,9,98
28775,2024-01-20 23:34:00,70,24,Alimento,9,94
28776,2024-01-20 23:35:00,63,170,Eletrônico,1,233
28777,2024-01-20 23:36:00,103,162,Móvel,2,265
28778,2024-01-20 23:37:00,73,133,Vestuário,5,206
28779,2024-01-20 23:38:00,119,118,Alimento,6,237
28780,2024-01-20 23:39:00,37,58,Eletrônico,8,95
28781,2024-01-20 23:40:00,39,56,Alimento,5,95
28782,2024-01-20 23:41:00,46,132,Vestuário,8,178
28783,2024-01-20 23:42:00,56,107,Móvel,4,163
28784,2024-01-20 23:43:00,11,16,Móvel,2,27
28785,2024-01-20 23:44:00,82,54,Eletrônico,4,136
28786,2024-01-20 23:45:00,65,139,Móvel,8,204
28787,2024-01-20 23:46:00,63,119,Móvel,2,182
28788,2024-01-20 23:47:00,105,60,Alimento,9,165
28789,2024-01-20 23:48:00,94,108,Brinquedo,7,202
28790,2024-01-20 23:49:00,15,127,Eletrônico,5,142
28791,2024-01-20 23:50:00,29,52,Brinquedo,1,81
28792,2024-01-20 23:51:00,34,69,Eletrônico,6,103
28793,2024-01-20 23:52:00,92,176,Alimento,7,268
28794,2024-01-20 23:53:00,68,159,Alimento,3,227
28795,2024-01-20 23:54:00,94,136,Móvel,6,230
28796,2024-01-20 23:55:00,101,27,Alimento,5,128
28797,2024-01-20 23:56:00,69,86,Móvel,1,155
28798,2024-01-20 23:57:00,50,86,Brinquedo,1,136
28799,2024-01-20 23:58:00,92,146,Brinquedo,3,238
28800,2024-01-20 23:59:00,114,103,Brinquedo,3,217
28801,2024-01-21 00:00:00,25,52,Brinquedo,2,77
28802,2024-01-21 00:01:00,87,117,Brinquedo,6,204
28803,2024-01-21 00:02:00,75,42,Eletrônico,8,117
28804,2024-01-21 00:03:00,78,76,Vestuário,3,154
28805,2024-01-21 00:04:00,67,173,Vestuário,4,240
28806,2024-01-21 00:05:00,55,178,Alimento,4,233
28807,2024-01-21 00:06:00,108,157,Brinquedo,7,265
28808,2024-01-21 00:07:00,54,168,Vestuário,9,222
28809,2024-01-21 00:08:00,81,15,Móvel,2,96
28810,2024-01-21 00:09:00,38,89,Alimento,5,127
28811,2024-01-21 00:10:00,38,65,Eletrônico,9,103
28812,2024-01-21 00:11:00,94,85,Móvel,2,179
28813,2024-01-21 00:12:00,71,169,Brinquedo,3,240
28814,2024-01-21 00:13:00,37,47,Móvel,1,84
28815,2024-01-21 00:14:00,82,12,Móvel,5,94
28816,2024-01-21 00:15:00,74,164,Alimento,9,238
28817,2024-01-21 00:16:00,88,69,Vestuário,3,157
28818,2024-01-21 00:17:00,105,172,Alimento,4,277
28819,2024-01-21 00:18:00,112,141,Brinquedo,3,253
28820,2024-01-21 00:19:00,98,85,Alimento,1,183
28821,2024-01-21 00:20:00,22,113,Vestuário,9,135
28822,2024-01-21 00:21:00,78,114,Brinquedo,7,192
28823,2024-01-21 00:22:00,112,94,Móvel,5,206
28824,2024-01-21 00:23:00,78,96,Vestuário,7,174
28825,2024-01-21 00:24:00,35,125,Alimento,3,160
28826,2024-01-21 00:25:00,80,152,Móvel,8,232
28827,2024-01-21 00:26:00,34,86,Vestuário,9,120
28828,2024-01-21 00:27:00,105,71,Móvel,1,176
28829,2024-01-21 00:28:00,74,132,Vestuário,5,206
28830,2024-01-21 00:29:00,20,38,Eletrônico,4,58
28831,2024-01-21 00:30:00,21,46,Vestuário,7,67
28832,2024-01-21 00:31:00,26,93,Vestuário,2,119
28833,2024-01-21 00:32:00,13,166,Vestuário,1,179
28834,2024-01-21 00:33:00,96,104,Eletrônico,2,200
28835,2024-01-21 00:34:00,45,24,Eletrônico,5,69
28836,2024-01-21 00:35:00,29,58,Vestuário,8,87
28837,2024-01-21 00:36:00,93,158,Eletrônico,4,251
28838,2024-01-21 00:37:00,14,111,Brinquedo,2,125
28839,2024-01-21 00:38:00,41,41,Móvel,6,82
28840,2024-01-21 00:39:00,117,21,Vestuário,6,138
28841,2024-01-21 00:40:00,41,118,Alimento,5,159
28842,2024-01-21 00:41:00,100,155,Móvel,1,255
28843,2024-01-21 00:42:00,66,75,Eletrônico,1,141
28844,2024-01-21 00:43:00,52,151,Vestuário,7,203
28845,2024-01-21 00:44:00,43,101,Eletrônico,1,144
28846,2024-01-21 00:45:00,85,112,Alimento,5,197
28847,2024-01-21 00:46:00,69,115,Móvel,1,184
28848,2024-01-21 00:47:00,45,132,Eletrônico,7,177
28849,2024-01-21 00:48:00,56,58,Alimento,5,114
28850,2024-01-21 00:49:00,103,168,Eletrônico,9,271
28851,2024-01-21 00:50:00,39,54,Eletrônico,6,93
28852,2024-01-21 00:51:00,114,69,Brinquedo,8,183
28853,2024-01-21 00:52:00,113,44,Brinquedo,5,157
28854,2024-01-21 00:53:00,17,149,Eletrônico,1,166
28855,2024-01-21 00:54:00,16,99,Eletrônico,1,115
28856,2024-01-21 00:55:00,100,32,Brinquedo,6,132
28857,2024-01-21 00:56:00,50,140,Móvel,3,190
28858,2024-01-21 00:57:00,37,138,Vestuário,1,175
28859,2024-01-21 00:58:00,116,31,Móvel,5,147
28860,2024-01-21 00:59:00,111,115,Brinquedo,4,226
28861,2024-01-21 01:00:00,104,52,Brinquedo,8,156
28862,2024-01-21 01:01:00,63,87,Vestuário,3,150
28863,2024-01-21 01:02:00,81,122,Móvel,9,203
28864,2024-01-21 01:03:00,94,84,Eletrônico,5,178
28865,2024-01-21 01:04:00,52,16,Alimento,4,68
28866,2024-01-21 01:05:00,94,84,Brinquedo,3,178
28867,2024-01-21 01:06:00,21,142,Alimento,2,163
28868,2024-01-21 01:07:00,108,152,Alimento,2,260
28869,2024-01-21 01:08:00,26,168,Brinquedo,3,194
28870,2024-01-21 01:09:00,58,77,Eletrônico,6,135
28871,2024-01-21 01:10:00,105,157,Brinquedo,1,262
28872,2024-01-21 01:11:00,74,47,Vestuário,3,121
28873,2024-01-21 01:12:00,103,77,Alimento,5,180
28874,2024-01-21 01:13:00,77,79,Vestuário,2,156
28875,2024-01-21 01:14:00,11,113,Alimento,7,124
28876,2024-01-21 01:15:00,81,71,Móvel,1,152
28877,2024-01-21 01:16:00,10,60,Móvel,1,70
28878,2024-01-21 01:17:00,27,50,Alimento,6,77
28879,2024-01-21 01:18:00,91,88,Eletrônico,9,179
28880,2024-01-21 01:19:00,95,160,Vestuário,7,255
28881,2024-01-21 01:20:00,19,152,Eletrônico,6,171
28882,2024-01-21 01:21:00,85,118,Alimento,2,203
28883,2024-01-21 01:22:00,27,70,Alimento,2,97
28884,2024-01-21 01:23:00,81,160,Alimento,2,241
28885,2024-01-21 01:24:00,40,176,Móvel,5,216
28886,2024-01-21 01:25:00,83,52,Eletrônico,3,135
28887,2024-01-21 01:26:00,40,138,Eletrônico,5,178
28888,2024-01-21 01:27:00,105,118,Vestuário,1,223
28889,2024-01-21 01:28:00,20,61,Alimento,5,81
28890,2024-01-21 01:29:00,89,25,Brinquedo,3,114
28891,2024-01-21 01:30:00,43,178,Vestuário,2,221
28892,2024-01-21 01:31:00,107,39,Eletrônico,7,146
28893,2024-01-21 01:32:00,39,61,Eletrônico,1,100
28894,2024-01-21 01:33:00,39,73,Alimento,9,112
28895,2024-01-21 01:34:00,91,16,Alimento,3,107
28896,2024-01-21 01:35:00,12,98,Eletrônico,9,110
28897,2024-01-21 01:36:00,33,72,Eletrônico,9,105
28898,2024-01-21 01:37:00,43,38,Brinquedo,3,81
28899,2024-01-21 01:38:00,36,165,Alimento,9,201
28900,2024-01-21 01:39:00,116,35,Alimento,8,151
28901,2024-01-21 01:40:00,103,124,Brinquedo,8,227
28902,2024-01-21 01:41:00,15,59,Brinquedo,7,74
28903,2024-01-21 01:42:00,65,116,Alimento,7,181
28904,2024-01-21 01:43:00,37,126,Brinquedo,2,163
28905,2024-01-21 01:44:00,32,32,Eletrônico,6,64
28906,2024-01-21 01:45:00,107,153,Alimento,2,260
28907,2024-01-21 01:46:00,54,54,Brinquedo,9,108
28908,2024-01-21 01:47:00,12,117,Brinquedo,4,129
28909,2024-01-21 01:48:00,38,62,Alimento,2,100
28910,2024-01-21 01:49:00,14,78,Eletrônico,6,92
28911,2024-01-21 01:50:00,81,123,Brinquedo,9,204
28912,2024-01-21 01:51:00,39,73,Vestuário,8,112
28913,2024-01-21 01:52:00,12,95,Vestuário,2,107
28914,2024-01-21 01:53:00,90,115,Vestuário,3,205
28915,2024-01-21 01:54:00,11,58,Vestuário,5,69
28916,2024-01-21 01:55:00,12,114,Brinquedo,5,126
28917,2024-01-21 01:56:00,106,129,Eletrônico,9,235
28918,2024-01-21 01:57:00,116,76,Eletrônico,1,192
28919,2024-01-21 01:58:00,58,136,Móvel,3,194
28920,2024-01-21 01:59:00,114,103,Móvel,2,217
28921,2024-01-21 02:00:00,25,100,Vestuário,1,125
28922,2024-01-21 02:01:00,38,12,Vestuário,6,50
28923,2024-01-21 02:02:00,42,126,Móvel,4,168
28924,2024-01-21 02:03:00,70,45,Eletrônico,7,115
28925,2024-01-21 02:04:00,93,37,Alimento,5,130
28926,2024-01-21 02:05:00,36,70,Brinquedo,3,106
28927,2024-01-21 02:06:00,35,77,Eletrônico,7,112
28928,2024-01-21 02:07:00,85,146,Eletrônico,9,231
28929,2024-01-21 02:08:00,11,46,Móvel,5,57
28930,2024-01-21 02:09:00,52,25,Móvel,9,77
28931,2024-01-21 02:10:00,28,58,Alimento,6,86
28932,2024-01-21 02:11:00,47,173,Móvel,7,220
28933,2024-01-21 02:12:00,28,113,Alimento,6,141
28934,2024-01-21 02:13:00,57,74,Eletrônico,5,131
28935,2024-01-21 02:14:00,41,126,Eletrônico,6,167
28936,2024-01-21 02:15:00,32,79,Alimento,3,111
28937,2024-01-21 02:16:00,105,124,Alimento,8,229
28938,2024-01-21 02:17:00,26,140,Alimento,8,166
28939,2024-01-21 02:18:00,18,130,Eletrônico,3,148
28940,2024-01-21 02:19:00,74,122,Vestuário,2,196
28941,2024-01-21 02:20:00,115,125,Eletrônico,4,240
28942,2024-01-21 02:21:00,104,21,Brinquedo,9,125
28943,2024-01-21 02:22:00,108,73,Vestuário,6,181
28944,2024-01-21 02:23:00,108,160,Móvel,1,268
28945,2024-01-21 02:24:00,40,88,Móvel,5,128
28946,2024-01-21 02:25:00,54,11,Brinquedo,6,65
28947,2024-01-21 02:26:00,44,90,Alimento,5,134
28948,2024-01-21 02:27:00,118,174,Móvel,1,292
28949,2024-01-21 02:28:00,70,128,Eletrônico,7,198
28950,2024-01-21 02:29:00,117,12,Vestuário,9,129
28951,2024-01-21 02:30:00,119,78,Eletrônico,7,197
28952,2024-01-21 02:31:00,44,138,Eletrônico,9,182
28953,2024-01-21 02:32:00,90,168,Alimento,1,258
28954,2024-01-21 02:33:00,83,127,Brinquedo,6,210
28955,2024-01-21 02:34:00,71,129,Vestuário,1,200
28956,2024-01-21 02:35:00,24,90,Móvel,5,114
28957,2024-01-21 02:36:00,49,148,Móvel,2,197
28958,2024-01-21 02:37:00,88,85,Brinquedo,8,173
28959,2024-01-21 02:38:00,104,124,Móvel,6,228
28960,2024-01-21 02:39:00,62,104,Brinquedo,7,166
28961,2024-01-21 02:40:00,42,15,Brinquedo,7,57
28962,2024-01-21 02:41:00,17,30,Brinquedo,5,47
28963,2024-01-21 02:42:00,77,52,Eletrônico,9,129
28964,2024-01-21 02:43:00,16,172,Eletrônico,3,188
28965,2024-01-21 02:44:00,49,107,Alimento,6,156
28966,2024-01-21 02:45:00,117,108,Brinquedo,2,225
28967,2024-01-21 02:46:00,74,82,Alimento,1,156
28968,2024-01-21 02:47:00,64,174,Eletrônico,6,238
28969,2024-01-21 02:48:00,67,128,Móvel,8,195
28970,2024-01-21 02:49:00,72,69,Alimento,7,141
28971,2024-01-21 02:50:00,53,58,Brinquedo,6,111
28972,2024-01-21 02:51:00,14,81,Brinquedo,4,95
28973,2024-01-21 02:52:00,62,62,Vestuário,7,124
28974,2024-01-21 02:53:00,59,89,Alimento,5,148
28975,2024-01-21 02:54:00,99,148,Vestuário,4,247
28976,2024-01-21 02:55:00,98,153,Brinquedo,2,251
28977,2024-01-21 02:56:00,87,36,Eletrônico,3,123
28978,2024-01-21 02:57:00,37,41,Móvel,4,78
28979,2024-01-21 02:58:00,82,40,Móvel,7,122
28980,2024-01-21 02:59:00,11,29,Brinquedo,9,40
28981,2024-01-21 03:00:00,119,171,Alimento,3,290
28982,2024-01-21 03:01:00,52,143,Alimento,7,195
28983,2024-01-21 03:02:00,100,165,Eletrônico,9,265
28984,2024-01-21 03:03:00,93,151,Móvel,9,244
28985,2024-01-21 03:04:00,101,115,Eletrônico,5,216
28986,2024-01-21 03:05:00,86,111,Eletrônico,2,197
28987,2024-01-21 03:06:00,28,80,Brinquedo,7,108
28988,2024-01-21 03:07:00,75,119,Móvel,5,194
28989,2024-01-21 03:08:00,32,33,Brinquedo,5,65
28990,2024-01-21 03:09:00,24,32,Alimento,4,56
28991,2024-01-21 03:10:00,66,160,Móvel,5,226
28992,2024-01-21 03:11:00,93,48,Alimento,4,141
28993,2024-01-21 03:12:00,28,104,Brinquedo,2,132
28994,2024-01-21 03:13:00,36,24,Móvel,8,60
28995,2024-01-21 03:14:00,21,56,Móvel,5,77
28996,2024-01-21 03:15:00,17,164,Alimento,8,181
28997,2024-01-21 03:16:00,102,87,Eletrônico,7,189
28998,2024-01-21 03:17:00,108,70,Vestuário,3,178
28999,2024-01-21 03:18:00,65,19,Alimento,1,84
29000,2024-01-21 03:19:00,78,24,Eletrônico,6,102
29001,2024-01-21 03:20:00,87,31,Móvel,8,118
29002,2024-01-21 03:21:00,15,115,Alimento,7,130
29003,2024-01-21 03:22:00,19,134,Móvel,1,153
29004,2024-01-21 03:23:00,48,166,Móvel,7,214
29005,2024-01-21 03:24:00,68,117,Móvel,9,185
29006,2024-01-21 03:25:00,26,171,Móvel,7,197
29007,2024-01-21 03:26:00,70,25,Vestuário,6,95
29008,2024-01-21 03:27:00,78,117,Móvel,9,195
29009,2024-01-21 03:28:00,83,20,Eletrônico,6,103
29010,2024-01-21 03:29:00,53,37,Eletrônico,8,90
29011,2024-01-21 03:30:00,37,37,Vestuário,8,74
29012,2024-01-21 03:31:00,93,73,Vestuário,8,166
29013,2024-01-21 03:32:00,94,99,Eletrônico,8,193
29014,2024-01-21 03:33:00,39,168,Alimento,6,207
29015,2024-01-21 03:34:00,38,133,Vestuário,6,171
29016,2024-01-21 03:35:00,40,86,Móvel,6,126
29017,2024-01-21 03:36:00,93,19,Alimento,7,112
29018,2024-01-21 03:37:00,53,73,Eletrônico,6,126
29019,2024-01-21 03:38:00,93,88,Vestuário,4,181
29020,2024-01-21 03:39:00,39,63,Alimento,5,102
29021,2024-01-21 03:40:00,116,178,Alimento,4,294
29022,2024-01-21 03:41:00,20,54,Vestuário,4,74
29023,2024-01-21 03:42:00,17,41,Eletrônico,5,58
29024,2024-01-21 03:43:00,42,108,Alimento,5,150
29025,2024-01-21 03:44:00,114,12,Vestuário,6,126
29026,2024-01-21 03:45:00,36,87,Alimento,7,123
29027,2024-01-21 03:46:00,15,104,Alimento,2,119
29028,2024-01-21 03:47:00,94,38,Móvel,2,132
29029,2024-01-21 03:48:00,108,60,Vestuário,8,168
29030,2024-01-21 03:49:00,87,28,Alimento,7,115
29031,2024-01-21 03:50:00,85,169,Alimento,7,254
29032,2024-01-21 03:51:00,107,97,Brinquedo,6,204
29033,2024-01-21 03:52:00,119,169,Eletrônico,9,288
29034,2024-01-21 03:53:00,94,43,Eletrônico,2,137
29035,2024-01-21 03:54:00,74,152,Alimento,2,226
29036,2024-01-21 03:55:00,76,60,Alimento,6,136
29037,2024-01-21 03:56:00,78,70,Brinquedo,1,148
29038,2024-01-21 03:57:00,82,77,Eletrônico,4,159
29039,2024-01-21 03:58:00,54,119,Alimento,5,173
29040,2024-01-21 03:59:00,83,26,Móvel,1,109
29041,2024-01-21 04:00:00,16,132,Vestuário,4,148
29042,2024-01-21 04:01:00,82,60,Vestuário,9,142
29043,2024-01-21 04:02:00,70,34,Vestuário,8,104
29044,2024-01-21 04:03:00,34,136,Alimento,1,170
29045,2024-01-21 04:04:00,89,91,Brinquedo,9,180
29046,2024-01-21 04:05:00,81,130,Eletrônico,9,211
29047,2024-01-21 04:06:00,119,16,Eletrônico,2,135
29048,2024-01-21 04:07:00,110,11,Eletrônico,2,121
29049,2024-01-21 04:08:00,10,74,Vestuário,2,84
29050,2024-01-21 04:09:00,13,84,Eletrônico,6,97
29051,2024-01-21 04:10:00,103,50,Vestuário,9,153
29052,2024-01-21 04:11:00,40,159,Vestuário,8,199
29053,2024-01-21 04:12:00,41,99,Brinquedo,6,140
29054,2024-01-21 04:13:00,58,47,Móvel,4,105
29055,2024-01-21 04:14:00,19,107,Alimento,5,126
29056,2024-01-21 04:15:00,44,79,Móvel,6,123
29057,2024-01-21 04:16:00,92,67,Alimento,6,159
29058,2024-01-21 04:17:00,38,113,Vestuário,1,151
29059,2024-01-21 04:18:00,76,125,Alimento,7,201
29060,2024-01-21 04:19:00,59,155,Móvel,5,214
29061,2024-01-21 04:20:00,71,30,Eletrônico,7,101
29062,2024-01-21 04:21:00,104,70,Móvel,9,174
29063,2024-01-21 04:22:00,67,101,Brinquedo,4,168
29064,2024-01-21 04:23:00,77,25,Brinquedo,6,102
29065,2024-01-21 04:24:00,73,15,Alimento,5,88
29066,2024-01-21 04:25:00,36,79,Alimento,7,115
29067,2024-01-21 04:26:00,116,11,Móvel,7,127
29068,2024-01-21 04:27:00,79,127,Eletrônico,1,206
29069,2024-01-21 04:28:00,11,90,Eletrônico,5,101
29070,2024-01-21 04:29:00,40,139,Alimento,4,179
29071,2024-01-21 04:30:00,116,166,Vestuário,8,282
29072,2024-01-21 04:31:00,22,43,Brinquedo,2,65
29073,2024-01-21 04:32:00,23,79,Eletrônico,3,102
29074,2024-01-21 04:33:00,21,29,Brinquedo,1,50
29075,2024-01-21 04:34:00,111,87,Brinquedo,3,198
29076,2024-01-21 04:35:00,47,66,Eletrônico,9,113
29077,2024-01-21 04:36:00,40,60,Vestuário,4,100
29078,2024-01-21 04:37:00,75,97,Brinquedo,6,172
29079,2024-01-21 04:38:00,63,85,Brinquedo,5,148
29080,2024-01-21 04:39:00,94,37,Vestuário,1,131
29081,2024-01-21 04:40:00,17,135,Móvel,9,152
29082,2024-01-21 04:41:00,55,136,Eletrônico,6,191
29083,2024-01-21 04:42:00,64,149,Eletrônico,9,213
29084,2024-01-21 04:43:00,112,96,Móvel,8,208
29085,2024-01-21 04:44:00,117,92,Alimento,5,209
29086,2024-01-21 04:45:00,50,139,Vestuário,9,189
29087,2024-01-21 04:46:00,51,46,Alimento,2,97
29088,2024-01-21 04:47:00,84,108,Móvel,9,192
29089,2024-01-21 04:48:00,92,97,Eletrônico,6,189
29090,2024-01-21 04:49:00,21,41,Brinquedo,4,62
29091,2024-01-21 04:50:00,58,164,Móvel,2,222
29092,2024-01-21 04:51:00,99,23,Móvel,3,122
29093,2024-01-21 04:52:00,106,100,Brinquedo,3,206
29094,2024-01-21 04:53:00,54,35,Eletrônico,4,89
29095,2024-01-21 04:54:00,107,114,Eletrônico,7,221
29096,2024-01-21 04:55:00,73,82,Vestuário,7,155
29097,2024-01-21 04:56:00,10,82,Vestuário,3,92
29098,2024-01-21 04:57:00,50,86,Vestuário,5,136
29099,2024-01-21 04:58:00,11,45,Eletrônico,9,56
29100,2024-01-21 04:59:00,111,65,Vestuário,5,176
29101,2024-01-21 05:00:00,87,160,Eletrônico,6,247
29102,2024-01-21 05:01:00,74,54,Eletrônico,7,128
29103,2024-01-21 05:02:00,47,117,Brinquedo,9,164
29104,2024-01-21 05:03:00,50,120,Vestuário,6,170
29105,2024-01-21 05:04:00,17,132,Eletrônico,6,149
29106,2024-01-21 05:05:00,22,145,Vestuário,9,167
29107,2024-01-21 05:06:00,28,46,Alimento,6,74
29108,2024-01-21 05:07:00,37,113,Eletrônico,9,150
29109,2024-01-21 05:08:00,104,56,Alimento,2,160
29110,2024-01-21 05:09:00,33,12,Móvel,2,45
29111,2024-01-21 05:10:00,74,71,Móvel,3,145
29112,2024-01-21 05:11:00,86,87,Eletrônico,7,173
29113,2024-01-21 05:12:00,25,128,Alimento,6,153
29114,2024-01-21 05:13:00,49,54,Brinquedo,9,103
29115,2024-01-21 05:14:00,50,68,Brinquedo,2,118
29116,2024-01-21 05:15:00,71,112,Alimento,4,183
29117,2024-01-21 05:16:00,100,23,Vestuário,5,123
29118,2024-01-21 05:17:00,21,130,Eletrônico,5,151
29119,2024-01-21 05:18:00,17,102,Móvel,3,119
29120,2024-01-21 05:19:00,54,153,Eletrônico,2,207
29121,2024-01-21 05:20:00,76,139,Vestuário,4,215
29122,2024-01-21 05:21:00,54,41,Vestuário,4,95
29123,2024-01-21 05:22:00,41,54,Eletrônico,7,95
29124,2024-01-21 05:23:00,29,97,Vestuário,7,126
29125,2024-01-21 05:24:00,20,87,Eletrônico,1,107
29126,2024-01-21 05:25:00,91,124,Brinquedo,2,215
29127,2024-01-21 05:26:00,104,94,Eletrônico,8,198
29128,2024-01-21 05:27:00,66,63,Alimento,7,129
29129,2024-01-21 05:28:00,58,35,Móvel,1,93
29130,2024-01-21 05:29:00,108,56,Vestuário,4,164
29131,2024-01-21 05:30:00,63,112,Vestuário,6,175
29132,2024-01-21 05:31:00,119,83,Móvel,2,202
29133,2024-01-21 05:32:00,40,26,Móvel,9,66
29134,2024-01-21 05:33:00,86,133,Eletrônico,5,219
29135,2024-01-21 05:34:00,103,38,Móvel,6,141
29136,2024-01-21 05:35:00,66,94,Vestuário,4,160
29137,2024-01-21 05:36:00,57,135,Brinquedo,5,192
29138,2024-01-21 05:37:00,115,94,Brinquedo,9,209
29139,2024-01-21 05:38:00,68,91,Eletrônico,5,159
29140,2024-01-21 05:39:00,113,68,Vestuário,9,181
29141,2024-01-21 05:40:00,81,36,Brinquedo,9,117
29142,2024-01-21 05:41:00,19,146,Alimento,4,165
29143,2024-01-21 05:42:00,18,70,Vestuário,9,88
29144,2024-01-21 05:43:00,74,139,Vestuário,2,213
29145,2024-01-21 05:44:00,90,85,Brinquedo,8,175
29146,2024-01-21 05:45:00,85,94,Brinquedo,1,179
29147,2024-01-21 05:46:00,86,66,Eletrônico,9,152
29148,2024-01-21 05:47:00,13,81,Vestuário,3,94
29149,2024-01-21 05:48:00,87,124,Móvel,3,211
29150,2024-01-21 05:49:00,50,177,Alimento,2,227
29151,2024-01-21 05:50:00,96,94,Alimento,3,190
29152,2024-01-21 05:51:00,94,47,Móvel,7,141
29153,2024-01-21 05:52:00,66,171,Brinquedo,3,237
29154,2024-01-21 05:53:00,59,95,Eletrônico,2,154
29155,2024-01-21 05:54:00,25,48,Eletrônico,9,73
29156,2024-01-21 05:55:00,50,11,Eletrônico,9,61
29157,2024-01-21 05:56:00,91,68,Eletrônico,9,159
29158,2024-01-21 05:57:00,100,117,Brinquedo,6,217
29159,2024-01-21 05:58:00,75,145,Vestuário,5,220
29160,2024-01-21 05:59:00,66,171,Alimento,4,237
29161,2024-01-21 06:00:00,117,96,Vestuário,1,213
29162,2024-01-21 06:01:00,44,118,Vestuário,3,162
29163,2024-01-21 06:02:00,101,164,Eletrônico,7,265
29164,2024-01-21 06:03:00,112,134,Vestuário,6,246
29165,2024-01-21 06:04:00,68,10,Alimento,6,78
29166,2024-01-21 06:05:00,79,14,Móvel,8,93
29167,2024-01-21 06:06:00,65,52,Móvel,3,117
29168,2024-01-21 06:07:00,56,79,Eletrônico,6,135
29169,2024-01-21 06:08:00,96,172,Eletrônico,1,268
29170,2024-01-21 06:09:00,118,59,Brinquedo,7,177
29171,2024-01-21 06:10:00,77,70,Alimento,9,147
29172,2024-01-21 06:11:00,91,128,Eletrônico,5,219
29173,2024-01-21 06:12:00,70,36,Vestuário,7,106
29174,2024-01-21 06:13:00,36,78,Alimento,6,114
29175,2024-01-21 06:14:00,58,159,Eletrônico,6,217
29176,2024-01-21 06:15:00,112,135,Vestuário,3,247
29177,2024-01-21 06:16:00,100,177,Eletrônico,1,277
29178,2024-01-21 06:17:00,56,93,Móvel,7,149
29179,2024-01-21 06:18:00,78,154,Eletrônico,6,232
29180,2024-01-21 06:19:00,102,81,Eletrônico,6,183
29181,2024-01-21 06:20:00,10,103,Vestuário,2,113
29182,2024-01-21 06:21:00,114,84,Brinquedo,4,198
29183,2024-01-21 06:22:00,99,63,Vestuário,3,162
29184,2024-01-21 06:23:00,65,104,Brinquedo,4,169
29185,2024-01-21 06:24:00,44,178,Brinquedo,9,222
29186,2024-01-21 06:25:00,92,89,Móvel,7,181
29187,2024-01-21 06:26:00,27,50,Eletrônico,6,77
29188,2024-01-21 06:27:00,68,102,Móvel,7,170
29189,2024-01-21 06:28:00,95,137,Vestuário,8,232
29190,2024-01-21 06:29:00,78,146,Alimento,4,224
29191,2024-01-21 06:30:00,79,83,Alimento,5,162
29192,2024-01-21 06:31:00,71,23,Móvel,9,94
29193,2024-01-21 06:32:00,116,25,Vestuário,8,141
29194,2024-01-21 06:33:00,42,82,Eletrônico,4,124
29195,2024-01-21 06:34:00,20,124,Móvel,5,144
29196,2024-01-21 06:35:00,41,137,Vestuário,7,178
29197,2024-01-21 06:36:00,19,177,Brinquedo,9,196
29198,2024-01-21 06:37:00,107,179,Alimento,3,286
29199,2024-01-21 06:38:00,54,93,Vestuário,9,147
29200,2024-01-21 06:39:00,15,106,Móvel,4,121
29201,2024-01-21 06:40:00,97,70,Brinquedo,5,167
29202,2024-01-21 06:41:00,11,140,Eletrônico,3,151
29203,2024-01-21 06:42:00,101,107,Móvel,9,208
29204,2024-01-21 06:43:00,12,143,Vestuário,9,155
29205,2024-01-21 06:44:00,35,47,Alimento,1,82
29206,2024-01-21 06:45:00,109,65,Vestuário,8,174
29207,2024-01-21 06:46:00,28,125,Móvel,8,153
29208,2024-01-21 06:47:00,50,31,Alimento,8,81
29209,2024-01-21 06:48:00,63,21,Brinquedo,1,84
29210,2024-01-21 06:49:00,73,62,Vestuário,8,135
29211,2024-01-21 06:50:00,19,55,Alimento,7,74
29212,2024-01-21 06:51:00,32,24,Móvel,5,56
29213,2024-01-21 06:52:00,84,76,Eletrônico,1,160
29214,2024-01-21 06:53:00,64,107,Vestuário,2,171
29215,2024-01-21 06:54:00,47,79,Móvel,5,126
29216,2024-01-21 06:55:00,49,176,Móvel,2,225
29217,2024-01-21 06:56:00,119,111,Eletrônico,2,230
29218,2024-01-21 06:57:00,116,16,Alimento,3,132
29219,2024-01-21 06:58:00,60,178,Brinquedo,6,238
29220,2024-01-21 06:59:00,39,152,Eletrônico,1,191
29221,2024-01-21 07:00:00,84,163,Alimento,5,247
29222,2024-01-21 07:01:00,83,167,Móvel,7,250
29223,2024-01-21 07:02:00,90,62,Eletrônico,9,152
29224,2024-01-21 07:03:00,97,95,Alimento,7,192
29225,2024-01-21 07:04:00,101,101,Vestuário,1,202
29226,2024-01-21 07:05:00,82,79,Vestuário,2,161
29227,2024-01-21 07:06:00,86,102,Vestuário,9,188
29228,2024-01-21 07:07:00,16,163,Brinquedo,6,179
29229,2024-01-21 07:08:00,16,56,Eletrônico,9,72
29230,2024-01-21 07:09:00,63,172,Brinquedo,9,235
29231,2024-01-21 07:10:00,118,117,Brinquedo,3,235
29232,2024-01-21 07:11:00,43,32,Vestuário,3,75
29233,2024-01-21 07:12:00,81,34,Móvel,2,115
29234,2024-01-21 07:13:00,13,39,Brinquedo,2,52
29235,2024-01-21 07:14:00,106,43,Alimento,1,149
29236,2024-01-21 07:15:00,84,66,Vestuário,3,150
29237,2024-01-21 07:16:00,64,51,Vestuário,7,115
29238,2024-01-21 07:17:00,58,145,Eletrônico,2,203
29239,2024-01-21 07:18:00,75,65,Vestuário,8,140
29240,2024-01-21 07:19:00,97,104,Brinquedo,3,201
29241,2024-01-21 07:20:00,90,27,Vestuário,9,117
29242,2024-01-21 07:21:00,17,93,Brinquedo,8,110
29243,2024-01-21 07:22:00,39,36,Brinquedo,6,75
29244,2024-01-21 07:23:00,108,124,Eletrônico,4,232
29245,2024-01-21 07:24:00,113,115,Alimento,6,228
29246,2024-01-21 07:25:00,59,174,Vestuário,1,233
29247,2024-01-21 07:26:00,12,80,Brinquedo,9,92
29248,2024-01-21 07:27:00,42,178,Eletrônico,7,220
29249,2024-01-21 07:28:00,75,149,Móvel,1,224
29250,2024-01-21 07:29:00,20,75,Alimento,5,95
29251,2024-01-21 07:30:00,56,162,Vestuário,8,218
29252,2024-01-21 07:31:00,100,48,Brinquedo,2,148
29253,2024-01-21 07:32:00,78,151,Alimento,8,229
29254,2024-01-21 07:33:00,103,114,Alimento,4,217
29255,2024-01-21 07:34:00,45,99,Vestuário,1,144
29256,2024-01-21 07:35:00,40,16,Brinquedo,4,56
29257,2024-01-21 07:36:00,40,168,Vestuário,1,208
29258,2024-01-21 07:37:00,26,44,Eletrônico,5,70
29259,2024-01-21 07:38:00,100,49,Móvel,3,149
29260,2024-01-21 07:39:00,17,48,Eletrônico,7,65
29261,2024-01-21 07:40:00,77,98,Alimento,3,175
29262,2024-01-21 07:41:00,17,143,Móvel,5,160
29263,2024-01-21 07:42:00,28,89,Eletrônico,8,117
29264,2024-01-21 07:43:00,55,29,Móvel,9,84
29265,2024-01-21 07:44:00,110,95,Brinquedo,9,205
29266,2024-01-21 07:45:00,69,138,Alimento,6,207
29267,2024-01-21 07:46:00,35,128,Brinquedo,6,163
29268,2024-01-21 07:47:00,53,35,Brinquedo,3,88
29269,2024-01-21 07:48:00,62,79,Brinquedo,3,141
29270,2024-01-21 07:49:00,94,107,Alimento,3,201
29271,2024-01-21 07:50:00,116,91,Eletrônico,4,207
29272,2024-01-21 07:51:00,24,173,Brinquedo,7,197
29273,2024-01-21 07:52:00,76,130,Eletrônico,5,206
29274,2024-01-21 07:53:00,64,163,Móvel,5,227
29275,2024-01-21 07:54:00,69,62,Eletrônico,9,131
29276,2024-01-21 07:55:00,91,130,Vestuário,7,221
29277,2024-01-21 07:56:00,112,104,Brinquedo,2,216
29278,2024-01-21 07:57:00,119,115,Móvel,1,234
29279,2024-01-21 07:58:00,39,110,Vestuário,4,149
29280,2024-01-21 07:59:00,40,75,Brinquedo,5,115
29281,2024-01-21 08:00:00,20,70,Alimento,7,90
29282,2024-01-21 08:01:00,77,110,Móvel,7,187
29283,2024-01-21 08:02:00,19,147,Eletrônico,2,166
29284,2024-01-21 08:03:00,56,52,Eletrônico,4,108
29285,2024-01-21 08:04:00,26,28,Alimento,3,54
29286,2024-01-21 08:05:00,39,177,Vestuário,3,216
29287,2024-01-21 08:06:00,68,164,Vestuário,4,232
29288,2024-01-21 08:07:00,115,176,Vestuário,6,291
29289,2024-01-21 08:08:00,57,48,Eletrônico,4,105
29290,2024-01-21 08:09:00,44,114,Vestuário,2,158
29291,2024-01-21 08:10:00,29,46,Eletrônico,7,75
29292,2024-01-21 08:11:00,10,20,Alimento,4,30
29293,2024-01-21 08:12:00,21,109,Brinquedo,5,130
29294,2024-01-21 08:13:00,19,104,Alimento,5,123
29295,2024-01-21 08:14:00,23,49,Móvel,4,72
29296,2024-01-21 08:15:00,63,132,Móvel,7,195
29297,2024-01-21 08:16:00,54,131,Vestuário,1,185
29298,2024-01-21 08:17:00,73,51,Vestuário,4,124
29299,2024-01-21 08:18:00,106,164,Brinquedo,3,270
29300,2024-01-21 08:19:00,53,177,Eletrônico,2,230
29301,2024-01-21 08:20:00,113,37,Brinquedo,5,150
29302,2024-01-21 08:21:00,78,146,Alimento,3,224
29303,2024-01-21 08:22:00,110,171,Brinquedo,2,281
29304,2024-01-21 08:23:00,57,135,Alimento,5,192
29305,2024-01-21 08:24:00,88,150,Móvel,6,238
29306,2024-01-21 08:25:00,73,174,Brinquedo,1,247
29307,2024-01-21 08:26:00,37,124,Móvel,2,161
29308,2024-01-21 08:27:00,33,146,Vestuário,1,179
29309,2024-01-21 08:28:00,81,42,Móvel,7,123
29310,2024-01-21 08:29:00,15,94,Móvel,3,109
29311,2024-01-21 08:30:00,61,152,Eletrônico,9,213
29312,2024-01-21 08:31:00,75,177,Brinquedo,2,252
29313,2024-01-21 08:32:00,94,14,Eletrônico,6,108
29314,2024-01-21 08:33:00,14,126,Alimento,7,140
29315,2024-01-21 08:34:00,17,40,Alimento,8,57
29316,2024-01-21 08:35:00,24,49,Alimento,5,73
29317,2024-01-21 08:36:00,20,37,Alimento,2,57
29318,2024-01-21 08:37:00,25,165,Eletrônico,7,190
29319,2024-01-21 08:38:00,102,37,Móvel,7,139
29320,2024-01-21 08:39:00,113,162,Eletrônico,1,275
29321,2024-01-21 08:40:00,69,139,Alimento,2,208
29322,2024-01-21 08:41:00,44,135,Eletrônico,5,179
29323,2024-01-21 08:42:00,95,59,Eletrônico,6,154
29324,2024-01-21 08:43:00,65,159,Vestuário,8,224
29325,2024-01-21 08:44:00,34,52,Eletrônico,3,86
29326,2024-01-21 08:45:00,101,64,Vestuário,7,165
29327,2024-01-21 08:46:00,61,178,Alimento,7,239
29328,2024-01-21 08:47:00,33,176,Vestuário,2,209
29329,2024-01-21 08:48:00,59,109,Móvel,5,168
29330,2024-01-21 08:49:00,29,44,Alimento,2,73
29331,2024-01-21 08:50:00,22,151,Alimento,6,173
29332,2024-01-21 08:51:00,18,90,Vestuário,5,108
29333,2024-01-21 08:52:00,70,56,Móvel,2,126
29334,2024-01-21 08:53:00,14,41,Vestuário,7,55
29335,2024-01-21 08:54:00,27,90,Móvel,9,117
29336,2024-01-21 08:55:00,111,165,Eletrônico,3,276
29337,2024-01-21 08:56:00,84,170,Eletrônico,1,254
29338,2024-01-21 08:57:00,77,95,Vestuário,3,172
29339,2024-01-21 08:58:00,119,81,Alimento,4,200
29340,2024-01-21 08:59:00,58,43,Vestuário,8,101
29341,2024-01-21 09:00:00,11,53,Móvel,6,64
29342,2024-01-21 09:01:00,60,60,Móvel,8,120
29343,2024-01-21 09:02:00,118,53,Eletrônico,4,171
29344,2024-01-21 09:03:00,102,144,Brinquedo,4,246
29345,2024-01-21 09:04:00,47,115,Eletrônico,4,162
29346,2024-01-21 09:05:00,83,50,Brinquedo,8,133
29347,2024-01-21 09:06:00,49,128,Brinquedo,7,177
29348,2024-01-21 09:07:00,59,169,Alimento,3,228
29349,2024-01-21 09:08:00,41,130,Vestuário,6,171
29350,2024-01-21 09:09:00,85,130,Brinquedo,6,215
29351,2024-01-21 09:10:00,65,40,Alimento,1,105
29352,2024-01-21 09:11:00,14,39,Brinquedo,9,53
29353,2024-01-21 09:12:00,98,43,Eletrônico,4,141
29354,2024-01-21 09:13:00,104,13,Eletrônico,7,117
29355,2024-01-21 09:14:00,42,59,Móvel,1,101
29356,2024-01-21 09:15:00,17,153,Alimento,7,170
29357,2024-01-21 09:16:00,67,175,Eletrônico,8,242
29358,2024-01-21 09:17:00,52,101,Móvel,4,153
29359,2024-01-21 09:18:00,18,132,Móvel,1,150
29360,2024-01-21 09:19:00,78,96,Brinquedo,8,174
29361,2024-01-21 09:20:00,69,110,Vestuário,8,179
29362,2024-01-21 09:21:00,80,66,Brinquedo,9,146
29363,2024-01-21 09:22:00,26,34,Vestuário,4,60
29364,2024-01-21 09:23:00,47,155,Móvel,8,202
29365,2024-01-21 09:24:00,34,31,Brinquedo,6,65
29366,2024-01-21 09:25:00,84,139,Móvel,8,223
29367,2024-01-21 09:26:00,116,74,Vestuário,2,190
29368,2024-01-21 09:27:00,99,14,Eletrônico,2,113
29369,2024-01-21 09:28:00,114,172,Vestuário,7,286
29370,2024-01-21 09:29:00,54,98,Alimento,8,152
29371,2024-01-21 09:30:00,59,139,Eletrônico,2,198
29372,2024-01-21 09:31:00,72,62,Vestuário,4,134
29373,2024-01-21 09:32:00,15,71,Alimento,9,86
29374,2024-01-21 09:33:00,111,122,Brinquedo,5,233
29375,2024-01-21 09:34:00,99,140,Móvel,6,239
29376,2024-01-21 09:35:00,65,148,Brinquedo,4,213
29377,2024-01-21 09:36:00,80,14,Eletrônico,2,94
29378,2024-01-21 09:37:00,10,114,Alimento,3,124
29379,2024-01-21 09:38:00,65,113,Alimento,4,178
29380,2024-01-21 09:39:00,62,108,Vestuário,7,170
29381,2024-01-21 09:40:00,97,93,Vestuário,5,190
29382,2024-01-21 09:41:00,42,37,Eletrônico,5,79
29383,2024-01-21 09:42:00,59,52,Móvel,3,111
29384,2024-01-21 09:43:00,102,169,Eletrônico,6,271
29385,2024-01-21 09:44:00,18,22,Alimento,5,40
29386,2024-01-21 09:45:00,44,47,Eletrônico,4,91
29387,2024-01-21 09:46:00,70,49,Eletrônico,8,119
29388,2024-01-21 09:47:00,76,148,Brinquedo,9,224
29389,2024-01-21 09:48:00,43,70,Alimento,8,113
29390,2024-01-21 09:49:00,97,178,Vestuário,7,275
29391,2024-01-21 09:50:00,100,98,Móvel,6,198
29392,2024-01-21 09:51:00,42,108,Móvel,1,150
29393,2024-01-21 09:52:00,63,43,Brinquedo,5,106
29394,2024-01-21 09:53:00,13,29,Vestuário,8,42
29395,2024-01-21 09:54:00,39,51,Alimento,9,90
29396,2024-01-21 09:55:00,20,111,Alimento,7,131
29397,2024-01-21 09:56:00,46,82,Vestuário,8,128
29398,2024-01-21 09:57:00,112,12,Eletrônico,3,124
29399,2024-01-21 09:58:00,96,138,Eletrônico,2,234
29400,2024-01-21 09:59:00,86,125,Móvel,4,211
29401,2024-01-21 10:00:00,70,90,Vestuário,2,160
29402,2024-01-21 10:01:00,17,17,Brinquedo,1,34
29403,2024-01-21 10:02:00,115,143,Móvel,2,258
29404,2024-01-21 10:03:00,15,11,Eletrônico,1,26
29405,2024-01-21 10:04:00,90,75,Alimento,1,165
29406,2024-01-21 10:05:00,113,135,Eletrônico,1,248
29407,2024-01-21 10:06:00,64,144,Móvel,4,208
29408,2024-01-21 10:07:00,70,127,Brinquedo,4,197
29409,2024-01-21 10:08:00,72,22,Eletrônico,1,94
29410,2024-01-21 10:09:00,47,49,Brinquedo,4,96
29411,2024-01-21 10:10:00,33,40,Vestuário,5,73
29412,2024-01-21 10:11:00,116,43,Móvel,7,159
29413,2024-01-21 10:12:00,51,72,Eletrônico,9,123
29414,2024-01-21 10:13:00,52,45,Alimento,5,97
29415,2024-01-21 10:14:00,65,94,Brinquedo,1,159
29416,2024-01-21 10:15:00,48,113,Alimento,9,161
29417,2024-01-21 10:16:00,40,120,Alimento,4,160
29418,2024-01-21 10:17:00,65,126,Eletrônico,9,191
29419,2024-01-21 10:18:00,46,174,Móvel,4,220
29420,2024-01-21 10:19:00,44,164,Brinquedo,8,208
29421,2024-01-21 10:20:00,12,67,Brinquedo,6,79
29422,2024-01-21 10:21:00,61,110,Vestuário,2,171
29423,2024-01-21 10:22:00,68,27,Brinquedo,2,95
29424,2024-01-21 10:23:00,11,45,Móvel,3,56
29425,2024-01-21 10:24:00,70,10,Móvel,9,80
29426,2024-01-21 10:25:00,83,15,Eletrônico,5,98
29427,2024-01-21 10:26:00,108,67,Vestuário,6,175
29428,2024-01-21 10:27:00,70,44,Vestuário,5,114
29429,2024-01-21 10:28:00,43,116,Eletrônico,9,159
29430,2024-01-21 10:29:00,63,106,Vestuário,2,169
29431,2024-01-21 10:30:00,90,80,Brinquedo,7,170
29432,2024-01-21 10:31:00,19,121,Vestuário,2,140
29433,2024-01-21 10:32:00,114,115,Brinquedo,7,229
29434,2024-01-21 10:33:00,36,162,Vestuário,9,198
29435,2024-01-21 10:34:00,89,147,Vestuário,2,236
29436,2024-01-21 10:35:00,92,109,Móvel,4,201
29437,2024-01-21 10:36:00,74,47,Eletrônico,1,121
29438,2024-01-21 10:37:00,116,36,Vestuário,9,152
29439,2024-01-21 10:38:00,35,109,Vestuário,9,144
29440,2024-01-21 10:39:00,90,23,Brinquedo,8,113
29441,2024-01-21 10:40:00,71,114,Vestuário,9,185
29442,2024-01-21 10:41:00,86,106,Brinquedo,3,192
29443,2024-01-21 10:42:00,30,10,Móvel,8,40
29444,2024-01-21 10:43:00,62,123,Eletrônico,6,185
29445,2024-01-21 10:44:00,93,68,Eletrônico,5,161
29446,2024-01-21 10:45:00,106,27,Alimento,9,133
29447,2024-01-21 10:46:00,32,24,Brinquedo,9,56
29448,2024-01-21 10:47:00,78,68,Eletrônico,6,146
29449,2024-01-21 10:48:00,43,97,Vestuário,5,140
29450,2024-01-21 10:49:00,34,36,Eletrônico,3,70
29451,2024-01-21 10:50:00,94,129,Alimento,7,223
29452,2024-01-21 10:51:00,53,34,Brinquedo,9,87
29453,2024-01-21 10:52:00,27,68,Eletrônico,1,95
29454,2024-01-21 10:53:00,24,161,Eletrônico,6,185
29455,2024-01-21 10:54:00,30,33,Alimento,6,63
29456,2024-01-21 10:55:00,110,44,Vestuário,9,154
29457,2024-01-21 10:56:00,80,89,Móvel,8,169
29458,2024-01-21 10:57:00,110,105,Brinquedo,1,215
29459,2024-01-21 10:58:00,46,12,Alimento,6,58
29460,2024-01-21 10:59:00,52,152,Móvel,1,204
29461,2024-01-21 11:00:00,87,45,Alimento,7,132
29462,2024-01-21 11:01:00,56,102,Brinquedo,3,158
29463,2024-01-21 11:02:00,59,106,Vestuário,4,165
29464,2024-01-21 11:03:00,60,41,Alimento,9,101
29465,2024-01-21 11:04:00,30,160,Alimento,1,190
29466,2024-01-21 11:05:00,59,84,Alimento,1,143
29467,2024-01-21 11:06:00,86,119,Alimento,8,205
29468,2024-01-21 11:07:00,82,169,Vestuário,1,251
29469,2024-01-21 11:08:00,93,11,Alimento,7,104
29470,2024-01-21 11:09:00,109,34,Móvel,9,143
29471,2024-01-21 11:10:00,55,84,Eletrônico,7,139
29472,2024-01-21 11:11:00,77,37,Vestuário,6,114
29473,2024-01-21 11:12:00,101,57,Vestuário,8,158
29474,2024-01-21 11:13:00,100,94,Vestuário,8,194
29475,2024-01-21 11:14:00,27,29,Alimento,1,56
29476,2024-01-21 11:15:00,51,175,Móvel,9,226
29477,2024-01-21 11:16:00,92,146,Vestuário,4,238
29478,2024-01-21 11:17:00,119,114,Alimento,9,233
29479,2024-01-21 11:18:00,66,129,Vestuário,6,195
29480,2024-01-21 11:19:00,41,53,Móvel,1,94
29481,2024-01-21 11:20:00,98,25,Vestuário,8,123
29482,2024-01-21 11:21:00,54,172,Móvel,4,226
29483,2024-01-21 11:22:00,49,38,Brinquedo,4,87
29484,2024-01-21 11:23:00,13,60,Vestuário,4,73
29485,2024-01-21 11:24:00,68,62,Alimento,6,130
29486,2024-01-21 11:25:00,74,93,Móvel,2,167
29487,2024-01-21 11:26:00,34,97,Eletrônico,9,131
29488,2024-01-21 11:27:00,17,144,Brinquedo,5,161
29489,2024-01-21 11:28:00,12,63,Móvel,1,75
29490,2024-01-21 11:29:00,30,86,Brinquedo,2,116
29491,2024-01-21 11:30:00,87,129,Eletrônico,3,216
29492,2024-01-21 11:31:00,87,48,Eletrônico,4,135
29493,2024-01-21 11:32:00,22,133,Brinquedo,5,155
29494,2024-01-21 11:33:00,11,119,Vestuário,3,130
29495,2024-01-21 11:34:00,81,46,Brinquedo,4,127
29496,2024-01-21 11:35:00,27,28,Alimento,6,55
29497,2024-01-21 11:36:00,12,65,Vestuário,8,77
29498,2024-01-21 11:37:00,37,49,Alimento,1,86
29499,2024-01-21 11:38:00,90,66,Alimento,4,156
29500,2024-01-21 11:39:00,55,175,Eletrônico,6,230
29501,2024-01-21 11:40:00,56,38,Vestuário,7,94
29502,2024-01-21 11:41:00,63,91,Eletrônico,4,154
29503,2024-01-21 11:42:00,61,145,Móvel,8,206
29504,2024-01-21 11:43:00,46,66,Móvel,8,112
29505,2024-01-21 11:44:00,10,57,Alimento,1,67
29506,2024-01-21 11:45:00,21,47,Eletrônico,1,68
29507,2024-01-21 11:46:00,100,20,Alimento,5,120
29508,2024-01-21 11:47:00,60,90,Brinquedo,1,150
29509,2024-01-21 11:48:00,30,114,Vestuário,9,144
29510,2024-01-21 11:49:00,82,25,Móvel,4,107
29511,2024-01-21 11:50:00,75,62,Vestuário,4,137
29512,2024-01-21 11:51:00,35,162,Brinquedo,3,197
29513,2024-01-21 11:52:00,33,68,Brinquedo,5,101
29514,2024-01-21 11:53:00,67,136,Alimento,3,203
29515,2024-01-21 11:54:00,34,130,Móvel,1,164
29516,2024-01-21 11:55:00,83,35,Brinquedo,5,118
29517,2024-01-21 11:56:00,87,79,Alimento,4,166
29518,2024-01-21 11:57:00,88,104,Vestuário,1,192
29519,2024-01-21 11:58:00,69,138,Brinquedo,7,207
29520,2024-01-21 11:59:00,81,21,Alimento,2,102
29521,2024-01-21 12:00:00,108,58,Vestuário,8,166
29522,2024-01-21 12:01:00,81,38,Brinquedo,5,119
29523,2024-01-21 12:02:00,24,38,Brinquedo,7,62
29524,2024-01-21 12:03:00,67,147,Brinquedo,8,214
29525,2024-01-21 12:04:00,45,47,Alimento,5,92
29526,2024-01-21 12:05:00,62,44,Móvel,2,106
29527,2024-01-21 12:06:00,90,146,Vestuário,9,236
29528,2024-01-21 12:07:00,47,118,Eletrônico,3,165
29529,2024-01-21 12:08:00,24,70,Móvel,5,94
29530,2024-01-21 12:09:00,78,129,Móvel,6,207
29531,2024-01-21 12:10:00,35,141,Brinquedo,1,176
29532,2024-01-21 12:11:00,15,112,Brinquedo,1,127
29533,2024-01-21 12:12:00,18,46,Alimento,1,64
29534,2024-01-21 12:13:00,36,78,Vestuário,6,114
29535,2024-01-21 12:14:00,18,174,Brinquedo,4,192
29536,2024-01-21 12:15:00,101,56,Móvel,2,157
29537,2024-01-21 12:16:00,78,54,Brinquedo,9,132
29538,2024-01-21 12:17:00,59,44,Vestuário,3,103
29539,2024-01-21 12:18:00,84,83,Móvel,2,167
29540,2024-01-21 12:19:00,105,179,Brinquedo,1,284
29541,2024-01-21 12:20:00,72,108,Alimento,2,180
29542,2024-01-21 12:21:00,17,81,Móvel,4,98
29543,2024-01-21 12:22:00,119,66,Vestuário,7,185
29544,2024-01-21 12:23:00,53,65,Eletrônico,2,118
29545,2024-01-21 12:24:00,115,66,Brinquedo,3,181
29546,2024-01-21 12:25:00,112,14,Eletrônico,8,126
29547,2024-01-21 12:26:00,81,149,Vestuário,4,230
29548,2024-01-21 12:27:00,115,122,Eletrônico,2,237
29549,2024-01-21 12:28:00,29,129,Eletrônico,1,158
29550,2024-01-21 12:29:00,52,121,Móvel,7,173
29551,2024-01-21 12:30:00,69,148,Móvel,3,217
29552,2024-01-21 12:31:00,64,117,Móvel,2,181
29553,2024-01-21 12:32:00,70,97,Vestuário,9,167
29554,2024-01-21 12:33:00,115,72,Eletrônico,4,187
29555,2024-01-21 12:34:00,35,115,Móvel,5,150
29556,2024-01-21 12:35:00,22,154,Alimento,1,176
29557,2024-01-21 12:36:00,111,136,Vestuário,9,247
29558,2024-01-21 12:37:00,12,102,Alimento,1,114
29559,2024-01-21 12:38:00,111,135,Alimento,7,246
29560,2024-01-21 12:39:00,90,17,Vestuário,9,107
29561,2024-01-21 12:40:00,94,67,Eletrônico,6,161
29562,2024-01-21 12:41:00,90,142,Alimento,2,232
29563,2024-01-21 12:42:00,70,15,Brinquedo,4,85
29564,2024-01-21 12:43:00,52,12,Vestuário,8,64
29565,2024-01-21 12:44:00,91,138,Eletrônico,1,229
29566,2024-01-21 12:45:00,119,57,Brinquedo,5,176
29567,2024-01-21 12:46:00,15,23,Alimento,7,38
29568,2024-01-21 12:47:00,117,168,Vestuário,9,285
29569,2024-01-21 12:48:00,116,167,Eletrônico,3,283
29570,2024-01-21 12:49:00,118,150,Eletrônico,4,268
29571,2024-01-21 12:50:00,110,164,Eletrônico,8,274
29572,2024-01-21 12:51:00,40,38,Vestuário,7,78
29573,2024-01-21 12:52:00,92,131,Alimento,7,223
29574,2024-01-21 12:53:00,108,130,Vestuário,3,238
29575,2024-01-21 12:54:00,95,70,Brinquedo,8,165
29576,2024-01-21 12:55:00,11,112,Móvel,5,123
29577,2024-01-21 12:56:00,30,81,Brinquedo,7,111
29578,2024-01-21 12:57:00,78,69,Alimento,2,147
29579,2024-01-21 12:58:00,50,123,Móvel,1,173
29580,2024-01-21 12:59:00,11,88,Alimento,7,99
29581,2024-01-21 13:00:00,19,60,Alimento,4,79
29582,2024-01-21 13:01:00,75,17,Brinquedo,2,92
29583,2024-01-21 13:02:00,62,25,Alimento,5,87
29584,2024-01-21 13:03:00,67,158,Eletrônico,9,225
29585,2024-01-21 13:04:00,36,104,Eletrônico,3,140
29586,2024-01-21 13:05:00,41,80,Eletrônico,1,121
29587,2024-01-21 13:06:00,91,74,Alimento,4,165
29588,2024-01-21 13:07:00,19,33,Alimento,5,52
29589,2024-01-21 13:08:00,58,77,Móvel,1,135
29590,2024-01-21 13:09:00,41,53,Móvel,9,94
29591,2024-01-21 13:10:00,75,22,Brinquedo,2,97
29592,2024-01-21 13:11:00,16,17,Vestuário,4,33
29593,2024-01-21 13:12:00,79,55,Vestuário,4,134
29594,2024-01-21 13:13:00,71,90,Eletrônico,6,161
29595,2024-01-21 13:14:00,22,113,Eletrônico,1,135
29596,2024-01-21 13:15:00,61,69,Vestuário,8,130
29597,2024-01-21 13:16:00,109,164,Móvel,4,273
29598,2024-01-21 13:17:00,42,145,Alimento,8,187
29599,2024-01-21 13:18:00,48,66,Eletrônico,8,114
29600,2024-01-21 13:19:00,42,21,Brinquedo,5,63
29601,2024-01-21 13:20:00,76,61,Alimento,2,137
29602,2024-01-21 13:21:00,11,57,Eletrônico,4,68
29603,2024-01-21 13:22:00,58,120,Alimento,5,178
29604,2024-01-21 13:23:00,86,133,Móvel,5,219
29605,2024-01-21 13:24:00,40,88,Alimento,3,128
29606,2024-01-21 13:25:00,57,84,Vestuário,4,141
29607,2024-01-21 13:26:00,49,130,Brinquedo,1,179
29608,2024-01-21 13:27:00,59,132,Móvel,9,191
29609,2024-01-21 13:28:00,62,102,Eletrônico,5,164
29610,2024-01-21 13:29:00,108,147,Eletrônico,4,255
29611,2024-01-21 13:30:00,32,43,Alimento,5,75
29612,2024-01-21 13:31:00,91,131,Eletrônico,7,222
29613,2024-01-21 13:32:00,78,71,Eletrônico,5,149
29614,2024-01-21 13:33:00,62,82,Vestuário,1,144
29615,2024-01-21 13:34:00,11,15,Alimento,1,26
29616,2024-01-21 13:35:00,62,152,Brinquedo,8,214
29617,2024-01-21 13:36:00,47,154,Eletrônico,2,201
29618,2024-01-21 13:37:00,85,35,Brinquedo,3,120
29619,2024-01-21 13:38:00,49,103,Brinquedo,2,152
29620,2024-01-21 13:39:00,33,75,Vestuário,7,108
29621,2024-01-21 13:40:00,17,122,Eletrônico,5,139
29622,2024-01-21 13:41:00,106,30,Móvel,2,136
29623,2024-01-21 13:42:00,51,104,Brinquedo,3,155
29624,2024-01-21 13:43:00,15,164,Alimento,8,179
29625,2024-01-21 13:44:00,34,108,Alimento,4,142
29626,2024-01-21 13:45:00,17,39,Brinquedo,7,56
29627,2024-01-21 13:46:00,34,67,Brinquedo,9,101
29628,2024-01-21 13:47:00,119,69,Móvel,3,188
29629,2024-01-21 13:48:00,68,23,Vestuário,5,91
29630,2024-01-21 13:49:00,42,154,Brinquedo,4,196
29631,2024-01-21 13:50:00,71,100,Vestuário,2,171
29632,2024-01-21 13:51:00,76,164,Eletrônico,7,240
29633,2024-01-21 13:52:00,65,105,Eletrônico,1,170
29634,2024-01-21 13:53:00,36,15,Móvel,2,51
29635,2024-01-21 13:54:00,35,90,Brinquedo,6,125
29636,2024-01-21 13:55:00,69,31,Vestuário,4,100
29637,2024-01-21 13:56:00,80,151,Brinquedo,7,231
29638,2024-01-21 13:57:00,108,30,Brinquedo,1,138
29639,2024-01-21 13:58:00,35,36,Alimento,1,71
29640,2024-01-21 13:59:00,66,175,Brinquedo,9,241
29641,2024-01-21 14:00:00,49,15,Vestuário,9,64
29642,2024-01-21 14:01:00,92,50,Vestuário,8,142
29643,2024-01-21 14:02:00,57,65,Eletrônico,6,122
29644,2024-01-21 14:03:00,49,139,Eletrônico,6,188
29645,2024-01-21 14:04:00,13,16,Eletrônico,1,29
29646,2024-01-21 14:05:00,35,33,Móvel,5,68
29647,2024-01-21 14:06:00,72,150,Eletrônico,7,222
29648,2024-01-21 14:07:00,18,47,Eletrônico,4,65
29649,2024-01-21 14:08:00,64,98,Brinquedo,1,162
29650,2024-01-21 14:09:00,40,138,Vestuário,1,178
29651,2024-01-21 14:10:00,68,166,Móvel,4,234
29652,2024-01-21 14:11:00,71,160,Brinquedo,3,231
29653,2024-01-21 14:12:00,30,100,Eletrônico,2,130
29654,2024-01-21 14:13:00,51,171,Eletrônico,2,222
29655,2024-01-21 14:14:00,25,178,Eletrônico,1,203
29656,2024-01-21 14:15:00,21,68,Vestuário,5,89
29657,2024-01-21 14:16:00,57,161,Eletrônico,5,218
29658,2024-01-21 14:17:00,115,50,Móvel,3,165
29659,2024-01-21 14:18:00,102,28,Móvel,5,130
29660,2024-01-21 14:19:00,35,49,Brinquedo,4,84
29661,2024-01-21 14:20:00,39,31,Vestuário,3,70
29662,2024-01-21 14:21:00,78,162,Móvel,2,240
29663,2024-01-21 14:22:00,53,16,Eletrônico,1,69
29664,2024-01-21 14:23:00,47,90,Eletrônico,2,137
29665,2024-01-21 14:24:00,118,84,Móvel,5,202
29666,2024-01-21 14:25:00,28,138,Vestuário,8,166
29667,2024-01-21 14:26:00,100,43,Alimento,1,143
29668,2024-01-21 14:27:00,11,137,Vestuário,4,148
29669,2024-01-21 14:28:00,16,158,Vestuário,6,174
29670,2024-01-21 14:29:00,52,137,Vestuário,9,189
29671,2024-01-21 14:30:00,85,50,Eletrônico,3,135
29672,2024-01-21 14:31:00,53,53,Alimento,4,106
29673,2024-01-21 14:32:00,105,70,Alimento,9,175
29674,2024-01-21 14:33:00,21,72,Alimento,9,93
29675,2024-01-21 14:34:00,16,126,Brinquedo,4,142
29676,2024-01-21 14:35:00,28,126,Móvel,7,154
29677,2024-01-21 14:36:00,28,162,Brinquedo,4,190
29678,2024-01-21 14:37:00,103,142,Alimento,9,245
29679,2024-01-21 14:38:00,73,32,Alimento,5,105
29680,2024-01-21 14:39:00,15,138,Brinquedo,3,153
29681,2024-01-21 14:40:00,40,137,Eletrônico,6,177
29682,2024-01-21 14:41:00,65,83,Móvel,2,148
29683,2024-01-21 14:42:00,77,76,Brinquedo,5,153
29684,2024-01-21 14:43:00,80,88,Brinquedo,8,168
29685,2024-01-21 14:44:00,42,56,Eletrônico,5,98
29686,2024-01-21 14:45:00,65,73,Móvel,1,138
29687,2024-01-21 14:46:00,76,110,Alimento,1,186
29688,2024-01-21 14:47:00,86,141,Vestuário,9,227
29689,2024-01-21 14:48:00,12,86,Vestuário,1,98
29690,2024-01-21 14:49:00,87,72,Brinquedo,9,159
29691,2024-01-21 14:50:00,91,18,Brinquedo,1,109
29692,2024-01-21 14:51:00,105,82,Eletrônico,4,187
29693,2024-01-21 14:52:00,74,50,Alimento,6,124
29694,2024-01-21 14:53:00,43,13,Alimento,7,56
29695,2024-01-21 14:54:00,61,97,Alimento,3,158
29696,2024-01-21 14:55:00,106,87,Móvel,3,193
29697,2024-01-21 14:56:00,39,169,Móvel,2,208
29698,2024-01-21 14:57:00,53,150,Alimento,2,203
29699,2024-01-21 14:58:00,85,13,Vestuário,9,98
29700,2024-01-21 14:59:00,22,150,Brinquedo,3,172
29701,2024-01-21 15:00:00,88,102,Eletrônico,1,190
29702,2024-01-21 15:01:00,44,24,Vestuário,1,68
29703,2024-01-21 15:02:00,51,20,Móvel,4,71
29704,2024-01-21 15:03:00,12,149,Brinquedo,1,161
29705,2024-01-21 15:04:00,41,163,Vestuário,6,204
29706,2024-01-21 15:05:00,21,123,Brinquedo,2,144
29707,2024-01-21 15:06:00,90,122,Vestuário,8,212
29708,2024-01-21 15:07:00,90,32,Eletrônico,2,122
29709,2024-01-21 15:08:00,113,141,Móvel,8,254
29710,2024-01-21 15:09:00,32,96,Vestuário,9,128
29711,2024-01-21 15:10:00,32,117,Alimento,9,149
29712,2024-01-21 15:11:00,52,167,Brinquedo,3,219
29713,2024-01-21 15:12:00,74,176,Eletrônico,1,250
29714,2024-01-21 15:13:00,115,25,Alimento,2,140
29715,2024-01-21 15:14:00,91,140,Móvel,1,231
29716,2024-01-21 15:15:00,110,91,Eletrônico,3,201
29717,2024-01-21 15:16:00,78,46,Vestuário,2,124
29718,2024-01-21 15:17:00,97,54,Vestuário,6,151
29719,2024-01-21 15:18:00,63,110,Móvel,7,173
29720,2024-01-21 15:19:00,62,116,Eletrônico,5,178
29721,2024-01-21 15:20:00,72,173,Vestuário,7,245
29722,2024-01-21 15:21:00,71,163,Móvel,5,234
29723,2024-01-21 15:22:00,113,83,Vestuário,8,196
29724,2024-01-21 15:23:00,13,150,Alimento,9,163
29725,2024-01-21 15:24:00,111,64,Brinquedo,8,175
29726,2024-01-21 15:25:00,85,145,Móvel,1,230
29727,2024-01-21 15:26:00,63,92,Móvel,5,155
29728,2024-01-21 15:27:00,84,84,Vestuário,1,168
29729,2024-01-21 15:28:00,111,176,Móvel,8,287
29730,2024-01-21 15:29:00,22,85,Eletrônico,5,107
29731,2024-01-21 15:30:00,117,164,Eletrônico,5,281
29732,2024-01-21 15:31:00,68,172,Alimento,8,240
29733,2024-01-21 15:32:00,113,133,Vestuário,8,246
29734,2024-01-21 15:33:00,13,25,Móvel,3,38
29735,2024-01-21 15:34:00,45,115,Eletrônico,2,160
29736,2024-01-21 15:35:00,114,157,Alimento,2,271
29737,2024-01-21 15:36:00,14,52,Vestuário,7,66
29738,2024-01-21 15:37:00,21,46,Eletrônico,4,67
29739,2024-01-21 15:38:00,94,27,Vestuário,1,121
29740,2024-01-21 15:39:00,68,80,Móvel,2,148
29741,2024-01-21 15:40:00,49,122,Brinquedo,8,171
29742,2024-01-21 15:41:00,115,178,Brinquedo,3,293
29743,2024-01-21 15:42:00,79,108,Eletrônico,3,187
29744,2024-01-21 15:43:00,67,105,Brinquedo,4,172
29745,2024-01-21 15:44:00,60,163,Brinquedo,5,223
29746,2024-01-21 15:45:00,22,168,Eletrônico,7,190
29747,2024-01-21 15:46:00,42,124,Brinquedo,3,166
29748,2024-01-21 15:47:00,92,66,Móvel,9,158
29749,2024-01-21 15:48:00,62,147,Alimento,3,209
29750,2024-01-21 15:49:00,44,58,Móvel,4,102
29751,2024-01-21 15:50:00,84,70,Móvel,4,154
29752,2024-01-21 15:51:00,52,119,Alimento,6,171
29753,2024-01-21 15:52:00,53,106,Brinquedo,1,159
29754,2024-01-21 15:53:00,48,28,Alimento,6,76
29755,2024-01-21 15:54:00,16,26,Móvel,3,42
29756,2024-01-21 15:55:00,76,156,Eletrônico,7,232
29757,2024-01-21 15:56:00,44,129,Móvel,3,173
29758,2024-01-21 15:57:00,62,108,Alimento,7,170
29759,2024-01-21 15:58:00,89,158,Brinquedo,4,247
29760,2024-01-21 15:59:00,112,22,Móvel,7,134
29761,2024-01-21 16:00:00,116,104,Eletrônico,4,220
29762,2024-01-21 16:01:00,63,153,Eletrônico,7,216
29763,2024-01-21 16:02:00,119,123,Vestuário,4,242
29764,2024-01-21 16:03:00,82,38,Vestuário,8,120
29765,2024-01-21 16:04:00,71,127,Eletrônico,7,198
29766,2024-01-21 16:05:00,55,132,Vestuário,5,187
29767,2024-01-21 16:06:00,83,165,Móvel,6,248
29768,2024-01-21 16:07:00,83,97,Vestuário,6,180
29769,2024-01-21 16:08:00,106,125,Brinquedo,5,231
29770,2024-01-21 16:09:00,56,154,Vestuário,6,210
29771,2024-01-21 16:10:00,21,88,Brinquedo,7,109
29772,2024-01-21 16:11:00,58,86,Móvel,2,144
29773,2024-01-21 16:12:00,53,58,Móvel,4,111
29774,2024-01-21 16:13:00,66,43,Móvel,7,109
29775,2024-01-21 16:14:00,102,159,Alimento,1,261
29776,2024-01-21 16:15:00,33,102,Vestuário,5,135
29777,2024-01-21 16:16:00,17,137,Brinquedo,8,154
29778,2024-01-21 16:17:00,97,115,Alimento,7,212
29779,2024-01-21 16:18:00,55,157,Alimento,8,212
29780,2024-01-21 16:19:00,113,100,Brinquedo,2,213
29781,2024-01-21 16:20:00,11,13,Alimento,2,24
29782,2024-01-21 16:21:00,21,51,Brinquedo,7,72
29783,2024-01-21 16:22:00,58,143,Móvel,5,201
29784,2024-01-21 16:23:00,70,138,Brinquedo,8,208
29785,2024-01-21 16:24:00,48,22,Alimento,8,70
29786,2024-01-21 16:25:00,81,105,Vestuário,3,186
29787,2024-01-21 16:26:00,53,163,Eletrônico,2,216
29788,2024-01-21 16:27:00,83,40,Móvel,3,123
29789,2024-01-21 16:28:00,41,168,Vestuário,7,209
29790,2024-01-21 16:29:00,14,62,Alimento,3,76
29791,2024-01-21 16:30:00,11,168,Alimento,3,179
29792,2024-01-21 16:31:00,74,70,Alimento,9,144
29793,2024-01-21 16:32:00,17,46,Alimento,3,63
29794,2024-01-21 16:33:00,98,176,Alimento,7,274
29795,2024-01-21 16:34:00,102,121,Móvel,1,223
29796,2024-01-21 16:35:00,52,100,Móvel,4,152
29797,2024-01-21 16:36:00,119,47,Eletrônico,9,166
29798,2024-01-21 16:37:00,35,65,Brinquedo,8,100
29799,2024-01-21 16:38:00,32,86,Móvel,2,118
29800,2024-01-21 16:39:00,35,131,Vestuário,9,166
29801,2024-01-21 16:40:00,102,57,Brinquedo,5,159
29802,2024-01-21 16:41:00,24,48,Móvel,7,72
29803,2024-01-21 16:42:00,70,150,Brinquedo,6,220
29804,2024-01-21 16:43:00,66,135,Eletrônico,6,201
29805,2024-01-21 16:44:00,108,128,Alimento,7,236
29806,2024-01-21 16:45:00,82,21,Brinquedo,2,103
29807,2024-01-21 16:46:00,88,84,Vestuário,1,172
29808,2024-01-21 16:47:00,83,10,Vestuário,4,93
29809,2024-01-21 16:48:00,14,88,Móvel,9,102
29810,2024-01-21 16:49:00,64,72,Eletrônico,5,136
29811,2024-01-21 16:50:00,97,75,Móvel,9,172
29812,2024-01-21 16:51:00,15,96,Vestuário,1,111
29813,2024-01-21 16:52:00,31,73,Vestuário,2,104
29814,2024-01-21 16:53:00,66,170,Alimento,5,236
29815,2024-01-21 16:54:00,99,102,Eletrônico,5,201
29816,2024-01-21 16:55:00,73,48,Vestuário,5,121
29817,2024-01-21 16:56:00,109,89,Móvel,6,198
29818,2024-01-21 16:57:00,72,173,Brinquedo,8,245
29819,2024-01-21 16:58:00,13,134,Brinquedo,5,147
29820,2024-01-21 16:59:00,74,127,Eletrônico,1,201
29821,2024-01-21 17:00:00,27,153,Alimento,3,180
29822,2024-01-21 17:01:00,48,158,Móvel,5,206
29823,2024-01-21 17:02:00,25,98,Vestuário,6,123
29824,2024-01-21 17:03:00,85,176,Alimento,6,261
29825,2024-01-21 17:04:00,91,72,Alimento,1,163
29826,2024-01-21 17:05:00,81,21,Eletrônico,6,102
29827,2024-01-21 17:06:00,77,77,Alimento,7,154
29828,2024-01-21 17:07:00,70,178,Móvel,7,248
29829,2024-01-21 17:08:00,106,50,Alimento,3,156
29830,2024-01-21 17:09:00,114,46,Brinquedo,5,160
29831,2024-01-21 17:10:00,38,131,Móvel,9,169
29832,2024-01-21 17:11:00,49,22,Alimento,2,71
29833,2024-01-21 17:12:00,82,126,Vestuário,8,208
29834,2024-01-21 17:13:00,95,56,Brinquedo,1,151
29835,2024-01-21 17:14:00,81,102,Móvel,5,183
29836,2024-01-21 17:15:00,76,27,Alimento,6,103
29837,2024-01-21 17:16:00,67,143,Eletrônico,2,210
29838,2024-01-21 17:17:00,21,19,Móvel,7,40
29839,2024-01-21 17:18:00,82,29,Brinquedo,5,111
29840,2024-01-21 17:19:00,87,138,Vestuário,9,225
29841,2024-01-21 17:20:00,60,97,Móvel,4,157
29842,2024-01-21 17:21:00,50,113,Brinquedo,2,163
29843,2024-01-21 17:22:00,99,91,Brinquedo,6,190
29844,2024-01-21 17:23:00,21,55,Móvel,8,76
29845,2024-01-21 17:24:00,37,32,Alimento,5,69
29846,2024-01-21 17:25:00,33,41,Móvel,4,74
29847,2024-01-21 17:26:00,29,144,Brinquedo,7,173
29848,2024-01-21 17:27:00,67,93,Eletrônico,8,160
29849,2024-01-21 17:28:00,13,163,Móvel,4,176
29850,2024-01-21 17:29:00,119,176,Eletrônico,5,295
29851,2024-01-21 17:30:00,66,31,Vestuário,9,97
29852,2024-01-21 17:31:00,15,173,Alimento,6,188
29853,2024-01-21 17:32:00,89,102,Eletrônico,7,191
29854,2024-01-21 17:33:00,10,20,Brinquedo,7,30
29855,2024-01-21 17:34:00,78,66,Vestuário,4,144
29856,2024-01-21 17:35:00,65,50,Vestuário,8,115
29857,2024-01-21 17:36:00,51,162,Alimento,2,213
29858,2024-01-21 17:37:00,117,61,Brinquedo,5,178
29859,2024-01-21 17:38:00,90,132,Vestuário,8,222
29860,2024-01-21 17:39:00,118,38,Móvel,5,156
29861,2024-01-21 17:40:00,72,112,Móvel,9,184
29862,2024-01-21 17:41:00,93,57,Brinquedo,5,150
29863,2024-01-21 17:42:00,35,78,Eletrônico,3,113
29864,2024-01-21 17:43:00,14,103,Alimento,4,117
29865,2024-01-21 17:44:00,105,154,Brinquedo,7,259
29866,2024-01-21 17:45:00,57,24,Alimento,6,81
29867,2024-01-21 17:46:00,32,37,Móvel,7,69
29868,2024-01-21 17:47:00,79,79,Móvel,9,158
29869,2024-01-21 17:48:00,42,157,Brinquedo,1,199
29870,2024-01-21 17:49:00,113,70,Vestuário,1,183
29871,2024-01-21 17:50:00,86,126,Alimento,4,212
29872,2024-01-21 17:51:00,108,22,Móvel,5,130
29873,2024-01-21 17:52:00,44,115,Eletrônico,6,159
29874,2024-01-21 17:53:00,87,149,Alimento,7,236
29875,2024-01-21 17:54:00,57,102,Vestuário,2,159
29876,2024-01-21 17:55:00,51,111,Vestuário,1,162
29877,2024-01-21 17:56:00,110,95,Eletrônico,6,205
29878,2024-01-21 17:57:00,27,118,Móvel,8,145
29879,2024-01-21 17:58:00,104,108,Alimento,3,212
29880,2024-01-21 17:59:00,90,25,Brinquedo,2,115
29881,2024-01-21 18:00:00,54,147,Alimento,9,201
29882,2024-01-21 18:01:00,113,90,Alimento,7,203
29883,2024-01-21 18:02:00,17,125,Alimento,1,142
29884,2024-01-21 18:03:00,89,110,Eletrônico,2,199
29885,2024-01-21 18:04:00,104,145,Móvel,4,249
29886,2024-01-21 18:05:00,52,77,Eletrônico,9,129
29887,2024-01-21 18:06:00,54,106,Vestuário,1,160
29888,2024-01-21 18:07:00,17,163,Vestuário,5,180
29889,2024-01-21 18:08:00,89,107,Brinquedo,9,196
29890,2024-01-21 18:09:00,52,70,Brinquedo,5,122
29891,2024-01-21 18:10:00,68,19,Brinquedo,4,87
29892,2024-01-21 18:11:00,45,27,Eletrônico,3,72
29893,2024-01-21 18:12:00,70,125,Eletrônico,2,195
29894,2024-01-21 18:13:00,63,22,Vestuário,2,85
29895,2024-01-21 18:14:00,83,171,Eletrônico,2,254
29896,2024-01-21 18:15:00,42,60,Alimento,6,102
29897,2024-01-21 18:16:00,58,23,Alimento,9,81
29898,2024-01-21 18:17:00,19,137,Móvel,2,156
29899,2024-01-21 18:18:00,30,58,Móvel,2,88
29900,2024-01-21 18:19:00,16,76,Móvel,3,92
29901,2024-01-21 18:20:00,23,96,Móvel,6,119
29902,2024-01-21 18:21:00,33,19,Brinquedo,1,52
29903,2024-01-21 18:22:00,35,176,Móvel,4,211
29904,2024-01-21 18:23:00,27,27,Móvel,6,54
29905,2024-01-21 18:24:00,102,171,Vestuário,8,273
29906,2024-01-21 18:25:00,42,29,Móvel,1,71
29907,2024-01-21 18:26:00,61,66,Vestuário,4,127
29908,2024-01-21 18:27:00,81,135,Alimento,4,216
29909,2024-01-21 18:28:00,28,64,Móvel,1,92
29910,2024-01-21 18:29:00,46,170,Brinquedo,6,216
29911,2024-01-21 18:30:00,84,87,Alimento,1,171
29912,2024-01-21 18:31:00,114,97,Móvel,8,211
29913,2024-01-21 18:32:00,41,95,Eletrônico,4,136
29914,2024-01-21 18:33:00,113,173,Brinquedo,4,286
29915,2024-01-21 18:34:00,44,58,Eletrônico,2,102
29916,2024-01-21 18:35:00,101,47,Vestuário,7,148
29917,2024-01-21 18:36:00,68,114,Móvel,9,182
29918,2024-01-21 18:37:00,109,99,Brinquedo,6,208
29919,2024-01-21 18:38:00,97,33,Eletrônico,1,130
29920,2024-01-21 18:39:00,10,78,Alimento,6,88
29921,2024-01-21 18:40:00,75,161,Brinquedo,9,236
29922,2024-01-21 18:41:00,84,35,Móvel,6,119
29923,2024-01-21 18:42:00,96,20,Alimento,8,116
29924,2024-01-21 18:43:00,110,37,Brinquedo,6,147
29925,2024-01-21 18:44:00,79,156,Móvel,9,235
29926,2024-01-21 18:45:00,48,30,Alimento,7,78
29927,2024-01-21 18:46:00,88,144,Brinquedo,3,232
29928,2024-01-21 18:47:00,60,117,Eletrônico,7,177
29929,2024-01-21 18:48:00,23,107,Móvel,5,130
29930,2024-01-21 18:49:00,38,170,Alimento,3,208
29931,2024-01-21 18:50:00,113,59,Móvel,3,172
29932,2024-01-21 18:51:00,96,159,Eletrônico,5,255
29933,2024-01-21 18:52:00,101,136,Brinquedo,3,237
29934,2024-01-21 18:53:00,67,160,Brinquedo,6,227
29935,2024-01-21 18:54:00,86,42,Alimento,2,128
29936,2024-01-21 18:55:00,40,139,Alimento,7,179
29937,2024-01-21 18:56:00,41,53,Vestuário,3,94
29938,2024-01-21 18:57:00,74,179,Eletrônico,1,253
29939,2024-01-21 18:58:00,57,32,Vestuário,6,89
29940,2024-01-21 18:59:00,59,79,Brinquedo,5,138
29941,2024-01-21 19:00:00,40,142,Alimento,7,182
29942,2024-01-21 19:01:00,83,162,Eletrônico,3,245
29943,2024-01-21 19:02:00,18,36,Brinquedo,2,54
29944,2024-01-21 19:03:00,36,65,Eletrônico,3,101
29945,2024-01-21 19:04:00,15,114,Brinquedo,9,129
29946,2024-01-21 19:05:00,55,33,Brinquedo,5,88
29947,2024-01-21 19:06:00,40,111,Eletrônico,3,151
29948,2024-01-21 19:07:00,45,154,Móvel,8,199
29949,2024-01-21 19:08:00,99,99,Brinquedo,2,198
29950,2024-01-21 19:09:00,67,108,Eletrônico,6,175
29951,2024-01-21 19:10:00,81,16,Móvel,6,97
29952,2024-01-21 19:11:00,104,122,Móvel,7,226
29953,2024-01-21 19:12:00,89,172,Móvel,1,261
29954,2024-01-21 19:13:00,33,146,Móvel,4,179
29955,2024-01-21 19:14:00,117,162,Alimento,4,279
29956,2024-01-21 19:15:00,99,94,Vestuário,4,193
29957,2024-01-21 19:16:00,33,119,Vestuário,2,152
29958,2024-01-21 19:17:00,66,14,Vestuário,2,80
29959,2024-01-21 19:18:00,116,34,Eletrônico,8,150
29960,2024-01-21 19:19:00,25,99,Eletrônico,2,124
29961,2024-01-21 19:20:00,83,11,Móvel,5,94
29962,2024-01-21 19:21:00,113,113,Vestuário,3,226
29963,2024-01-21 19:22:00,30,141,Móvel,7,171
29964,2024-01-21 19:23:00,41,116,Brinquedo,6,157
29965,2024-01-21 19:24:00,43,92,Brinquedo,9,135
29966,2024-01-21 19:25:00,84,147,Móvel,1,231
29967,2024-01-21 19:26:00,78,41,Brinquedo,4,119
29968,2024-01-21 19:27:00,53,150,Eletrônico,8,203
29969,2024-01-21 19:28:00,79,72,Brinquedo,2,151
29970,2024-01-21 19:29:00,77,12,Brinquedo,7,89
29971,2024-01-21 19:30:00,116,174,Vestuário,4,290
29972,2024-01-21 19:31:00,110,75,Móvel,2,185
29973,2024-01-21 19:32:00,42,30,Móvel,7,72
29974,2024-01-21 19:33:00,78,87,Móvel,6,165
29975,2024-01-21 19:34:00,105,117,Brinquedo,8,222
29976,2024-01-21 19:35:00,118,179,Eletrônico,5,297
29977,2024-01-21 19:36:00,73,11,Alimento,5,84
29978,2024-01-21 19:37:00,34,122,Alimento,9,156
29979,2024-01-21 19:38:00,78,21,Eletrônico,8,99
29980,2024-01-21 19:39:00,58,90,Vestuário,7,148
29981,2024-01-21 19:40:00,19,127,Alimento,6,146
29982,2024-01-21 19:41:00,104,132,Eletrônico,5,236
29983,2024-01-21 19:42:00,56,108,Alimento,2,164
29984,2024-01-21 19:43:00,95,161,Vestuário,6,256
29985,2024-01-21 19:44:00,57,105,Alimento,5,162
29986,2024-01-21 19:45:00,83,129,Brinquedo,7,212
29987,2024-01-21 19:46:00,23,26,Brinquedo,5,49
29988,2024-01-21 19:47:00,53,27,Alimento,9,80
29989,2024-01-21 19:48:00,84,84,Brinquedo,4,168
29990,2024-01-21 19:49:00,29,83,Eletrônico,2,112
29991,2024-01-21 19:50:00,49,77,Vestuário,4,126
29992,2024-01-21 19:51:00,29,93,Brinquedo,7,122
29993,2024-01-21 19:52:00,83,160,Vestuário,5,243
29994,2024-01-21 19:53:00,11,143,Eletrônico,1,154
29995,2024-01-21 19:54:00,52,136,Móvel,6,188
29996,2024-01-21 19:55:00,31,164,Eletrônico,5,195
29997,2024-01-21 19:56:00,48,64,Alimento,4,112
29998,2024-01-21 19:57:00,60,111,Eletrônico,1,171
29999,2024-01-21 19:58:00,94,149,Eletrônico,9,243
30000,2024-01-21 19:59:00,77,77,Móvel,6,154
30001,2024-01-21 20:00:00,61,68,Móvel,6,129
30002,2024-01-21 20:01:00,74,106,Brinquedo,4,180
30003,2024-01-21 20:02:00,100,99,Vestuário,9,199
30004,2024-01-21 20:03:00,84,118,Móvel,4,202
30005,2024-01-21 20:04:00,18,154,Brinquedo,2,172
30006,2024-01-21 20:05:00,86,45,Eletrônico,7,131
30007,2024-01-21 20:06:00,112,63,Eletrônico,3,175
30008,2024-01-21 20:07:00,103,91,Alimento,3,194
30009,2024-01-21 20:08:00,68,47,Eletrônico,5,115
30010,2024-01-21 20:09:00,42,171,Brinquedo,5,213
30011,2024-01-21 20:10:00,44,98,Brinquedo,9,142
30012,2024-01-21 20:11:00,68,162,Alimento,6,230
30013,2024-01-21 20:12:00,108,122,Vestuário,6,230
30014,2024-01-21 20:13:00,115,99,Alimento,9,214
30015,2024-01-21 20:14:00,108,149,Alimento,5,257
30016,2024-01-21 20:15:00,98,69,Eletrônico,1,167
30017,2024-01-21 20:16:00,96,146,Vestuário,8,242
30018,2024-01-21 20:17:00,91,68,Brinquedo,3,159
30019,2024-01-21 20:18:00,52,42,Móvel,5,94
30020,2024-01-21 20:19:00,49,129,Brinquedo,5,178
30021,2024-01-21 20:20:00,71,78,Móvel,1,149
30022,2024-01-21 20:21:00,16,129,Alimento,6,145
30023,2024-01-21 20:22:00,105,38,Vestuário,4,143
30024,2024-01-21 20:23:00,71,13,Móvel,3,84
30025,2024-01-21 20:24:00,26,60,Móvel,8,86
30026,2024-01-21 20:25:00,112,52,Vestuário,7,164
30027,2024-01-21 20:26:00,72,27,Alimento,4,99
30028,2024-01-21 20:27:00,55,115,Alimento,3,170
30029,2024-01-21 20:28:00,119,97,Brinquedo,8,216
30030,2024-01-21 20:29:00,91,112,Eletrônico,2,203
30031,2024-01-21 20:30:00,74,87,Brinquedo,7,161
30032,2024-01-21 20:31:00,14,19,Alimento,6,33
30033,2024-01-21 20:32:00,69,12,Móvel,5,81
30034,2024-01-21 20:33:00,51,151,Alimento,5,202
30035,2024-01-21 20:34:00,20,131,Vestuário,6,151
30036,2024-01-21 20:35:00,77,30,Vestuário,3,107
30037,2024-01-21 20:36:00,116,116,Móvel,4,232
30038,2024-01-21 20:37:00,103,32,Móvel,9,135
30039,2024-01-21 20:38:00,49,172,Alimento,8,221
30040,2024-01-21 20:39:00,65,126,Brinquedo,3,191
30041,2024-01-21 20:40:00,101,68,Brinquedo,8,169
30042,2024-01-21 20:41:00,43,120,Móvel,6,163
30043,2024-01-21 20:42:00,39,114,Alimento,6,153
30044,2024-01-21 20:43:00,16,65,Alimento,2,81
30045,2024-01-21 20:44:00,65,69,Vestuário,6,134
30046,2024-01-21 20:45:00,16,99,Alimento,5,115
30047,2024-01-21 20:46:00,107,31,Alimento,7,138
30048,2024-01-21 20:47:00,41,131,Eletrônico,7,172
30049,2024-01-21 20:48:00,22,159,Vestuário,9,181
30050,2024-01-21 20:49:00,119,124,Móvel,2,243
30051,2024-01-21 20:50:00,45,149,Alimento,3,194
30052,2024-01-21 20:51:00,65,19,Alimento,9,84
30053,2024-01-21 20:52:00,22,76,Brinquedo,3,98
30054,2024-01-21 20:53:00,105,23,Brinquedo,9,128
30055,2024-01-21 20:54:00,46,137,Vestuário,6,183
30056,2024-01-21 20:55:00,116,50,Alimento,2,166
30057,2024-01-21 20:56:00,15,72,Brinquedo,6,87
30058,2024-01-21 20:57:00,76,96,Alimento,1,172
30059,2024-01-21 20:58:00,67,165,Móvel,4,232
30060,2024-01-21 20:59:00,41,50,Eletrônico,7,91
30061,2024-01-21 21:00:00,15,167,Brinquedo,2,182
30062,2024-01-21 21:01:00,99,12,Brinquedo,2,111
30063,2024-01-21 21:02:00,34,22,Vestuário,2,56
30064,2024-01-21 21:03:00,60,31,Vestuário,8,91
30065,2024-01-21 21:04:00,100,102,Móvel,3,202
30066,2024-01-21 21:05:00,38,101,Móvel,3,139
30067,2024-01-21 21:06:00,61,107,Eletrônico,1,168
30068,2024-01-21 21:07:00,107,139,Brinquedo,4,246
30069,2024-01-21 21:08:00,50,170,Brinquedo,5,220
30070,2024-01-21 21:09:00,113,50,Móvel,4,163
30071,2024-01-21 21:10:00,91,150,Brinquedo,5,241
30072,2024-01-21 21:11:00,64,25,Alimento,4,89
30073,2024-01-21 21:12:00,87,163,Brinquedo,2,250
30074,2024-01-21 21:13:00,119,55,Vestuário,3,174
30075,2024-01-21 21:14:00,95,53,Móvel,6,148
30076,2024-01-21 21:15:00,61,98,Alimento,3,159
30077,2024-01-21 21:16:00,57,74,Brinquedo,7,131
30078,2024-01-21 21:17:00,22,146,Móvel,9,168
30079,2024-01-21 21:18:00,43,47,Brinquedo,7,90
30080,2024-01-21 21:19:00,60,157,Vestuário,3,217
30081,2024-01-21 21:20:00,29,165,Móvel,5,194
30082,2024-01-21 21:21:00,87,21,Alimento,5,108
30083,2024-01-21 21:22:00,17,32,Móvel,4,49
30084,2024-01-21 21:23:00,48,121,Brinquedo,6,169
30085,2024-01-21 21:24:00,79,100,Móvel,1,179
30086,2024-01-21 21:25:00,113,116,Brinquedo,7,229
30087,2024-01-21 21:26:00,115,71,Eletrônico,7,186
30088,2024-01-21 21:27:00,31,12,Alimento,9,43
30089,2024-01-21 21:28:00,47,142,Eletrônico,7,189
30090,2024-01-21 21:29:00,104,22,Brinquedo,6,126
30091,2024-01-21 21:30:00,119,144,Móvel,8,263
30092,2024-01-21 21:31:00,14,20,Alimento,2,34
30093,2024-01-21 21:32:00,73,144,Eletrônico,4,217
30094,2024-01-21 21:33:00,77,33,Brinquedo,2,110
30095,2024-01-21 21:34:00,41,51,Móvel,4,92
30096,2024-01-21 21:35:00,63,141,Vestuário,8,204
30097,2024-01-21 21:36:00,108,37,Eletrônico,1,145
30098,2024-01-21 21:37:00,36,48,Vestuário,7,84
30099,2024-01-21 21:38:00,21,129,Vestuário,1,150
30100,2024-01-21 21:39:00,113,118,Eletrônico,5,231
30101,2024-01-21 21:40:00,110,89,Brinquedo,7,199
30102,2024-01-21 21:41:00,81,17,Alimento,5,98
30103,2024-01-21 21:42:00,18,90,Vestuário,5,108
30104,2024-01-21 21:43:00,21,62,Brinquedo,6,83
30105,2024-01-21 21:44:00,60,26,Brinquedo,9,86
30106,2024-01-21 21:45:00,14,167,Vestuário,8,181
30107,2024-01-21 21:46:00,83,84,Alimento,7,167
30108,2024-01-21 21:47:00,98,77,Alimento,2,175
30109,2024-01-21 21:48:00,29,38,Móvel,6,67
30110,2024-01-21 21:49:00,46,110,Vestuário,7,156
30111,2024-01-21 21:50:00,87,150,Eletrônico,4,237
30112,2024-01-21 21:51:00,33,135,Vestuário,9,168
30113,2024-01-21 21:52:00,13,176,Móvel,8,189
30114,2024-01-21 21:53:00,111,21,Brinquedo,4,132
30115,2024-01-21 21:54:00,44,21,Móvel,9,65
30116,2024-01-21 21:55:00,39,97,Móvel,4,136
30117,2024-01-21 21:56:00,50,135,Eletrônico,9,185
30118,2024-01-21 21:57:00,11,134,Vestuário,9,145
30119,2024-01-21 21:58:00,28,75,Brinquedo,5,103
30120,2024-01-21 21:59:00,91,135,Brinquedo,2,226
30121,2024-01-21 22:00:00,76,157,Eletrônico,4,233
30122,2024-01-21 22:01:00,56,29,Vestuário,1,85
30123,2024-01-21 22:02:00,106,138,Eletrônico,4,244
30124,2024-01-21 22:03:00,118,36,Alimento,9,154
30125,2024-01-21 22:04:00,98,160,Brinquedo,9,258
30126,2024-01-21 22:05:00,84,121,Alimento,1,205
30127,2024-01-21 22:06:00,97,57,Vestuário,7,154
30128,2024-01-21 22:07:00,49,175,Vestuário,2,224
30129,2024-01-21 22:08:00,108,118,Eletrônico,7,226
30130,2024-01-21 22:09:00,52,31,Móvel,8,83
30131,2024-01-21 22:10:00,24,118,Vestuário,2,142
30132,2024-01-21 22:11:00,65,23,Móvel,8,88
30133,2024-01-21 22:12:00,50,70,Vestuário,6,120
30134,2024-01-21 22:13:00,78,43,Vestuário,3,121
30135,2024-01-21 22:14:00,52,154,Móvel,2,206
30136,2024-01-21 22:15:00,112,59,Alimento,8,171
30137,2024-01-21 22:16:00,82,121,Alimento,2,203
30138,2024-01-21 22:17:00,25,104,Eletrônico,6,129
30139,2024-01-21 22:18:00,79,12,Eletrônico,9,91
30140,2024-01-21 22:19:00,27,56,Eletrônico,2,83
30141,2024-01-21 22:20:00,56,172,Eletrônico,1,228
30142,2024-01-21 22:21:00,113,106,Brinquedo,8,219
30143,2024-01-21 22:22:00,119,144,Alimento,1,263
30144,2024-01-21 22:23:00,92,83,Vestuário,5,175
30145,2024-01-21 22:24:00,67,93,Vestuário,3,160
30146,2024-01-21 22:25:00,114,141,Brinquedo,9,255
30147,2024-01-21 22:26:00,82,19,Vestuário,4,101
30148,2024-01-21 22:27:00,119,108,Alimento,8,227
30149,2024-01-21 22:28:00,55,80,Brinquedo,5,135
30150,2024-01-21 22:29:00,106,123,Brinquedo,8,229
30151,2024-01-21 22:30:00,12,99,Alimento,9,111
30152,2024-01-21 22:31:00,99,128,Brinquedo,4,227
30153,2024-01-21 22:32:00,89,113,Eletrônico,8,202
30154,2024-01-21 22:33:00,63,73,Eletrônico,1,136
30155,2024-01-21 22:34:00,23,17,Móvel,6,40
30156,2024-01-21 22:35:00,48,176,Brinquedo,4,224
30157,2024-01-21 22:36:00,34,26,Alimento,9,60
30158,2024-01-21 22:37:00,70,151,Eletrônico,5,221
30159,2024-01-21 22:38:00,65,149,Brinquedo,3,214
30160,2024-01-21 22:39:00,22,120,Eletrônico,9,142
30161,2024-01-21 22:40:00,50,127,Alimento,8,177
30162,2024-01-21 22:41:00,75,23,Móvel,5,98
30163,2024-01-21 22:42:00,46,11,Vestuário,7,57
30164,2024-01-21 22:43:00,23,60,Eletrônico,3,83
30165,2024-01-21 22:44:00,99,164,Vestuário,9,263
30166,2024-01-21 22:45:00,50,173,Eletrônico,1,223
30167,2024-01-21 22:46:00,111,43,Alimento,8,154
30168,2024-01-21 22:47:00,96,12,Brinquedo,1,108
30169,2024-01-21 22:48:00,69,153,Móvel,2,222
30170,2024-01-21 22:49:00,56,91,Eletrônico,8,147
30171,2024-01-21 22:50:00,108,66,Móvel,3,174
30172,2024-01-21 22:51:00,55,99,Eletrônico,3,154
30173,2024-01-21 22:52:00,24,128,Vestuário,7,152
30174,2024-01-21 22:53:00,57,148,Brinquedo,7,205
30175,2024-01-21 22:54:00,116,175,Eletrônico,5,291
30176,2024-01-21 22:55:00,79,170,Eletrônico,6,249
30177,2024-01-21 22:56:00,61,75,Eletrônico,4,136
30178,2024-01-21 22:57:00,66,16,Alimento,6,82
30179,2024-01-21 22:58:00,21,91,Móvel,1,112
30180,2024-01-21 22:59:00,63,165,Vestuário,9,228
30181,2024-01-21 23:00:00,16,70,Eletrônico,8,86
30182,2024-01-21 23:01:00,68,118,Móvel,8,186
30183,2024-01-21 23:02:00,18,76,Brinquedo,9,94
30184,2024-01-21 23:03:00,57,154,Vestuário,5,211
30185,2024-01-21 23:04:00,20,30,Brinquedo,3,50
30186,2024-01-21 23:05:00,116,154,Vestuário,7,270
30187,2024-01-21 23:06:00,95,58,Brinquedo,7,153
30188,2024-01-21 23:07:00,15,96,Eletrônico,3,111
30189,2024-01-21 23:08:00,116,45,Alimento,5,161
30190,2024-01-21 23:09:00,28,179,Eletrônico,8,207
30191,2024-01-21 23:10:00,119,76,Vestuário,6,195
30192,2024-01-21 23:11:00,52,108,Móvel,4,160
30193,2024-01-21 23:12:00,14,90,Móvel,8,104
30194,2024-01-21 23:13:00,75,142,Brinquedo,2,217
30195,2024-01-21 23:14:00,19,70,Eletrônico,6,89
30196,2024-01-21 23:15:00,36,126,Vestuário,4,162
30197,2024-01-21 23:16:00,75,154,Alimento,9,229
30198,2024-01-21 23:17:00,119,109,Vestuário,4,228
30199,2024-01-21 23:18:00,18,72,Brinquedo,5,90
30200,2024-01-21 23:19:00,55,90,Alimento,7,145
30201,2024-01-21 23:20:00,66,93,Alimento,1,159
30202,2024-01-21 23:21:00,53,36,Vestuário,3,89
30203,2024-01-21 23:22:00,36,65,Brinquedo,7,101
30204,2024-01-21 23:23:00,87,114,Eletrônico,8,201
30205,2024-01-21 23:24:00,116,14,Brinquedo,5,130
30206,2024-01-21 23:25:00,113,63,Eletrônico,9,176
30207,2024-01-21 23:26:00,74,15,Eletrônico,3,89
30208,2024-01-21 23:27:00,103,116,Vestuário,6,219
30209,2024-01-21 23:28:00,20,164,Eletrônico,5,184
30210,2024-01-21 23:29:00,93,107,Móvel,1,200
30211,2024-01-21 23:30:00,64,60,Vestuário,8,124
30212,2024-01-21 23:31:00,110,175,Móvel,1,285
30213,2024-01-21 23:32:00,62,50,Alimento,8,112
30214,2024-01-21 23:33:00,90,114,Eletrônico,9,204
30215,2024-01-21 23:34:00,43,142,Brinquedo,2,185
30216,2024-01-21 23:35:00,34,54,Brinquedo,5,88
30217,2024-01-21 23:36:00,43,156,Móvel,6,199
30218,2024-01-21 23:37:00,81,165,Móvel,5,246
30219,2024-01-21 23:38:00,51,44,Móvel,7,95
30220,2024-01-21 23:39:00,83,67,Brinquedo,1,150
30221,2024-01-21 23:40:00,15,116,Eletrônico,6,131
30222,2024-01-21 23:41:00,99,21,Brinquedo,7,120
30223,2024-01-21 23:42:00,53,18,Alimento,4,71
30224,2024-01-21 23:43:00,24,56,Brinquedo,1,80
30225,2024-01-21 23:44:00,23,55,Alimento,2,78
30226,2024-01-21 23:45:00,26,63,Alimento,8,89
30227,2024-01-21 23:46:00,51,112,Brinquedo,3,163
30228,2024-01-21 23:47:00,30,168,Brinquedo,9,198
30229,2024-01-21 23:48:00,41,179,Brinquedo,8,220
30230,2024-01-21 23:49:00,115,75,Vestuário,6,190
30231,2024-01-21 23:50:00,21,63,Vestuário,8,84
30232,2024-01-21 23:51:00,29,46,Vestuário,3,75
30233,2024-01-21 23:52:00,96,51,Brinquedo,1,147
30234,2024-01-21 23:53:00,24,91,Vestuário,8,115
30235,2024-01-21 23:54:00,95,10,Alimento,5,105
30236,2024-01-21 23:55:00,92,86,Móvel,8,178
30237,2024-01-21 23:56:00,17,103,Alimento,5,120
30238,2024-01-21 23:57:00,59,92,Brinquedo,1,151
30239,2024-01-21 23:58:00,101,155,Eletrônico,4,256
30240,2024-01-21 23:59:00,61,135,Vestuário,3,196
30241,2024-01-22 00:00:00,107,60,Vestuário,2,167
30242,2024-01-22 00:01:00,68,66,Móvel,3,134
30243,2024-01-22 00:02:00,39,176,Brinquedo,6,215
30244,2024-01-22 00:03:00,14,159,Alimento,1,173
30245,2024-01-22 00:04:00,11,86,Alimento,5,97
30246,2024-01-22 00:05:00,98,45,Brinquedo,1,143
30247,2024-01-22 00:06:00,34,145,Alimento,7,179
30248,2024-01-22 00:07:00,54,115,Móvel,5,169
30249,2024-01-22 00:08:00,82,162,Brinquedo,2,244
30250,2024-01-22 00:09:00,104,87,Eletrônico,2,191
30251,2024-01-22 00:10:00,106,43,Vestuário,5,149
30252,2024-01-22 00:11:00,49,159,Brinquedo,9,208
30253,2024-01-22 00:12:00,101,153,Alimento,4,254
30254,2024-01-22 00:13:00,33,152,Eletrônico,4,185
30255,2024-01-22 00:14:00,33,24,Alimento,7,57
30256,2024-01-22 00:15:00,108,138,Alimento,8,246
30257,2024-01-22 00:16:00,48,121,Alimento,4,169
30258,2024-01-22 00:17:00,39,56,Brinquedo,1,95
30259,2024-01-22 00:18:00,118,58,Alimento,6,176
30260,2024-01-22 00:19:00,59,151,Eletrônico,7,210
30261,2024-01-22 00:20:00,43,77,Móvel,9,120
30262,2024-01-22 00:21:00,80,93,Brinquedo,1,173
30263,2024-01-22 00:22:00,33,125,Brinquedo,2,158
30264,2024-01-22 00:23:00,13,36,Eletrônico,6,49
30265,2024-01-22 00:24:00,94,139,Brinquedo,7,233
30266,2024-01-22 00:25:00,112,17,Móvel,7,129
30267,2024-01-22 00:26:00,28,48,Móvel,1,76
30268,2024-01-22 00:27:00,36,129,Móvel,9,165
30269,2024-01-22 00:28:00,88,152,Móvel,8,240
30270,2024-01-22 00:29:00,113,159,Alimento,9,272
30271,2024-01-22 00:30:00,71,136,Eletrônico,3,207
30272,2024-01-22 00:31:00,80,52,Vestuário,4,132
30273,2024-01-22 00:32:00,41,162,Alimento,2,203
30274,2024-01-22 00:33:00,19,170,Móvel,7,189
30275,2024-01-22 00:34:00,12,76,Eletrônico,5,88
30276,2024-01-22 00:35:00,89,25,Brinquedo,3,114
30277,2024-01-22 00:36:00,83,50,Móvel,2,133
30278,2024-01-22 00:37:00,65,159,Móvel,6,224
30279,2024-01-22 00:38:00,102,98,Móvel,4,200
30280,2024-01-22 00:39:00,69,113,Vestuário,2,182
30281,2024-01-22 00:40:00,108,81,Eletrônico,8,189
30282,2024-01-22 00:41:00,110,128,Vestuário,3,238
30283,2024-01-22 00:42:00,50,138,Eletrônico,4,188
30284,2024-01-22 00:43:00,104,19,Eletrônico,8,123
30285,2024-01-22 00:44:00,104,152,Alimento,4,256
30286,2024-01-22 00:45:00,97,57,Móvel,2,154
30287,2024-01-22 00:46:00,90,179,Brinquedo,5,269
30288,2024-01-22 00:47:00,21,130,Brinquedo,2,151
30289,2024-01-22 00:48:00,107,56,Brinquedo,8,163
30290,2024-01-22 00:49:00,87,158,Alimento,1,245
30291,2024-01-22 00:50:00,114,72,Móvel,2,186
30292,2024-01-22 00:51:00,106,154,Eletrônico,6,260
30293,2024-01-22 00:52:00,85,120,Vestuário,3,205
30294,2024-01-22 00:53:00,70,12,Móvel,5,82
30295,2024-01-22 00:54:00,26,50,Alimento,2,76
30296,2024-01-22 00:55:00,70,103,Vestuário,9,173
30297,2024-01-22 00:56:00,115,91,Alimento,3,206
30298,2024-01-22 00:57:00,111,148,Vestuário,7,259
30299,2024-01-22 00:58:00,35,122,Vestuário,2,157
30300,2024-01-22 00:59:00,36,151,Alimento,4,187
30301,2024-01-22 01:00:00,30,47,Brinquedo,8,77
30302,2024-01-22 01:01:00,110,100,Alimento,8,210
30303,2024-01-22 01:02:00,103,95,Móvel,9,198
30304,2024-01-22 01:03:00,43,104,Vestuário,3,147
30305,2024-01-22 01:04:00,93,25,Eletrônico,1,118
30306,2024-01-22 01:05:00,105,82,Vestuário,1,187
30307,2024-01-22 01:06:00,42,90,Brinquedo,7,132
30308,2024-01-22 01:07:00,38,51,Móvel,1,89
30309,2024-01-22 01:08:00,31,72,Vestuário,3,103
30310,2024-01-22 01:09:00,73,12,Móvel,3,85
30311,2024-01-22 01:10:00,90,23,Alimento,5,113
30312,2024-01-22 01:11:00,118,82,Eletrônico,4,200
30313,2024-01-22 01:12:00,93,87,Vestuário,3,180
30314,2024-01-22 01:13:00,80,10,Móvel,8,90
30315,2024-01-22 01:14:00,119,72,Eletrônico,9,191
30316,2024-01-22 01:15:00,50,161,Alimento,8,211
30317,2024-01-22 01:16:00,12,145,Vestuário,7,157
30318,2024-01-22 01:17:00,108,113,Alimento,7,221
30319,2024-01-22 01:18:00,23,125,Eletrônico,3,148
30320,2024-01-22 01:19:00,98,42,Alimento,2,140
30321,2024-01-22 01:20:00,15,94,Brinquedo,9,109
30322,2024-01-22 01:21:00,94,154,Eletrônico,7,248
30323,2024-01-22 01:22:00,92,127,Móvel,1,219
30324,2024-01-22 01:23:00,98,75,Eletrônico,1,173
30325,2024-01-22 01:24:00,81,126,Alimento,1,207
30326,2024-01-22 01:25:00,27,82,Móvel,3,109
30327,2024-01-22 01:26:00,107,71,Eletrônico,4,178
30328,2024-01-22 01:27:00,114,36,Vestuário,3,150
30329,2024-01-22 01:28:00,24,89,Eletrônico,5,113
30330,2024-01-22 01:29:00,90,133,Vestuário,4,223
30331,2024-01-22 01:30:00,108,142,Brinquedo,7,250
30332,2024-01-22 01:31:00,100,24,Eletrônico,6,124
30333,2024-01-22 01:32:00,58,52,Vestuário,3,110
30334,2024-01-22 01:33:00,80,84,Brinquedo,5,164
30335,2024-01-22 01:34:00,83,140,Vestuário,1,223
30336,2024-01-22 01:35:00,119,159,Vestuário,8,278
30337,2024-01-22 01:36:00,106,167,Vestuário,6,273
30338,2024-01-22 01:37:00,11,129,Eletrônico,4,140
30339,2024-01-22 01:38:00,73,46,Brinquedo,3,119
30340,2024-01-22 01:39:00,53,82,Móvel,1,135
30341,2024-01-22 01:40:00,91,169,Brinquedo,5,260
30342,2024-01-22 01:41:00,10,176,Móvel,5,186
30343,2024-01-22 01:42:00,116,66,Alimento,6,182
30344,2024-01-22 01:43:00,74,13,Brinquedo,1,87
30345,2024-01-22 01:44:00,93,70,Móvel,9,163
30346,2024-01-22 01:45:00,54,77,Alimento,7,131
30347,2024-01-22 01:46:00,97,75,Alimento,1,172
30348,2024-01-22 01:47:00,96,170,Vestuário,5,266
30349,2024-01-22 01:48:00,114,163,Vestuário,5,277
30350,2024-01-22 01:49:00,52,25,Alimento,3,77
30351,2024-01-22 01:50:00,50,68,Brinquedo,5,118
30352,2024-01-22 01:51:00,35,124,Alimento,8,159
30353,2024-01-22 01:52:00,51,26,Eletrônico,5,77
30354,2024-01-22 01:53:00,97,153,Vestuário,7,250
30355,2024-01-22 01:54:00,15,113,Móvel,4,128
30356,2024-01-22 01:55:00,71,139,Vestuário,3,210
30357,2024-01-22 01:56:00,37,99,Alimento,5,136
30358,2024-01-22 01:57:00,87,168,Vestuário,6,255
30359,2024-01-22 01:58:00,103,54,Brinquedo,1,157
30360,2024-01-22 01:59:00,54,94,Brinquedo,3,148
30361,2024-01-22 02:00:00,119,33,Alimento,2,152
30362,2024-01-22 02:01:00,114,128,Vestuário,2,242
30363,2024-01-22 02:02:00,92,178,Alimento,4,270
30364,2024-01-22 02:03:00,12,67,Eletrônico,6,79
30365,2024-01-22 02:04:00,79,82,Alimento,3,161
30366,2024-01-22 02:05:00,73,95,Alimento,4,168
30367,2024-01-22 02:06:00,96,66,Eletrônico,1,162
30368,2024-01-22 02:07:00,71,153,Alimento,1,224
30369,2024-01-22 02:08:00,95,99,Brinquedo,1,194
30370,2024-01-22 02:09:00,39,130,Alimento,4,169
30371,2024-01-22 02:10:00,98,48,Vestuário,3,146
30372,2024-01-22 02:11:00,12,16,Móvel,8,28
30373,2024-01-22 02:12:00,84,133,Vestuário,9,217
30374,2024-01-22 02:13:00,18,177,Alimento,2,195
30375,2024-01-22 02:14:00,59,131,Eletrônico,6,190
30376,2024-01-22 02:15:00,12,68,Eletrônico,5,80
30377,2024-01-22 02:16:00,108,66,Móvel,6,174
30378,2024-01-22 02:17:00,119,32,Brinquedo,1,151
30379,2024-01-22 02:18:00,42,176,Brinquedo,3,218
30380,2024-01-22 02:19:00,113,11,Eletrônico,3,124
30381,2024-01-22 02:20:00,70,38,Alimento,9,108
30382,2024-01-22 02:21:00,35,89,Alimento,8,124
30383,2024-01-22 02:22:00,48,32,Vestuário,3,80
30384,2024-01-22 02:23:00,110,173,Vestuário,3,283
30385,2024-01-22 02:24:00,103,134,Brinquedo,1,237
30386,2024-01-22 02:25:00,83,61,Vestuário,6,144
30387,2024-01-22 02:26:00,95,13,Móvel,7,108
30388,2024-01-22 02:27:00,77,149,Brinquedo,6,226
30389,2024-01-22 02:28:00,53,55,Eletrônico,1,108
30390,2024-01-22 02:29:00,13,107,Alimento,9,120
30391,2024-01-22 02:30:00,76,52,Alimento,6,128
30392,2024-01-22 02:31:00,33,55,Vestuário,3,88
30393,2024-01-22 02:32:00,43,28,Móvel,2,71
30394,2024-01-22 02:33:00,49,84,Eletrônico,1,133
30395,2024-01-22 02:34:00,108,23,Brinquedo,6,131
30396,2024-01-22 02:35:00,55,138,Alimento,1,193
30397,2024-01-22 02:36:00,50,43,Vestuário,3,93
30398,2024-01-22 02:37:00,53,46,Móvel,8,99
30399,2024-01-22 02:38:00,74,172,Alimento,9,246
30400,2024-01-22 02:39:00,29,94,Vestuário,8,123
30401,2024-01-22 02:40:00,70,34,Alimento,1,104
30402,2024-01-22 02:41:00,74,64,Brinquedo,2,138
30403,2024-01-22 02:42:00,14,40,Eletrônico,2,54
30404,2024-01-22 02:43:00,21,150,Eletrônico,2,171
30405,2024-01-22 02:44:00,51,95,Vestuário,4,146
30406,2024-01-22 02:45:00,71,10,Vestuário,8,81
30407,2024-01-22 02:46:00,10,167,Eletrônico,6,177
30408,2024-01-22 02:47:00,72,15,Eletrônico,4,87
30409,2024-01-22 02:48:00,82,164,Eletrônico,3,246
30410,2024-01-22 02:49:00,68,166,Móvel,3,234
30411,2024-01-22 02:50:00,30,153,Vestuário,8,183
30412,2024-01-22 02:51:00,18,96,Alimento,5,114
30413,2024-01-22 02:52:00,78,50,Vestuário,4,128
30414,2024-01-22 02:53:00,34,73,Alimento,4,107
30415,2024-01-22 02:54:00,28,73,Eletrônico,4,101
30416,2024-01-22 02:55:00,108,173,Móvel,2,281
30417,2024-01-22 02:56:00,59,114,Brinquedo,1,173
30418,2024-01-22 02:57:00,78,146,Vestuário,8,224
30419,2024-01-22 02:58:00,30,147,Alimento,8,177
30420,2024-01-22 02:59:00,71,104,Brinquedo,9,175
30421,2024-01-22 03:00:00,27,136,Vestuário,6,163
30422,2024-01-22 03:01:00,89,122,Alimento,6,211
30423,2024-01-22 03:02:00,30,132,Eletrônico,2,162
30424,2024-01-22 03:03:00,56,98,Móvel,4,154
30425,2024-01-22 03:04:00,105,164,Brinquedo,1,269
30426,2024-01-22 03:05:00,106,165,Eletrônico,3,271
30427,2024-01-22 03:06:00,53,91,Vestuário,7,144
30428,2024-01-22 03:07:00,38,90,Móvel,2,128
30429,2024-01-22 03:08:00,90,91,Vestuário,8,181
30430,2024-01-22 03:09:00,112,97,Vestuário,3,209
30431,2024-01-22 03:10:00,75,87,Vestuário,1,162
30432,2024-01-22 03:11:00,102,87,Eletrônico,3,189
30433,2024-01-22 03:12:00,78,165,Brinquedo,4,243
30434,2024-01-22 03:13:00,68,114,Vestuário,9,182
30435,2024-01-22 03:14:00,97,169,Alimento,9,266
30436,2024-01-22 03:15:00,98,178,Alimento,3,276
30437,2024-01-22 03:16:00,58,55,Eletrônico,9,113
30438,2024-01-22 03:17:00,14,128,Móvel,4,142
30439,2024-01-22 03:18:00,102,72,Brinquedo,8,174
30440,2024-01-22 03:19:00,60,48,Alimento,4,108
30441,2024-01-22 03:20:00,24,58,Vestuário,5,82
30442,2024-01-22 03:21:00,96,102,Vestuário,2,198
30443,2024-01-22 03:22:00,12,122,Eletrônico,9,134
30444,2024-01-22 03:23:00,79,152,Vestuário,8,231
30445,2024-01-22 03:24:00,16,21,Eletrônico,1,37
30446,2024-01-22 03:25:00,73,74,Eletrônico,9,147
30447,2024-01-22 03:26:00,61,27,Brinquedo,6,88
30448,2024-01-22 03:27:00,70,27,Vestuário,1,97
30449,2024-01-22 03:28:00,113,174,Brinquedo,4,287
30450,2024-01-22 03:29:00,84,137,Alimento,4,221
30451,2024-01-22 03:30:00,102,23,Móvel,1,125
30452,2024-01-22 03:31:00,76,56,Alimento,5,132
30453,2024-01-22 03:32:00,106,57,Brinquedo,3,163
30454,2024-01-22 03:33:00,22,177,Móvel,4,199
30455,2024-01-22 03:34:00,118,173,Eletrônico,2,291
30456,2024-01-22 03:35:00,51,28,Móvel,7,79
30457,2024-01-22 03:36:00,32,179,Vestuário,3,211
30458,2024-01-22 03:37:00,12,75,Brinquedo,2,87
30459,2024-01-22 03:38:00,42,147,Brinquedo,9,189
30460,2024-01-22 03:39:00,31,168,Brinquedo,1,199
30461,2024-01-22 03:40:00,68,119,Eletrônico,9,187
30462,2024-01-22 03:41:00,67,46,Brinquedo,1,113
30463,2024-01-22 03:42:00,119,72,Brinquedo,8,191
30464,2024-01-22 03:43:00,116,144,Eletrônico,1,260
30465,2024-01-22 03:44:00,89,30,Alimento,5,119
30466,2024-01-22 03:45:00,56,11,Brinquedo,7,67
30467,2024-01-22 03:46:00,12,52,Eletrônico,5,64
30468,2024-01-22 03:47:00,52,46,Brinquedo,2,98
30469,2024-01-22 03:48:00,38,33,Brinquedo,9,71
30470,2024-01-22 03:49:00,77,101,Brinquedo,7,178
30471,2024-01-22 03:50:00,113,174,Alimento,2,287
30472,2024-01-22 03:51:00,21,67,Móvel,2,88
30473,2024-01-22 03:52:00,78,45,Brinquedo,7,123
30474,2024-01-22 03:53:00,83,20,Móvel,4,103
30475,2024-01-22 03:54:00,89,161,Móvel,3,250
30476,2024-01-22 03:55:00,68,112,Móvel,2,180
30477,2024-01-22 03:56:00,107,55,Brinquedo,5,162
30478,2024-01-22 03:57:00,13,175,Alimento,2,188
30479,2024-01-22 03:58:00,46,71,Brinquedo,8,117
30480,2024-01-22 03:59:00,22,66,Alimento,4,88
30481,2024-01-22 04:00:00,29,20,Móvel,8,49
30482,2024-01-22 04:01:00,18,151,Alimento,1,169
30483,2024-01-22 04:02:00,97,33,Móvel,5,130
30484,2024-01-22 04:03:00,12,67,Eletrônico,6,79
30485,2024-01-22 04:04:00,74,50,Vestuário,9,124
30486,2024-01-22 04:05:00,119,37,Vestuário,3,156
30487,2024-01-22 04:06:00,55,112,Vestuário,1,167
30488,2024-01-22 04:07:00,11,65,Alimento,1,76
30489,2024-01-22 04:08:00,46,63,Vestuário,9,109
30490,2024-01-22 04:09:00,118,11,Móvel,8,129
30491,2024-01-22 04:10:00,12,155,Vestuário,4,167
30492,2024-01-22 04:11:00,46,151,Alimento,5,197
30493,2024-01-22 04:12:00,98,44,Móvel,7,142
30494,2024-01-22 04:13:00,74,80,Móvel,6,154
30495,2024-01-22 04:14:00,114,45,Móvel,9,159
30496,2024-01-22 04:15:00,70,142,Vestuário,6,212
30497,2024-01-22 04:16:00,67,25,Móvel,5,92
30498,2024-01-22 04:17:00,51,85,Alimento,4,136
30499,2024-01-22 04:18:00,15,87,Alimento,3,102
30500,2024-01-22 04:19:00,52,135,Vestuário,6,187
30501,2024-01-22 04:20:00,40,158,Móvel,6,198
30502,2024-01-22 04:21:00,75,112,Móvel,2,187
30503,2024-01-22 04:22:00,117,174,Eletrônico,5,291
30504,2024-01-22 04:23:00,116,94,Móvel,5,210
30505,2024-01-22 04:24:00,73,100,Brinquedo,3,173
30506,2024-01-22 04:25:00,78,34,Vestuário,1,112
30507,2024-01-22 04:26:00,23,92,Alimento,2,115
30508,2024-01-22 04:27:00,111,154,Brinquedo,9,265
30509,2024-01-22 04:28:00,68,67,Eletrônico,9,135
30510,2024-01-22 04:29:00,10,144,Eletrônico,3,154
30511,2024-01-22 04:30:00,60,124,Eletrônico,6,184
30512,2024-01-22 04:31:00,99,27,Alimento,1,126
30513,2024-01-22 04:32:00,114,137,Eletrônico,9,251
30514,2024-01-22 04:33:00,25,75,Eletrônico,9,100
30515,2024-01-22 04:34:00,94,114,Móvel,7,208
30516,2024-01-22 04:35:00,117,52,Vestuário,4,169
30517,2024-01-22 04:36:00,88,16,Eletrônico,1,104
30518,2024-01-22 04:37:00,111,58,Brinquedo,2,169
30519,2024-01-22 04:38:00,94,70,Eletrônico,2,164
30520,2024-01-22 04:39:00,94,171,Móvel,9,265
30521,2024-01-22 04:40:00,15,116,Móvel,7,131
30522,2024-01-22 04:41:00,11,72,Vestuário,7,83
30523,2024-01-22 04:42:00,48,28,Brinquedo,1,76
30524,2024-01-22 04:43:00,42,131,Móvel,4,173
30525,2024-01-22 04:44:00,89,140,Móvel,9,229
30526,2024-01-22 04:45:00,47,167,Móvel,7,214
30527,2024-01-22 04:46:00,51,46,Alimento,5,97
30528,2024-01-22 04:47:00,102,36,Brinquedo,7,138
30529,2024-01-22 04:48:00,38,163,Vestuário,9,201
30530,2024-01-22 04:49:00,35,49,Vestuário,4,84
30531,2024-01-22 04:50:00,32,45,Móvel,4,77
30532,2024-01-22 04:51:00,73,165,Móvel,9,238
30533,2024-01-22 04:52:00,91,137,Eletrônico,3,228
30534,2024-01-22 04:53:00,105,107,Vestuário,1,212
30535,2024-01-22 04:54:00,88,127,Alimento,6,215
30536,2024-01-22 04:55:00,46,68,Vestuário,3,114
30537,2024-01-22 04:56:00,48,81,Eletrônico,9,129
30538,2024-01-22 04:57:00,84,18,Móvel,7,102
30539,2024-01-22 04:58:00,47,110,Brinquedo,9,157
30540,2024-01-22 04:59:00,13,140,Brinquedo,1,153
30541,2024-01-22 05:00:00,54,114,Vestuário,6,168
30542,2024-01-22 05:01:00,36,148,Eletrônico,8,184
30543,2024-01-22 05:02:00,113,132,Móvel,3,245
30544,2024-01-22 05:03:00,108,37,Brinquedo,8,145
30545,2024-01-22 05:04:00,76,23,Vestuário,6,99
30546,2024-01-22 05:05:00,11,73,Alimento,9,84
30547,2024-01-22 05:06:00,94,161,Móvel,6,255
30548,2024-01-22 05:07:00,56,39,Vestuário,8,95
30549,2024-01-22 05:08:00,110,11,Brinquedo,5,121
30550,2024-01-22 05:09:00,12,124,Brinquedo,9,136
30551,2024-01-22 05:10:00,66,138,Alimento,9,204
30552,2024-01-22 05:11:00,55,64,Vestuário,1,119
30553,2024-01-22 05:12:00,93,169,Vestuário,6,262
30554,2024-01-22 05:13:00,29,41,Vestuário,5,70
30555,2024-01-22 05:14:00,112,87,Eletrônico,1,199
30556,2024-01-22 05:15:00,10,130,Vestuário,7,140
30557,2024-01-22 05:16:00,49,103,Vestuário,1,152
30558,2024-01-22 05:17:00,81,121,Brinquedo,3,202
30559,2024-01-22 05:18:00,81,159,Vestuário,3,240
30560,2024-01-22 05:19:00,55,54,Móvel,5,109
30561,2024-01-22 05:20:00,25,57,Alimento,3,82
30562,2024-01-22 05:21:00,11,26,Brinquedo,3,37
30563,2024-01-22 05:22:00,85,147,Vestuário,6,232
30564,2024-01-22 05:23:00,14,177,Alimento,8,191
30565,2024-01-22 05:24:00,109,66,Vestuário,9,175
30566,2024-01-22 05:25:00,29,63,Eletrônico,8,92
30567,2024-01-22 05:26:00,90,12,Brinquedo,1,102
30568,2024-01-22 05:27:00,32,144,Vestuário,5,176
30569,2024-01-22 05:28:00,66,108,Eletrônico,8,174
30570,2024-01-22 05:29:00,94,72,Móvel,7,166
30571,2024-01-22 05:30:00,47,47,Alimento,6,94
30572,2024-01-22 05:31:00,17,56,Vestuário,2,73
30573,2024-01-22 05:32:00,101,104,Vestuário,3,205
30574,2024-01-22 05:33:00,100,88,Móvel,3,188
30575,2024-01-22 05:34:00,31,160,Vestuário,9,191
30576,2024-01-22 05:35:00,51,61,Eletrônico,6,112
30577,2024-01-22 05:36:00,57,147,Alimento,1,204
30578,2024-01-22 05:37:00,118,42,Móvel,2,160
30579,2024-01-22 05:38:00,99,15,Vestuário,3,114
30580,2024-01-22 05:39:00,116,178,Alimento,4,294
30581,2024-01-22 05:40:00,43,26,Brinquedo,1,69
30582,2024-01-22 05:41:00,19,26,Brinquedo,2,45
30583,2024-01-22 05:42:00,83,128,Móvel,1,211
30584,2024-01-22 05:43:00,113,105,Móvel,1,218
30585,2024-01-22 05:44:00,65,109,Eletrônico,3,174
30586,2024-01-22 05:45:00,37,147,Vestuário,4,184
30587,2024-01-22 05:46:00,78,110,Alimento,2,188
30588,2024-01-22 05:47:00,17,25,Alimento,3,42
30589,2024-01-22 05:48:00,61,175,Móvel,1,236
30590,2024-01-22 05:49:00,39,17,Móvel,6,56
30591,2024-01-22 05:50:00,16,116,Eletrônico,5,132
30592,2024-01-22 05:51:00,10,165,Vestuário,5,175
30593,2024-01-22 05:52:00,27,33,Alimento,1,60
30594,2024-01-22 05:53:00,101,22,Eletrônico,4,123
30595,2024-01-22 05:54:00,115,30,Alimento,7,145
30596,2024-01-22 05:55:00,21,147,Eletrônico,6,168
30597,2024-01-22 05:56:00,33,114,Brinquedo,4,147
30598,2024-01-22 05:57:00,65,125,Brinquedo,8,190
30599,2024-01-22 05:58:00,106,167,Brinquedo,5,273
30600,2024-01-22 05:59:00,31,129,Brinquedo,4,160
30601,2024-01-22 06:00:00,27,115,Vestuário,8,142
30602,2024-01-22 06:01:00,102,19,Alimento,3,121
30603,2024-01-22 06:02:00,63,87,Vestuário,5,150
30604,2024-01-22 06:03:00,20,40,Vestuário,6,60
30605,2024-01-22 06:04:00,64,12,Móvel,5,76
30606,2024-01-22 06:05:00,52,169,Brinquedo,3,221
30607,2024-01-22 06:06:00,13,105,Brinquedo,3,118
30608,2024-01-22 06:07:00,35,94,Vestuário,6,129
30609,2024-01-22 06:08:00,47,154,Alimento,3,201
30610,2024-01-22 06:09:00,72,148,Vestuário,5,220
30611,2024-01-22 06:10:00,101,111,Eletrônico,2,212
30612,2024-01-22 06:11:00,61,141,Alimento,5,202
30613,2024-01-22 06:12:00,80,100,Brinquedo,6,180
30614,2024-01-22 06:13:00,53,68,Brinquedo,9,121
30615,2024-01-22 06:14:00,76,68,Alimento,2,144
30616,2024-01-22 06:15:00,115,111,Móvel,2,226
30617,2024-01-22 06:16:00,19,133,Móvel,8,152
30618,2024-01-22 06:17:00,99,153,Alimento,1,252
30619,2024-01-22 06:18:00,79,127,Brinquedo,8,206
30620,2024-01-22 06:19:00,45,166,Alimento,7,211
30621,2024-01-22 06:20:00,39,76,Brinquedo,7,115
30622,2024-01-22 06:21:00,65,12,Brinquedo,7,77
30623,2024-01-22 06:22:00,74,117,Vestuário,4,191
30624,2024-01-22 06:23:00,87,49,Vestuário,8,136
30625,2024-01-22 06:24:00,73,168,Vestuário,4,241
30626,2024-01-22 06:25:00,17,37,Eletrônico,5,54
30627,2024-01-22 06:26:00,54,78,Vestuário,5,132
30628,2024-01-22 06:27:00,76,145,Brinquedo,7,221
30629,2024-01-22 06:28:00,114,109,Brinquedo,1,223
30630,2024-01-22 06:29:00,114,99,Alimento,6,213
30631,2024-01-22 06:30:00,91,57,Brinquedo,8,148
30632,2024-01-22 06:31:00,51,35,Brinquedo,1,86
30633,2024-01-22 06:32:00,79,112,Móvel,6,191
30634,2024-01-22 06:33:00,89,144,Vestuário,2,233
30635,2024-01-22 06:34:00,33,27,Móvel,7,60
30636,2024-01-22 06:35:00,85,91,Móvel,3,176
30637,2024-01-22 06:36:00,81,56,Eletrônico,1,137
30638,2024-01-22 06:37:00,85,115,Brinquedo,5,200
30639,2024-01-22 06:38:00,19,90,Eletrônico,9,109
30640,2024-01-22 06:39:00,109,151,Móvel,3,260
30641,2024-01-22 06:40:00,89,144,Móvel,9,233
30642,2024-01-22 06:41:00,94,171,Brinquedo,6,265
30643,2024-01-22 06:42:00,101,103,Móvel,2,204
30644,2024-01-22 06:43:00,68,150,Brinquedo,5,218
30645,2024-01-22 06:44:00,69,114,Vestuário,2,183
30646,2024-01-22 06:45:00,61,108,Eletrônico,7,169
30647,2024-01-22 06:46:00,35,52,Brinquedo,8,87
30648,2024-01-22 06:47:00,58,57,Móvel,1,115
30649,2024-01-22 06:48:00,50,114,Alimento,1,164
30650,2024-01-22 06:49:00,118,162,Alimento,4,280
30651,2024-01-22 06:50:00,11,174,Vestuário,1,185
30652,2024-01-22 06:51:00,25,156,Brinquedo,4,181
30653,2024-01-22 06:52:00,65,66,Eletrônico,3,131
30654,2024-01-22 06:53:00,63,172,Brinquedo,7,235
30655,2024-01-22 06:54:00,33,151,Brinquedo,3,184
30656,2024-01-22 06:55:00,29,93,Móvel,7,122
30657,2024-01-22 06:56:00,98,67,Brinquedo,9,165
30658,2024-01-22 06:57:00,111,33,Vestuário,7,144
30659,2024-01-22 06:58:00,63,56,Brinquedo,5,119
30660,2024-01-22 06:59:00,89,149,Brinquedo,1,238
30661,2024-01-22 07:00:00,85,29,Eletrônico,8,114
30662,2024-01-22 07:01:00,77,44,Brinquedo,1,121
30663,2024-01-22 07:02:00,32,97,Eletrônico,7,129
30664,2024-01-22 07:03:00,115,158,Móvel,6,273
30665,2024-01-22 07:04:00,116,36,Brinquedo,9,152
30666,2024-01-22 07:05:00,75,154,Vestuário,8,229
30667,2024-01-22 07:06:00,68,63,Vestuário,8,131
30668,2024-01-22 07:07:00,51,65,Vestuário,3,116
30669,2024-01-22 07:08:00,28,168,Eletrônico,6,196
30670,2024-01-22 07:09:00,109,154,Vestuário,4,263
30671,2024-01-22 07:10:00,57,37,Alimento,1,94
30672,2024-01-22 07:11:00,53,66,Eletrônico,1,119
30673,2024-01-22 07:12:00,55,47,Eletrônico,5,102
30674,2024-01-22 07:13:00,89,102,Alimento,8,191
30675,2024-01-22 07:14:00,18,86,Vestuário,7,104
30676,2024-01-22 07:15:00,79,170,Móvel,8,249
30677,2024-01-22 07:16:00,115,22,Eletrônico,4,137
30678,2024-01-22 07:17:00,12,147,Brinquedo,7,159
30679,2024-01-22 07:18:00,71,72,Vestuário,7,143
30680,2024-01-22 07:19:00,107,104,Vestuário,8,211
30681,2024-01-22 07:20:00,45,106,Eletrônico,2,151
30682,2024-01-22 07:21:00,19,167,Eletrônico,3,186
30683,2024-01-22 07:22:00,59,14,Vestuário,5,73
30684,2024-01-22 07:23:00,39,125,Brinquedo,7,164
30685,2024-01-22 07:24:00,22,61,Brinquedo,5,83
30686,2024-01-22 07:25:00,118,39,Brinquedo,6,157
30687,2024-01-22 07:26:00,102,53,Alimento,8,155
30688,2024-01-22 07:27:00,35,95,Brinquedo,7,130
30689,2024-01-22 07:28:00,68,116,Brinquedo,6,184
30690,2024-01-22 07:29:00,111,20,Vestuário,9,131
30691,2024-01-22 07:30:00,107,54,Vestuário,5,161
30692,2024-01-22 07:31:00,33,149,Alimento,7,182
30693,2024-01-22 07:32:00,114,65,Eletrônico,7,179
30694,2024-01-22 07:33:00,26,83,Alimento,5,109
30695,2024-01-22 07:34:00,66,122,Vestuário,5,188
30696,2024-01-22 07:35:00,72,153,Eletrônico,6,225
30697,2024-01-22 07:36:00,66,36,Móvel,9,102
30698,2024-01-22 07:37:00,11,110,Vestuário,2,121
30699,2024-01-22 07:38:00,119,164,Móvel,9,283
30700,2024-01-22 07:39:00,94,165,Vestuário,6,259
30701,2024-01-22 07:40:00,77,68,Brinquedo,7,145
30702,2024-01-22 07:41:00,118,75,Eletrônico,7,193
30703,2024-01-22 07:42:00,13,132,Eletrônico,4,145
30704,2024-01-22 07:43:00,95,153,Brinquedo,2,248
30705,2024-01-22 07:44:00,78,162,Alimento,8,240
30706,2024-01-22 07:45:00,23,131,Brinquedo,9,154
30707,2024-01-22 07:46:00,102,118,Vestuário,1,220
30708,2024-01-22 07:47:00,50,12,Vestuário,6,62
30709,2024-01-22 07:48:00,93,76,Alimento,3,169
30710,2024-01-22 07:49:00,105,170,Vestuário,8,275
30711,2024-01-22 07:50:00,20,156,Eletrônico,1,176
30712,2024-01-22 07:51:00,66,82,Brinquedo,8,148
30713,2024-01-22 07:52:00,50,166,Alimento,2,216
30714,2024-01-22 07:53:00,53,35,Móvel,6,88
30715,2024-01-22 07:54:00,38,45,Brinquedo,7,83
30716,2024-01-22 07:55:00,50,124,Alimento,4,174
30717,2024-01-22 07:56:00,92,161,Móvel,4,253
30718,2024-01-22 07:57:00,89,129,Alimento,4,218
30719,2024-01-22 07:58:00,113,53,Móvel,2,166
30720,2024-01-22 07:59:00,97,166,Eletrônico,7,263
30721,2024-01-22 08:00:00,15,14,Vestuário,3,29
30722,2024-01-22 08:01:00,58,159,Alimento,3,217
30723,2024-01-22 08:02:00,43,59,Vestuário,8,102
30724,2024-01-22 08:03:00,19,30,Eletrônico,1,49
30725,2024-01-22 08:04:00,98,132,Móvel,5,230
30726,2024-01-22 08:05:00,115,49,Móvel,8,164
30727,2024-01-22 08:06:00,110,11,Eletrônico,9,121
30728,2024-01-22 08:07:00,71,20,Vestuário,6,91
30729,2024-01-22 08:08:00,13,99,Eletrônico,6,112
30730,2024-01-22 08:09:00,10,109,Móvel,9,119
30731,2024-01-22 08:10:00,52,106,Vestuário,5,158
30732,2024-01-22 08:11:00,114,93,Alimento,4,207
30733,2024-01-22 08:12:00,49,164,Alimento,7,213
30734,2024-01-22 08:13:00,75,80,Móvel,5,155
30735,2024-01-22 08:14:00,24,68,Brinquedo,4,92
30736,2024-01-22 08:15:00,88,149,Eletrônico,7,237
30737,2024-01-22 08:16:00,92,124,Móvel,5,216
30738,2024-01-22 08:17:00,18,151,Alimento,6,169
30739,2024-01-22 08:18:00,115,160,Eletrônico,8,275
30740,2024-01-22 08:19:00,33,170,Móvel,3,203
30741,2024-01-22 08:20:00,28,122,Alimento,7,150
30742,2024-01-22 08:21:00,42,170,Brinquedo,5,212
30743,2024-01-22 08:22:00,115,45,Vestuário,3,160
30744,2024-01-22 08:23:00,92,103,Vestuário,7,195
30745,2024-01-22 08:24:00,27,78,Brinquedo,6,105
30746,2024-01-22 08:25:00,43,24,Eletrônico,2,67
30747,2024-01-22 08:26:00,80,51,Vestuário,7,131
30748,2024-01-22 08:27:00,28,55,Brinquedo,9,83
30749,2024-01-22 08:28:00,28,133,Brinquedo,8,161
30750,2024-01-22 08:29:00,95,96,Móvel,3,191
30751,2024-01-22 08:30:00,49,170,Móvel,7,219
30752,2024-01-22 08:31:00,88,37,Eletrônico,3,125
30753,2024-01-22 08:32:00,37,146,Brinquedo,1,183
30754,2024-01-22 08:33:00,71,37,Vestuário,5,108
30755,2024-01-22 08:34:00,21,110,Vestuário,4,131
30756,2024-01-22 08:35:00,25,64,Vestuário,6,89
30757,2024-01-22 08:36:00,82,96,Móvel,1,178
30758,2024-01-22 08:37:00,74,170,Móvel,2,244
30759,2024-01-22 08:38:00,115,132,Móvel,7,247
30760,2024-01-22 08:39:00,32,115,Eletrônico,3,147
30761,2024-01-22 08:40:00,72,150,Vestuário,2,222
30762,2024-01-22 08:41:00,42,156,Móvel,8,198
30763,2024-01-22 08:42:00,75,116,Vestuário,5,191
30764,2024-01-22 08:43:00,34,17,Móvel,8,51
30765,2024-01-22 08:44:00,69,125,Eletrônico,7,194
30766,2024-01-22 08:45:00,113,114,Vestuário,3,227
30767,2024-01-22 08:46:00,70,87,Alimento,5,157
30768,2024-01-22 08:47:00,68,142,Vestuário,4,210
30769,2024-01-22 08:48:00,74,125,Vestuário,5,199
30770,2024-01-22 08:49:00,44,111,Brinquedo,1,155
30771,2024-01-22 08:50:00,73,136,Eletrônico,2,209
30772,2024-01-22 08:51:00,29,176,Vestuário,5,205
30773,2024-01-22 08:52:00,67,19,Vestuário,8,86
30774,2024-01-22 08:53:00,115,96,Brinquedo,8,211
30775,2024-01-22 08:54:00,87,82,Alimento,9,169
30776,2024-01-22 08:55:00,60,149,Móvel,7,209
30777,2024-01-22 08:56:00,51,133,Eletrônico,4,184
30778,2024-01-22 08:57:00,86,107,Vestuário,2,193
30779,2024-01-22 08:58:00,28,52,Móvel,2,80
30780,2024-01-22 08:59:00,17,54,Brinquedo,3,71
30781,2024-01-22 09:00:00,19,129,Brinquedo,6,148
30782,2024-01-22 09:01:00,72,96,Eletrônico,6,168
30783,2024-01-22 09:02:00,16,176,Vestuário,2,192
30784,2024-01-22 09:03:00,43,36,Vestuário,8,79
30785,2024-01-22 09:04:00,16,33,Brinquedo,6,49
30786,2024-01-22 09:05:00,41,118,Vestuário,9,159
30787,2024-01-22 09:06:00,118,65,Móvel,7,183
30788,2024-01-22 09:07:00,83,61,Vestuário,1,144
30789,2024-01-22 09:08:00,106,82,Alimento,2,188
30790,2024-01-22 09:09:00,30,121,Móvel,6,151
30791,2024-01-22 09:10:00,30,148,Alimento,9,178
30792,2024-01-22 09:11:00,98,24,Alimento,3,122
30793,2024-01-22 09:12:00,39,113,Vestuário,8,152
30794,2024-01-22 09:13:00,49,67,Alimento,4,116
30795,2024-01-22 09:14:00,70,155,Vestuário,9,225
30796,2024-01-22 09:15:00,79,90,Vestuário,4,169
30797,2024-01-22 09:16:00,96,108,Brinquedo,6,204
30798,2024-01-22 09:17:00,103,153,Eletrônico,7,256
30799,2024-01-22 09:18:00,47,68,Móvel,4,115
30800,2024-01-22 09:19:00,96,32,Eletrônico,5,128
30801,2024-01-22 09:20:00,72,140,Móvel,5,212
30802,2024-01-22 09:21:00,42,13,Alimento,2,55
30803,2024-01-22 09:22:00,115,138,Alimento,2,253
30804,2024-01-22 09:23:00,61,56,Eletrônico,1,117
30805,2024-01-22 09:24:00,59,51,Eletrônico,9,110
30806,2024-01-22 09:25:00,75,139,Vestuário,5,214
30807,2024-01-22 09:26:00,22,65,Móvel,3,87
30808,2024-01-22 09:27:00,14,16,Brinquedo,1,30
30809,2024-01-22 09:28:00,81,163,Eletrônico,8,244
30810,2024-01-22 09:29:00,67,177,Brinquedo,5,244
30811,2024-01-22 09:30:00,116,143,Eletrônico,8,259
30812,2024-01-22 09:31:00,72,52,Brinquedo,5,124
30813,2024-01-22 09:32:00,19,15,Alimento,7,34
30814,2024-01-22 09:33:00,103,39,Brinquedo,1,142
30815,2024-01-22 09:34:00,75,138,Móvel,7,213
30816,2024-01-22 09:35:00,89,117,Vestuário,5,206
30817,2024-01-22 09:36:00,104,51,Móvel,7,155
30818,2024-01-22 09:37:00,119,42,Eletrônico,1,161
30819,2024-01-22 09:38:00,55,15,Vestuário,9,70
30820,2024-01-22 09:39:00,82,124,Alimento,4,206
30821,2024-01-22 09:40:00,46,50,Alimento,1,96
30822,2024-01-22 09:41:00,108,81,Vestuário,8,189
30823,2024-01-22 09:42:00,79,170,Alimento,2,249
30824,2024-01-22 09:43:00,71,126,Brinquedo,9,197
30825,2024-01-22 09:44:00,32,62,Brinquedo,9,94
30826,2024-01-22 09:45:00,13,17,Eletrônico,4,30
30827,2024-01-22 09:46:00,77,84,Móvel,5,161
30828,2024-01-22 09:47:00,12,156,Brinquedo,4,168
30829,2024-01-22 09:48:00,63,46,Alimento,3,109
30830,2024-01-22 09:49:00,85,57,Alimento,7,142
30831,2024-01-22 09:50:00,24,76,Alimento,1,100
30832,2024-01-22 09:51:00,22,103,Alimento,9,125
30833,2024-01-22 09:52:00,97,99,Brinquedo,4,196
30834,2024-01-22 09:53:00,92,111,Brinquedo,4,203
30835,2024-01-22 09:54:00,11,136,Móvel,5,147
30836,2024-01-22 09:55:00,101,87,Brinquedo,5,188
30837,2024-01-22 09:56:00,101,107,Móvel,2,208
30838,2024-01-22 09:57:00,64,133,Alimento,8,197
30839,2024-01-22 09:58:00,17,27,Alimento,7,44
30840,2024-01-22 09:59:00,73,82,Vestuário,2,155
30841,2024-01-22 10:00:00,53,50,Vestuário,7,103
30842,2024-01-22 10:01:00,66,130,Móvel,5,196
30843,2024-01-22 10:02:00,41,83,Alimento,7,124
30844,2024-01-22 10:03:00,15,164,Vestuário,9,179
30845,2024-01-22 10:04:00,96,122,Eletrônico,8,218
30846,2024-01-22 10:05:00,11,82,Móvel,3,93
30847,2024-01-22 10:06:00,97,157,Eletrônico,9,254
30848,2024-01-22 10:07:00,12,12,Brinquedo,1,24
30849,2024-01-22 10:08:00,30,38,Móvel,1,68
30850,2024-01-22 10:09:00,111,23,Eletrônico,5,134
30851,2024-01-22 10:10:00,102,163,Alimento,3,265
30852,2024-01-22 10:11:00,82,144,Brinquedo,4,226
30853,2024-01-22 10:12:00,57,43,Eletrônico,4,100
30854,2024-01-22 10:13:00,85,116,Alimento,2,201
30855,2024-01-22 10:14:00,37,46,Alimento,3,83
30856,2024-01-22 10:15:00,57,158,Móvel,2,215
30857,2024-01-22 10:16:00,33,87,Móvel,4,120
30858,2024-01-22 10:17:00,101,11,Eletrônico,3,112
30859,2024-01-22 10:18:00,26,150,Eletrônico,7,176
30860,2024-01-22 10:19:00,88,166,Vestuário,6,254
30861,2024-01-22 10:20:00,36,176,Alimento,6,212
30862,2024-01-22 10:21:00,36,178,Vestuário,4,214
30863,2024-01-22 10:22:00,102,145,Alimento,9,247
30864,2024-01-22 10:23:00,30,61,Alimento,1,91
30865,2024-01-22 10:24:00,76,58,Móvel,7,134
30866,2024-01-22 10:25:00,115,70,Brinquedo,7,185
30867,2024-01-22 10:26:00,29,153,Alimento,7,182
30868,2024-01-22 10:27:00,82,158,Alimento,6,240
30869,2024-01-22 10:28:00,88,120,Alimento,5,208
30870,2024-01-22 10:29:00,50,112,Alimento,6,162
30871,2024-01-22 10:30:00,87,132,Móvel,6,219
30872,2024-01-22 10:31:00,109,105,Alimento,8,214
30873,2024-01-22 10:32:00,52,30,Eletrônico,8,82
30874,2024-01-22 10:33:00,84,14,Alimento,1,98
30875,2024-01-22 10:34:00,84,66,Brinquedo,8,150
30876,2024-01-22 10:35:00,38,30,Brinquedo,1,68
30877,2024-01-22 10:36:00,81,157,Brinquedo,4,238
30878,2024-01-22 10:37:00,11,124,Alimento,2,135
30879,2024-01-22 10:38:00,79,77,Eletrônico,4,156
30880,2024-01-22 10:39:00,47,111,Móvel,6,158
30881,2024-01-22 10:40:00,119,27,Móvel,3,146
30882,2024-01-22 10:41:00,63,45,Eletrônico,3,108
30883,2024-01-22 10:42:00,47,76,Alimento,7,123
30884,2024-01-22 10:43:00,74,39,Vestuário,6,113
30885,2024-01-22 10:44:00,84,150,Vestuário,4,234
30886,2024-01-22 10:45:00,44,91,Móvel,1,135
30887,2024-01-22 10:46:00,50,27,Vestuário,7,77
30888,2024-01-22 10:47:00,32,133,Vestuário,3,165
30889,2024-01-22 10:48:00,102,51,Vestuário,9,153
30890,2024-01-22 10:49:00,44,148,Eletrônico,5,192
30891,2024-01-22 10:50:00,89,151,Eletrônico,8,240
30892,2024-01-22 10:51:00,29,128,Móvel,3,157
30893,2024-01-22 10:52:00,119,100,Vestuário,2,219
30894,2024-01-22 10:53:00,119,167,Alimento,9,286
30895,2024-01-22 10:54:00,86,40,Alimento,2,126
30896,2024-01-22 10:55:00,111,173,Móvel,4,284
30897,2024-01-22 10:56:00,26,99,Alimento,2,125
30898,2024-01-22 10:57:00,23,144,Brinquedo,1,167
30899,2024-01-22 10:58:00,46,84,Brinquedo,5,130
30900,2024-01-22 10:59:00,49,137,Eletrônico,3,186
30901,2024-01-22 11:00:00,95,37,Eletrônico,1,132
30902,2024-01-22 11:01:00,96,77,Móvel,4,173
30903,2024-01-22 11:02:00,118,80,Móvel,7,198
30904,2024-01-22 11:03:00,81,60,Alimento,9,141
30905,2024-01-22 11:04:00,46,58,Vestuário,7,104
30906,2024-01-22 11:05:00,13,15,Eletrônico,4,28
30907,2024-01-22 11:06:00,14,148,Vestuário,8,162
30908,2024-01-22 11:07:00,102,103,Vestuário,6,205
30909,2024-01-22 11:08:00,71,25,Alimento,8,96
30910,2024-01-22 11:09:00,68,46,Vestuário,7,114
30911,2024-01-22 11:10:00,67,63,Alimento,3,130
30912,2024-01-22 11:11:00,111,30,Móvel,4,141
30913,2024-01-22 11:12:00,45,35,Brinquedo,5,80
30914,2024-01-22 11:13:00,108,111,Alimento,7,219
30915,2024-01-22 11:14:00,90,84,Móvel,1,174
30916,2024-01-22 11:15:00,26,17,Eletrônico,3,43
30917,2024-01-22 11:16:00,16,62,Móvel,5,78
30918,2024-01-22 11:17:00,32,167,Móvel,2,199
30919,2024-01-22 11:18:00,82,82,Vestuário,1,164
30920,2024-01-22 11:19:00,40,25,Vestuário,7,65
30921,2024-01-22 11:20:00,12,108,Brinquedo,4,120
30922,2024-01-22 11:21:00,18,102,Eletrônico,3,120
30923,2024-01-22 11:22:00,24,169,Móvel,7,193
30924,2024-01-22 11:23:00,25,137,Vestuário,4,162
30925,2024-01-22 11:24:00,20,13,Brinquedo,8,33
30926,2024-01-22 11:25:00,27,29,Vestuário,9,56
30927,2024-01-22 11:26:00,21,98,Móvel,4,119
30928,2024-01-22 11:27:00,51,153,Vestuário,8,204
30929,2024-01-22 11:28:00,48,35,Eletrônico,6,83
30930,2024-01-22 11:29:00,31,87,Móvel,6,118
30931,2024-01-22 11:30:00,51,79,Alimento,2,130
30932,2024-01-22 11:31:00,49,34,Brinquedo,6,83
30933,2024-01-22 11:32:00,82,122,Móvel,2,204
30934,2024-01-22 11:33:00,50,95,Vestuário,6,145
30935,2024-01-22 11:34:00,38,28,Móvel,5,66
30936,2024-01-22 11:35:00,74,50,Eletrônico,9,124
30937,2024-01-22 11:36:00,83,28,Móvel,7,111
30938,2024-01-22 11:37:00,41,111,Vestuário,3,152
30939,2024-01-22 11:38:00,104,134,Alimento,3,238
30940,2024-01-22 11:39:00,15,162,Eletrônico,8,177
30941,2024-01-22 11:40:00,60,28,Brinquedo,3,88
30942,2024-01-22 11:41:00,104,82,Eletrônico,8,186
30943,2024-01-22 11:42:00,118,89,Brinquedo,6,207
30944,2024-01-22 11:43:00,118,153,Vestuário,3,271
30945,2024-01-22 11:44:00,18,16,Alimento,7,34
30946,2024-01-22 11:45:00,72,49,Alimento,6,121
30947,2024-01-22 11:46:00,58,31,Alimento,6,89
30948,2024-01-22 11:47:00,79,39,Eletrônico,2,118
30949,2024-01-22 11:48:00,79,88,Eletrônico,7,167
30950,2024-01-22 11:49:00,89,22,Vestuário,1,111
30951,2024-01-22 11:50:00,41,150,Brinquedo,6,191
30952,2024-01-22 11:51:00,32,50,Eletrônico,8,82
30953,2024-01-22 11:52:00,55,96,Brinquedo,3,151
30954,2024-01-22 11:53:00,31,121,Vestuário,6,152
30955,2024-01-22 11:54:00,42,101,Alimento,1,143
30956,2024-01-22 11:55:00,51,105,Vestuário,7,156
30957,2024-01-22 11:56:00,12,80,Móvel,6,92
30958,2024-01-22 11:57:00,93,40,Vestuário,9,133
30959,2024-01-22 11:58:00,45,73,Eletrônico,2,118
30960,2024-01-22 11:59:00,66,91,Brinquedo,2,157
30961,2024-01-22 12:00:00,71,41,Brinquedo,3,112
30962,2024-01-22 12:01:00,67,175,Móvel,8,242
30963,2024-01-22 12:02:00,13,168,Vestuário,1,181
30964,2024-01-22 12:03:00,48,68,Móvel,5,116
30965,2024-01-22 12:04:00,57,20,Eletrônico,2,77
30966,2024-01-22 12:05:00,58,60,Alimento,7,118
30967,2024-01-22 12:06:00,115,107,Alimento,8,222
30968,2024-01-22 12:07:00,67,170,Vestuário,5,237
30969,2024-01-22 12:08:00,43,155,Móvel,5,198
30970,2024-01-22 12:09:00,117,97,Brinquedo,2,214
30971,2024-01-22 12:10:00,28,112,Eletrônico,4,140
30972,2024-01-22 12:11:00,101,88,Vestuário,1,189
30973,2024-01-22 12:12:00,63,59,Vestuário,2,122
30974,2024-01-22 12:13:00,116,109,Brinquedo,5,225
30975,2024-01-22 12:14:00,42,132,Vestuário,4,174
30976,2024-01-22 12:15:00,116,89,Móvel,9,205
30977,2024-01-22 12:16:00,116,147,Vestuário,7,263
30978,2024-01-22 12:17:00,62,42,Alimento,3,104
30979,2024-01-22 12:18:00,97,42,Eletrônico,9,139
30980,2024-01-22 12:19:00,90,143,Brinquedo,3,233
30981,2024-01-22 12:20:00,46,31,Vestuário,5,77
30982,2024-01-22 12:21:00,112,151,Eletrônico,3,263
30983,2024-01-22 12:22:00,34,90,Brinquedo,6,124
30984,2024-01-22 12:23:00,54,132,Alimento,8,186
30985,2024-01-22 12:24:00,92,44,Móvel,7,136
30986,2024-01-22 12:25:00,96,36,Eletrônico,8,132
30987,2024-01-22 12:26:00,95,43,Brinquedo,2,138
30988,2024-01-22 12:27:00,84,150,Alimento,5,234
30989,2024-01-22 12:28:00,104,127,Móvel,4,231
30990,2024-01-22 12:29:00,29,109,Eletrônico,3,138
30991,2024-01-22 12:30:00,62,100,Móvel,4,162
30992,2024-01-22 12:31:00,52,50,Alimento,4,102
30993,2024-01-22 12:32:00,86,91,Vestuário,4,177
30994,2024-01-22 12:33:00,49,125,Alimento,4,174
30995,2024-01-22 12:34:00,64,10,Alimento,8,74
30996,2024-01-22 12:35:00,58,113,Móvel,5,171
30997,2024-01-22 12:36:00,106,85,Vestuário,6,191
30998,2024-01-22 12:37:00,60,143,Vestuário,7,203
30999,2024-01-22 12:38:00,17,125,Móvel,9,142
31000,2024-01-22 12:39:00,16,146,Móvel,4,162
31001,2024-01-22 12:40:00,85,81,Eletrônico,5,166
31002,2024-01-22 12:41:00,106,73,Brinquedo,2,179
31003,2024-01-22 12:42:00,102,128,Brinquedo,2,230
31004,2024-01-22 12:43:00,39,148,Brinquedo,3,187
31005,2024-01-22 12:44:00,92,111,Vestuário,5,203
31006,2024-01-22 12:45:00,40,132,Eletrônico,7,172
31007,2024-01-22 12:46:00,74,21,Eletrônico,5,95
31008,2024-01-22 12:47:00,58,32,Alimento,7,90
31009,2024-01-22 12:48:00,40,142,Móvel,6,182
31010,2024-01-22 12:49:00,92,58,Eletrônico,7,150
31011,2024-01-22 12:50:00,71,46,Vestuário,6,117
31012,2024-01-22 12:51:00,20,148,Móvel,6,168
31013,2024-01-22 12:52:00,41,110,Alimento,6,151
31014,2024-01-22 12:53:00,28,178,Brinquedo,5,206
31015,2024-01-22 12:54:00,105,131,Móvel,6,236
31016,2024-01-22 12:55:00,78,95,Brinquedo,6,173
31017,2024-01-22 12:56:00,75,58,Vestuário,5,133
31018,2024-01-22 12:57:00,25,64,Alimento,9,89
31019,2024-01-22 12:58:00,95,33,Vestuário,7,128
31020,2024-01-22 12:59:00,38,155,Vestuário,7,193
31021,2024-01-22 13:00:00,118,72,Móvel,8,190
31022,2024-01-22 13:01:00,53,159,Vestuário,4,212
31023,2024-01-22 13:02:00,102,104,Vestuário,3,206
31024,2024-01-22 13:03:00,95,155,Brinquedo,4,250
31025,2024-01-22 13:04:00,86,35,Eletrônico,8,121
31026,2024-01-22 13:05:00,100,108,Vestuário,9,208
31027,2024-01-22 13:06:00,71,131,Eletrônico,5,202
31028,2024-01-22 13:07:00,96,72,Brinquedo,4,168
31029,2024-01-22 13:08:00,99,145,Móvel,5,244
31030,2024-01-22 13:09:00,24,92,Brinquedo,7,116
31031,2024-01-22 13:10:00,44,86,Brinquedo,4,130
31032,2024-01-22 13:11:00,101,58,Móvel,5,159
31033,2024-01-22 13:12:00,110,137,Eletrônico,2,247
31034,2024-01-22 13:13:00,50,153,Brinquedo,6,203
31035,2024-01-22 13:14:00,45,137,Móvel,8,182
31036,2024-01-22 13:15:00,82,27,Eletrônico,1,109
31037,2024-01-22 13:16:00,93,116,Brinquedo,8,209
31038,2024-01-22 13:17:00,23,178,Alimento,2,201
31039,2024-01-22 13:18:00,84,118,Móvel,1,202
31040,2024-01-22 13:19:00,113,174,Brinquedo,9,287
31041,2024-01-22 13:20:00,66,46,Eletrônico,4,112
31042,2024-01-22 13:21:00,114,96,Vestuário,6,210
31043,2024-01-22 13:22:00,95,67,Eletrônico,3,162
31044,2024-01-22 13:23:00,23,10,Vestuário,4,33
31045,2024-01-22 13:24:00,92,95,Eletrônico,1,187
31046,2024-01-22 13:25:00,99,140,Vestuário,8,239
31047,2024-01-22 13:26:00,24,100,Vestuário,4,124
31048,2024-01-22 13:27:00,88,57,Móvel,2,145
31049,2024-01-22 13:28:00,81,68,Alimento,1,149
31050,2024-01-22 13:29:00,24,149,Alimento,6,173
31051,2024-01-22 13:30:00,63,43,Brinquedo,3,106
31052,2024-01-22 13:31:00,66,94,Eletrônico,9,160
31053,2024-01-22 13:32:00,67,170,Alimento,9,237
31054,2024-01-22 13:33:00,96,92,Móvel,3,188
31055,2024-01-22 13:34:00,80,173,Eletrônico,3,253
31056,2024-01-22 13:35:00,82,29,Vestuário,5,111
31057,2024-01-22 13:36:00,106,110,Vestuário,7,216
31058,2024-01-22 13:37:00,44,27,Brinquedo,9,71
31059,2024-01-22 13:38:00,106,58,Móvel,1,164
31060,2024-01-22 13:39:00,22,140,Vestuário,1,162
31061,2024-01-22 13:40:00,27,14,Vestuário,6,41
31062,2024-01-22 13:41:00,64,55,Alimento,1,119
31063,2024-01-22 13:42:00,47,137,Vestuário,7,184
31064,2024-01-22 13:43:00,44,113,Brinquedo,2,157
31065,2024-01-22 13:44:00,60,11,Eletrônico,2,71
31066,2024-01-22 13:45:00,119,104,Vestuário,5,223
31067,2024-01-22 13:46:00,20,29,Brinquedo,8,49
31068,2024-01-22 13:47:00,32,93,Brinquedo,3,125
31069,2024-01-22 13:48:00,91,33,Alimento,8,124
31070,2024-01-22 13:49:00,88,109,Alimento,4,197
31071,2024-01-22 13:50:00,91,38,Vestuário,3,129
31072,2024-01-22 13:51:00,91,71,Móvel,6,162
31073,2024-01-22 13:52:00,97,52,Alimento,4,149
31074,2024-01-22 13:53:00,69,117,Brinquedo,2,186
31075,2024-01-22 13:54:00,86,156,Brinquedo,9,242
31076,2024-01-22 13:55:00,23,15,Eletrônico,1,38
31077,2024-01-22 13:56:00,55,55,Alimento,6,110
31078,2024-01-22 13:57:00,95,45,Móvel,7,140
31079,2024-01-22 13:58:00,68,128,Vestuário,4,196
31080,2024-01-22 13:59:00,42,34,Alimento,1,76
31081,2024-01-22 14:00:00,106,55,Vestuário,1,161
31082,2024-01-22 14:01:00,42,115,Móvel,9,157
31083,2024-01-22 14:02:00,104,74,Alimento,6,178
31084,2024-01-22 14:03:00,88,106,Alimento,9,194
31085,2024-01-22 14:04:00,46,73,Alimento,1,119
31086,2024-01-22 14:05:00,115,50,Vestuário,6,165
31087,2024-01-22 14:06:00,55,113,Móvel,7,168
31088,2024-01-22 14:07:00,109,160,Brinquedo,7,269
31089,2024-01-22 14:08:00,80,163,Eletrônico,5,243
31090,2024-01-22 14:09:00,22,117,Alimento,4,139
31091,2024-01-22 14:10:00,22,159,Brinquedo,6,181
31092,2024-01-22 14:11:00,110,91,Alimento,4,201
31093,2024-01-22 14:12:00,26,66,Móvel,3,92
31094,2024-01-22 14:13:00,96,108,Alimento,2,204
31095,2024-01-22 14:14:00,10,130,Brinquedo,4,140
31096,2024-01-22 14:15:00,34,16,Vestuário,2,50
31097,2024-01-22 14:16:00,17,145,Eletrônico,1,162
31098,2024-01-22 14:17:00,77,115,Móvel,5,192
31099,2024-01-22 14:18:00,24,117,Móvel,8,141
31100,2024-01-22 14:19:00,89,20,Brinquedo,8,109
31101,2024-01-22 14:20:00,51,96,Móvel,5,147
31102,2024-01-22 14:21:00,60,33,Vestuário,1,93
31103,2024-01-22 14:22:00,61,53,Vestuário,8,114
31104,2024-01-22 14:23:00,59,48,Eletrônico,1,107
31105,2024-01-22 14:24:00,104,30,Móvel,2,134
31106,2024-01-22 14:25:00,107,57,Brinquedo,2,164
31107,2024-01-22 14:26:00,77,115,Vestuário,3,192
31108,2024-01-22 14:27:00,62,134,Brinquedo,7,196
31109,2024-01-22 14:28:00,116,14,Móvel,3,130
31110,2024-01-22 14:29:00,57,130,Alimento,3,187
31111,2024-01-22 14:30:00,44,81,Móvel,1,125
31112,2024-01-22 14:31:00,100,39,Alimento,1,139
31113,2024-01-22 14:32:00,98,38,Alimento,6,136
31114,2024-01-22 14:33:00,14,86,Móvel,6,100
31115,2024-01-22 14:34:00,65,137,Alimento,7,202
31116,2024-01-22 14:35:00,46,143,Alimento,9,189
31117,2024-01-22 14:36:00,92,47,Móvel,5,139
31118,2024-01-22 14:37:00,109,131,Alimento,4,240
31119,2024-01-22 14:38:00,61,145,Móvel,3,206
31120,2024-01-22 14:39:00,49,121,Móvel,4,170
31121,2024-01-22 14:40:00,49,58,Vestuário,3,107
31122,2024-01-22 14:41:00,90,109,Brinquedo,4,199
31123,2024-01-22 14:42:00,107,105,Móvel,8,212
31124,2024-01-22 14:43:00,117,96,Brinquedo,7,213
31125,2024-01-22 14:44:00,29,81,Alimento,1,110
31126,2024-01-22 14:45:00,35,15,Móvel,7,50
31127,2024-01-22 14:46:00,78,169,Alimento,6,247
31128,2024-01-22 14:47:00,100,126,Móvel,1,226
31129,2024-01-22 14:48:00,112,24,Móvel,1,136
31130,2024-01-22 14:49:00,111,104,Vestuário,9,215
31131,2024-01-22 14:50:00,10,128,Eletrônico,3,138
31132,2024-01-22 14:51:00,73,127,Móvel,1,200
31133,2024-01-22 14:52:00,82,48,Vestuário,8,130
31134,2024-01-22 14:53:00,16,159,Móvel,2,175
31135,2024-01-22 14:54:00,38,65,Móvel,6,103
31136,2024-01-22 14:55:00,39,85,Móvel,9,124
31137,2024-01-22 14:56:00,80,117,Móvel,2,197
31138,2024-01-22 14:57:00,98,50,Alimento,7,148
31139,2024-01-22 14:58:00,49,59,Brinquedo,2,108
31140,2024-01-22 14:59:00,96,168,Brinquedo,4,264
31141,2024-01-22 15:00:00,20,112,Vestuário,5,132
31142,2024-01-22 15:01:00,71,50,Vestuário,2,121
31143,2024-01-22 15:02:00,110,11,Brinquedo,1,121
31144,2024-01-22 15:03:00,116,107,Vestuário,9,223
31145,2024-01-22 15:04:00,99,83,Móvel,3,182
31146,2024-01-22 15:05:00,79,36,Eletrônico,2,115
31147,2024-01-22 15:06:00,108,169,Brinquedo,4,277
31148,2024-01-22 15:07:00,44,58,Vestuário,9,102
31149,2024-01-22 15:08:00,65,112,Eletrônico,5,177
31150,2024-01-22 15:09:00,94,130,Alimento,2,224
31151,2024-01-22 15:10:00,112,153,Eletrônico,3,265
31152,2024-01-22 15:11:00,10,21,Eletrônico,6,31
31153,2024-01-22 15:12:00,29,24,Brinquedo,7,53
31154,2024-01-22 15:13:00,79,150,Vestuário,4,229
31155,2024-01-22 15:14:00,48,83,Alimento,1,131
31156,2024-01-22 15:15:00,28,95,Vestuário,2,123
31157,2024-01-22 15:16:00,53,144,Alimento,3,197
31158,2024-01-22 15:17:00,33,91,Eletrônico,7,124
31159,2024-01-22 15:18:00,83,108,Alimento,6,191
31160,2024-01-22 15:19:00,44,79,Alimento,3,123
31161,2024-01-22 15:20:00,25,174,Vestuário,1,199
31162,2024-01-22 15:21:00,119,129,Brinquedo,5,248
31163,2024-01-22 15:22:00,102,129,Brinquedo,5,231
31164,2024-01-22 15:23:00,11,49,Alimento,7,60
31165,2024-01-22 15:24:00,105,38,Móvel,5,143
31166,2024-01-22 15:25:00,32,95,Eletrônico,4,127
31167,2024-01-22 15:26:00,97,56,Eletrônico,3,153
31168,2024-01-22 15:27:00,30,25,Brinquedo,2,55
31169,2024-01-22 15:28:00,87,66,Brinquedo,3,153
31170,2024-01-22 15:29:00,103,159,Eletrônico,7,262
31171,2024-01-22 15:30:00,58,157,Vestuário,3,215
31172,2024-01-22 15:31:00,31,157,Brinquedo,1,188
31173,2024-01-22 15:32:00,54,160,Alimento,1,214
31174,2024-01-22 15:33:00,99,82,Eletrônico,1,181
31175,2024-01-22 15:34:00,76,16,Vestuário,1,92
31176,2024-01-22 15:35:00,15,55,Alimento,9,70
31177,2024-01-22 15:36:00,48,41,Brinquedo,7,89
31178,2024-01-22 15:37:00,28,62,Eletrônico,7,90
31179,2024-01-22 15:38:00,30,70,Alimento,2,100
31180,2024-01-22 15:39:00,86,14,Vestuário,1,100
31181,2024-01-22 15:40:00,86,33,Eletrônico,2,119
31182,2024-01-22 15:41:00,85,136,Móvel,4,221
31183,2024-01-22 15:42:00,119,12,Móvel,3,131
31184,2024-01-22 15:43:00,90,178,Eletrônico,6,268
31185,2024-01-22 15:44:00,65,121,Brinquedo,9,186
31186,2024-01-22 15:45:00,113,71,Eletrônico,1,184
31187,2024-01-22 15:46:00,111,122,Vestuário,4,233
31188,2024-01-22 15:47:00,16,102,Eletrônico,5,118
31189,2024-01-22 15:48:00,66,118,Móvel,3,184
31190,2024-01-22 15:49:00,14,57,Móvel,4,71
31191,2024-01-22 15:50:00,76,14,Alimento,7,90
31192,2024-01-22 15:51:00,12,140,Brinquedo,2,152
31193,2024-01-22 15:52:00,89,27,Vestuário,8,116
31194,2024-01-22 15:53:00,95,116,Móvel,8,211
31195,2024-01-22 15:54:00,103,38,Eletrônico,7,141
31196,2024-01-22 15:55:00,58,117,Brinquedo,6,175
31197,2024-01-22 15:56:00,16,59,Vestuário,5,75
31198,2024-01-22 15:57:00,75,76,Alimento,8,151
31199,2024-01-22 15:58:00,55,24,Alimento,6,79
31200,2024-01-22 15:59:00,48,175,Móvel,6,223
31201,2024-01-22 16:00:00,71,67,Brinquedo,3,138
31202,2024-01-22 16:01:00,47,20,Eletrônico,9,67
31203,2024-01-22 16:02:00,58,53,Vestuário,3,111
31204,2024-01-22 16:03:00,54,129,Móvel,1,183
31205,2024-01-22 16:04:00,75,146,Brinquedo,9,221
31206,2024-01-22 16:05:00,118,56,Brinquedo,3,174
31207,2024-01-22 16:06:00,116,71,Vestuário,1,187
31208,2024-01-22 16:07:00,90,174,Móvel,1,264
31209,2024-01-22 16:08:00,27,11,Vestuário,4,38
31210,2024-01-22 16:09:00,81,139,Móvel,4,220
31211,2024-01-22 16:10:00,114,73,Vestuário,8,187
31212,2024-01-22 16:11:00,103,67,Alimento,7,170
31213,2024-01-22 16:12:00,65,29,Eletrônico,9,94
31214,2024-01-22 16:13:00,65,170,Brinquedo,4,235
31215,2024-01-22 16:14:00,74,14,Vestuário,4,88
31216,2024-01-22 16:15:00,117,97,Alimento,5,214
31217,2024-01-22 16:16:00,34,102,Alimento,6,136
31218,2024-01-22 16:17:00,36,60,Eletrônico,7,96
31219,2024-01-22 16:18:00,21,82,Móvel,8,103
31220,2024-01-22 16:19:00,86,104,Vestuário,4,190
31221,2024-01-22 16:20:00,69,31,Alimento,1,100
31222,2024-01-22 16:21:00,27,27,Brinquedo,1,54
31223,2024-01-22 16:22:00,35,43,Móvel,3,78
31224,2024-01-22 16:23:00,110,36,Alimento,9,146
31225,2024-01-22 16:24:00,48,177,Eletrônico,3,225
31226,2024-01-22 16:25:00,45,57,Móvel,6,102
31227,2024-01-22 16:26:00,34,15,Alimento,8,49
31228,2024-01-22 16:27:00,111,10,Brinquedo,8,121
31229,2024-01-22 16:28:00,59,112,Eletrônico,8,171
31230,2024-01-22 16:29:00,33,140,Alimento,7,173
31231,2024-01-22 16:30:00,119,11,Eletrônico,8,130
31232,2024-01-22 16:31:00,54,126,Brinquedo,2,180
31233,2024-01-22 16:32:00,84,128,Vestuário,8,212
31234,2024-01-22 16:33:00,17,52,Brinquedo,3,69
31235,2024-01-22 16:34:00,96,161,Alimento,5,257
31236,2024-01-22 16:35:00,102,34,Alimento,8,136
31237,2024-01-22 16:36:00,78,146,Alimento,6,224
31238,2024-01-22 16:37:00,107,147,Vestuário,1,254
31239,2024-01-22 16:38:00,71,167,Brinquedo,2,238
31240,2024-01-22 16:39:00,101,134,Móvel,2,235
31241,2024-01-22 16:40:00,50,68,Vestuário,3,118
31242,2024-01-22 16:41:00,82,75,Móvel,8,157
31243,2024-01-22 16:42:00,44,110,Brinquedo,8,154
31244,2024-01-22 16:43:00,83,168,Vestuário,3,251
31245,2024-01-22 16:44:00,88,141,Vestuário,1,229
31246,2024-01-22 16:45:00,33,17,Alimento,2,50
31247,2024-01-22 16:46:00,37,56,Eletrônico,4,93
31248,2024-01-22 16:47:00,119,179,Alimento,7,298
31249,2024-01-22 16:48:00,32,130,Móvel,9,162
31250,2024-01-22 16:49:00,24,167,Brinquedo,5,191
31251,2024-01-22 16:50:00,55,63,Eletrônico,3,118
31252,2024-01-22 16:51:00,87,74,Vestuário,6,161
31253,2024-01-22 16:52:00,98,11,Vestuário,2,109
31254,2024-01-22 16:53:00,97,18,Eletrônico,9,115
31255,2024-01-22 16:54:00,69,115,Móvel,6,184
31256,2024-01-22 16:55:00,58,52,Alimento,6,110
31257,2024-01-22 16:56:00,93,25,Alimento,1,118
31258,2024-01-22 16:57:00,101,100,Vestuário,1,201
31259,2024-01-22 16:58:00,117,12,Brinquedo,8,129
31260,2024-01-22 16:59:00,60,51,Brinquedo,3,111
31261,2024-01-22 17:00:00,23,19,Brinquedo,8,42
31262,2024-01-22 17:01:00,53,133,Vestuário,9,186
31263,2024-01-22 17:02:00,41,27,Eletrônico,2,68
31264,2024-01-22 17:03:00,108,119,Móvel,3,227
31265,2024-01-22 17:04:00,15,77,Móvel,7,92
31266,2024-01-22 17:05:00,66,168,Alimento,9,234
31267,2024-01-22 17:06:00,29,123,Eletrônico,2,152
31268,2024-01-22 17:07:00,12,126,Móvel,6,138
31269,2024-01-22 17:08:00,72,101,Eletrônico,4,173
31270,2024-01-22 17:09:00,109,95,Brinquedo,4,204
31271,2024-01-22 17:10:00,47,29,Alimento,8,76
31272,2024-01-22 17:11:00,30,22,Móvel,8,52
31273,2024-01-22 17:12:00,58,111,Vestuário,5,169
31274,2024-01-22 17:13:00,54,27,Vestuário,9,81
31275,2024-01-22 17:14:00,26,100,Brinquedo,9,126
31276,2024-01-22 17:15:00,99,20,Brinquedo,3,119
31277,2024-01-22 17:16:00,54,148,Vestuário,9,202
31278,2024-01-22 17:17:00,67,48,Alimento,5,115
31279,2024-01-22 17:18:00,88,164,Brinquedo,6,252
31280,2024-01-22 17:19:00,51,144,Alimento,6,195
31281,2024-01-22 17:20:00,87,43,Alimento,8,130
31282,2024-01-22 17:21:00,47,73,Alimento,1,120
31283,2024-01-22 17:22:00,52,127,Móvel,4,179
31284,2024-01-22 17:23:00,24,40,Brinquedo,4,64
31285,2024-01-22 17:24:00,47,113,Móvel,2,160
31286,2024-01-22 17:25:00,56,82,Móvel,1,138
31287,2024-01-22 17:26:00,58,148,Eletrônico,6,206
31288,2024-01-22 17:27:00,83,175,Vestuário,7,258
31289,2024-01-22 17:28:00,35,116,Móvel,8,151
31290,2024-01-22 17:29:00,48,24,Móvel,8,72
31291,2024-01-22 17:30:00,93,79,Alimento,9,172
31292,2024-01-22 17:31:00,55,167,Eletrônico,6,222
31293,2024-01-22 17:32:00,51,134,Móvel,4,185
31294,2024-01-22 17:33:00,113,92,Brinquedo,8,205
31295,2024-01-22 17:34:00,86,160,Vestuário,1,246
31296,2024-01-22 17:35:00,90,54,Móvel,1,144
31297,2024-01-22 17:36:00,80,128,Eletrônico,9,208
31298,2024-01-22 17:37:00,89,46,Vestuário,5,135
31299,2024-01-22 17:38:00,40,24,Móvel,2,64
31300,2024-01-22 17:39:00,98,170,Brinquedo,6,268
31301,2024-01-22 17:40:00,61,64,Brinquedo,4,125
31302,2024-01-22 17:41:00,93,146,Brinquedo,5,239
31303,2024-01-22 17:42:00,53,40,Brinquedo,2,93
31304,2024-01-22 17:43:00,96,171,Móvel,1,267
31305,2024-01-22 17:44:00,85,85,Eletrônico,1,170
31306,2024-01-22 17:45:00,12,69,Brinquedo,5,81
31307,2024-01-22 17:46:00,39,61,Vestuário,2,100
31308,2024-01-22 17:47:00,70,28,Brinquedo,3,98
31309,2024-01-22 17:48:00,116,49,Brinquedo,7,165
31310,2024-01-22 17:49:00,91,149,Eletrônico,9,240
31311,2024-01-22 17:50:00,27,127,Móvel,8,154
31312,2024-01-22 17:51:00,108,24,Brinquedo,5,132
31313,2024-01-22 17:52:00,117,162,Brinquedo,4,279
31314,2024-01-22 17:53:00,69,112,Móvel,3,181
31315,2024-01-22 17:54:00,11,137,Brinquedo,7,148
31316,2024-01-22 17:55:00,40,26,Alimento,9,66
31317,2024-01-22 17:56:00,30,29,Móvel,4,59
31318,2024-01-22 17:57:00,108,52,Eletrônico,1,160
31319,2024-01-22 17:58:00,65,150,Brinquedo,4,215
31320,2024-01-22 17:59:00,17,110,Alimento,5,127
31321,2024-01-22 18:00:00,116,46,Móvel,6,162
31322,2024-01-22 18:01:00,40,89,Móvel,4,129
31323,2024-01-22 18:02:00,36,131,Alimento,7,167
31324,2024-01-22 18:03:00,59,103,Vestuário,3,162
31325,2024-01-22 18:04:00,78,42,Brinquedo,3,120
31326,2024-01-22 18:05:00,73,88,Alimento,2,161
31327,2024-01-22 18:06:00,50,97,Móvel,6,147
31328,2024-01-22 18:07:00,91,56,Brinquedo,3,147
31329,2024-01-22 18:08:00,40,20,Brinquedo,9,60
31330,2024-01-22 18:09:00,70,139,Eletrônico,1,209
31331,2024-01-22 18:10:00,100,143,Alimento,5,243
31332,2024-01-22 18:11:00,29,169,Alimento,6,198
31333,2024-01-22 18:12:00,20,159,Vestuário,9,179
31334,2024-01-22 18:13:00,98,42,Eletrônico,8,140
31335,2024-01-22 18:14:00,24,102,Alimento,6,126
31336,2024-01-22 18:15:00,87,96,Alimento,5,183
31337,2024-01-22 18:16:00,103,37,Eletrônico,9,140
31338,2024-01-22 18:17:00,27,70,Brinquedo,5,97
31339,2024-01-22 18:18:00,101,162,Móvel,6,263
31340,2024-01-22 18:19:00,12,155,Alimento,1,167
31341,2024-01-22 18:20:00,50,135,Móvel,3,185
31342,2024-01-22 18:21:00,117,170,Alimento,1,287
31343,2024-01-22 18:22:00,42,51,Vestuário,5,93
31344,2024-01-22 18:23:00,32,83,Vestuário,5,115
31345,2024-01-22 18:24:00,34,38,Alimento,1,72
31346,2024-01-22 18:25:00,13,92,Alimento,2,105
31347,2024-01-22 18:26:00,34,100,Móvel,8,134
31348,2024-01-22 18:27:00,50,133,Eletrônico,6,183
31349,2024-01-22 18:28:00,32,68,Vestuário,6,100
31350,2024-01-22 18:29:00,28,163,Eletrônico,4,191
31351,2024-01-22 18:30:00,20,36,Alimento,7,56
31352,2024-01-22 18:31:00,18,17,Eletrônico,6,35
31353,2024-01-22 18:32:00,96,162,Brinquedo,8,258
31354,2024-01-22 18:33:00,77,71,Eletrônico,9,148
31355,2024-01-22 18:34:00,12,158,Brinquedo,8,170
31356,2024-01-22 18:35:00,118,34,Móvel,1,152
31357,2024-01-22 18:36:00,61,52,Eletrônico,2,113
31358,2024-01-22 18:37:00,39,96,Móvel,7,135
31359,2024-01-22 18:38:00,53,152,Alimento,4,205
31360,2024-01-22 18:39:00,78,32,Vestuário,4,110
31361,2024-01-22 18:40:00,79,152,Vestuário,8,231
31362,2024-01-22 18:41:00,95,112,Vestuário,3,207
31363,2024-01-22 18:42:00,28,147,Vestuário,4,175
31364,2024-01-22 18:43:00,27,117,Brinquedo,1,144
31365,2024-01-22 18:44:00,20,135,Móvel,9,155
31366,2024-01-22 18:45:00,103,133,Móvel,3,236
31367,2024-01-22 18:46:00,29,27,Alimento,6,56
31368,2024-01-22 18:47:00,24,134,Eletrônico,1,158
31369,2024-01-22 18:48:00,16,38,Vestuário,2,54
31370,2024-01-22 18:49:00,85,92,Brinquedo,3,177
31371,2024-01-22 18:50:00,73,41,Vestuário,6,114
31372,2024-01-22 18:51:00,69,148,Eletrônico,7,217
31373,2024-01-22 18:52:00,89,69,Brinquedo,1,158
31374,2024-01-22 18:53:00,40,108,Brinquedo,9,148
31375,2024-01-22 18:54:00,31,46,Brinquedo,7,77
31376,2024-01-22 18:55:00,29,157,Eletrônico,8,186
31377,2024-01-22 18:56:00,60,27,Vestuário,3,87
31378,2024-01-22 18:57:00,46,95,Alimento,7,141
31379,2024-01-22 18:58:00,93,18,Alimento,4,111
31380,2024-01-22 18:59:00,42,175,Móvel,9,217
31381,2024-01-22 19:00:00,117,151,Brinquedo,2,268
31382,2024-01-22 19:01:00,118,40,Vestuário,6,158
31383,2024-01-22 19:02:00,65,37,Brinquedo,3,102
31384,2024-01-22 19:03:00,118,51,Vestuário,1,169
31385,2024-01-22 19:04:00,90,103,Vestuário,4,193
31386,2024-01-22 19:05:00,36,158,Vestuário,8,194
31387,2024-01-22 19:06:00,28,175,Móvel,7,203
31388,2024-01-22 19:07:00,47,173,Vestuário,4,220
31389,2024-01-22 19:08:00,81,143,Eletrônico,5,224
31390,2024-01-22 19:09:00,70,155,Móvel,2,225
31391,2024-01-22 19:10:00,94,77,Vestuário,6,171
31392,2024-01-22 19:11:00,73,70,Alimento,6,143
31393,2024-01-22 19:12:00,42,74,Móvel,4,116
31394,2024-01-22 19:13:00,52,137,Móvel,3,189
31395,2024-01-22 19:14:00,37,94,Eletrônico,3,131
31396,2024-01-22 19:15:00,118,21,Alimento,2,139
31397,2024-01-22 19:16:00,111,112,Eletrônico,3,223
31398,2024-01-22 19:17:00,87,64,Alimento,1,151
31399,2024-01-22 19:18:00,113,166,Vestuário,4,279
31400,2024-01-22 19:19:00,76,106,Alimento,1,182
31401,2024-01-22 19:20:00,66,159,Alimento,9,225
31402,2024-01-22 19:21:00,87,85,Brinquedo,1,172
31403,2024-01-22 19:22:00,89,102,Móvel,1,191
31404,2024-01-22 19:23:00,51,121,Brinquedo,3,172
31405,2024-01-22 19:24:00,106,40,Alimento,5,146
31406,2024-01-22 19:25:00,16,23,Vestuário,4,39
31407,2024-01-22 19:26:00,45,135,Alimento,7,180
31408,2024-01-22 19:27:00,52,144,Móvel,2,196
31409,2024-01-22 19:28:00,81,48,Vestuário,7,129
31410,2024-01-22 19:29:00,36,101,Brinquedo,2,137
31411,2024-01-22 19:30:00,76,145,Brinquedo,7,221
31412,2024-01-22 19:31:00,73,39,Brinquedo,7,112
31413,2024-01-22 19:32:00,63,126,Móvel,6,189
31414,2024-01-22 19:33:00,18,113,Vestuário,3,131
31415,2024-01-22 19:34:00,112,98,Alimento,5,210
31416,2024-01-22 19:35:00,89,32,Alimento,3,121
31417,2024-01-22 19:36:00,113,115,Alimento,1,228
31418,2024-01-22 19:37:00,63,146,Vestuário,6,209
31419,2024-01-22 19:38:00,14,78,Eletrônico,3,92
31420,2024-01-22 19:39:00,16,118,Móvel,6,134
31421,2024-01-22 19:40:00,70,76,Eletrônico,7,146
31422,2024-01-22 19:41:00,15,101,Móvel,7,116
31423,2024-01-22 19:42:00,45,59,Móvel,6,104
31424,2024-01-22 19:43:00,57,20,Eletrônico,8,77
31425,2024-01-22 19:44:00,65,172,Eletrônico,5,237
31426,2024-01-22 19:45:00,19,99,Móvel,3,118
31427,2024-01-22 19:46:00,86,133,Vestuário,7,219
31428,2024-01-22 19:47:00,38,164,Brinquedo,2,202
31429,2024-01-22 19:48:00,81,94,Móvel,1,175
31430,2024-01-22 19:49:00,90,85,Eletrônico,2,175
31431,2024-01-22 19:50:00,36,169,Móvel,7,205
31432,2024-01-22 19:51:00,89,11,Alimento,5,100
31433,2024-01-22 19:52:00,67,92,Alimento,3,159
31434,2024-01-22 19:53:00,109,98,Brinquedo,9,207
31435,2024-01-22 19:54:00,27,80,Móvel,7,107
31436,2024-01-22 19:55:00,38,105,Brinquedo,6,143
31437,2024-01-22 19:56:00,104,115,Eletrônico,8,219
31438,2024-01-22 19:57:00,108,12,Vestuário,1,120
31439,2024-01-22 19:58:00,52,53,Brinquedo,1,105
31440,2024-01-22 19:59:00,24,68,Móvel,2,92
31441,2024-01-22 20:00:00,64,77,Móvel,2,141
31442,2024-01-22 20:01:00,30,54,Móvel,6,84
31443,2024-01-22 20:02:00,15,73,Alimento,6,88
31444,2024-01-22 20:03:00,31,166,Brinquedo,5,197
31445,2024-01-22 20:04:00,53,70,Alimento,8,123
31446,2024-01-22 20:05:00,43,74,Vestuário,5,117
31447,2024-01-22 20:06:00,67,169,Alimento,4,236
31448,2024-01-22 20:07:00,89,168,Vestuário,7,257
31449,2024-01-22 20:08:00,99,27,Móvel,7,126
31450,2024-01-22 20:09:00,43,98,Eletrônico,5,141
31451,2024-01-22 20:10:00,79,164,Brinquedo,3,243
31452,2024-01-22 20:11:00,78,54,Brinquedo,4,132
31453,2024-01-22 20:12:00,98,36,Brinquedo,7,134
31454,2024-01-22 20:13:00,69,128,Móvel,9,197
31455,2024-01-22 20:14:00,61,46,Alimento,2,107
31456,2024-01-22 20:15:00,46,40,Móvel,9,86
31457,2024-01-22 20:16:00,50,166,Brinquedo,5,216
31458,2024-01-22 20:17:00,18,29,Móvel,2,47
31459,2024-01-22 20:18:00,16,10,Vestuário,8,26
31460,2024-01-22 20:19:00,119,10,Eletrônico,4,129
31461,2024-01-22 20:20:00,32,122,Brinquedo,6,154
31462,2024-01-22 20:21:00,65,35,Brinquedo,4,100
31463,2024-01-22 20:22:00,45,41,Brinquedo,8,86
31464,2024-01-22 20:23:00,82,175,Móvel,8,257
31465,2024-01-22 20:24:00,84,138,Móvel,2,222
31466,2024-01-22 20:25:00,99,173,Alimento,3,272
31467,2024-01-22 20:26:00,70,14,Móvel,9,84
31468,2024-01-22 20:27:00,61,117,Móvel,9,178
31469,2024-01-22 20:28:00,28,107,Brinquedo,7,135
31470,2024-01-22 20:29:00,115,117,Brinquedo,5,232
31471,2024-01-22 20:30:00,72,173,Brinquedo,6,245
31472,2024-01-22 20:31:00,72,123,Brinquedo,8,195
31473,2024-01-22 20:32:00,111,139,Vestuário,4,250
31474,2024-01-22 20:33:00,68,128,Brinquedo,8,196
31475,2024-01-22 20:34:00,102,33,Eletrônico,4,135
31476,2024-01-22 20:35:00,52,92,Vestuário,8,144
31477,2024-01-22 20:36:00,45,96,Vestuário,8,141
31478,2024-01-22 20:37:00,66,32,Móvel,6,98
31479,2024-01-22 20:38:00,114,101,Brinquedo,6,215
31480,2024-01-22 20:39:00,99,122,Móvel,5,221
31481,2024-01-22 20:40:00,20,70,Vestuário,6,90
31482,2024-01-22 20:41:00,108,73,Móvel,3,181
31483,2024-01-22 20:42:00,60,63,Vestuário,9,123
31484,2024-01-22 20:43:00,68,21,Brinquedo,2,89
31485,2024-01-22 20:44:00,40,48,Alimento,1,88
31486,2024-01-22 20:45:00,96,69,Móvel,8,165
31487,2024-01-22 20:46:00,98,128,Eletrônico,6,226
31488,2024-01-22 20:47:00,82,108,Eletrônico,9,190
31489,2024-01-22 20:48:00,100,72,Móvel,5,172
31490,2024-01-22 20:49:00,74,55,Móvel,5,129
31491,2024-01-22 20:50:00,77,166,Vestuário,5,243
31492,2024-01-22 20:51:00,21,67,Vestuário,4,88
31493,2024-01-22 20:52:00,49,65,Móvel,1,114
31494,2024-01-22 20:53:00,63,45,Alimento,9,108
31495,2024-01-22 20:54:00,37,92,Eletrônico,8,129
31496,2024-01-22 20:55:00,82,51,Móvel,6,133
31497,2024-01-22 20:56:00,67,138,Eletrônico,9,205
31498,2024-01-22 20:57:00,28,18,Eletrônico,5,46
31499,2024-01-22 20:58:00,35,101,Eletrônico,6,136
31500,2024-01-22 20:59:00,53,69,Móvel,8,122
31501,2024-01-22 21:00:00,48,87,Vestuário,1,135
31502,2024-01-22 21:01:00,114,92,Alimento,5,206
31503,2024-01-22 21:02:00,90,130,Vestuário,5,220
31504,2024-01-22 21:03:00,96,142,Móvel,7,238
31505,2024-01-22 21:04:00,59,149,Brinquedo,3,208
31506,2024-01-22 21:05:00,63,20,Alimento,8,83
31507,2024-01-22 21:06:00,62,13,Brinquedo,7,75
31508,2024-01-22 21:07:00,99,125,Brinquedo,4,224
31509,2024-01-22 21:08:00,57,135,Eletrônico,8,192
31510,2024-01-22 21:09:00,63,125,Eletrônico,4,188
31511,2024-01-22 21:10:00,43,111,Alimento,1,154
31512,2024-01-22 21:11:00,89,56,Brinquedo,3,145
31513,2024-01-22 21:12:00,82,67,Brinquedo,3,149
31514,2024-01-22 21:13:00,83,93,Alimento,9,176
31515,2024-01-22 21:14:00,28,134,Móvel,1,162
31516,2024-01-22 21:15:00,47,61,Vestuário,4,108
31517,2024-01-22 21:16:00,114,16,Eletrônico,7,130
31518,2024-01-22 21:17:00,119,61,Eletrônico,7,180
31519,2024-01-22 21:18:00,23,134,Móvel,8,157
31520,2024-01-22 21:19:00,62,104,Vestuário,5,166
31521,2024-01-22 21:20:00,66,149,Brinquedo,5,215
31522,2024-01-22 21:21:00,99,86,Eletrônico,3,185
31523,2024-01-22 21:22:00,105,37,Eletrônico,1,142
31524,2024-01-22 21:23:00,91,73,Alimento,8,164
31525,2024-01-22 21:24:00,62,55,Eletrônico,8,117
31526,2024-01-22 21:25:00,114,67,Alimento,7,181
31527,2024-01-22 21:26:00,74,61,Brinquedo,9,135
31528,2024-01-22 21:27:00,47,124,Eletrônico,7,171
31529,2024-01-22 21:28:00,118,45,Vestuário,2,163
31530,2024-01-22 21:29:00,80,95,Eletrônico,3,175
31531,2024-01-22 21:30:00,97,149,Eletrônico,8,246
31532,2024-01-22 21:31:00,72,134,Vestuário,3,206
31533,2024-01-22 21:32:00,46,42,Móvel,2,88
31534,2024-01-22 21:33:00,108,139,Brinquedo,9,247
31535,2024-01-22 21:34:00,21,18,Alimento,2,39
31536,2024-01-22 21:35:00,101,77,Vestuário,7,178
31537,2024-01-22 21:36:00,13,134,Móvel,3,147
31538,2024-01-22 21:37:00,49,77,Eletrônico,5,126
31539,2024-01-22 21:38:00,13,160,Alimento,2,173
31540,2024-01-22 21:39:00,49,74,Brinquedo,5,123
31541,2024-01-22 21:40:00,107,22,Alimento,7,129
31542,2024-01-22 21:41:00,112,13,Móvel,3,125
31543,2024-01-22 21:42:00,71,136,Eletrônico,9,207
31544,2024-01-22 21:43:00,13,82,Móvel,8,95
31545,2024-01-22 21:44:00,75,110,Brinquedo,2,185
31546,2024-01-22 21:45:00,52,29,Eletrônico,7,81
31547,2024-01-22 21:46:00,14,133,Eletrônico,2,147
31548,2024-01-22 21:47:00,104,114,Brinquedo,3,218
31549,2024-01-22 21:48:00,52,41,Brinquedo,6,93
31550,2024-01-22 21:49:00,36,115,Eletrônico,5,151
31551,2024-01-22 21:50:00,57,35,Alimento,1,92
31552,2024-01-22 21:51:00,30,70,Móvel,4,100
31553,2024-01-22 21:52:00,118,24,Eletrônico,8,142
31554,2024-01-22 21:53:00,48,70,Brinquedo,4,118
31555,2024-01-22 21:54:00,90,33,Móvel,2,123
31556,2024-01-22 21:55:00,51,55,Móvel,5,106
31557,2024-01-22 21:56:00,29,42,Brinquedo,8,71
31558,2024-01-22 21:57:00,82,163,Móvel,7,245
31559,2024-01-22 21:58:00,108,95,Eletrônico,6,203
31560,2024-01-22 21:59:00,47,74,Vestuário,5,121
31561,2024-01-22 22:00:00,108,20,Vestuário,8,128
31562,2024-01-22 22:01:00,96,58,Brinquedo,1,154
31563,2024-01-22 22:02:00,72,74,Eletrônico,4,146
31564,2024-01-22 22:03:00,14,138,Eletrônico,7,152
31565,2024-01-22 22:04:00,97,177,Alimento,2,274
31566,2024-01-22 22:05:00,72,164,Vestuário,4,236
31567,2024-01-22 22:06:00,44,82,Eletrônico,2,126
31568,2024-01-22 22:07:00,14,19,Eletrônico,3,33
31569,2024-01-22 22:08:00,82,123,Vestuário,6,205
31570,2024-01-22 22:09:00,119,101,Móvel,3,220
31571,2024-01-22 22:10:00,91,86,Móvel,9,177
31572,2024-01-22 22:11:00,91,58,Móvel,7,149
31573,2024-01-22 22:12:00,67,95,Eletrônico,5,162
31574,2024-01-22 22:13:00,45,142,Brinquedo,1,187
31575,2024-01-22 22:14:00,64,87,Móvel,1,151
31576,2024-01-22 22:15:00,113,162,Eletrônico,1,275
31577,2024-01-22 22:16:00,72,136,Vestuário,6,208
31578,2024-01-22 22:17:00,103,35,Brinquedo,1,138
31579,2024-01-22 22:18:00,94,96,Alimento,4,190
31580,2024-01-22 22:19:00,14,25,Eletrônico,1,39
31581,2024-01-22 22:20:00,36,139,Vestuário,7,175
31582,2024-01-22 22:21:00,48,102,Eletrônico,2,150
31583,2024-01-22 22:22:00,92,50,Móvel,9,142
31584,2024-01-22 22:23:00,51,79,Vestuário,4,130
31585,2024-01-22 22:24:00,71,33,Alimento,4,104
31586,2024-01-22 22:25:00,25,77,Alimento,2,102
31587,2024-01-22 22:26:00,18,70,Móvel,4,88
31588,2024-01-22 22:27:00,43,105,Vestuário,5,148
31589,2024-01-22 22:28:00,71,35,Alimento,9,106
31590,2024-01-22 22:29:00,65,108,Vestuário,7,173
31591,2024-01-22 22:30:00,100,49,Vestuário,7,149
31592,2024-01-22 22:31:00,27,160,Vestuário,3,187
31593,2024-01-22 22:32:00,56,101,Brinquedo,5,157
31594,2024-01-22 22:33:00,101,111,Alimento,5,212
31595,2024-01-22 22:34:00,83,37,Eletrônico,6,120
31596,2024-01-22 22:35:00,23,174,Eletrônico,3,197
31597,2024-01-22 22:36:00,11,66,Móvel,1,77
31598,2024-01-22 22:37:00,50,86,Móvel,6,136
31599,2024-01-22 22:38:00,62,94,Vestuário,9,156
31600,2024-01-22 22:39:00,76,26,Brinquedo,2,102
31601,2024-01-22 22:40:00,79,26,Vestuário,5,105
31602,2024-01-22 22:41:00,46,150,Móvel,9,196
31603,2024-01-22 22:42:00,85,154,Alimento,3,239
31604,2024-01-22 22:43:00,47,62,Alimento,6,109
31605,2024-01-22 22:44:00,59,49,Móvel,3,108
31606,2024-01-22 22:45:00,96,61,Vestuário,2,157
31607,2024-01-22 22:46:00,65,152,Vestuário,9,217
31608,2024-01-22 22:47:00,33,144,Eletrônico,4,177
31609,2024-01-22 22:48:00,31,68,Eletrônico,7,99
31610,2024-01-22 22:49:00,81,80,Alimento,2,161
31611,2024-01-22 22:50:00,116,32,Vestuário,1,148
31612,2024-01-22 22:51:00,51,106,Eletrônico,5,157
31613,2024-01-22 22:52:00,11,83,Brinquedo,5,94
31614,2024-01-22 22:53:00,49,22,Brinquedo,9,71
31615,2024-01-22 22:54:00,114,43,Móvel,3,157
31616,2024-01-22 22:55:00,73,34,Alimento,9,107
31617,2024-01-22 22:56:00,100,153,Móvel,8,253
31618,2024-01-22 22:57:00,119,163,Eletrônico,2,282
31619,2024-01-22 22:58:00,16,68,Brinquedo,7,84
31620,2024-01-22 22:59:00,119,55,Vestuário,2,174
31621,2024-01-22 23:00:00,59,71,Brinquedo,9,130
31622,2024-01-22 23:01:00,51,62,Brinquedo,5,113
31623,2024-01-22 23:02:00,18,42,Vestuário,1,60
31624,2024-01-22 23:03:00,47,99,Brinquedo,2,146
31625,2024-01-22 23:04:00,20,149,Alimento,2,169
31626,2024-01-22 23:05:00,51,48,Móvel,4,99
31627,2024-01-22 23:06:00,43,175,Eletrônico,7,218
31628,2024-01-22 23:07:00,80,156,Brinquedo,9,236
31629,2024-01-22 23:08:00,58,81,Alimento,6,139
31630,2024-01-22 23:09:00,25,31,Eletrônico,3,56
31631,2024-01-22 23:10:00,33,156,Vestuário,4,189
31632,2024-01-22 23:11:00,11,164,Alimento,1,175
31633,2024-01-22 23:12:00,77,56,Móvel,8,133
31634,2024-01-22 23:13:00,98,175,Brinquedo,3,273
31635,2024-01-22 23:14:00,88,150,Vestuário,8,238
31636,2024-01-22 23:15:00,97,44,Vestuário,3,141
31637,2024-01-22 23:16:00,44,177,Brinquedo,7,221
31638,2024-01-22 23:17:00,46,145,Eletrônico,9,191
31639,2024-01-22 23:18:00,98,162,Brinquedo,3,260
31640,2024-01-22 23:19:00,17,23,Móvel,2,40
31641,2024-01-22 23:20:00,69,128,Brinquedo,9,197
31642,2024-01-22 23:21:00,70,117,Móvel,9,187
31643,2024-01-22 23:22:00,31,94,Alimento,9,125
31644,2024-01-22 23:23:00,10,34,Alimento,5,44
31645,2024-01-22 23:24:00,28,64,Eletrônico,4,92
31646,2024-01-22 23:25:00,101,18,Vestuário,9,119
31647,2024-01-22 23:26:00,103,76,Vestuário,7,179
31648,2024-01-22 23:27:00,41,178,Móvel,9,219
31649,2024-01-22 23:28:00,118,68,Alimento,2,186
31650,2024-01-22 23:29:00,47,11,Móvel,5,58
31651,2024-01-22 23:30:00,74,122,Brinquedo,8,196
31652,2024-01-22 23:31:00,11,15,Eletrônico,7,26
31653,2024-01-22 23:32:00,32,177,Eletrônico,3,209
31654,2024-01-22 23:33:00,97,100,Alimento,4,197
31655,2024-01-22 23:34:00,19,142,Eletrônico,5,161
31656,2024-01-22 23:35:00,91,107,Móvel,4,198
31657,2024-01-22 23:36:00,83,94,Brinquedo,4,177
31658,2024-01-22 23:37:00,102,117,Vestuário,5,219
31659,2024-01-22 23:38:00,46,63,Alimento,1,109
31660,2024-01-22 23:39:00,88,58,Alimento,7,146
31661,2024-01-22 23:40:00,114,56,Móvel,5,170
31662,2024-01-22 23:41:00,65,67,Vestuário,9,132
31663,2024-01-22 23:42:00,16,114,Vestuário,2,130
31664,2024-01-22 23:43:00,27,105,Alimento,5,132
31665,2024-01-22 23:44:00,100,175,Móvel,7,275
31666,2024-01-22 23:45:00,17,59,Alimento,8,76
31667,2024-01-22 23:46:00,98,10,Brinquedo,9,108
31668,2024-01-22 23:47:00,59,131,Alimento,7,190
31669,2024-01-22 23:48:00,35,84,Móvel,5,119
31670,2024-01-22 23:49:00,61,153,Vestuário,3,214
31671,2024-01-22 23:50:00,93,27,Eletrônico,2,120
31672,2024-01-22 23:51:00,110,29,Alimento,4,139
31673,2024-01-22 23:52:00,15,134,Brinquedo,3,149
31674,2024-01-22 23:53:00,41,56,Alimento,7,97
31675,2024-01-22 23:54:00,44,124,Vestuário,3,168
31676,2024-01-22 23:55:00,15,119,Alimento,8,134
31677,2024-01-22 23:56:00,19,68,Móvel,3,87
31678,2024-01-22 23:57:00,12,129,Brinquedo,2,141
31679,2024-01-22 23:58:00,79,99,Móvel,1,178
31680,2024-01-22 23:59:00,13,116,Eletrônico,3,129
31681,2024-01-23 00:00:00,56,172,Brinquedo,7,228
31682,2024-01-23 00:01:00,83,96,Eletrônico,9,179
31683,2024-01-23 00:02:00,24,152,Móvel,4,176
31684,2024-01-23 00:03:00,68,68,Móvel,6,136
31685,2024-01-23 00:04:00,93,179,Eletrônico,9,272
31686,2024-01-23 00:05:00,69,37,Móvel,3,106
31687,2024-01-23 00:06:00,15,113,Móvel,6,128
31688,2024-01-23 00:07:00,32,112,Brinquedo,4,144
31689,2024-01-23 00:08:00,107,120,Brinquedo,1,227
31690,2024-01-23 00:09:00,35,17,Vestuário,1,52
31691,2024-01-23 00:10:00,84,66,Brinquedo,2,150
31692,2024-01-23 00:11:00,34,134,Brinquedo,7,168
31693,2024-01-23 00:12:00,78,124,Vestuário,6,202
31694,2024-01-23 00:13:00,79,33,Vestuário,6,112
31695,2024-01-23 00:14:00,83,171,Móvel,1,254
31696,2024-01-23 00:15:00,38,156,Vestuário,4,194
31697,2024-01-23 00:16:00,53,49,Vestuário,9,102
31698,2024-01-23 00:17:00,73,113,Móvel,9,186
31699,2024-01-23 00:18:00,76,83,Alimento,1,159
31700,2024-01-23 00:19:00,26,17,Brinquedo,4,43
31701,2024-01-23 00:20:00,13,42,Eletrônico,3,55
31702,2024-01-23 00:21:00,51,104,Eletrônico,5,155
31703,2024-01-23 00:22:00,61,17,Brinquedo,1,78
31704,2024-01-23 00:23:00,30,46,Eletrônico,4,76
31705,2024-01-23 00:24:00,87,74,Alimento,9,161
31706,2024-01-23 00:25:00,14,78,Brinquedo,5,92
31707,2024-01-23 00:26:00,85,25,Vestuário,3,110
31708,2024-01-23 00:27:00,13,94,Vestuário,4,107
31709,2024-01-23 00:28:00,89,151,Eletrônico,3,240
31710,2024-01-23 00:29:00,18,24,Vestuário,8,42
31711,2024-01-23 00:30:00,76,68,Alimento,8,144
31712,2024-01-23 00:31:00,56,39,Vestuário,5,95
31713,2024-01-23 00:32:00,86,82,Móvel,4,168
31714,2024-01-23 00:33:00,116,28,Vestuário,8,144
31715,2024-01-23 00:34:00,49,162,Alimento,7,211
31716,2024-01-23 00:35:00,93,152,Eletrônico,4,245
31717,2024-01-23 00:36:00,110,137,Móvel,5,247
31718,2024-01-23 00:37:00,20,46,Brinquedo,1,66
31719,2024-01-23 00:38:00,69,133,Alimento,5,202
31720,2024-01-23 00:39:00,105,119,Eletrônico,1,224
31721,2024-01-23 00:40:00,66,142,Eletrônico,1,208
31722,2024-01-23 00:41:00,107,26,Eletrônico,7,133
31723,2024-01-23 00:42:00,68,58,Móvel,6,126
31724,2024-01-23 00:43:00,36,38,Móvel,6,74
31725,2024-01-23 00:44:00,14,118,Alimento,5,132
31726,2024-01-23 00:45:00,104,40,Móvel,2,144
31727,2024-01-23 00:46:00,87,38,Alimento,4,125
31728,2024-01-23 00:47:00,77,11,Brinquedo,6,88
31729,2024-01-23 00:48:00,108,152,Vestuário,9,260
31730,2024-01-23 00:49:00,101,73,Brinquedo,8,174
31731,2024-01-23 00:50:00,19,111,Brinquedo,6,130
31732,2024-01-23 00:51:00,95,172,Brinquedo,7,267
31733,2024-01-23 00:52:00,30,12,Eletrônico,7,42
31734,2024-01-23 00:53:00,34,161,Móvel,1,195
31735,2024-01-23 00:54:00,60,28,Vestuário,8,88
31736,2024-01-23 00:55:00,75,120,Vestuário,3,195
31737,2024-01-23 00:56:00,70,27,Móvel,2,97
31738,2024-01-23 00:57:00,66,15,Alimento,7,81
31739,2024-01-23 00:58:00,13,13,Eletrônico,6,26
31740,2024-01-23 00:59:00,53,83,Alimento,3,136
31741,2024-01-23 01:00:00,77,44,Vestuário,6,121
31742,2024-01-23 01:01:00,111,61,Vestuário,7,172
31743,2024-01-23 01:02:00,11,143,Brinquedo,4,154
31744,2024-01-23 01:03:00,89,56,Eletrônico,4,145
31745,2024-01-23 01:04:00,112,12,Brinquedo,6,124
31746,2024-01-23 01:05:00,11,121,Eletrônico,7,132
31747,2024-01-23 01:06:00,101,39,Alimento,3,140
31748,2024-01-23 01:07:00,17,37,Móvel,4,54
31749,2024-01-23 01:08:00,48,19,Vestuário,1,67
31750,2024-01-23 01:09:00,26,161,Vestuário,2,187
31751,2024-01-23 01:10:00,99,159,Vestuário,3,258
31752,2024-01-23 01:11:00,55,81,Eletrônico,1,136
31753,2024-01-23 01:12:00,37,20,Eletrônico,8,57
31754,2024-01-23 01:13:00,12,145,Alimento,4,157
31755,2024-01-23 01:14:00,80,124,Vestuário,9,204
31756,2024-01-23 01:15:00,33,81,Eletrônico,2,114
31757,2024-01-23 01:16:00,17,103,Vestuário,4,120
31758,2024-01-23 01:17:00,77,37,Móvel,3,114
31759,2024-01-23 01:18:00,13,63,Brinquedo,3,76
31760,2024-01-23 01:19:00,83,19,Brinquedo,5,102
31761,2024-01-23 01:20:00,34,94,Alimento,8,128
31762,2024-01-23 01:21:00,86,120,Eletrônico,5,206
31763,2024-01-23 01:22:00,60,174,Móvel,2,234
31764,2024-01-23 01:23:00,89,130,Eletrônico,2,219
31765,2024-01-23 01:24:00,110,60,Vestuário,2,170
31766,2024-01-23 01:25:00,33,92,Eletrônico,1,125
31767,2024-01-23 01:26:00,97,16,Eletrônico,7,113
31768,2024-01-23 01:27:00,32,137,Alimento,5,169
31769,2024-01-23 01:28:00,116,91,Alimento,7,207
31770,2024-01-23 01:29:00,107,131,Móvel,3,238
31771,2024-01-23 01:30:00,72,85,Alimento,9,157
31772,2024-01-23 01:31:00,92,116,Vestuário,4,208
31773,2024-01-23 01:32:00,77,10,Vestuário,4,87
31774,2024-01-23 01:33:00,18,22,Brinquedo,5,40
31775,2024-01-23 01:34:00,95,49,Móvel,5,144
31776,2024-01-23 01:35:00,20,127,Móvel,2,147
31777,2024-01-23 01:36:00,100,160,Brinquedo,7,260
31778,2024-01-23 01:37:00,56,124,Vestuário,7,180
31779,2024-01-23 01:38:00,72,140,Móvel,6,212
31780,2024-01-23 01:39:00,56,36,Vestuário,1,92
31781,2024-01-23 01:40:00,78,121,Vestuário,2,199
31782,2024-01-23 01:41:00,110,118,Móvel,6,228
31783,2024-01-23 01:42:00,36,114,Eletrônico,2,150
31784,2024-01-23 01:43:00,78,126,Móvel,4,204
31785,2024-01-23 01:44:00,114,128,Eletrônico,9,242
31786,2024-01-23 01:45:00,57,67,Brinquedo,8,124
31787,2024-01-23 01:46:00,19,37,Eletrônico,3,56
31788,2024-01-23 01:47:00,24,132,Vestuário,1,156
31789,2024-01-23 01:48:00,26,152,Vestuário,7,178
31790,2024-01-23 01:49:00,85,71,Vestuário,9,156
31791,2024-01-23 01:50:00,104,82,Brinquedo,6,186
31792,2024-01-23 01:51:00,13,51,Eletrônico,8,64
31793,2024-01-23 01:52:00,80,24,Alimento,4,104
31794,2024-01-23 01:53:00,47,141,Alimento,5,188
31795,2024-01-23 01:54:00,74,13,Eletrônico,8,87
31796,2024-01-23 01:55:00,104,107,Eletrônico,8,211
31797,2024-01-23 01:56:00,106,170,Alimento,3,276
31798,2024-01-23 01:57:00,114,97,Eletrônico,9,211
31799,2024-01-23 01:58:00,114,16,Eletrônico,3,130
31800,2024-01-23 01:59:00,102,35,Eletrônico,8,137
31801,2024-01-23 02:00:00,88,57,Eletrônico,4,145
31802,2024-01-23 02:01:00,12,122,Vestuário,6,134
31803,2024-01-23 02:02:00,105,121,Eletrônico,4,226
31804,2024-01-23 02:03:00,107,54,Vestuário,6,161
31805,2024-01-23 02:04:00,86,90,Móvel,4,176
31806,2024-01-23 02:05:00,84,46,Vestuário,5,130
31807,2024-01-23 02:06:00,83,50,Alimento,9,133
31808,2024-01-23 02:07:00,35,22,Vestuário,5,57
31809,2024-01-23 02:08:00,77,104,Brinquedo,2,181
31810,2024-01-23 02:09:00,90,58,Eletrônico,2,148
31811,2024-01-23 02:10:00,70,70,Brinquedo,9,140
31812,2024-01-23 02:11:00,81,32,Eletrônico,5,113
31813,2024-01-23 02:12:00,17,94,Brinquedo,5,111
31814,2024-01-23 02:13:00,90,140,Vestuário,9,230
31815,2024-01-23 02:14:00,106,72,Alimento,9,178
31816,2024-01-23 02:15:00,115,63,Vestuário,8,178
31817,2024-01-23 02:16:00,114,78,Móvel,3,192
31818,2024-01-23 02:17:00,47,58,Eletrônico,9,105
31819,2024-01-23 02:18:00,88,94,Vestuário,1,182
31820,2024-01-23 02:19:00,94,134,Móvel,9,228
31821,2024-01-23 02:20:00,15,155,Móvel,7,170
31822,2024-01-23 02:21:00,40,105,Vestuário,2,145
31823,2024-01-23 02:22:00,93,36,Brinquedo,2,129
31824,2024-01-23 02:23:00,30,36,Brinquedo,9,66
31825,2024-01-23 02:24:00,41,154,Móvel,6,195
31826,2024-01-23 02:25:00,74,84,Eletrônico,2,158
31827,2024-01-23 02:26:00,30,165,Alimento,9,195
31828,2024-01-23 02:27:00,46,65,Vestuário,5,111
31829,2024-01-23 02:28:00,23,175,Móvel,7,198
31830,2024-01-23 02:29:00,15,70,Móvel,4,85
31831,2024-01-23 02:30:00,43,56,Eletrônico,7,99
31832,2024-01-23 02:31:00,31,55,Móvel,7,86
31833,2024-01-23 02:32:00,41,99,Vestuário,3,140
31834,2024-01-23 02:33:00,69,163,Móvel,9,232
31835,2024-01-23 02:34:00,47,29,Móvel,4,76
31836,2024-01-23 02:35:00,10,56,Móvel,2,66
31837,2024-01-23 02:36:00,34,50,Eletrônico,5,84
31838,2024-01-23 02:37:00,19,104,Brinquedo,2,123
31839,2024-01-23 02:38:00,18,165,Móvel,3,183
31840,2024-01-23 02:39:00,53,98,Eletrônico,8,151
31841,2024-01-23 02:40:00,13,50,Vestuário,1,63
31842,2024-01-23 02:41:00,46,132,Brinquedo,3,178
31843,2024-01-23 02:42:00,73,119,Vestuário,5,192
31844,2024-01-23 02:43:00,24,141,Eletrônico,6,165
31845,2024-01-23 02:44:00,46,52,Alimento,4,98
31846,2024-01-23 02:45:00,49,165,Móvel,1,214
31847,2024-01-23 02:46:00,108,93,Brinquedo,9,201
31848,2024-01-23 02:47:00,112,48,Eletrônico,4,160
31849,2024-01-23 02:48:00,20,39,Alimento,4,59
31850,2024-01-23 02:49:00,108,163,Vestuário,9,271
31851,2024-01-23 02:50:00,118,18,Móvel,9,136
31852,2024-01-23 02:51:00,49,147,Móvel,9,196
31853,2024-01-23 02:52:00,71,174,Vestuário,3,245
31854,2024-01-23 02:53:00,10,22,Vestuário,5,32
31855,2024-01-23 02:54:00,119,119,Brinquedo,9,238
31856,2024-01-23 02:55:00,46,76,Vestuário,8,122
31857,2024-01-23 02:56:00,119,170,Alimento,5,289
31858,2024-01-23 02:57:00,110,51,Móvel,7,161
31859,2024-01-23 02:58:00,69,13,Eletrônico,8,82
31860,2024-01-23 02:59:00,31,106,Vestuário,4,137
31861,2024-01-23 03:00:00,19,123,Brinquedo,7,142
31862,2024-01-23 03:01:00,30,62,Alimento,9,92
31863,2024-01-23 03:02:00,58,30,Alimento,2,88
31864,2024-01-23 03:03:00,119,17,Eletrônico,3,136
31865,2024-01-23 03:04:00,78,137,Vestuário,1,215
31866,2024-01-23 03:05:00,11,61,Vestuário,7,72
31867,2024-01-23 03:06:00,87,160,Móvel,4,247
31868,2024-01-23 03:07:00,33,152,Brinquedo,8,185
31869,2024-01-23 03:08:00,11,12,Vestuário,6,23
31870,2024-01-23 03:09:00,46,106,Brinquedo,2,152
31871,2024-01-23 03:10:00,31,85,Vestuário,6,116
31872,2024-01-23 03:11:00,90,118,Vestuário,3,208
31873,2024-01-23 03:12:00,100,179,Alimento,1,279
31874,2024-01-23 03:13:00,106,17,Vestuário,9,123
31875,2024-01-23 03:14:00,70,169,Brinquedo,3,239
31876,2024-01-23 03:15:00,30,147,Vestuário,1,177
31877,2024-01-23 03:16:00,97,12,Móvel,6,109
31878,2024-01-23 03:17:00,51,25,Vestuário,3,76
31879,2024-01-23 03:18:00,66,124,Vestuário,3,190
31880,2024-01-23 03:19:00,87,14,Alimento,2,101
31881,2024-01-23 03:20:00,101,156,Móvel,4,257
31882,2024-01-23 03:21:00,83,141,Móvel,4,224
31883,2024-01-23 03:22:00,35,45,Alimento,4,80
31884,2024-01-23 03:23:00,36,106,Brinquedo,7,142
31885,2024-01-23 03:24:00,64,14,Brinquedo,4,78
31886,2024-01-23 03:25:00,45,97,Móvel,5,142
31887,2024-01-23 03:26:00,25,94,Brinquedo,7,119
31888,2024-01-23 03:27:00,102,152,Brinquedo,3,254
31889,2024-01-23 03:28:00,87,66,Eletrônico,2,153
31890,2024-01-23 03:29:00,37,45,Eletrônico,4,82
31891,2024-01-23 03:30:00,27,61,Eletrônico,8,88
31892,2024-01-23 03:31:00,25,56,Vestuário,3,81
31893,2024-01-23 03:32:00,78,140,Alimento,7,218
31894,2024-01-23 03:33:00,22,55,Brinquedo,8,77
31895,2024-01-23 03:34:00,35,174,Móvel,7,209
31896,2024-01-23 03:35:00,82,132,Eletrônico,2,214
31897,2024-01-23 03:36:00,26,53,Alimento,5,79
31898,2024-01-23 03:37:00,15,99,Brinquedo,6,114
31899,2024-01-23 03:38:00,101,90,Móvel,1,191
31900,2024-01-23 03:39:00,101,156,Vestuário,7,257
31901,2024-01-23 03:40:00,110,172,Vestuário,9,282
31902,2024-01-23 03:41:00,97,19,Eletrônico,9,116
31903,2024-01-23 03:42:00,21,83,Eletrônico,3,104
31904,2024-01-23 03:43:00,73,119,Alimento,6,192
31905,2024-01-23 03:44:00,94,126,Brinquedo,9,220
31906,2024-01-23 03:45:00,111,51,Vestuário,3,162
31907,2024-01-23 03:46:00,112,137,Móvel,8,249
31908,2024-01-23 03:47:00,77,34,Vestuário,4,111
31909,2024-01-23 03:48:00,90,82,Eletrônico,1,172
31910,2024-01-23 03:49:00,82,142,Móvel,4,224
31911,2024-01-23 03:50:00,43,54,Eletrônico,7,97
31912,2024-01-23 03:51:00,105,28,Móvel,1,133
31913,2024-01-23 03:52:00,24,29,Vestuário,2,53
31914,2024-01-23 03:53:00,86,82,Vestuário,4,168
31915,2024-01-23 03:54:00,10,109,Alimento,4,119
31916,2024-01-23 03:55:00,18,90,Vestuário,5,108
31917,2024-01-23 03:56:00,13,99,Eletrônico,7,112
31918,2024-01-23 03:57:00,105,174,Móvel,8,279
31919,2024-01-23 03:58:00,24,122,Eletrônico,5,146
31920,2024-01-23 03:59:00,98,105,Eletrônico,5,203
31921,2024-01-23 04:00:00,57,91,Móvel,7,148
31922,2024-01-23 04:01:00,70,78,Eletrônico,6,148
31923,2024-01-23 04:02:00,46,169,Alimento,3,215
31924,2024-01-23 04:03:00,113,118,Móvel,1,231
31925,2024-01-23 04:04:00,39,127,Eletrônico,1,166
31926,2024-01-23 04:05:00,68,123,Móvel,3,191
31927,2024-01-23 04:06:00,45,118,Eletrônico,2,163
31928,2024-01-23 04:07:00,75,125,Brinquedo,3,200
31929,2024-01-23 04:08:00,79,42,Móvel,5,121
31930,2024-01-23 04:09:00,27,65,Vestuário,7,92
31931,2024-01-23 04:10:00,60,167,Vestuário,3,227
31932,2024-01-23 04:11:00,80,83,Móvel,2,163
31933,2024-01-23 04:12:00,98,45,Brinquedo,1,143
31934,2024-01-23 04:13:00,61,170,Vestuário,6,231
31935,2024-01-23 04:14:00,115,148,Móvel,2,263
31936,2024-01-23 04:15:00,37,93,Alimento,6,130
31937,2024-01-23 04:16:00,64,141,Vestuário,5,205
31938,2024-01-23 04:17:00,24,90,Brinquedo,6,114
31939,2024-01-23 04:18:00,68,175,Brinquedo,7,243
31940,2024-01-23 04:19:00,32,65,Móvel,3,97
31941,2024-01-23 04:20:00,75,175,Eletrônico,6,250
31942,2024-01-23 04:21:00,106,162,Brinquedo,8,268
31943,2024-01-23 04:22:00,12,48,Alimento,6,60
31944,2024-01-23 04:23:00,91,136,Brinquedo,2,227
31945,2024-01-23 04:24:00,10,173,Móvel,4,183
31946,2024-01-23 04:25:00,51,105,Móvel,4,156
31947,2024-01-23 04:26:00,31,112,Vestuário,8,143
31948,2024-01-23 04:27:00,102,104,Vestuário,3,206
31949,2024-01-23 04:28:00,88,59,Móvel,5,147
31950,2024-01-23 04:29:00,34,85,Vestuário,7,119
31951,2024-01-23 04:30:00,114,102,Vestuário,5,216
31952,2024-01-23 04:31:00,83,161,Brinquedo,8,244
31953,2024-01-23 04:32:00,84,25,Eletrônico,2,109
31954,2024-01-23 04:33:00,18,140,Vestuário,1,158
31955,2024-01-23 04:34:00,19,66,Móvel,8,85
31956,2024-01-23 04:35:00,35,83,Brinquedo,8,118
31957,2024-01-23 04:36:00,89,13,Vestuário,5,102
31958,2024-01-23 04:37:00,44,161,Alimento,1,205
31959,2024-01-23 04:38:00,35,38,Alimento,2,73
31960,2024-01-23 04:39:00,48,131,Eletrônico,5,179
31961,2024-01-23 04:40:00,35,44,Brinquedo,9,79
31962,2024-01-23 04:41:00,36,56,Brinquedo,8,92
31963,2024-01-23 04:42:00,15,30,Brinquedo,4,45
31964,2024-01-23 04:43:00,118,174,Alimento,7,292
31965,2024-01-23 04:44:00,102,177,Móvel,1,279
31966,2024-01-23 04:45:00,58,58,Vestuário,6,116
31967,2024-01-23 04:46:00,11,47,Móvel,7,58
31968,2024-01-23 04:47:00,89,162,Eletrônico,2,251
31969,2024-01-23 04:48:00,91,16,Eletrônico,2,107
31970,2024-01-23 04:49:00,48,93,Vestuário,4,141
31971,2024-01-23 04:50:00,44,40,Móvel,2,84
31972,2024-01-23 04:51:00,99,28,Móvel,1,127
31973,2024-01-23 04:52:00,21,162,Móvel,6,183
31974,2024-01-23 04:53:00,96,161,Alimento,1,257
31975,2024-01-23 04:54:00,118,19,Eletrônico,4,137
31976,2024-01-23 04:55:00,37,23,Alimento,9,60
31977,2024-01-23 04:56:00,98,158,Vestuário,8,256
31978,2024-01-23 04:57:00,99,69,Eletrônico,2,168
31979,2024-01-23 04:58:00,51,69,Eletrônico,4,120
31980,2024-01-23 04:59:00,57,116,Vestuário,3,173
31981,2024-01-23 05:00:00,114,93,Eletrônico,2,207
31982,2024-01-23 05:01:00,82,100,Alimento,4,182
31983,2024-01-23 05:02:00,71,89,Eletrônico,4,160
31984,2024-01-23 05:03:00,63,64,Alimento,1,127
31985,2024-01-23 05:04:00,92,38,Vestuário,1,130
31986,2024-01-23 05:05:00,78,100,Eletrônico,7,178
31987,2024-01-23 05:06:00,30,25,Vestuário,3,55
31988,2024-01-23 05:07:00,26,20,Alimento,3,46
31989,2024-01-23 05:08:00,68,57,Vestuário,6,125
31990,2024-01-23 05:09:00,67,24,Vestuário,3,91
31991,2024-01-23 05:10:00,62,113,Eletrônico,2,175
31992,2024-01-23 05:11:00,30,116,Vestuário,7,146
31993,2024-01-23 05:12:00,46,20,Brinquedo,4,66
31994,2024-01-23 05:13:00,77,63,Vestuário,8,140
31995,2024-01-23 05:14:00,99,70,Móvel,7,169
31996,2024-01-23 05:15:00,26,151,Eletrônico,2,177
31997,2024-01-23 05:16:00,18,44,Móvel,3,62
31998,2024-01-23 05:17:00,35,19,Eletrônico,8,54
31999,2024-01-23 05:18:00,95,149,Vestuário,5,244
32000,2024-01-23 05:19:00,96,42,Eletrônico,2,138
32001,2024-01-23 05:20:00,60,109,Brinquedo,6,169
32002,2024-01-23 05:21:00,100,47,Brinquedo,5,147
32003,2024-01-23 05:22:00,65,125,Vestuário,9,190
32004,2024-01-23 05:23:00,50,29,Brinquedo,9,79
32005,2024-01-23 05:24:00,72,13,Vestuário,3,85
32006,2024-01-23 05:25:00,102,71,Eletrônico,6,173
32007,2024-01-23 05:26:00,51,41,Brinquedo,9,92
32008,2024-01-23 05:27:00,79,131,Móvel,4,210
32009,2024-01-23 05:28:00,61,179,Alimento,9,240
32010,2024-01-23 05:29:00,109,79,Eletrônico,8,188
32011,2024-01-23 05:30:00,105,155,Brinquedo,1,260
32012,2024-01-23 05:31:00,14,66,Móvel,6,80
32013,2024-01-23 05:32:00,94,151,Vestuário,9,245
32014,2024-01-23 05:33:00,115,149,Eletrônico,4,264
32015,2024-01-23 05:34:00,42,131,Alimento,8,173
32016,2024-01-23 05:35:00,11,43,Móvel,6,54
32017,2024-01-23 05:36:00,24,60,Brinquedo,6,84
32018,2024-01-23 05:37:00,119,179,Móvel,4,298
32019,2024-01-23 05:38:00,31,172,Alimento,7,203
32020,2024-01-23 05:39:00,89,163,Vestuário,5,252
32021,2024-01-23 05:40:00,65,60,Móvel,4,125
32022,2024-01-23 05:41:00,55,36,Móvel,9,91
32023,2024-01-23 05:42:00,13,54,Eletrônico,8,67
32024,2024-01-23 05:43:00,18,170,Brinquedo,7,188
32025,2024-01-23 05:44:00,12,100,Brinquedo,7,112
32026,2024-01-23 05:45:00,42,157,Brinquedo,7,199
32027,2024-01-23 05:46:00,26,93,Eletrônico,3,119
32028,2024-01-23 05:47:00,96,140,Brinquedo,4,236
32029,2024-01-23 05:48:00,119,137,Móvel,9,256
32030,2024-01-23 05:49:00,23,73,Móvel,4,96
32031,2024-01-23 05:50:00,32,150,Móvel,4,182
32032,2024-01-23 05:51:00,65,42,Brinquedo,6,107
32033,2024-01-23 05:52:00,113,149,Brinquedo,7,262
32034,2024-01-23 05:53:00,44,68,Brinquedo,2,112
32035,2024-01-23 05:54:00,108,133,Alimento,6,241
32036,2024-01-23 05:55:00,63,51,Vestuário,7,114
32037,2024-01-23 05:56:00,97,141,Eletrônico,6,238
32038,2024-01-23 05:57:00,85,168,Alimento,6,253
32039,2024-01-23 05:58:00,105,108,Vestuário,2,213
32040,2024-01-23 05:59:00,118,171,Vestuário,1,289
32041,2024-01-23 06:00:00,56,45,Móvel,5,101
32042,2024-01-23 06:01:00,61,120,Alimento,4,181
32043,2024-01-23 06:02:00,25,89,Alimento,7,114
32044,2024-01-23 06:03:00,81,87,Brinquedo,2,168
32045,2024-01-23 06:04:00,54,63,Móvel,6,117
32046,2024-01-23 06:05:00,101,33,Eletrônico,2,134
32047,2024-01-23 06:06:00,18,76,Brinquedo,6,94
32048,2024-01-23 06:07:00,73,16,Móvel,1,89
32049,2024-01-23 06:08:00,105,151,Móvel,4,256
32050,2024-01-23 06:09:00,72,126,Móvel,3,198
32051,2024-01-23 06:10:00,93,144,Móvel,9,237
32052,2024-01-23 06:11:00,82,86,Móvel,1,168
32053,2024-01-23 06:12:00,119,12,Vestuário,6,131
32054,2024-01-23 06:13:00,32,78,Alimento,3,110
32055,2024-01-23 06:14:00,79,28,Vestuário,5,107
32056,2024-01-23 06:15:00,84,134,Vestuário,4,218
32057,2024-01-23 06:16:00,93,21,Brinquedo,9,114
32058,2024-01-23 06:17:00,101,142,Brinquedo,6,243
32059,2024-01-23 06:18:00,17,167,Móvel,5,184
32060,2024-01-23 06:19:00,65,46,Alimento,5,111
32061,2024-01-23 06:20:00,31,32,Eletrônico,1,63
32062,2024-01-23 06:21:00,93,100,Vestuário,4,193
32063,2024-01-23 06:22:00,118,103,Brinquedo,1,221
32064,2024-01-23 06:23:00,115,107,Alimento,4,222
32065,2024-01-23 06:24:00,26,66,Vestuário,9,92
32066,2024-01-23 06:25:00,107,27,Alimento,2,134
32067,2024-01-23 06:26:00,98,145,Alimento,9,243
32068,2024-01-23 06:27:00,35,51,Alimento,6,86
32069,2024-01-23 06:28:00,53,68,Vestuário,9,121
32070,2024-01-23 06:29:00,68,118,Eletrônico,9,186
32071,2024-01-23 06:30:00,45,31,Alimento,8,76
32072,2024-01-23 06:31:00,62,82,Alimento,5,144
32073,2024-01-23 06:32:00,95,151,Móvel,9,246
32074,2024-01-23 06:33:00,19,15,Móvel,3,34
32075,2024-01-23 06:34:00,106,104,Móvel,8,210
32076,2024-01-23 06:35:00,77,166,Brinquedo,6,243
32077,2024-01-23 06:36:00,72,38,Eletrônico,2,110
32078,2024-01-23 06:37:00,28,152,Alimento,2,180
32079,2024-01-23 06:38:00,90,35,Brinquedo,8,125
32080,2024-01-23 06:39:00,69,99,Eletrônico,3,168
32081,2024-01-23 06:40:00,25,15,Móvel,9,40
32082,2024-01-23 06:41:00,100,110,Alimento,7,210
32083,2024-01-23 06:42:00,25,126,Móvel,5,151
32084,2024-01-23 06:43:00,91,126,Vestuário,9,217
32085,2024-01-23 06:44:00,110,31,Alimento,7,141
32086,2024-01-23 06:45:00,111,76,Alimento,8,187
32087,2024-01-23 06:46:00,52,177,Eletrônico,5,229
32088,2024-01-23 06:47:00,65,87,Eletrônico,3,152
32089,2024-01-23 06:48:00,14,162,Vestuário,7,176
32090,2024-01-23 06:49:00,97,94,Alimento,6,191
32091,2024-01-23 06:50:00,84,134,Vestuário,4,218
32092,2024-01-23 06:51:00,77,54,Móvel,7,131
32093,2024-01-23 06:52:00,82,55,Móvel,5,137
32094,2024-01-23 06:53:00,59,146,Vestuário,4,205
32095,2024-01-23 06:54:00,25,142,Brinquedo,6,167
32096,2024-01-23 06:55:00,12,147,Eletrônico,3,159
32097,2024-01-23 06:56:00,119,160,Brinquedo,7,279
32098,2024-01-23 06:57:00,23,22,Alimento,5,45
32099,2024-01-23 06:58:00,41,17,Vestuário,6,58
32100,2024-01-23 06:59:00,52,95,Móvel,9,147
32101,2024-01-23 07:00:00,66,168,Móvel,2,234
32102,2024-01-23 07:01:00,48,137,Brinquedo,4,185
32103,2024-01-23 07:02:00,50,110,Móvel,7,160
32104,2024-01-23 07:03:00,60,60,Móvel,7,120
32105,2024-01-23 07:04:00,119,114,Eletrônico,6,233
32106,2024-01-23 07:05:00,41,84,Vestuário,1,125
32107,2024-01-23 07:06:00,94,85,Brinquedo,1,179
32108,2024-01-23 07:07:00,60,145,Brinquedo,1,205
32109,2024-01-23 07:08:00,20,46,Alimento,4,66
32110,2024-01-23 07:09:00,15,22,Eletrônico,7,37
32111,2024-01-23 07:10:00,74,152,Vestuário,1,226
32112,2024-01-23 07:11:00,58,83,Vestuário,5,141
32113,2024-01-23 07:12:00,89,169,Brinquedo,5,258
32114,2024-01-23 07:13:00,20,167,Brinquedo,6,187
32115,2024-01-23 07:14:00,75,95,Móvel,9,170
32116,2024-01-23 07:15:00,19,147,Eletrônico,9,166
32117,2024-01-23 07:16:00,70,69,Alimento,3,139
32118,2024-01-23 07:17:00,88,61,Móvel,6,149
32119,2024-01-23 07:18:00,54,152,Móvel,4,206
32120,2024-01-23 07:19:00,52,46,Eletrônico,7,98
32121,2024-01-23 07:20:00,117,34,Móvel,9,151
32122,2024-01-23 07:21:00,19,55,Eletrônico,3,74
32123,2024-01-23 07:22:00,47,145,Brinquedo,8,192
32124,2024-01-23 07:23:00,73,158,Alimento,6,231
32125,2024-01-23 07:24:00,73,31,Vestuário,8,104
32126,2024-01-23 07:25:00,49,30,Eletrônico,9,79
32127,2024-01-23 07:26:00,68,177,Brinquedo,7,245
32128,2024-01-23 07:27:00,12,89,Eletrônico,5,101
32129,2024-01-23 07:28:00,16,179,Alimento,4,195
32130,2024-01-23 07:29:00,58,172,Móvel,3,230
32131,2024-01-23 07:30:00,109,45,Brinquedo,8,154
32132,2024-01-23 07:31:00,54,24,Móvel,4,78
32133,2024-01-23 07:32:00,99,99,Móvel,3,198
32134,2024-01-23 07:33:00,45,28,Móvel,9,73
32135,2024-01-23 07:34:00,90,51,Brinquedo,3,141
32136,2024-01-23 07:35:00,112,108,Eletrônico,6,220
32137,2024-01-23 07:36:00,117,178,Eletrônico,5,295
32138,2024-01-23 07:37:00,113,141,Vestuário,1,254
32139,2024-01-23 07:38:00,61,26,Alimento,5,87
32140,2024-01-23 07:39:00,32,139,Brinquedo,4,171
32141,2024-01-23 07:40:00,34,172,Móvel,8,206
32142,2024-01-23 07:41:00,66,168,Alimento,3,234
32143,2024-01-23 07:42:00,17,78,Móvel,2,95
32144,2024-01-23 07:43:00,44,123,Alimento,2,167
32145,2024-01-23 07:44:00,19,85,Móvel,3,104
32146,2024-01-23 07:45:00,26,161,Vestuário,1,187
32147,2024-01-23 07:46:00,95,149,Brinquedo,4,244
32148,2024-01-23 07:47:00,57,48,Vestuário,4,105
32149,2024-01-23 07:48:00,64,69,Vestuário,6,133
32150,2024-01-23 07:49:00,111,98,Brinquedo,5,209
32151,2024-01-23 07:50:00,118,20,Brinquedo,7,138
32152,2024-01-23 07:51:00,57,93,Móvel,6,150
32153,2024-01-23 07:52:00,12,107,Brinquedo,9,119
32154,2024-01-23 07:53:00,87,28,Eletrônico,5,115
32155,2024-01-23 07:54:00,102,52,Vestuário,2,154
32156,2024-01-23 07:55:00,100,156,Móvel,7,256
32157,2024-01-23 07:56:00,23,32,Eletrônico,3,55
32158,2024-01-23 07:57:00,12,94,Móvel,2,106
32159,2024-01-23 07:58:00,54,42,Eletrônico,8,96
32160,2024-01-23 07:59:00,24,174,Alimento,8,198
32161,2024-01-23 08:00:00,25,73,Móvel,4,98
32162,2024-01-23 08:01:00,19,66,Móvel,3,85
32163,2024-01-23 08:02:00,96,10,Eletrônico,7,106
32164,2024-01-23 08:03:00,28,58,Brinquedo,8,86
32165,2024-01-23 08:04:00,44,48,Móvel,6,92
32166,2024-01-23 08:05:00,53,135,Alimento,5,188
32167,2024-01-23 08:06:00,33,37,Móvel,3,70
32168,2024-01-23 08:07:00,100,135,Móvel,3,235
32169,2024-01-23 08:08:00,72,127,Brinquedo,7,199
32170,2024-01-23 08:09:00,22,101,Vestuário,7,123
32171,2024-01-23 08:10:00,46,32,Alimento,4,78
32172,2024-01-23 08:11:00,96,135,Eletrônico,2,231
32173,2024-01-23 08:12:00,109,94,Vestuário,1,203
32174,2024-01-23 08:13:00,13,103,Eletrônico,8,116
32175,2024-01-23 08:14:00,85,30,Eletrônico,3,115
32176,2024-01-23 08:15:00,118,21,Brinquedo,6,139
32177,2024-01-23 08:16:00,17,24,Alimento,6,41
32178,2024-01-23 08:17:00,106,42,Eletrônico,3,148
32179,2024-01-23 08:18:00,31,52,Móvel,1,83
32180,2024-01-23 08:19:00,36,32,Vestuário,1,68
32181,2024-01-23 08:20:00,39,12,Alimento,6,51
32182,2024-01-23 08:21:00,28,81,Brinquedo,3,109
32183,2024-01-23 08:22:00,87,104,Brinquedo,7,191
32184,2024-01-23 08:23:00,28,12,Móvel,9,40
32185,2024-01-23 08:24:00,86,103,Brinquedo,2,189
32186,2024-01-23 08:25:00,42,34,Vestuário,3,76
32187,2024-01-23 08:26:00,61,50,Vestuário,3,111
32188,2024-01-23 08:27:00,92,135,Móvel,2,227
32189,2024-01-23 08:28:00,69,127,Brinquedo,9,196
32190,2024-01-23 08:29:00,28,76,Móvel,4,104
32191,2024-01-23 08:30:00,73,118,Brinquedo,3,191
32192,2024-01-23 08:31:00,37,173,Brinquedo,3,210
32193,2024-01-23 08:32:00,10,138,Vestuário,1,148
32194,2024-01-23 08:33:00,55,115,Móvel,8,170
32195,2024-01-23 08:34:00,88,15,Alimento,9,103
32196,2024-01-23 08:35:00,39,72,Alimento,7,111
32197,2024-01-23 08:36:00,112,170,Brinquedo,4,282
32198,2024-01-23 08:37:00,80,57,Alimento,4,137
32199,2024-01-23 08:38:00,70,30,Eletrônico,2,100
32200,2024-01-23 08:39:00,40,115,Vestuário,6,155
32201,2024-01-23 08:40:00,91,138,Eletrônico,6,229
32202,2024-01-23 08:41:00,102,55,Brinquedo,8,157
32203,2024-01-23 08:42:00,91,87,Alimento,1,178
32204,2024-01-23 08:43:00,63,174,Móvel,4,237
32205,2024-01-23 08:44:00,93,32,Brinquedo,4,125
32206,2024-01-23 08:45:00,27,126,Brinquedo,1,153
32207,2024-01-23 08:46:00,91,39,Móvel,4,130
32208,2024-01-23 08:47:00,21,174,Eletrônico,5,195
32209,2024-01-23 08:48:00,15,177,Vestuário,5,192
32210,2024-01-23 08:49:00,99,26,Brinquedo,1,125
32211,2024-01-23 08:50:00,98,147,Eletrônico,7,245
32212,2024-01-23 08:51:00,119,20,Brinquedo,5,139
32213,2024-01-23 08:52:00,21,163,Alimento,1,184
32214,2024-01-23 08:53:00,83,74,Móvel,3,157
32215,2024-01-23 08:54:00,114,76,Vestuário,2,190
32216,2024-01-23 08:55:00,83,61,Móvel,8,144
32217,2024-01-23 08:56:00,107,10,Alimento,4,117
32218,2024-01-23 08:57:00,66,171,Móvel,2,237
32219,2024-01-23 08:58:00,17,11,Brinquedo,9,28
32220,2024-01-23 08:59:00,60,11,Eletrônico,8,71
32221,2024-01-23 09:00:00,103,150,Móvel,6,253
32222,2024-01-23 09:01:00,83,118,Vestuário,9,201
32223,2024-01-23 09:02:00,37,38,Eletrônico,4,75
32224,2024-01-23 09:03:00,29,32,Móvel,4,61
32225,2024-01-23 09:04:00,85,44,Brinquedo,4,129
32226,2024-01-23 09:05:00,75,35,Eletrônico,8,110
32227,2024-01-23 09:06:00,10,123,Brinquedo,8,133
32228,2024-01-23 09:07:00,83,27,Móvel,7,110
32229,2024-01-23 09:08:00,51,142,Alimento,3,193
32230,2024-01-23 09:09:00,39,57,Alimento,4,96
32231,2024-01-23 09:10:00,64,140,Brinquedo,5,204
32232,2024-01-23 09:11:00,89,92,Eletrônico,3,181
32233,2024-01-23 09:12:00,50,109,Eletrônico,5,159
32234,2024-01-23 09:13:00,12,87,Móvel,6,99
32235,2024-01-23 09:14:00,14,152,Móvel,8,166
32236,2024-01-23 09:15:00,21,71,Móvel,6,92
32237,2024-01-23 09:16:00,77,176,Alimento,9,253
32238,2024-01-23 09:17:00,88,173,Eletrônico,3,261
32239,2024-01-23 09:18:00,96,63,Eletrônico,9,159
32240,2024-01-23 09:19:00,16,157,Brinquedo,9,173
32241,2024-01-23 09:20:00,13,159,Brinquedo,8,172
32242,2024-01-23 09:21:00,82,145,Eletrônico,2,227
32243,2024-01-23 09:22:00,70,26,Móvel,5,96
32244,2024-01-23 09:23:00,90,72,Eletrônico,5,162
32245,2024-01-23 09:24:00,104,59,Vestuário,5,163
32246,2024-01-23 09:25:00,49,52,Móvel,5,101
32247,2024-01-23 09:26:00,84,92,Brinquedo,8,176
32248,2024-01-23 09:27:00,22,99,Brinquedo,4,121
32249,2024-01-23 09:28:00,105,157,Brinquedo,7,262
32250,2024-01-23 09:29:00,39,123,Móvel,4,162
32251,2024-01-23 09:30:00,85,125,Brinquedo,3,210
32252,2024-01-23 09:31:00,86,146,Eletrônico,4,232
32253,2024-01-23 09:32:00,61,132,Eletrônico,5,193
32254,2024-01-23 09:33:00,97,158,Eletrônico,5,255
32255,2024-01-23 09:34:00,59,145,Móvel,5,204
32256,2024-01-23 09:35:00,13,174,Vestuário,8,187
32257,2024-01-23 09:36:00,89,121,Eletrônico,7,210
32258,2024-01-23 09:37:00,10,124,Alimento,6,134
32259,2024-01-23 09:38:00,18,57,Vestuário,8,75
32260,2024-01-23 09:39:00,55,138,Móvel,1,193
32261,2024-01-23 09:40:00,80,61,Eletrônico,2,141
32262,2024-01-23 09:41:00,44,88,Alimento,7,132
32263,2024-01-23 09:42:00,79,174,Eletrônico,5,253
32264,2024-01-23 09:43:00,79,30,Alimento,1,109
32265,2024-01-23 09:44:00,116,148,Vestuário,1,264
32266,2024-01-23 09:45:00,66,21,Alimento,9,87
32267,2024-01-23 09:46:00,27,78,Alimento,8,105
32268,2024-01-23 09:47:00,26,159,Móvel,4,185
32269,2024-01-23 09:48:00,39,16,Vestuário,1,55
32270,2024-01-23 09:49:00,104,170,Brinquedo,9,274
32271,2024-01-23 09:50:00,94,46,Alimento,4,140
32272,2024-01-23 09:51:00,61,71,Vestuário,9,132
32273,2024-01-23 09:52:00,59,85,Móvel,1,144
32274,2024-01-23 09:53:00,102,109,Móvel,2,211
32275,2024-01-23 09:54:00,112,15,Vestuário,1,127
32276,2024-01-23 09:55:00,36,107,Vestuário,4,143
32277,2024-01-23 09:56:00,60,100,Alimento,2,160
32278,2024-01-23 09:57:00,116,12,Vestuário,7,128
32279,2024-01-23 09:58:00,103,114,Alimento,2,217
32280,2024-01-23 09:59:00,81,123,Alimento,1,204
32281,2024-01-23 10:00:00,106,75,Alimento,7,181
32282,2024-01-23 10:01:00,94,81,Brinquedo,9,175
32283,2024-01-23 10:02:00,58,87,Móvel,3,145
32284,2024-01-23 10:03:00,117,117,Alimento,3,234
32285,2024-01-23 10:04:00,39,153,Alimento,1,192
32286,2024-01-23 10:05:00,84,53,Brinquedo,8,137
32287,2024-01-23 10:06:00,68,93,Eletrônico,5,161
32288,2024-01-23 10:07:00,49,117,Móvel,1,166
32289,2024-01-23 10:08:00,81,39,Brinquedo,5,120
32290,2024-01-23 10:09:00,55,20,Alimento,7,75
32291,2024-01-23 10:10:00,76,155,Móvel,3,231
32292,2024-01-23 10:11:00,100,41,Eletrônico,9,141
32293,2024-01-23 10:12:00,106,59,Brinquedo,6,165
32294,2024-01-23 10:13:00,76,170,Alimento,6,246
32295,2024-01-23 10:14:00,64,51,Alimento,6,115
32296,2024-01-23 10:15:00,85,163,Eletrônico,4,248
32297,2024-01-23 10:16:00,98,91,Eletrônico,8,189
32298,2024-01-23 10:17:00,85,29,Móvel,4,114
32299,2024-01-23 10:18:00,95,168,Alimento,5,263
32300,2024-01-23 10:19:00,16,121,Brinquedo,1,137
32301,2024-01-23 10:20:00,114,44,Alimento,7,158
32302,2024-01-23 10:21:00,117,95,Eletrônico,3,212
32303,2024-01-23 10:22:00,98,31,Móvel,2,129
32304,2024-01-23 10:23:00,117,31,Vestuário,8,148
32305,2024-01-23 10:24:00,16,140,Brinquedo,2,156
32306,2024-01-23 10:25:00,43,157,Vestuário,2,200
32307,2024-01-23 10:26:00,41,120,Móvel,3,161
32308,2024-01-23 10:27:00,23,50,Eletrônico,8,73
32309,2024-01-23 10:28:00,96,163,Eletrônico,5,259
32310,2024-01-23 10:29:00,29,59,Alimento,1,88
32311,2024-01-23 10:30:00,104,85,Brinquedo,9,189
32312,2024-01-23 10:31:00,32,178,Vestuário,3,210
32313,2024-01-23 10:32:00,116,71,Móvel,1,187
32314,2024-01-23 10:33:00,12,154,Móvel,9,166
32315,2024-01-23 10:34:00,41,166,Alimento,9,207
32316,2024-01-23 10:35:00,78,98,Eletrônico,9,176
32317,2024-01-23 10:36:00,81,112,Móvel,8,193
32318,2024-01-23 10:37:00,72,173,Móvel,1,245
32319,2024-01-23 10:38:00,87,41,Alimento,9,128
32320,2024-01-23 10:39:00,107,128,Alimento,6,235
32321,2024-01-23 10:40:00,70,80,Brinquedo,4,150
32322,2024-01-23 10:41:00,64,179,Brinquedo,4,243
32323,2024-01-23 10:42:00,93,15,Alimento,4,108
32324,2024-01-23 10:43:00,97,36,Móvel,5,133
32325,2024-01-23 10:44:00,87,124,Vestuário,9,211
32326,2024-01-23 10:45:00,11,25,Alimento,5,36
32327,2024-01-23 10:46:00,63,154,Eletrônico,8,217
32328,2024-01-23 10:47:00,82,165,Eletrônico,2,247
32329,2024-01-23 10:48:00,35,170,Vestuário,6,205
32330,2024-01-23 10:49:00,66,137,Móvel,5,203
32331,2024-01-23 10:50:00,63,29,Brinquedo,1,92
32332,2024-01-23 10:51:00,54,140,Eletrônico,6,194
32333,2024-01-23 10:52:00,61,85,Brinquedo,3,146
32334,2024-01-23 10:53:00,20,98,Alimento,6,118
32335,2024-01-23 10:54:00,114,60,Alimento,4,174
32336,2024-01-23 10:55:00,24,96,Brinquedo,4,120
32337,2024-01-23 10:56:00,53,135,Vestuário,1,188
32338,2024-01-23 10:57:00,32,12,Eletrônico,1,44
32339,2024-01-23 10:58:00,114,54,Eletrônico,7,168
32340,2024-01-23 10:59:00,81,54,Alimento,5,135
32341,2024-01-23 11:00:00,99,18,Alimento,2,117
32342,2024-01-23 11:01:00,32,133,Alimento,2,165
32343,2024-01-23 11:02:00,44,82,Vestuário,1,126
32344,2024-01-23 11:03:00,86,94,Brinquedo,8,180
32345,2024-01-23 11:04:00,19,110,Vestuário,4,129
32346,2024-01-23 11:05:00,15,46,Móvel,1,61
32347,2024-01-23 11:06:00,87,129,Alimento,8,216
32348,2024-01-23 11:07:00,31,104,Brinquedo,1,135
32349,2024-01-23 11:08:00,100,56,Eletrônico,1,156
32350,2024-01-23 11:09:00,29,163,Eletrônico,3,192
32351,2024-01-23 11:10:00,78,101,Móvel,2,179
32352,2024-01-23 11:11:00,58,130,Alimento,7,188
32353,2024-01-23 11:12:00,77,167,Brinquedo,9,244
32354,2024-01-23 11:13:00,83,154,Alimento,3,237
32355,2024-01-23 11:14:00,65,19,Móvel,1,84
32356,2024-01-23 11:15:00,74,73,Vestuário,2,147
32357,2024-01-23 11:16:00,53,80,Vestuário,1,133
32358,2024-01-23 11:17:00,23,19,Alimento,5,42
32359,2024-01-23 11:18:00,41,114,Alimento,8,155
32360,2024-01-23 11:19:00,91,90,Eletrônico,2,181
32361,2024-01-23 11:20:00,102,143,Brinquedo,7,245
32362,2024-01-23 11:21:00,84,72,Alimento,3,156
32363,2024-01-23 11:22:00,24,127,Eletrônico,1,151
32364,2024-01-23 11:23:00,113,113,Vestuário,5,226
32365,2024-01-23 11:24:00,18,160,Brinquedo,1,178
32366,2024-01-23 11:25:00,10,52,Móvel,7,62
32367,2024-01-23 11:26:00,45,39,Móvel,6,84
32368,2024-01-23 11:27:00,89,117,Alimento,8,206
32369,2024-01-23 11:28:00,94,12,Eletrônico,9,106
32370,2024-01-23 11:29:00,65,59,Brinquedo,6,124
32371,2024-01-23 11:30:00,29,32,Vestuário,4,61
32372,2024-01-23 11:31:00,85,135,Brinquedo,3,220
32373,2024-01-23 11:32:00,21,23,Móvel,1,44
32374,2024-01-23 11:33:00,82,31,Móvel,3,113
32375,2024-01-23 11:34:00,106,129,Brinquedo,5,235
32376,2024-01-23 11:35:00,79,179,Alimento,3,258
32377,2024-01-23 11:36:00,14,160,Brinquedo,2,174
32378,2024-01-23 11:37:00,44,53,Móvel,2,97
32379,2024-01-23 11:38:00,26,153,Alimento,7,179
32380,2024-01-23 11:39:00,106,34,Móvel,7,140
32381,2024-01-23 11:40:00,67,157,Eletrônico,7,224
32382,2024-01-23 11:41:00,60,66,Eletrônico,6,126
32383,2024-01-23 11:42:00,90,140,Móvel,1,230
32384,2024-01-23 11:43:00,118,68,Alimento,7,186
32385,2024-01-23 11:44:00,63,142,Móvel,7,205
32386,2024-01-23 11:45:00,29,114,Vestuário,8,143
32387,2024-01-23 11:46:00,97,126,Vestuário,6,223
32388,2024-01-23 11:47:00,11,81,Vestuário,2,92
32389,2024-01-23 11:48:00,116,139,Brinquedo,5,255
32390,2024-01-23 11:49:00,31,23,Móvel,1,54
32391,2024-01-23 11:50:00,119,72,Brinquedo,5,191
32392,2024-01-23 11:51:00,38,105,Eletrônico,3,143
32393,2024-01-23 11:52:00,101,144,Eletrônico,5,245
32394,2024-01-23 11:53:00,112,141,Vestuário,8,253
32395,2024-01-23 11:54:00,68,30,Eletrônico,1,98
32396,2024-01-23 11:55:00,62,178,Vestuário,5,240
32397,2024-01-23 11:56:00,117,138,Móvel,8,255
32398,2024-01-23 11:57:00,92,142,Vestuário,9,234
32399,2024-01-23 11:58:00,59,74,Brinquedo,8,133
32400,2024-01-23 11:59:00,78,56,Alimento,6,134
32401,2024-01-23 12:00:00,37,96,Vestuário,8,133
32402,2024-01-23 12:01:00,52,90,Vestuário,5,142
32403,2024-01-23 12:02:00,47,127,Alimento,3,174
32404,2024-01-23 12:03:00,54,165,Brinquedo,3,219
32405,2024-01-23 12:04:00,12,70,Móvel,9,82
32406,2024-01-23 12:05:00,77,111,Móvel,8,188
32407,2024-01-23 12:06:00,12,44,Brinquedo,5,56
32408,2024-01-23 12:07:00,29,156,Vestuário,4,185
32409,2024-01-23 12:08:00,101,30,Móvel,2,131
32410,2024-01-23 12:09:00,18,91,Vestuário,5,109
32411,2024-01-23 12:10:00,112,14,Brinquedo,2,126
32412,2024-01-23 12:11:00,90,165,Móvel,4,255
32413,2024-01-23 12:12:00,55,74,Vestuário,7,129
32414,2024-01-23 12:13:00,80,171,Vestuário,5,251
32415,2024-01-23 12:14:00,31,13,Alimento,5,44
32416,2024-01-23 12:15:00,28,49,Brinquedo,9,77
32417,2024-01-23 12:16:00,77,120,Eletrônico,7,197
32418,2024-01-23 12:17:00,112,172,Vestuário,8,284
32419,2024-01-23 12:18:00,23,84,Brinquedo,6,107
32420,2024-01-23 12:19:00,58,141,Vestuário,4,199
32421,2024-01-23 12:20:00,74,34,Brinquedo,9,108
32422,2024-01-23 12:21:00,76,54,Alimento,9,130
32423,2024-01-23 12:22:00,79,131,Brinquedo,5,210
32424,2024-01-23 12:23:00,110,123,Alimento,4,233
32425,2024-01-23 12:24:00,75,109,Brinquedo,7,184
32426,2024-01-23 12:25:00,71,96,Vestuário,9,167
32427,2024-01-23 12:26:00,69,37,Eletrônico,2,106
32428,2024-01-23 12:27:00,72,168,Vestuário,6,240
32429,2024-01-23 12:28:00,42,27,Móvel,2,69
32430,2024-01-23 12:29:00,41,27,Alimento,3,68
32431,2024-01-23 12:30:00,94,107,Alimento,1,201
32432,2024-01-23 12:31:00,74,52,Móvel,1,126
32433,2024-01-23 12:32:00,71,12,Vestuário,2,83
32434,2024-01-23 12:33:00,119,173,Brinquedo,7,292
32435,2024-01-23 12:34:00,109,132,Eletrônico,8,241
32436,2024-01-23 12:35:00,21,16,Brinquedo,7,37
32437,2024-01-23 12:36:00,17,78,Vestuário,1,95
32438,2024-01-23 12:37:00,17,52,Eletrônico,7,69
32439,2024-01-23 12:38:00,103,158,Alimento,9,261
32440,2024-01-23 12:39:00,112,128,Vestuário,6,240
32441,2024-01-23 12:40:00,108,129,Brinquedo,6,237
32442,2024-01-23 12:41:00,95,49,Vestuário,6,144
32443,2024-01-23 12:42:00,108,120,Eletrônico,9,228
32444,2024-01-23 12:43:00,12,98,Vestuário,9,110
32445,2024-01-23 12:44:00,12,76,Vestuário,4,88
32446,2024-01-23 12:45:00,83,112,Brinquedo,6,195
32447,2024-01-23 12:46:00,25,151,Brinquedo,5,176
32448,2024-01-23 12:47:00,47,162,Vestuário,9,209
32449,2024-01-23 12:48:00,33,118,Móvel,5,151
32450,2024-01-23 12:49:00,40,173,Alimento,3,213
32451,2024-01-23 12:50:00,75,179,Brinquedo,2,254
32452,2024-01-23 12:51:00,27,164,Vestuário,7,191
32453,2024-01-23 12:52:00,94,105,Vestuário,1,199
32454,2024-01-23 12:53:00,69,146,Vestuário,7,215
32455,2024-01-23 12:54:00,32,99,Móvel,3,131
32456,2024-01-23 12:55:00,102,102,Alimento,7,204
32457,2024-01-23 12:56:00,84,175,Vestuário,7,259
32458,2024-01-23 12:57:00,19,174,Móvel,6,193
32459,2024-01-23 12:58:00,38,18,Brinquedo,6,56
32460,2024-01-23 12:59:00,117,129,Eletrônico,9,246
32461,2024-01-23 13:00:00,24,37,Vestuário,3,61
32462,2024-01-23 13:01:00,54,151,Móvel,6,205
32463,2024-01-23 13:02:00,88,158,Alimento,6,246
32464,2024-01-23 13:03:00,10,52,Móvel,3,62
32465,2024-01-23 13:04:00,66,114,Vestuário,3,180
32466,2024-01-23 13:05:00,50,10,Vestuário,2,60
32467,2024-01-23 13:06:00,102,113,Alimento,9,215
32468,2024-01-23 13:07:00,70,161,Vestuário,1,231
32469,2024-01-23 13:08:00,19,166,Vestuário,9,185
32470,2024-01-23 13:09:00,73,77,Vestuário,5,150
32471,2024-01-23 13:10:00,57,13,Brinquedo,2,70
32472,2024-01-23 13:11:00,87,15,Eletrônico,4,102
32473,2024-01-23 13:12:00,60,37,Alimento,8,97
32474,2024-01-23 13:13:00,68,34,Móvel,6,102
32475,2024-01-23 13:14:00,103,80,Vestuário,3,183
32476,2024-01-23 13:15:00,115,175,Eletrônico,6,290
32477,2024-01-23 13:16:00,45,137,Eletrônico,1,182
32478,2024-01-23 13:17:00,88,90,Brinquedo,5,178
32479,2024-01-23 13:18:00,81,142,Móvel,1,223
32480,2024-01-23 13:19:00,76,169,Alimento,6,245
32481,2024-01-23 13:20:00,103,113,Vestuário,5,216
32482,2024-01-23 13:21:00,91,149,Brinquedo,6,240
32483,2024-01-23 13:22:00,92,30,Brinquedo,1,122
32484,2024-01-23 13:23:00,15,107,Vestuário,7,122
32485,2024-01-23 13:24:00,107,107,Alimento,3,214
32486,2024-01-23 13:25:00,66,31,Móvel,7,97
32487,2024-01-23 13:26:00,32,132,Alimento,3,164
32488,2024-01-23 13:27:00,118,107,Vestuário,2,225
32489,2024-01-23 13:28:00,81,131,Vestuário,6,212
32490,2024-01-23 13:29:00,27,14,Móvel,6,41
32491,2024-01-23 13:30:00,35,126,Móvel,2,161
32492,2024-01-23 13:31:00,48,26,Brinquedo,5,74
32493,2024-01-23 13:32:00,65,175,Eletrônico,2,240
32494,2024-01-23 13:33:00,78,107,Vestuário,6,185
32495,2024-01-23 13:34:00,35,70,Eletrônico,4,105
32496,2024-01-23 13:35:00,73,73,Móvel,6,146
32497,2024-01-23 13:36:00,70,78,Vestuário,3,148
32498,2024-01-23 13:37:00,31,170,Alimento,8,201
32499,2024-01-23 13:38:00,114,68,Eletrônico,3,182
32500,2024-01-23 13:39:00,90,40,Eletrônico,8,130
32501,2024-01-23 13:40:00,106,156,Móvel,4,262
32502,2024-01-23 13:41:00,83,40,Móvel,8,123
32503,2024-01-23 13:42:00,115,56,Alimento,3,171
32504,2024-01-23 13:43:00,106,145,Móvel,5,251
32505,2024-01-23 13:44:00,45,67,Eletrônico,4,112
32506,2024-01-23 13:45:00,22,121,Móvel,9,143
32507,2024-01-23 13:46:00,115,25,Vestuário,9,140
32508,2024-01-23 13:47:00,114,71,Alimento,5,185
32509,2024-01-23 13:48:00,32,107,Vestuário,4,139
32510,2024-01-23 13:49:00,50,106,Móvel,5,156
32511,2024-01-23 13:50:00,57,19,Eletrônico,9,76
32512,2024-01-23 13:51:00,52,42,Brinquedo,6,94
32513,2024-01-23 13:52:00,48,43,Vestuário,7,91
32514,2024-01-23 13:53:00,91,110,Brinquedo,3,201
32515,2024-01-23 13:54:00,58,141,Eletrônico,5,199
32516,2024-01-23 13:55:00,74,142,Móvel,7,216
32517,2024-01-23 13:56:00,40,41,Móvel,7,81
32518,2024-01-23 13:57:00,87,102,Eletrônico,5,189
32519,2024-01-23 13:58:00,65,22,Vestuário,9,87
32520,2024-01-23 13:59:00,39,41,Brinquedo,8,80
32521,2024-01-23 14:00:00,106,165,Brinquedo,1,271
32522,2024-01-23 14:01:00,44,48,Vestuário,2,92
32523,2024-01-23 14:02:00,72,152,Vestuário,2,224
32524,2024-01-23 14:03:00,49,118,Vestuário,6,167
32525,2024-01-23 14:04:00,48,58,Eletrônico,7,106
32526,2024-01-23 14:05:00,75,149,Alimento,6,224
32527,2024-01-23 14:06:00,52,12,Móvel,5,64
32528,2024-01-23 14:07:00,98,29,Móvel,3,127
32529,2024-01-23 14:08:00,99,70,Brinquedo,8,169
32530,2024-01-23 14:09:00,117,37,Brinquedo,7,154
32531,2024-01-23 14:10:00,92,123,Brinquedo,9,215
32532,2024-01-23 14:11:00,90,97,Móvel,7,187
32533,2024-01-23 14:12:00,49,156,Eletrônico,6,205
32534,2024-01-23 14:13:00,102,33,Alimento,3,135
32535,2024-01-23 14:14:00,113,57,Eletrônico,5,170
32536,2024-01-23 14:15:00,67,87,Alimento,9,154
32537,2024-01-23 14:16:00,101,29,Brinquedo,1,130
32538,2024-01-23 14:17:00,114,162,Brinquedo,5,276
32539,2024-01-23 14:18:00,72,163,Vestuário,5,235
32540,2024-01-23 14:19:00,69,103,Vestuário,4,172
32541,2024-01-23 14:20:00,60,163,Eletrônico,7,223
32542,2024-01-23 14:21:00,79,152,Vestuário,1,231
32543,2024-01-23 14:22:00,94,19,Alimento,5,113
32544,2024-01-23 14:23:00,66,101,Brinquedo,2,167
32545,2024-01-23 14:24:00,93,21,Móvel,7,114
32546,2024-01-23 14:25:00,40,172,Vestuário,2,212
32547,2024-01-23 14:26:00,17,92,Eletrônico,3,109
32548,2024-01-23 14:27:00,89,175,Eletrônico,4,264
32549,2024-01-23 14:28:00,30,26,Alimento,2,56
32550,2024-01-23 14:29:00,108,52,Alimento,3,160
32551,2024-01-23 14:30:00,22,149,Brinquedo,7,171
32552,2024-01-23 14:31:00,44,153,Vestuário,2,197
32553,2024-01-23 14:32:00,86,149,Móvel,5,235
32554,2024-01-23 14:33:00,91,29,Móvel,4,120
32555,2024-01-23 14:34:00,111,60,Eletrônico,6,171
32556,2024-01-23 14:35:00,34,48,Alimento,6,82
32557,2024-01-23 14:36:00,117,26,Móvel,5,143
32558,2024-01-23 14:37:00,111,115,Móvel,7,226
32559,2024-01-23 14:38:00,33,84,Brinquedo,5,117
32560,2024-01-23 14:39:00,53,88,Alimento,3,141
32561,2024-01-23 14:40:00,71,96,Eletrônico,3,167
32562,2024-01-23 14:41:00,40,151,Brinquedo,9,191
32563,2024-01-23 14:42:00,14,167,Móvel,4,181
32564,2024-01-23 14:43:00,88,41,Móvel,5,129
32565,2024-01-23 14:44:00,20,46,Eletrônico,4,66
32566,2024-01-23 14:45:00,60,126,Alimento,3,186
32567,2024-01-23 14:46:00,96,103,Eletrônico,3,199
32568,2024-01-23 14:47:00,105,140,Eletrônico,7,245
32569,2024-01-23 14:48:00,107,96,Brinquedo,9,203
32570,2024-01-23 14:49:00,90,11,Alimento,8,101
32571,2024-01-23 14:50:00,55,25,Móvel,9,80
32572,2024-01-23 14:51:00,56,72,Vestuário,4,128
32573,2024-01-23 14:52:00,19,41,Vestuário,1,60
32574,2024-01-23 14:53:00,71,10,Eletrônico,2,81
32575,2024-01-23 14:54:00,82,136,Alimento,6,218
32576,2024-01-23 14:55:00,98,75,Vestuário,9,173
32577,2024-01-23 14:56:00,29,64,Eletrônico,8,93
32578,2024-01-23 14:57:00,26,47,Eletrônico,5,73
32579,2024-01-23 14:58:00,22,144,Brinquedo,3,166
32580,2024-01-23 14:59:00,112,113,Móvel,7,225
32581,2024-01-23 15:00:00,64,149,Brinquedo,5,213
32582,2024-01-23 15:01:00,67,160,Brinquedo,3,227
32583,2024-01-23 15:02:00,101,33,Móvel,9,134
32584,2024-01-23 15:03:00,109,143,Brinquedo,2,252
32585,2024-01-23 15:04:00,55,174,Móvel,8,229
32586,2024-01-23 15:05:00,47,100,Móvel,6,147
32587,2024-01-23 15:06:00,105,69,Vestuário,2,174
32588,2024-01-23 15:07:00,115,92,Móvel,9,207
32589,2024-01-23 15:08:00,42,92,Brinquedo,3,134
32590,2024-01-23 15:09:00,39,88,Vestuário,5,127
32591,2024-01-23 15:10:00,50,35,Eletrônico,2,85
32592,2024-01-23 15:11:00,119,150,Alimento,4,269
32593,2024-01-23 15:12:00,56,41,Eletrônico,5,97
32594,2024-01-23 15:13:00,95,64,Brinquedo,1,159
32595,2024-01-23 15:14:00,48,68,Vestuário,9,116
32596,2024-01-23 15:15:00,36,146,Móvel,1,182
32597,2024-01-23 15:16:00,68,80,Brinquedo,8,148
32598,2024-01-23 15:17:00,53,93,Alimento,9,146
32599,2024-01-23 15:18:00,18,126,Alimento,1,144
32600,2024-01-23 15:19:00,103,158,Alimento,3,261
32601,2024-01-23 15:20:00,36,107,Eletrônico,1,143
32602,2024-01-23 15:21:00,49,102,Brinquedo,2,151
32603,2024-01-23 15:22:00,28,150,Vestuário,2,178
32604,2024-01-23 15:23:00,110,112,Brinquedo,6,222
32605,2024-01-23 15:24:00,38,20,Alimento,9,58
32606,2024-01-23 15:25:00,72,164,Eletrônico,3,236
32607,2024-01-23 15:26:00,10,68,Móvel,5,78
32608,2024-01-23 15:27:00,38,130,Móvel,1,168
32609,2024-01-23 15:28:00,59,49,Eletrônico,9,108
32610,2024-01-23 15:29:00,93,53,Brinquedo,8,146
32611,2024-01-23 15:30:00,45,167,Móvel,2,212
32612,2024-01-23 15:31:00,74,61,Brinquedo,5,135
32613,2024-01-23 15:32:00,34,60,Alimento,5,94
32614,2024-01-23 15:33:00,94,72,Alimento,7,166
32615,2024-01-23 15:34:00,85,130,Alimento,7,215
32616,2024-01-23 15:35:00,60,148,Alimento,4,208
32617,2024-01-23 15:36:00,36,66,Móvel,2,102
32618,2024-01-23 15:37:00,114,50,Alimento,3,164
32619,2024-01-23 15:38:00,119,126,Eletrônico,4,245
32620,2024-01-23 15:39:00,71,154,Eletrônico,8,225
32621,2024-01-23 15:40:00,69,174,Eletrônico,5,243
32622,2024-01-23 15:41:00,44,159,Brinquedo,6,203
32623,2024-01-23 15:42:00,22,75,Vestuário,3,97
32624,2024-01-23 15:43:00,108,103,Eletrônico,7,211
32625,2024-01-23 15:44:00,71,154,Vestuário,6,225
32626,2024-01-23 15:45:00,35,158,Brinquedo,2,193
32627,2024-01-23 15:46:00,34,77,Brinquedo,6,111
32628,2024-01-23 15:47:00,62,110,Vestuário,4,172
32629,2024-01-23 15:48:00,61,98,Vestuário,1,159
32630,2024-01-23 15:49:00,40,78,Móvel,6,118
32631,2024-01-23 15:50:00,10,42,Brinquedo,2,52
32632,2024-01-23 15:51:00,118,149,Eletrônico,2,267
32633,2024-01-23 15:52:00,84,99,Brinquedo,5,183
32634,2024-01-23 15:53:00,12,172,Eletrônico,3,184
32635,2024-01-23 15:54:00,88,102,Alimento,9,190
32636,2024-01-23 15:55:00,67,12,Eletrônico,6,79
32637,2024-01-23 15:56:00,115,166,Alimento,6,281
32638,2024-01-23 15:57:00,75,115,Móvel,9,190
32639,2024-01-23 15:58:00,23,159,Móvel,9,182
32640,2024-01-23 15:59:00,81,28,Móvel,6,109
32641,2024-01-23 16:00:00,49,98,Vestuário,4,147
32642,2024-01-23 16:01:00,118,92,Eletrônico,5,210
32643,2024-01-23 16:02:00,73,78,Alimento,5,151
32644,2024-01-23 16:03:00,66,89,Brinquedo,3,155
32645,2024-01-23 16:04:00,64,141,Alimento,5,205
32646,2024-01-23 16:05:00,99,129,Alimento,1,228
32647,2024-01-23 16:06:00,49,72,Vestuário,9,121
32648,2024-01-23 16:07:00,96,109,Brinquedo,6,205
32649,2024-01-23 16:08:00,76,71,Móvel,3,147
32650,2024-01-23 16:09:00,68,122,Brinquedo,3,190
32651,2024-01-23 16:10:00,29,135,Eletrônico,3,164
32652,2024-01-23 16:11:00,49,169,Brinquedo,8,218
32653,2024-01-23 16:12:00,54,168,Vestuário,6,222
32654,2024-01-23 16:13:00,20,98,Eletrônico,9,118
32655,2024-01-23 16:14:00,54,157,Móvel,5,211
32656,2024-01-23 16:15:00,90,12,Alimento,4,102
32657,2024-01-23 16:16:00,49,116,Vestuário,3,165
32658,2024-01-23 16:17:00,31,137,Eletrônico,9,168
32659,2024-01-23 16:18:00,29,106,Eletrônico,4,135
32660,2024-01-23 16:19:00,73,136,Móvel,7,209
32661,2024-01-23 16:20:00,44,130,Eletrônico,4,174
32662,2024-01-23 16:21:00,40,152,Eletrônico,2,192
32663,2024-01-23 16:22:00,70,94,Eletrônico,2,164
32664,2024-01-23 16:23:00,25,69,Eletrônico,2,94
32665,2024-01-23 16:24:00,77,18,Alimento,3,95
32666,2024-01-23 16:25:00,58,139,Alimento,5,197
32667,2024-01-23 16:26:00,112,12,Alimento,4,124
32668,2024-01-23 16:27:00,79,31,Vestuário,1,110
32669,2024-01-23 16:28:00,105,109,Brinquedo,3,214
32670,2024-01-23 16:29:00,88,47,Alimento,7,135
32671,2024-01-23 16:30:00,43,103,Vestuário,6,146
32672,2024-01-23 16:31:00,86,156,Alimento,4,242
32673,2024-01-23 16:32:00,21,48,Vestuário,5,69
32674,2024-01-23 16:33:00,86,170,Móvel,2,256
32675,2024-01-23 16:34:00,35,23,Brinquedo,4,58
32676,2024-01-23 16:35:00,66,25,Móvel,4,91
32677,2024-01-23 16:36:00,58,94,Brinquedo,9,152
32678,2024-01-23 16:37:00,12,178,Móvel,5,190
32679,2024-01-23 16:38:00,34,68,Vestuário,8,102
32680,2024-01-23 16:39:00,84,62,Eletrônico,7,146
32681,2024-01-23 16:40:00,78,109,Vestuário,3,187
32682,2024-01-23 16:41:00,117,119,Eletrônico,9,236
32683,2024-01-23 16:42:00,49,17,Móvel,3,66
32684,2024-01-23 16:43:00,14,171,Vestuário,4,185
32685,2024-01-23 16:44:00,25,53,Móvel,5,78
32686,2024-01-23 16:45:00,114,175,Móvel,9,289
32687,2024-01-23 16:46:00,27,68,Brinquedo,7,95
32688,2024-01-23 16:47:00,70,115,Brinquedo,7,185
32689,2024-01-23 16:48:00,48,20,Móvel,7,68
32690,2024-01-23 16:49:00,12,85,Vestuário,2,97
32691,2024-01-23 16:50:00,108,159,Vestuário,6,267
32692,2024-01-23 16:51:00,33,85,Vestuário,1,118
32693,2024-01-23 16:52:00,68,37,Vestuário,9,105
32694,2024-01-23 16:53:00,56,167,Alimento,6,223
32695,2024-01-23 16:54:00,25,168,Eletrônico,1,193
32696,2024-01-23 16:55:00,67,64,Brinquedo,5,131
32697,2024-01-23 16:56:00,15,121,Vestuário,9,136
32698,2024-01-23 16:57:00,43,23,Vestuário,8,66
32699,2024-01-23 16:58:00,104,31,Vestuário,8,135
32700,2024-01-23 16:59:00,30,27,Brinquedo,6,57
32701,2024-01-23 17:00:00,24,142,Eletrônico,8,166
32702,2024-01-23 17:01:00,71,67,Brinquedo,3,138
32703,2024-01-23 17:02:00,106,88,Brinquedo,7,194
32704,2024-01-23 17:03:00,31,43,Alimento,6,74
32705,2024-01-23 17:04:00,118,81,Alimento,1,199
32706,2024-01-23 17:05:00,60,112,Alimento,1,172
32707,2024-01-23 17:06:00,83,21,Alimento,2,104
32708,2024-01-23 17:07:00,115,111,Eletrônico,2,226
32709,2024-01-23 17:08:00,84,21,Brinquedo,1,105
32710,2024-01-23 17:09:00,82,36,Eletrônico,7,118
32711,2024-01-23 17:10:00,43,81,Vestuário,6,124
32712,2024-01-23 17:11:00,78,34,Brinquedo,8,112
32713,2024-01-23 17:12:00,105,129,Móvel,7,234
32714,2024-01-23 17:13:00,55,101,Vestuário,5,156
32715,2024-01-23 17:14:00,103,88,Brinquedo,2,191
32716,2024-01-23 17:15:00,112,73,Móvel,5,185
32717,2024-01-23 17:16:00,76,14,Brinquedo,1,90
32718,2024-01-23 17:17:00,28,171,Brinquedo,5,199
32719,2024-01-23 17:18:00,23,61,Vestuário,3,84
32720,2024-01-23 17:19:00,92,18,Brinquedo,3,110
32721,2024-01-23 17:20:00,75,102,Vestuário,6,177
32722,2024-01-23 17:21:00,41,151,Brinquedo,9,192
32723,2024-01-23 17:22:00,58,156,Vestuário,2,214
32724,2024-01-23 17:23:00,66,25,Vestuário,3,91
32725,2024-01-23 17:24:00,67,145,Móvel,1,212
32726,2024-01-23 17:25:00,69,172,Eletrônico,4,241
32727,2024-01-23 17:26:00,37,115,Eletrônico,8,152
32728,2024-01-23 17:27:00,46,165,Vestuário,7,211
32729,2024-01-23 17:28:00,100,29,Brinquedo,8,129
32730,2024-01-23 17:29:00,68,109,Vestuário,1,177
32731,2024-01-23 17:30:00,54,66,Vestuário,4,120
32732,2024-01-23 17:31:00,90,137,Alimento,2,227
32733,2024-01-23 17:32:00,49,162,Brinquedo,5,211
32734,2024-01-23 17:33:00,70,65,Brinquedo,8,135
32735,2024-01-23 17:34:00,10,169,Móvel,2,179
32736,2024-01-23 17:35:00,99,89,Vestuário,2,188
32737,2024-01-23 17:36:00,53,147,Vestuário,5,200
32738,2024-01-23 17:37:00,31,120,Vestuário,2,151
32739,2024-01-23 17:38:00,78,36,Eletrônico,4,114
32740,2024-01-23 17:39:00,112,37,Vestuário,6,149
32741,2024-01-23 17:40:00,104,14,Vestuário,1,118
32742,2024-01-23 17:41:00,65,176,Vestuário,6,241
32743,2024-01-23 17:42:00,17,38,Móvel,9,55
32744,2024-01-23 17:43:00,31,88,Alimento,7,119
32745,2024-01-23 17:44:00,76,88,Eletrônico,2,164
32746,2024-01-23 17:45:00,75,87,Brinquedo,6,162
32747,2024-01-23 17:46:00,89,146,Eletrônico,3,235
32748,2024-01-23 17:47:00,18,54,Vestuário,5,72
32749,2024-01-23 17:48:00,95,73,Móvel,3,168
32750,2024-01-23 17:49:00,49,150,Brinquedo,3,199
32751,2024-01-23 17:50:00,111,110,Vestuário,5,221
32752,2024-01-23 17:51:00,70,159,Brinquedo,9,229
32753,2024-01-23 17:52:00,106,157,Alimento,9,263
32754,2024-01-23 17:53:00,43,169,Alimento,5,212
32755,2024-01-23 17:54:00,20,62,Móvel,3,82
32756,2024-01-23 17:55:00,42,103,Brinquedo,1,145
32757,2024-01-23 17:56:00,79,24,Móvel,8,103
32758,2024-01-23 17:57:00,35,152,Eletrônico,1,187
32759,2024-01-23 17:58:00,13,104,Vestuário,6,117
32760,2024-01-23 17:59:00,37,71,Móvel,7,108
32761,2024-01-23 18:00:00,12,84,Brinquedo,7,96
32762,2024-01-23 18:01:00,60,59,Móvel,5,119
32763,2024-01-23 18:02:00,100,111,Vestuário,1,211
32764,2024-01-23 18:03:00,66,24,Alimento,8,90
32765,2024-01-23 18:04:00,11,17,Móvel,6,28
32766,2024-01-23 18:05:00,59,71,Móvel,8,130
32767,2024-01-23 18:06:00,49,87,Eletrônico,1,136
32768,2024-01-23 18:07:00,113,147,Alimento,9,260
32769,2024-01-23 18:08:00,100,101,Eletrônico,9,201
32770,2024-01-23 18:09:00,58,11,Móvel,3,69
32771,2024-01-23 18:10:00,10,111,Brinquedo,4,121
32772,2024-01-23 18:11:00,49,39,Alimento,4,88
32773,2024-01-23 18:12:00,92,61,Eletrônico,8,153
32774,2024-01-23 18:13:00,30,95,Eletrônico,5,125
32775,2024-01-23 18:14:00,68,123,Alimento,8,191
32776,2024-01-23 18:15:00,23,37,Vestuário,7,60
32777,2024-01-23 18:16:00,111,47,Móvel,7,158
32778,2024-01-23 18:17:00,19,154,Brinquedo,4,173
32779,2024-01-23 18:18:00,111,90,Móvel,9,201
32780,2024-01-23 18:19:00,29,123,Eletrônico,4,152
32781,2024-01-23 18:20:00,72,35,Vestuário,6,107
32782,2024-01-23 18:21:00,48,28,Vestuário,1,76
32783,2024-01-23 18:22:00,91,77,Alimento,2,168
32784,2024-01-23 18:23:00,19,30,Alimento,3,49
32785,2024-01-23 18:24:00,77,77,Eletrônico,7,154
32786,2024-01-23 18:25:00,62,32,Eletrônico,6,94
32787,2024-01-23 18:26:00,46,13,Móvel,8,59
32788,2024-01-23 18:27:00,58,69,Brinquedo,9,127
32789,2024-01-23 18:28:00,78,106,Eletrônico,7,184
32790,2024-01-23 18:29:00,49,54,Eletrônico,5,103
32791,2024-01-23 18:30:00,14,41,Móvel,6,55
32792,2024-01-23 18:31:00,12,80,Eletrônico,3,92
32793,2024-01-23 18:32:00,62,57,Vestuário,5,119
32794,2024-01-23 18:33:00,63,152,Vestuário,2,215
32795,2024-01-23 18:34:00,54,25,Móvel,2,79
32796,2024-01-23 18:35:00,93,95,Vestuário,3,188
32797,2024-01-23 18:36:00,69,156,Alimento,8,225
32798,2024-01-23 18:37:00,34,175,Vestuário,7,209
32799,2024-01-23 18:38:00,43,173,Móvel,3,216
32800,2024-01-23 18:39:00,107,151,Brinquedo,4,258
32801,2024-01-23 18:40:00,53,39,Móvel,4,92
32802,2024-01-23 18:41:00,62,76,Brinquedo,1,138
32803,2024-01-23 18:42:00,100,77,Móvel,8,177
32804,2024-01-23 18:43:00,112,115,Móvel,9,227
32805,2024-01-23 18:44:00,111,58,Móvel,5,169
32806,2024-01-23 18:45:00,65,119,Brinquedo,5,184
32807,2024-01-23 18:46:00,56,166,Brinquedo,6,222
32808,2024-01-23 18:47:00,98,86,Brinquedo,5,184
32809,2024-01-23 18:48:00,38,67,Eletrônico,4,105
32810,2024-01-23 18:49:00,92,135,Móvel,3,227
32811,2024-01-23 18:50:00,59,177,Brinquedo,8,236
32812,2024-01-23 18:51:00,77,120,Eletrônico,7,197
32813,2024-01-23 18:52:00,111,94,Eletrônico,5,205
32814,2024-01-23 18:53:00,116,17,Brinquedo,2,133
32815,2024-01-23 18:54:00,113,175,Brinquedo,5,288
32816,2024-01-23 18:55:00,76,133,Alimento,1,209
32817,2024-01-23 18:56:00,98,126,Vestuário,6,224
32818,2024-01-23 18:57:00,70,84,Eletrônico,4,154
32819,2024-01-23 18:58:00,56,90,Vestuário,1,146
32820,2024-01-23 18:59:00,74,68,Móvel,3,142
32821,2024-01-23 19:00:00,119,50,Brinquedo,2,169
32822,2024-01-23 19:01:00,43,38,Vestuário,8,81
32823,2024-01-23 19:02:00,35,40,Brinquedo,6,75
32824,2024-01-23 19:03:00,62,138,Brinquedo,4,200
32825,2024-01-23 19:04:00,81,28,Alimento,7,109
32826,2024-01-23 19:05:00,88,78,Vestuário,2,166
32827,2024-01-23 19:06:00,105,129,Vestuário,7,234
32828,2024-01-23 19:07:00,88,163,Vestuário,3,251
32829,2024-01-23 19:08:00,89,21,Eletrônico,8,110
32830,2024-01-23 19:09:00,99,108,Vestuário,5,207
32831,2024-01-23 19:10:00,63,103,Alimento,4,166
32832,2024-01-23 19:11:00,54,79,Alimento,8,133
32833,2024-01-23 19:12:00,48,130,Vestuário,6,178
32834,2024-01-23 19:13:00,46,35,Brinquedo,6,81
32835,2024-01-23 19:14:00,71,96,Alimento,7,167
32836,2024-01-23 19:15:00,104,12,Brinquedo,8,116
32837,2024-01-23 19:16:00,110,24,Alimento,9,134
32838,2024-01-23 19:17:00,72,38,Brinquedo,7,110
32839,2024-01-23 19:18:00,38,32,Vestuário,5,70
32840,2024-01-23 19:19:00,71,79,Brinquedo,9,150
32841,2024-01-23 19:20:00,81,168,Vestuário,7,249
32842,2024-01-23 19:21:00,116,143,Alimento,3,259
32843,2024-01-23 19:22:00,52,69,Alimento,7,121
32844,2024-01-23 19:23:00,44,101,Eletrônico,3,145
32845,2024-01-23 19:24:00,119,64,Móvel,7,183
32846,2024-01-23 19:25:00,15,20,Vestuário,4,35
32847,2024-01-23 19:26:00,41,32,Eletrônico,3,73
32848,2024-01-23 19:27:00,94,44,Brinquedo,1,138
32849,2024-01-23 19:28:00,42,91,Móvel,3,133
32850,2024-01-23 19:29:00,73,119,Eletrônico,7,192
32851,2024-01-23 19:30:00,15,89,Brinquedo,6,104
32852,2024-01-23 19:31:00,34,106,Eletrônico,5,140
32853,2024-01-23 19:32:00,48,56,Alimento,8,104
32854,2024-01-23 19:33:00,65,88,Eletrônico,4,153
32855,2024-01-23 19:34:00,67,10,Móvel,8,77
32856,2024-01-23 19:35:00,75,95,Brinquedo,4,170
32857,2024-01-23 19:36:00,64,75,Brinquedo,3,139
32858,2024-01-23 19:37:00,23,83,Móvel,8,106
32859,2024-01-23 19:38:00,36,13,Brinquedo,8,49
32860,2024-01-23 19:39:00,84,124,Alimento,1,208
32861,2024-01-23 19:40:00,95,175,Eletrônico,4,270
32862,2024-01-23 19:41:00,18,148,Móvel,5,166
32863,2024-01-23 19:42:00,13,35,Eletrônico,4,48
32864,2024-01-23 19:43:00,119,123,Vestuário,6,242
32865,2024-01-23 19:44:00,10,96,Eletrônico,6,106
32866,2024-01-23 19:45:00,79,178,Móvel,2,257
32867,2024-01-23 19:46:00,31,129,Brinquedo,7,160
32868,2024-01-23 19:47:00,24,50,Móvel,5,74
32869,2024-01-23 19:48:00,34,45,Eletrônico,2,79
32870,2024-01-23 19:49:00,96,105,Eletrônico,1,201
32871,2024-01-23 19:50:00,10,114,Alimento,5,124
32872,2024-01-23 19:51:00,87,91,Eletrônico,4,178
32873,2024-01-23 19:52:00,39,13,Alimento,6,52
32874,2024-01-23 19:53:00,35,129,Eletrônico,9,164
32875,2024-01-23 19:54:00,80,137,Vestuário,7,217
32876,2024-01-23 19:55:00,113,160,Alimento,4,273
32877,2024-01-23 19:56:00,96,151,Alimento,1,247
32878,2024-01-23 19:57:00,87,116,Móvel,2,203
32879,2024-01-23 19:58:00,68,76,Eletrônico,9,144
32880,2024-01-23 19:59:00,72,20,Brinquedo,3,92
32881,2024-01-23 20:00:00,115,49,Eletrônico,5,164
32882,2024-01-23 20:01:00,21,78,Alimento,4,99
32883,2024-01-23 20:02:00,113,63,Brinquedo,5,176
32884,2024-01-23 20:03:00,29,112,Brinquedo,3,141
32885,2024-01-23 20:04:00,116,70,Móvel,2,186
32886,2024-01-23 20:05:00,34,133,Brinquedo,5,167
32887,2024-01-23 20:06:00,44,117,Móvel,9,161
32888,2024-01-23 20:07:00,41,36,Brinquedo,7,77
32889,2024-01-23 20:08:00,109,123,Brinquedo,5,232
32890,2024-01-23 20:09:00,73,77,Eletrônico,2,150
32891,2024-01-23 20:10:00,85,138,Brinquedo,3,223
32892,2024-01-23 20:11:00,52,80,Eletrônico,6,132
32893,2024-01-23 20:12:00,100,157,Móvel,9,257
32894,2024-01-23 20:13:00,62,112,Alimento,6,174
32895,2024-01-23 20:14:00,116,130,Vestuário,4,246
32896,2024-01-23 20:15:00,15,31,Móvel,5,46
32897,2024-01-23 20:16:00,113,62,Brinquedo,2,175
32898,2024-01-23 20:17:00,114,63,Eletrônico,9,177
32899,2024-01-23 20:18:00,16,57,Brinquedo,1,73
32900,2024-01-23 20:19:00,94,18,Brinquedo,5,112
32901,2024-01-23 20:20:00,28,161,Eletrônico,4,189
32902,2024-01-23 20:21:00,22,31,Vestuário,9,53
32903,2024-01-23 20:22:00,101,136,Brinquedo,8,237
32904,2024-01-23 20:23:00,74,125,Eletrônico,3,199
32905,2024-01-23 20:24:00,67,125,Eletrônico,6,192
32906,2024-01-23 20:25:00,10,114,Móvel,7,124
32907,2024-01-23 20:26:00,45,62,Móvel,7,107
32908,2024-01-23 20:27:00,104,109,Brinquedo,6,213
32909,2024-01-23 20:28:00,50,154,Móvel,7,204
32910,2024-01-23 20:29:00,59,145,Vestuário,9,204
32911,2024-01-23 20:30:00,93,104,Móvel,8,197
32912,2024-01-23 20:31:00,57,176,Eletrônico,9,233
32913,2024-01-23 20:32:00,24,25,Brinquedo,7,49
32914,2024-01-23 20:33:00,17,165,Alimento,1,182
32915,2024-01-23 20:34:00,57,94,Brinquedo,9,151
32916,2024-01-23 20:35:00,33,116,Vestuário,9,149
32917,2024-01-23 20:36:00,99,92,Eletrônico,3,191
32918,2024-01-23 20:37:00,114,69,Brinquedo,7,183
32919,2024-01-23 20:38:00,53,141,Alimento,5,194
32920,2024-01-23 20:39:00,70,139,Alimento,1,209
32921,2024-01-23 20:40:00,42,16,Brinquedo,1,58
32922,2024-01-23 20:41:00,23,152,Móvel,2,175
32923,2024-01-23 20:42:00,92,70,Alimento,9,162
32924,2024-01-23 20:43:00,24,161,Móvel,5,185
32925,2024-01-23 20:44:00,117,93,Alimento,9,210
32926,2024-01-23 20:45:00,23,32,Vestuário,9,55
32927,2024-01-23 20:46:00,103,168,Móvel,7,271
32928,2024-01-23 20:47:00,47,47,Alimento,5,94
32929,2024-01-23 20:48:00,29,145,Brinquedo,8,174
32930,2024-01-23 20:49:00,28,118,Móvel,1,146
32931,2024-01-23 20:50:00,56,100,Eletrônico,9,156
32932,2024-01-23 20:51:00,100,42,Eletrônico,3,142
32933,2024-01-23 20:52:00,51,60,Eletrônico,9,111
32934,2024-01-23 20:53:00,63,13,Móvel,3,76
32935,2024-01-23 20:54:00,97,40,Brinquedo,9,137
32936,2024-01-23 20:55:00,119,126,Alimento,7,245
32937,2024-01-23 20:56:00,100,170,Vestuário,7,270
32938,2024-01-23 20:57:00,96,124,Alimento,2,220
32939,2024-01-23 20:58:00,116,143,Vestuário,8,259
32940,2024-01-23 20:59:00,65,179,Brinquedo,3,244
32941,2024-01-23 21:00:00,61,16,Eletrônico,5,77
32942,2024-01-23 21:01:00,54,49,Móvel,2,103
32943,2024-01-23 21:02:00,21,40,Eletrônico,7,61
32944,2024-01-23 21:03:00,79,126,Eletrônico,9,205
32945,2024-01-23 21:04:00,117,28,Brinquedo,4,145
32946,2024-01-23 21:05:00,95,79,Vestuário,5,174
32947,2024-01-23 21:06:00,14,83,Alimento,2,97
32948,2024-01-23 21:07:00,83,18,Móvel,8,101
32949,2024-01-23 21:08:00,38,167,Brinquedo,4,205
32950,2024-01-23 21:09:00,52,91,Alimento,6,143
32951,2024-01-23 21:10:00,110,84,Alimento,5,194
32952,2024-01-23 21:11:00,34,85,Brinquedo,4,119
32953,2024-01-23 21:12:00,52,37,Alimento,6,89
32954,2024-01-23 21:13:00,112,67,Móvel,3,179
32955,2024-01-23 21:14:00,106,56,Móvel,6,162
32956,2024-01-23 21:15:00,76,137,Alimento,3,213
32957,2024-01-23 21:16:00,89,151,Brinquedo,5,240
32958,2024-01-23 21:17:00,14,86,Brinquedo,6,100
32959,2024-01-23 21:18:00,95,10,Móvel,9,105
32960,2024-01-23 21:19:00,104,66,Vestuário,7,170
32961,2024-01-23 21:20:00,58,138,Móvel,8,196
32962,2024-01-23 21:21:00,112,95,Alimento,1,207
32963,2024-01-23 21:22:00,62,120,Eletrônico,6,182
32964,2024-01-23 21:23:00,88,70,Vestuário,3,158
32965,2024-01-23 21:24:00,110,34,Alimento,6,144
32966,2024-01-23 21:25:00,22,164,Móvel,9,186
32967,2024-01-23 21:26:00,113,71,Brinquedo,2,184
32968,2024-01-23 21:27:00,63,36,Móvel,6,99
32969,2024-01-23 21:28:00,91,166,Eletrônico,3,257
32970,2024-01-23 21:29:00,96,158,Brinquedo,6,254
32971,2024-01-23 21:30:00,40,83,Eletrônico,2,123
32972,2024-01-23 21:31:00,62,66,Eletrônico,9,128
32973,2024-01-23 21:32:00,81,49,Alimento,4,130
32974,2024-01-23 21:33:00,37,38,Eletrônico,7,75
32975,2024-01-23 21:34:00,26,92,Alimento,4,118
32976,2024-01-23 21:35:00,77,79,Vestuário,9,156
32977,2024-01-23 21:36:00,36,17,Vestuário,1,53
32978,2024-01-23 21:37:00,55,75,Móvel,2,130
32979,2024-01-23 21:38:00,110,54,Eletrônico,5,164
32980,2024-01-23 21:39:00,20,159,Brinquedo,3,179
32981,2024-01-23 21:40:00,17,49,Eletrônico,4,66
32982,2024-01-23 21:41:00,63,16,Móvel,2,79
32983,2024-01-23 21:42:00,95,68,Alimento,2,163
32984,2024-01-23 21:43:00,78,32,Eletrônico,6,110
32985,2024-01-23 21:44:00,36,177,Eletrônico,8,213
32986,2024-01-23 21:45:00,113,144,Móvel,2,257
32987,2024-01-23 21:46:00,101,178,Móvel,2,279
32988,2024-01-23 21:47:00,93,158,Vestuário,5,251
32989,2024-01-23 21:48:00,59,145,Móvel,3,204
32990,2024-01-23 21:49:00,64,36,Eletrônico,3,100
32991,2024-01-23 21:50:00,85,31,Eletrônico,4,116
32992,2024-01-23 21:51:00,101,63,Alimento,5,164
32993,2024-01-23 21:52:00,69,92,Eletrônico,1,161
32994,2024-01-23 21:53:00,67,58,Eletrônico,2,125
32995,2024-01-23 21:54:00,30,63,Alimento,7,93
32996,2024-01-23 21:55:00,106,22,Vestuário,3,128
32997,2024-01-23 21:56:00,74,129,Vestuário,1,203
32998,2024-01-23 21:57:00,22,48,Vestuário,5,70
32999,2024-01-23 21:58:00,14,176,Eletrônico,7,190
33000,2024-01-23 21:59:00,37,135,Alimento,9,172
33001,2024-01-23 22:00:00,28,47,Brinquedo,9,75
33002,2024-01-23 22:01:00,73,56,Alimento,3,129
33003,2024-01-23 22:02:00,81,12,Móvel,2,93
33004,2024-01-23 22:03:00,115,36,Eletrônico,2,151
33005,2024-01-23 22:04:00,45,64,Alimento,9,109
33006,2024-01-23 22:05:00,30,142,Móvel,6,172
33007,2024-01-23 22:06:00,68,83,Móvel,8,151
33008,2024-01-23 22:07:00,36,118,Alimento,5,154
33009,2024-01-23 22:08:00,86,64,Brinquedo,8,150
33010,2024-01-23 22:09:00,80,42,Móvel,1,122
33011,2024-01-23 22:10:00,60,161,Eletrônico,6,221
33012,2024-01-23 22:11:00,95,111,Eletrônico,8,206
33013,2024-01-23 22:12:00,19,130,Alimento,7,149
33014,2024-01-23 22:13:00,34,166,Alimento,2,200
33015,2024-01-23 22:14:00,103,108,Móvel,3,211
33016,2024-01-23 22:15:00,52,144,Alimento,1,196
33017,2024-01-23 22:16:00,37,51,Vestuário,9,88
33018,2024-01-23 22:17:00,60,141,Alimento,3,201
33019,2024-01-23 22:18:00,47,19,Brinquedo,8,66
33020,2024-01-23 22:19:00,60,81,Móvel,2,141
33021,2024-01-23 22:20:00,77,66,Vestuário,9,143
33022,2024-01-23 22:21:00,63,89,Móvel,6,152
33023,2024-01-23 22:22:00,99,149,Eletrônico,7,248
33024,2024-01-23 22:23:00,75,79,Brinquedo,1,154
33025,2024-01-23 22:24:00,113,147,Vestuário,8,260
33026,2024-01-23 22:25:00,16,147,Alimento,7,163
33027,2024-01-23 22:26:00,37,132,Eletrônico,8,169
33028,2024-01-23 22:27:00,67,56,Alimento,4,123
33029,2024-01-23 22:28:00,103,16,Alimento,2,119
33030,2024-01-23 22:29:00,97,63,Brinquedo,1,160
33031,2024-01-23 22:30:00,94,55,Brinquedo,4,149
33032,2024-01-23 22:31:00,17,109,Alimento,1,126
33033,2024-01-23 22:32:00,67,129,Móvel,9,196
33034,2024-01-23 22:33:00,60,39,Móvel,1,99
33035,2024-01-23 22:34:00,96,47,Móvel,4,143
33036,2024-01-23 22:35:00,12,127,Alimento,9,139
33037,2024-01-23 22:36:00,58,118,Vestuário,2,176
33038,2024-01-23 22:37:00,47,85,Vestuário,9,132
33039,2024-01-23 22:38:00,63,69,Eletrônico,8,132
33040,2024-01-23 22:39:00,81,167,Eletrônico,4,248
33041,2024-01-23 22:40:00,48,54,Móvel,7,102
33042,2024-01-23 22:41:00,47,71,Eletrônico,4,118
33043,2024-01-23 22:42:00,25,146,Móvel,2,171
33044,2024-01-23 22:43:00,50,28,Brinquedo,3,78
33045,2024-01-23 22:44:00,108,42,Eletrônico,7,150
33046,2024-01-23 22:45:00,117,92,Vestuário,6,209
33047,2024-01-23 22:46:00,83,29,Móvel,9,112
33048,2024-01-23 22:47:00,115,152,Alimento,4,267
33049,2024-01-23 22:48:00,50,97,Vestuário,2,147
33050,2024-01-23 22:49:00,37,50,Móvel,6,87
33051,2024-01-23 22:50:00,86,66,Alimento,9,152
33052,2024-01-23 22:51:00,17,138,Alimento,1,155
33053,2024-01-23 22:52:00,77,169,Móvel,6,246
33054,2024-01-23 22:53:00,43,103,Vestuário,1,146
33055,2024-01-23 22:54:00,62,97,Móvel,1,159
33056,2024-01-23 22:55:00,58,23,Brinquedo,2,81
33057,2024-01-23 22:56:00,95,93,Alimento,9,188
33058,2024-01-23 22:57:00,21,58,Móvel,1,79
33059,2024-01-23 22:58:00,33,45,Móvel,7,78
33060,2024-01-23 22:59:00,19,43,Eletrônico,9,62
33061,2024-01-23 23:00:00,114,18,Alimento,4,132
33062,2024-01-23 23:01:00,25,134,Vestuário,5,159
33063,2024-01-23 23:02:00,65,88,Vestuário,7,153
33064,2024-01-23 23:03:00,17,143,Móvel,7,160
33065,2024-01-23 23:04:00,115,36,Vestuário,7,151
33066,2024-01-23 23:05:00,51,55,Eletrônico,3,106
33067,2024-01-23 23:06:00,39,169,Alimento,6,208
33068,2024-01-23 23:07:00,106,126,Eletrônico,6,232
33069,2024-01-23 23:08:00,73,108,Alimento,7,181
33070,2024-01-23 23:09:00,96,10,Móvel,8,106
33071,2024-01-23 23:10:00,76,78,Brinquedo,4,154
33072,2024-01-23 23:11:00,91,126,Alimento,8,217
33073,2024-01-23 23:12:00,68,53,Eletrônico,1,121
33074,2024-01-23 23:13:00,35,95,Eletrônico,2,130
33075,2024-01-23 23:14:00,46,134,Móvel,2,180
33076,2024-01-23 23:15:00,90,88,Vestuário,4,178
33077,2024-01-23 23:16:00,78,85,Móvel,8,163
33078,2024-01-23 23:17:00,20,82,Brinquedo,1,102
33079,2024-01-23 23:18:00,35,36,Vestuário,6,71
33080,2024-01-23 23:19:00,84,42,Vestuário,7,126
33081,2024-01-23 23:20:00,68,116,Móvel,7,184
33082,2024-01-23 23:21:00,111,151,Brinquedo,5,262
33083,2024-01-23 23:22:00,69,145,Alimento,4,214
33084,2024-01-23 23:23:00,61,90,Eletrônico,2,151
33085,2024-01-23 23:24:00,62,80,Brinquedo,4,142
33086,2024-01-23 23:25:00,118,68,Alimento,7,186
33087,2024-01-23 23:26:00,92,35,Alimento,1,127
33088,2024-01-23 23:27:00,25,57,Alimento,6,82
33089,2024-01-23 23:28:00,89,36,Brinquedo,7,125
33090,2024-01-23 23:29:00,100,134,Móvel,4,234
33091,2024-01-23 23:30:00,28,77,Móvel,4,105
33092,2024-01-23 23:31:00,69,87,Alimento,9,156
33093,2024-01-23 23:32:00,113,58,Vestuário,4,171
33094,2024-01-23 23:33:00,39,111,Eletrônico,5,150
33095,2024-01-23 23:34:00,108,64,Alimento,5,172
33096,2024-01-23 23:35:00,87,97,Alimento,1,184
33097,2024-01-23 23:36:00,20,57,Brinquedo,3,77
33098,2024-01-23 23:37:00,77,17,Vestuário,9,94
33099,2024-01-23 23:38:00,31,132,Vestuário,3,163
33100,2024-01-23 23:39:00,109,42,Móvel,9,151
33101,2024-01-23 23:40:00,100,95,Eletrônico,2,195
33102,2024-01-23 23:41:00,44,35,Vestuário,6,79
33103,2024-01-23 23:42:00,26,131,Alimento,2,157
33104,2024-01-23 23:43:00,26,26,Eletrônico,8,52
33105,2024-01-23 23:44:00,57,95,Eletrônico,1,152
33106,2024-01-23 23:45:00,73,44,Móvel,1,117
33107,2024-01-23 23:46:00,59,173,Alimento,3,232
33108,2024-01-23 23:47:00,21,131,Brinquedo,9,152
33109,2024-01-23 23:48:00,96,134,Brinquedo,2,230
33110,2024-01-23 23:49:00,45,68,Eletrônico,8,113
33111,2024-01-23 23:50:00,118,164,Eletrônico,2,282
33112,2024-01-23 23:51:00,19,117,Vestuário,1,136
33113,2024-01-23 23:52:00,96,66,Brinquedo,7,162
33114,2024-01-23 23:53:00,23,41,Eletrônico,2,64
33115,2024-01-23 23:54:00,75,178,Brinquedo,5,253
33116,2024-01-23 23:55:00,11,40,Eletrônico,1,51
33117,2024-01-23 23:56:00,93,142,Brinquedo,1,235
33118,2024-01-23 23:57:00,118,113,Vestuário,6,231
33119,2024-01-23 23:58:00,86,170,Brinquedo,7,256
33120,2024-01-23 23:59:00,107,68,Alimento,5,175
33121,2024-01-24 00:00:00,55,86,Vestuário,1,141
33122,2024-01-24 00:01:00,63,25,Móvel,8,88
33123,2024-01-24 00:02:00,72,174,Móvel,8,246
33124,2024-01-24 00:03:00,62,82,Alimento,8,144
33125,2024-01-24 00:04:00,52,129,Vestuário,6,181
33126,2024-01-24 00:05:00,46,144,Móvel,1,190
33127,2024-01-24 00:06:00,99,139,Alimento,9,238
33128,2024-01-24 00:07:00,36,104,Alimento,6,140
33129,2024-01-24 00:08:00,30,163,Brinquedo,9,193
33130,2024-01-24 00:09:00,10,99,Móvel,4,109
33131,2024-01-24 00:10:00,20,16,Vestuário,8,36
33132,2024-01-24 00:11:00,16,78,Móvel,6,94
33133,2024-01-24 00:12:00,39,68,Vestuário,9,107
33134,2024-01-24 00:13:00,20,21,Alimento,2,41
33135,2024-01-24 00:14:00,46,125,Brinquedo,8,171
33136,2024-01-24 00:15:00,28,146,Vestuário,3,174
33137,2024-01-24 00:16:00,100,39,Eletrônico,6,139
33138,2024-01-24 00:17:00,26,31,Alimento,3,57
33139,2024-01-24 00:18:00,80,74,Brinquedo,9,154
33140,2024-01-24 00:19:00,13,107,Alimento,5,120
33141,2024-01-24 00:20:00,98,63,Móvel,2,161
33142,2024-01-24 00:21:00,114,113,Móvel,6,227
33143,2024-01-24 00:22:00,70,82,Móvel,4,152
33144,2024-01-24 00:23:00,106,172,Alimento,1,278
33145,2024-01-24 00:24:00,103,31,Vestuário,8,134
33146,2024-01-24 00:25:00,59,138,Eletrônico,6,197
33147,2024-01-24 00:26:00,62,173,Eletrônico,4,235
33148,2024-01-24 00:27:00,73,36,Vestuário,6,109
33149,2024-01-24 00:28:00,13,52,Eletrônico,9,65
33150,2024-01-24 00:29:00,25,160,Móvel,4,185
33151,2024-01-24 00:30:00,85,62,Alimento,9,147
33152,2024-01-24 00:31:00,97,21,Alimento,5,118
33153,2024-01-24 00:32:00,28,96,Brinquedo,8,124
33154,2024-01-24 00:33:00,89,91,Brinquedo,9,180
33155,2024-01-24 00:34:00,80,132,Móvel,8,212
33156,2024-01-24 00:35:00,100,129,Alimento,2,229
33157,2024-01-24 00:36:00,103,43,Alimento,6,146
33158,2024-01-24 00:37:00,92,160,Eletrônico,6,252
33159,2024-01-24 00:38:00,15,72,Móvel,7,87
33160,2024-01-24 00:39:00,77,120,Alimento,7,197
33161,2024-01-24 00:40:00,21,78,Alimento,2,99
33162,2024-01-24 00:41:00,93,39,Móvel,6,132
33163,2024-01-24 00:42:00,20,29,Alimento,5,49
33164,2024-01-24 00:43:00,73,47,Vestuário,8,120
33165,2024-01-24 00:44:00,91,145,Alimento,6,236
33166,2024-01-24 00:45:00,116,85,Móvel,9,201
33167,2024-01-24 00:46:00,13,166,Alimento,8,179
33168,2024-01-24 00:47:00,63,11,Vestuário,1,74
33169,2024-01-24 00:48:00,17,55,Brinquedo,3,72
33170,2024-01-24 00:49:00,37,149,Brinquedo,8,186
33171,2024-01-24 00:50:00,97,127,Vestuário,9,224
33172,2024-01-24 00:51:00,82,16,Brinquedo,8,98
33173,2024-01-24 00:52:00,12,173,Brinquedo,7,185
33174,2024-01-24 00:53:00,79,166,Brinquedo,2,245
33175,2024-01-24 00:54:00,47,19,Eletrônico,9,66
33176,2024-01-24 00:55:00,94,63,Brinquedo,4,157
33177,2024-01-24 00:56:00,113,110,Móvel,8,223
33178,2024-01-24 00:57:00,15,24,Vestuário,3,39
33179,2024-01-24 00:58:00,115,151,Alimento,2,266
33180,2024-01-24 00:59:00,62,141,Brinquedo,1,203
33181,2024-01-24 01:00:00,100,172,Brinquedo,4,272
33182,2024-01-24 01:01:00,102,155,Vestuário,1,257
33183,2024-01-24 01:02:00,111,164,Brinquedo,6,275
33184,2024-01-24 01:03:00,49,144,Vestuário,7,193
33185,2024-01-24 01:04:00,54,97,Móvel,8,151
33186,2024-01-24 01:05:00,105,81,Alimento,2,186
33187,2024-01-24 01:06:00,79,160,Móvel,4,239
33188,2024-01-24 01:07:00,70,20,Eletrônico,5,90
33189,2024-01-24 01:08:00,29,46,Brinquedo,9,75
33190,2024-01-24 01:09:00,62,125,Alimento,8,187
33191,2024-01-24 01:10:00,54,128,Brinquedo,3,182
33192,2024-01-24 01:11:00,94,121,Eletrônico,2,215
33193,2024-01-24 01:12:00,79,132,Brinquedo,1,211
33194,2024-01-24 01:13:00,27,117,Brinquedo,8,144
33195,2024-01-24 01:14:00,39,109,Alimento,7,148
33196,2024-01-24 01:15:00,20,64,Brinquedo,1,84
33197,2024-01-24 01:16:00,64,88,Vestuário,4,152
33198,2024-01-24 01:17:00,100,117,Móvel,9,217
33199,2024-01-24 01:18:00,103,175,Alimento,9,278
33200,2024-01-24 01:19:00,14,82,Brinquedo,9,96
33201,2024-01-24 01:20:00,91,49,Brinquedo,6,140
33202,2024-01-24 01:21:00,114,162,Alimento,5,276
33203,2024-01-24 01:22:00,19,16,Eletrônico,7,35
33204,2024-01-24 01:23:00,14,102,Eletrônico,1,116
33205,2024-01-24 01:24:00,105,178,Vestuário,4,283
33206,2024-01-24 01:25:00,46,11,Brinquedo,9,57
33207,2024-01-24 01:26:00,115,80,Vestuário,3,195
33208,2024-01-24 01:27:00,100,152,Móvel,9,252
33209,2024-01-24 01:28:00,14,121,Alimento,1,135
33210,2024-01-24 01:29:00,61,16,Móvel,6,77
33211,2024-01-24 01:30:00,59,57,Eletrônico,8,116
33212,2024-01-24 01:31:00,29,35,Móvel,5,64
33213,2024-01-24 01:32:00,104,27,Eletrônico,7,131
33214,2024-01-24 01:33:00,80,28,Vestuário,9,108
33215,2024-01-24 01:34:00,25,173,Brinquedo,2,198
33216,2024-01-24 01:35:00,86,176,Vestuário,9,262
33217,2024-01-24 01:36:00,110,17,Alimento,5,127
33218,2024-01-24 01:37:00,67,166,Móvel,7,233
33219,2024-01-24 01:38:00,71,46,Vestuário,9,117
33220,2024-01-24 01:39:00,81,88,Brinquedo,7,169
33221,2024-01-24 01:40:00,66,78,Alimento,5,144
33222,2024-01-24 01:41:00,104,97,Brinquedo,3,201
33223,2024-01-24 01:42:00,78,177,Brinquedo,8,255
33224,2024-01-24 01:43:00,77,166,Eletrônico,1,243
33225,2024-01-24 01:44:00,86,106,Alimento,6,192
33226,2024-01-24 01:45:00,29,68,Alimento,1,97
33227,2024-01-24 01:46:00,108,88,Móvel,6,196
33228,2024-01-24 01:47:00,39,112,Vestuário,4,151
33229,2024-01-24 01:48:00,94,146,Vestuário,8,240
33230,2024-01-24 01:49:00,59,66,Brinquedo,8,125
33231,2024-01-24 01:50:00,71,82,Brinquedo,9,153
33232,2024-01-24 01:51:00,53,78,Eletrônico,1,131
33233,2024-01-24 01:52:00,82,162,Eletrônico,3,244
33234,2024-01-24 01:53:00,93,45,Vestuário,6,138
33235,2024-01-24 01:54:00,92,95,Móvel,7,187
33236,2024-01-24 01:55:00,19,135,Alimento,5,154
33237,2024-01-24 01:56:00,69,70,Vestuário,6,139
33238,2024-01-24 01:57:00,104,64,Eletrônico,2,168
33239,2024-01-24 01:58:00,55,15,Eletrônico,5,70
33240,2024-01-24 01:59:00,96,30,Eletrônico,2,126
33241,2024-01-24 02:00:00,60,63,Móvel,1,123
33242,2024-01-24 02:01:00,32,73,Alimento,1,105
33243,2024-01-24 02:02:00,38,172,Alimento,9,210
33244,2024-01-24 02:03:00,90,172,Alimento,4,262
33245,2024-01-24 02:04:00,37,11,Vestuário,7,48
33246,2024-01-24 02:05:00,62,46,Móvel,4,108
33247,2024-01-24 02:06:00,46,63,Brinquedo,9,109
33248,2024-01-24 02:07:00,75,115,Vestuário,9,190
33249,2024-01-24 02:08:00,10,163,Móvel,6,173
33250,2024-01-24 02:09:00,111,166,Eletrônico,9,277
33251,2024-01-24 02:10:00,22,59,Móvel,7,81
33252,2024-01-24 02:11:00,113,71,Brinquedo,1,184
33253,2024-01-24 02:12:00,92,10,Brinquedo,4,102
33254,2024-01-24 02:13:00,78,53,Eletrônico,1,131
33255,2024-01-24 02:14:00,68,174,Brinquedo,8,242
33256,2024-01-24 02:15:00,13,113,Alimento,7,126
33257,2024-01-24 02:16:00,24,48,Móvel,4,72
33258,2024-01-24 02:17:00,72,145,Eletrônico,7,217
33259,2024-01-24 02:18:00,10,25,Alimento,9,35
33260,2024-01-24 02:19:00,10,67,Vestuário,2,77
33261,2024-01-24 02:20:00,101,75,Eletrônico,8,176
33262,2024-01-24 02:21:00,112,35,Vestuário,2,147
33263,2024-01-24 02:22:00,117,177,Brinquedo,9,294
33264,2024-01-24 02:23:00,61,21,Vestuário,1,82
33265,2024-01-24 02:24:00,96,106,Eletrônico,2,202
33266,2024-01-24 02:25:00,106,124,Brinquedo,7,230
33267,2024-01-24 02:26:00,67,161,Eletrônico,6,228
33268,2024-01-24 02:27:00,31,14,Eletrônico,2,45
33269,2024-01-24 02:28:00,109,145,Alimento,4,254
33270,2024-01-24 02:29:00,15,100,Brinquedo,3,115
33271,2024-01-24 02:30:00,109,93,Móvel,6,202
33272,2024-01-24 02:31:00,39,81,Brinquedo,1,120
33273,2024-01-24 02:32:00,45,137,Brinquedo,4,182
33274,2024-01-24 02:33:00,50,94,Vestuário,8,144
33275,2024-01-24 02:34:00,93,13,Vestuário,7,106
33276,2024-01-24 02:35:00,58,112,Brinquedo,9,170
33277,2024-01-24 02:36:00,93,164,Eletrônico,9,257
33278,2024-01-24 02:37:00,56,115,Brinquedo,5,171
33279,2024-01-24 02:38:00,26,81,Alimento,3,107
33280,2024-01-24 02:39:00,28,154,Brinquedo,5,182
33281,2024-01-24 02:40:00,68,171,Vestuário,7,239
33282,2024-01-24 02:41:00,91,40,Eletrônico,8,131
33283,2024-01-24 02:42:00,22,79,Brinquedo,7,101
33284,2024-01-24 02:43:00,64,30,Vestuário,1,94
33285,2024-01-24 02:44:00,38,53,Brinquedo,9,91
33286,2024-01-24 02:45:00,64,132,Móvel,2,196
33287,2024-01-24 02:46:00,49,107,Alimento,8,156
33288,2024-01-24 02:47:00,56,44,Vestuário,1,100
33289,2024-01-24 02:48:00,43,133,Eletrônico,2,176
33290,2024-01-24 02:49:00,42,108,Móvel,2,150
33291,2024-01-24 02:50:00,56,48,Brinquedo,2,104
33292,2024-01-24 02:51:00,95,94,Vestuário,5,189
33293,2024-01-24 02:52:00,98,77,Móvel,5,175
33294,2024-01-24 02:53:00,56,123,Brinquedo,2,179
33295,2024-01-24 02:54:00,92,61,Brinquedo,2,153
33296,2024-01-24 02:55:00,117,38,Vestuário,8,155
33297,2024-01-24 02:56:00,116,80,Alimento,3,196
33298,2024-01-24 02:57:00,29,120,Vestuário,6,149
33299,2024-01-24 02:58:00,47,137,Vestuário,5,184
33300,2024-01-24 02:59:00,70,75,Vestuário,9,145
33301,2024-01-24 03:00:00,16,102,Alimento,2,118
33302,2024-01-24 03:01:00,24,89,Brinquedo,6,113
33303,2024-01-24 03:02:00,88,49,Alimento,7,137
33304,2024-01-24 03:03:00,24,135,Vestuário,2,159
33305,2024-01-24 03:04:00,50,103,Brinquedo,8,153
33306,2024-01-24 03:05:00,28,126,Móvel,7,154
33307,2024-01-24 03:06:00,117,42,Vestuário,5,159
33308,2024-01-24 03:07:00,117,121,Eletrônico,3,238
33309,2024-01-24 03:08:00,86,150,Eletrônico,1,236
33310,2024-01-24 03:09:00,65,27,Móvel,8,92
33311,2024-01-24 03:10:00,87,98,Alimento,1,185
33312,2024-01-24 03:11:00,19,15,Brinquedo,2,34
33313,2024-01-24 03:12:00,77,44,Alimento,9,121
33314,2024-01-24 03:13:00,41,30,Eletrônico,5,71
33315,2024-01-24 03:14:00,29,118,Móvel,7,147
33316,2024-01-24 03:15:00,118,103,Eletrônico,1,221
33317,2024-01-24 03:16:00,50,121,Móvel,3,171
33318,2024-01-24 03:17:00,63,36,Vestuário,8,99
33319,2024-01-24 03:18:00,35,174,Eletrônico,4,209
33320,2024-01-24 03:19:00,87,131,Vestuário,9,218
33321,2024-01-24 03:20:00,102,54,Móvel,9,156
33322,2024-01-24 03:21:00,10,72,Eletrônico,2,82
33323,2024-01-24 03:22:00,64,25,Brinquedo,6,89
33324,2024-01-24 03:23:00,103,70,Eletrônico,2,173
33325,2024-01-24 03:24:00,102,62,Brinquedo,6,164
33326,2024-01-24 03:25:00,50,11,Alimento,2,61
33327,2024-01-24 03:26:00,71,62,Alimento,3,133
33328,2024-01-24 03:27:00,81,161,Alimento,7,242
33329,2024-01-24 03:28:00,108,19,Brinquedo,7,127
33330,2024-01-24 03:29:00,106,175,Móvel,8,281
33331,2024-01-24 03:30:00,106,36,Vestuário,7,142
33332,2024-01-24 03:31:00,65,155,Móvel,8,220
33333,2024-01-24 03:32:00,81,57,Vestuário,4,138
33334,2024-01-24 03:33:00,91,138,Móvel,4,229
33335,2024-01-24 03:34:00,51,127,Vestuário,1,178
33336,2024-01-24 03:35:00,60,100,Alimento,5,160
33337,2024-01-24 03:36:00,96,38,Móvel,3,134
33338,2024-01-24 03:37:00,50,61,Eletrônico,8,111
33339,2024-01-24 03:38:00,78,134,Móvel,7,212
33340,2024-01-24 03:39:00,51,135,Brinquedo,9,186
33341,2024-01-24 03:40:00,68,61,Vestuário,8,129
33342,2024-01-24 03:41:00,103,58,Brinquedo,9,161
33343,2024-01-24 03:42:00,63,147,Móvel,2,210
33344,2024-01-24 03:43:00,46,67,Brinquedo,1,113
33345,2024-01-24 03:44:00,91,65,Alimento,4,156
33346,2024-01-24 03:45:00,69,170,Brinquedo,3,239
33347,2024-01-24 03:46:00,50,74,Alimento,3,124
33348,2024-01-24 03:47:00,116,50,Brinquedo,2,166
33349,2024-01-24 03:48:00,22,115,Alimento,2,137
33350,2024-01-24 03:49:00,28,86,Móvel,1,114
33351,2024-01-24 03:50:00,97,31,Vestuário,3,128
33352,2024-01-24 03:51:00,65,160,Brinquedo,4,225
33353,2024-01-24 03:52:00,56,146,Eletrônico,5,202
33354,2024-01-24 03:53:00,71,119,Móvel,9,190
33355,2024-01-24 03:54:00,41,80,Brinquedo,5,121
33356,2024-01-24 03:55:00,111,37,Alimento,3,148
33357,2024-01-24 03:56:00,61,52,Brinquedo,4,113
33358,2024-01-24 03:57:00,95,104,Eletrônico,6,199
33359,2024-01-24 03:58:00,109,21,Vestuário,5,130
33360,2024-01-24 03:59:00,65,169,Móvel,3,234
33361,2024-01-24 04:00:00,90,74,Brinquedo,7,164
33362,2024-01-24 04:01:00,84,96,Alimento,5,180
33363,2024-01-24 04:02:00,76,69,Alimento,4,145
33364,2024-01-24 04:03:00,119,45,Eletrônico,4,164
33365,2024-01-24 04:04:00,14,127,Alimento,6,141
33366,2024-01-24 04:05:00,69,125,Brinquedo,5,194
33367,2024-01-24 04:06:00,34,39,Alimento,1,73
33368,2024-01-24 04:07:00,52,115,Vestuário,3,167
33369,2024-01-24 04:08:00,89,118,Vestuário,9,207
33370,2024-01-24 04:09:00,71,82,Eletrônico,7,153
33371,2024-01-24 04:10:00,61,161,Alimento,5,222
33372,2024-01-24 04:11:00,64,90,Brinquedo,3,154
33373,2024-01-24 04:12:00,41,132,Vestuário,9,173
33374,2024-01-24 04:13:00,76,102,Brinquedo,9,178
33375,2024-01-24 04:14:00,11,32,Móvel,6,43
33376,2024-01-24 04:15:00,94,167,Eletrônico,3,261
33377,2024-01-24 04:16:00,108,36,Brinquedo,2,144
33378,2024-01-24 04:17:00,98,133,Brinquedo,8,231
33379,2024-01-24 04:18:00,91,75,Vestuário,4,166
33380,2024-01-24 04:19:00,22,88,Brinquedo,8,110
33381,2024-01-24 04:20:00,22,22,Vestuário,8,44
33382,2024-01-24 04:21:00,68,94,Vestuário,3,162
33383,2024-01-24 04:22:00,113,42,Brinquedo,4,155
33384,2024-01-24 04:23:00,45,126,Alimento,5,171
33385,2024-01-24 04:24:00,14,128,Móvel,4,142
33386,2024-01-24 04:25:00,69,71,Alimento,5,140
33387,2024-01-24 04:26:00,115,150,Brinquedo,1,265
33388,2024-01-24 04:27:00,117,147,Eletrônico,7,264
33389,2024-01-24 04:28:00,11,88,Alimento,3,99
33390,2024-01-24 04:29:00,20,45,Eletrônico,9,65
33391,2024-01-24 04:30:00,104,67,Eletrônico,6,171
33392,2024-01-24 04:31:00,89,149,Alimento,5,238
33393,2024-01-24 04:32:00,115,139,Alimento,7,254
33394,2024-01-24 04:33:00,64,155,Vestuário,2,219
33395,2024-01-24 04:34:00,16,100,Vestuário,8,116
33396,2024-01-24 04:35:00,40,124,Eletrônico,8,164
33397,2024-01-24 04:36:00,56,11,Móvel,6,67
33398,2024-01-24 04:37:00,18,85,Vestuário,3,103
33399,2024-01-24 04:38:00,101,174,Brinquedo,5,275
33400,2024-01-24 04:39:00,39,108,Brinquedo,8,147
33401,2024-01-24 04:40:00,107,177,Alimento,7,284
33402,2024-01-24 04:41:00,91,61,Alimento,3,152
33403,2024-01-24 04:42:00,57,164,Brinquedo,5,221
33404,2024-01-24 04:43:00,116,69,Alimento,8,185
33405,2024-01-24 04:44:00,106,130,Brinquedo,4,236
33406,2024-01-24 04:45:00,101,33,Alimento,5,134
33407,2024-01-24 04:46:00,112,90,Eletrônico,1,202
33408,2024-01-24 04:47:00,50,106,Brinquedo,4,156
33409,2024-01-24 04:48:00,103,52,Alimento,9,155
33410,2024-01-24 04:49:00,109,147,Eletrônico,3,256
33411,2024-01-24 04:50:00,44,119,Móvel,9,163
33412,2024-01-24 04:51:00,37,147,Eletrônico,5,184
33413,2024-01-24 04:52:00,116,111,Eletrônico,7,227
33414,2024-01-24 04:53:00,33,24,Brinquedo,2,57
33415,2024-01-24 04:54:00,70,98,Alimento,7,168
33416,2024-01-24 04:55:00,95,36,Alimento,4,131
33417,2024-01-24 04:56:00,101,98,Móvel,2,199
33418,2024-01-24 04:57:00,66,28,Alimento,7,94
33419,2024-01-24 04:58:00,72,44,Eletrônico,8,116
33420,2024-01-24 04:59:00,70,103,Vestuário,3,173
33421,2024-01-24 05:00:00,91,113,Vestuário,7,204
33422,2024-01-24 05:01:00,98,178,Vestuário,7,276
33423,2024-01-24 05:02:00,110,133,Alimento,2,243
33424,2024-01-24 05:03:00,62,50,Eletrônico,8,112
33425,2024-01-24 05:04:00,62,152,Brinquedo,8,214
33426,2024-01-24 05:05:00,107,15,Alimento,8,122
33427,2024-01-24 05:06:00,49,24,Alimento,7,73
33428,2024-01-24 05:07:00,20,43,Brinquedo,7,63
33429,2024-01-24 05:08:00,64,73,Eletrônico,3,137
33430,2024-01-24 05:09:00,27,155,Alimento,1,182
33431,2024-01-24 05:10:00,87,68,Alimento,4,155
33432,2024-01-24 05:11:00,82,16,Alimento,6,98
33433,2024-01-24 05:12:00,91,132,Móvel,2,223
33434,2024-01-24 05:13:00,18,32,Brinquedo,7,50
33435,2024-01-24 05:14:00,12,121,Alimento,6,133
33436,2024-01-24 05:15:00,109,130,Eletrônico,2,239
33437,2024-01-24 05:16:00,105,146,Vestuário,2,251
33438,2024-01-24 05:17:00,55,161,Móvel,5,216
33439,2024-01-24 05:18:00,69,86,Alimento,4,155
33440,2024-01-24 05:19:00,74,167,Móvel,1,241
33441,2024-01-24 05:20:00,116,102,Móvel,5,218
33442,2024-01-24 05:21:00,89,153,Brinquedo,2,242
33443,2024-01-24 05:22:00,73,25,Eletrônico,8,98
33444,2024-01-24 05:23:00,35,64,Alimento,9,99
33445,2024-01-24 05:24:00,91,66,Brinquedo,3,157
33446,2024-01-24 05:25:00,100,25,Móvel,6,125
33447,2024-01-24 05:26:00,97,145,Brinquedo,9,242
33448,2024-01-24 05:27:00,94,87,Vestuário,3,181
33449,2024-01-24 05:28:00,53,89,Vestuário,6,142
33450,2024-01-24 05:29:00,78,152,Eletrônico,3,230
33451,2024-01-24 05:30:00,41,119,Brinquedo,9,160
33452,2024-01-24 05:31:00,63,155,Vestuário,4,218
33453,2024-01-24 05:32:00,13,51,Eletrônico,1,64
33454,2024-01-24 05:33:00,104,157,Brinquedo,2,261
33455,2024-01-24 05:34:00,100,110,Vestuário,2,210
33456,2024-01-24 05:35:00,49,37,Brinquedo,5,86
33457,2024-01-24 05:36:00,80,143,Eletrônico,5,223
33458,2024-01-24 05:37:00,16,163,Brinquedo,5,179
33459,2024-01-24 05:38:00,25,129,Brinquedo,1,154
33460,2024-01-24 05:39:00,66,45,Móvel,2,111
33461,2024-01-24 05:40:00,80,165,Brinquedo,6,245
33462,2024-01-24 05:41:00,67,158,Vestuário,9,225
33463,2024-01-24 05:42:00,12,173,Brinquedo,7,185
33464,2024-01-24 05:43:00,20,108,Brinquedo,3,128
33465,2024-01-24 05:44:00,82,41,Móvel,2,123
33466,2024-01-24 05:45:00,89,30,Eletrônico,7,119
33467,2024-01-24 05:46:00,43,61,Alimento,2,104
33468,2024-01-24 05:47:00,88,141,Eletrônico,2,229
33469,2024-01-24 05:48:00,45,163,Eletrônico,6,208
33470,2024-01-24 05:49:00,72,141,Brinquedo,9,213
33471,2024-01-24 05:50:00,25,173,Brinquedo,7,198
33472,2024-01-24 05:51:00,94,145,Vestuário,1,239
33473,2024-01-24 05:52:00,28,117,Alimento,4,145
33474,2024-01-24 05:53:00,11,68,Alimento,4,79
33475,2024-01-24 05:54:00,69,148,Eletrônico,1,217
33476,2024-01-24 05:55:00,70,86,Brinquedo,7,156
33477,2024-01-24 05:56:00,54,23,Vestuário,7,77
33478,2024-01-24 05:57:00,33,88,Móvel,2,121
33479,2024-01-24 05:58:00,30,68,Eletrônico,6,98
33480,2024-01-24 05:59:00,59,47,Vestuário,7,106
33481,2024-01-24 06:00:00,11,31,Eletrônico,9,42
33482,2024-01-24 06:01:00,16,73,Eletrônico,8,89
33483,2024-01-24 06:02:00,29,50,Alimento,6,79
33484,2024-01-24 06:03:00,74,60,Alimento,9,134
33485,2024-01-24 06:04:00,74,80,Vestuário,6,154
33486,2024-01-24 06:05:00,69,167,Alimento,5,236
33487,2024-01-24 06:06:00,89,68,Móvel,5,157
33488,2024-01-24 06:07:00,62,75,Vestuário,3,137
33489,2024-01-24 06:08:00,92,157,Eletrônico,3,249
33490,2024-01-24 06:09:00,109,157,Móvel,4,266
33491,2024-01-24 06:10:00,83,161,Eletrônico,3,244
33492,2024-01-24 06:11:00,40,77,Eletrônico,1,117
33493,2024-01-24 06:12:00,101,137,Alimento,7,238
33494,2024-01-24 06:13:00,93,86,Alimento,1,179
33495,2024-01-24 06:14:00,21,110,Vestuário,8,131
33496,2024-01-24 06:15:00,67,19,Vestuário,6,86
33497,2024-01-24 06:16:00,58,159,Vestuário,1,217
33498,2024-01-24 06:17:00,57,99,Vestuário,1,156
33499,2024-01-24 06:18:00,116,176,Vestuário,5,292
33500,2024-01-24 06:19:00,106,103,Alimento,3,209
33501,2024-01-24 06:20:00,29,73,Brinquedo,7,102
33502,2024-01-24 06:21:00,18,142,Eletrônico,8,160
33503,2024-01-24 06:22:00,15,111,Vestuário,4,126
33504,2024-01-24 06:23:00,62,105,Eletrônico,7,167
33505,2024-01-24 06:24:00,54,89,Eletrônico,4,143
33506,2024-01-24 06:25:00,87,16,Eletrônico,6,103
33507,2024-01-24 06:26:00,91,51,Alimento,4,142
33508,2024-01-24 06:27:00,46,143,Móvel,8,189
33509,2024-01-24 06:28:00,96,70,Vestuário,5,166
33510,2024-01-24 06:29:00,26,79,Móvel,2,105
33511,2024-01-24 06:30:00,15,132,Móvel,9,147
33512,2024-01-24 06:31:00,62,33,Alimento,7,95
33513,2024-01-24 06:32:00,14,27,Alimento,2,41
33514,2024-01-24 06:33:00,29,100,Brinquedo,3,129
33515,2024-01-24 06:34:00,16,165,Alimento,1,181
33516,2024-01-24 06:35:00,29,77,Móvel,3,106
33517,2024-01-24 06:36:00,106,88,Alimento,3,194
33518,2024-01-24 06:37:00,20,67,Vestuário,6,87
33519,2024-01-24 06:38:00,104,118,Alimento,8,222
33520,2024-01-24 06:39:00,31,41,Vestuário,2,72
33521,2024-01-24 06:40:00,64,38,Eletrônico,1,102
33522,2024-01-24 06:41:00,114,11,Vestuário,6,125
33523,2024-01-24 06:42:00,56,85,Brinquedo,3,141
33524,2024-01-24 06:43:00,66,81,Eletrônico,5,147
33525,2024-01-24 06:44:00,83,68,Eletrônico,2,151
33526,2024-01-24 06:45:00,114,165,Alimento,4,279
33527,2024-01-24 06:46:00,36,165,Móvel,2,201
33528,2024-01-24 06:47:00,15,125,Eletrônico,2,140
33529,2024-01-24 06:48:00,110,147,Móvel,7,257
33530,2024-01-24 06:49:00,72,130,Brinquedo,8,202
33531,2024-01-24 06:50:00,11,159,Móvel,2,170
33532,2024-01-24 06:51:00,54,106,Alimento,3,160
33533,2024-01-24 06:52:00,52,37,Móvel,6,89
33534,2024-01-24 06:53:00,41,163,Brinquedo,5,204
33535,2024-01-24 06:54:00,17,86,Vestuário,7,103
33536,2024-01-24 06:55:00,95,147,Alimento,4,242
33537,2024-01-24 06:56:00,77,32,Eletrônico,8,109
33538,2024-01-24 06:57:00,16,25,Alimento,8,41
33539,2024-01-24 06:58:00,42,155,Alimento,7,197
33540,2024-01-24 06:59:00,16,139,Móvel,7,155
33541,2024-01-24 07:00:00,70,154,Alimento,5,224
33542,2024-01-24 07:01:00,119,149,Brinquedo,5,268
33543,2024-01-24 07:02:00,45,147,Alimento,3,192
33544,2024-01-24 07:03:00,29,104,Eletrônico,6,133
33545,2024-01-24 07:04:00,99,26,Eletrônico,9,125
33546,2024-01-24 07:05:00,35,145,Alimento,8,180
33547,2024-01-24 07:06:00,83,72,Alimento,1,155
33548,2024-01-24 07:07:00,67,154,Alimento,8,221
33549,2024-01-24 07:08:00,38,111,Vestuário,9,149
33550,2024-01-24 07:09:00,45,115,Eletrônico,8,160
33551,2024-01-24 07:10:00,54,122,Vestuário,5,176
33552,2024-01-24 07:11:00,28,20,Eletrônico,4,48
33553,2024-01-24 07:12:00,35,98,Vestuário,8,133
33554,2024-01-24 07:13:00,114,107,Eletrônico,1,221
33555,2024-01-24 07:14:00,53,139,Brinquedo,5,192
33556,2024-01-24 07:15:00,75,125,Móvel,2,200
33557,2024-01-24 07:16:00,63,87,Móvel,2,150
33558,2024-01-24 07:17:00,35,43,Alimento,4,78
33559,2024-01-24 07:18:00,80,104,Móvel,2,184
33560,2024-01-24 07:19:00,89,82,Brinquedo,2,171
33561,2024-01-24 07:20:00,119,120,Eletrônico,4,239
33562,2024-01-24 07:21:00,58,57,Brinquedo,9,115
33563,2024-01-24 07:22:00,41,66,Alimento,6,107
33564,2024-01-24 07:23:00,28,144,Brinquedo,3,172
33565,2024-01-24 07:24:00,85,23,Brinquedo,6,108
33566,2024-01-24 07:25:00,53,60,Móvel,5,113
33567,2024-01-24 07:26:00,12,64,Alimento,1,76
33568,2024-01-24 07:27:00,44,46,Vestuário,1,90
33569,2024-01-24 07:28:00,20,24,Brinquedo,6,44
33570,2024-01-24 07:29:00,46,114,Brinquedo,6,160
33571,2024-01-24 07:30:00,72,48,Móvel,9,120
33572,2024-01-24 07:31:00,51,118,Alimento,9,169
33573,2024-01-24 07:32:00,22,122,Eletrônico,9,144
33574,2024-01-24 07:33:00,106,101,Móvel,8,207
33575,2024-01-24 07:34:00,15,125,Eletrônico,9,140
33576,2024-01-24 07:35:00,12,95,Móvel,9,107
33577,2024-01-24 07:36:00,57,78,Eletrônico,6,135
33578,2024-01-24 07:37:00,92,106,Alimento,4,198
33579,2024-01-24 07:38:00,20,98,Brinquedo,5,118
33580,2024-01-24 07:39:00,115,39,Eletrônico,7,154
33581,2024-01-24 07:40:00,23,127,Alimento,6,150
33582,2024-01-24 07:41:00,116,81,Vestuário,4,197
33583,2024-01-24 07:42:00,83,156,Eletrônico,6,239
33584,2024-01-24 07:43:00,76,115,Brinquedo,4,191
33585,2024-01-24 07:44:00,94,17,Alimento,6,111
33586,2024-01-24 07:45:00,99,20,Vestuário,8,119
33587,2024-01-24 07:46:00,100,60,Móvel,1,160
33588,2024-01-24 07:47:00,76,149,Alimento,5,225
33589,2024-01-24 07:48:00,24,84,Alimento,5,108
33590,2024-01-24 07:49:00,70,167,Eletrônico,1,237
33591,2024-01-24 07:50:00,102,72,Brinquedo,7,174
33592,2024-01-24 07:51:00,16,56,Eletrônico,2,72
33593,2024-01-24 07:52:00,96,85,Brinquedo,7,181
33594,2024-01-24 07:53:00,23,55,Móvel,5,78
33595,2024-01-24 07:54:00,110,78,Vestuário,6,188
33596,2024-01-24 07:55:00,112,166,Alimento,7,278
33597,2024-01-24 07:56:00,22,77,Vestuário,9,99
33598,2024-01-24 07:57:00,119,53,Alimento,6,172
33599,2024-01-24 07:58:00,56,15,Vestuário,7,71
33600,2024-01-24 07:59:00,39,111,Alimento,9,150
33601,2024-01-24 08:00:00,63,54,Móvel,4,117
33602,2024-01-24 08:01:00,39,13,Móvel,3,52
33603,2024-01-24 08:02:00,39,55,Brinquedo,2,94
33604,2024-01-24 08:03:00,72,146,Eletrônico,6,218
33605,2024-01-24 08:04:00,68,156,Eletrônico,8,224
33606,2024-01-24 08:05:00,39,103,Vestuário,3,142
33607,2024-01-24 08:06:00,39,44,Eletrônico,4,83
33608,2024-01-24 08:07:00,12,126,Vestuário,6,138
33609,2024-01-24 08:08:00,107,88,Móvel,7,195
33610,2024-01-24 08:09:00,38,20,Alimento,4,58
33611,2024-01-24 08:10:00,72,63,Alimento,7,135
33612,2024-01-24 08:11:00,107,86,Brinquedo,7,193
33613,2024-01-24 08:12:00,65,136,Eletrônico,2,201
33614,2024-01-24 08:13:00,28,40,Eletrônico,4,68
33615,2024-01-24 08:14:00,86,67,Eletrônico,9,153
33616,2024-01-24 08:15:00,41,56,Eletrônico,4,97
33617,2024-01-24 08:16:00,43,45,Eletrônico,2,88
33618,2024-01-24 08:17:00,16,137,Alimento,9,153
33619,2024-01-24 08:18:00,17,87,Eletrônico,8,104
33620,2024-01-24 08:19:00,84,133,Alimento,2,217
33621,2024-01-24 08:20:00,26,91,Vestuário,5,117
33622,2024-01-24 08:21:00,54,79,Alimento,8,133
33623,2024-01-24 08:22:00,82,173,Vestuário,2,255
33624,2024-01-24 08:23:00,60,102,Móvel,2,162
33625,2024-01-24 08:24:00,99,58,Móvel,9,157
33626,2024-01-24 08:25:00,67,168,Alimento,1,235
33627,2024-01-24 08:26:00,111,16,Móvel,9,127
33628,2024-01-24 08:27:00,55,71,Brinquedo,5,126
33629,2024-01-24 08:28:00,26,89,Móvel,3,115
33630,2024-01-24 08:29:00,11,88,Eletrônico,6,99
33631,2024-01-24 08:30:00,43,22,Vestuário,2,65
33632,2024-01-24 08:31:00,68,70,Alimento,5,138
33633,2024-01-24 08:32:00,70,79,Brinquedo,8,149
33634,2024-01-24 08:33:00,82,37,Alimento,6,119
33635,2024-01-24 08:34:00,21,166,Alimento,5,187
33636,2024-01-24 08:35:00,41,153,Eletrônico,3,194
33637,2024-01-24 08:36:00,79,89,Eletrônico,8,168
33638,2024-01-24 08:37:00,49,123,Eletrônico,1,172
33639,2024-01-24 08:38:00,42,32,Alimento,9,74
33640,2024-01-24 08:39:00,62,176,Alimento,6,238
33641,2024-01-24 08:40:00,60,94,Brinquedo,5,154
33642,2024-01-24 08:41:00,27,77,Móvel,7,104
33643,2024-01-24 08:42:00,52,124,Brinquedo,2,176
33644,2024-01-24 08:43:00,66,28,Alimento,2,94
33645,2024-01-24 08:44:00,54,177,Vestuário,4,231
33646,2024-01-24 08:45:00,65,130,Vestuário,8,195
33647,2024-01-24 08:46:00,36,136,Brinquedo,9,172
33648,2024-01-24 08:47:00,96,100,Móvel,4,196
33649,2024-01-24 08:48:00,78,97,Eletrônico,8,175
33650,2024-01-24 08:49:00,119,132,Alimento,4,251
33651,2024-01-24 08:50:00,96,41,Móvel,6,137
33652,2024-01-24 08:51:00,47,20,Brinquedo,9,67
33653,2024-01-24 08:52:00,117,174,Vestuário,9,291
33654,2024-01-24 08:53:00,77,89,Móvel,3,166
33655,2024-01-24 08:54:00,33,96,Vestuário,4,129
33656,2024-01-24 08:55:00,31,163,Eletrônico,8,194
33657,2024-01-24 08:56:00,48,109,Brinquedo,8,157
33658,2024-01-24 08:57:00,81,79,Móvel,4,160
33659,2024-01-24 08:58:00,61,34,Móvel,2,95
33660,2024-01-24 08:59:00,35,118,Alimento,2,153
33661,2024-01-24 09:00:00,95,69,Eletrônico,5,164
33662,2024-01-24 09:01:00,114,38,Brinquedo,5,152
33663,2024-01-24 09:02:00,98,160,Vestuário,9,258
33664,2024-01-24 09:03:00,13,106,Móvel,7,119
33665,2024-01-24 09:04:00,102,44,Móvel,6,146
33666,2024-01-24 09:05:00,39,137,Vestuário,8,176
33667,2024-01-24 09:06:00,37,100,Vestuário,1,137
33668,2024-01-24 09:07:00,72,177,Móvel,8,249
33669,2024-01-24 09:08:00,35,120,Brinquedo,9,155
33670,2024-01-24 09:09:00,53,27,Móvel,1,80
33671,2024-01-24 09:10:00,41,105,Alimento,2,146
33672,2024-01-24 09:11:00,19,173,Alimento,4,192
33673,2024-01-24 09:12:00,29,175,Vestuário,6,204
33674,2024-01-24 09:13:00,88,50,Alimento,4,138
33675,2024-01-24 09:14:00,66,118,Vestuário,4,184
33676,2024-01-24 09:15:00,101,126,Vestuário,3,227
33677,2024-01-24 09:16:00,76,64,Móvel,6,140
33678,2024-01-24 09:17:00,49,58,Eletrônico,4,107
33679,2024-01-24 09:18:00,35,133,Móvel,4,168
33680,2024-01-24 09:19:00,71,43,Brinquedo,6,114
33681,2024-01-24 09:20:00,73,156,Vestuário,3,229
33682,2024-01-24 09:21:00,88,161,Móvel,8,249
33683,2024-01-24 09:22:00,66,123,Alimento,7,189
33684,2024-01-24 09:23:00,43,39,Móvel,5,82
33685,2024-01-24 09:24:00,115,45,Móvel,2,160
33686,2024-01-24 09:25:00,34,116,Brinquedo,7,150
33687,2024-01-24 09:26:00,117,95,Alimento,2,212
33688,2024-01-24 09:27:00,72,163,Móvel,6,235
33689,2024-01-24 09:28:00,98,107,Brinquedo,1,205
33690,2024-01-24 09:29:00,10,84,Brinquedo,6,94
33691,2024-01-24 09:30:00,84,121,Eletrônico,8,205
33692,2024-01-24 09:31:00,109,87,Móvel,9,196
33693,2024-01-24 09:32:00,46,41,Brinquedo,2,87
33694,2024-01-24 09:33:00,46,14,Eletrônico,6,60
33695,2024-01-24 09:34:00,89,36,Brinquedo,5,125
33696,2024-01-24 09:35:00,76,149,Alimento,5,225
33697,2024-01-24 09:36:00,89,10,Alimento,5,99
33698,2024-01-24 09:37:00,32,113,Eletrônico,7,145
33699,2024-01-24 09:38:00,12,148,Móvel,2,160
33700,2024-01-24 09:39:00,34,72,Brinquedo,2,106
33701,2024-01-24 09:40:00,30,127,Alimento,1,157
33702,2024-01-24 09:41:00,34,33,Vestuário,2,67
33703,2024-01-24 09:42:00,66,99,Brinquedo,9,165
33704,2024-01-24 09:43:00,24,56,Vestuário,1,80
33705,2024-01-24 09:44:00,58,32,Alimento,8,90
33706,2024-01-24 09:45:00,27,154,Vestuário,2,181
33707,2024-01-24 09:46:00,95,66,Móvel,1,161
33708,2024-01-24 09:47:00,67,163,Alimento,7,230
33709,2024-01-24 09:48:00,48,89,Brinquedo,9,137
33710,2024-01-24 09:49:00,54,92,Brinquedo,9,146
33711,2024-01-24 09:50:00,64,112,Brinquedo,7,176
33712,2024-01-24 09:51:00,108,137,Brinquedo,1,245
33713,2024-01-24 09:52:00,40,84,Eletrônico,2,124
33714,2024-01-24 09:53:00,110,18,Eletrônico,3,128
33715,2024-01-24 09:54:00,74,96,Vestuário,9,170
33716,2024-01-24 09:55:00,60,115,Brinquedo,8,175
33717,2024-01-24 09:56:00,49,23,Eletrônico,4,72
33718,2024-01-24 09:57:00,82,137,Móvel,3,219
33719,2024-01-24 09:58:00,55,158,Vestuário,3,213
33720,2024-01-24 09:59:00,54,151,Alimento,8,205
33721,2024-01-24 10:00:00,35,169,Vestuário,9,204
33722,2024-01-24 10:01:00,26,176,Alimento,9,202
33723,2024-01-24 10:02:00,97,146,Brinquedo,9,243
33724,2024-01-24 10:03:00,75,11,Vestuário,7,86
33725,2024-01-24 10:04:00,32,92,Alimento,1,124
33726,2024-01-24 10:05:00,42,109,Vestuário,5,151
33727,2024-01-24 10:06:00,43,55,Alimento,9,98
33728,2024-01-24 10:07:00,103,79,Vestuário,1,182
33729,2024-01-24 10:08:00,85,56,Móvel,2,141
33730,2024-01-24 10:09:00,37,83,Móvel,9,120
33731,2024-01-24 10:10:00,49,18,Eletrônico,8,67
33732,2024-01-24 10:11:00,104,148,Brinquedo,5,252
33733,2024-01-24 10:12:00,115,40,Vestuário,5,155
33734,2024-01-24 10:13:00,26,68,Móvel,3,94
33735,2024-01-24 10:14:00,83,50,Brinquedo,3,133
33736,2024-01-24 10:15:00,105,145,Brinquedo,2,250
33737,2024-01-24 10:16:00,65,30,Alimento,3,95
33738,2024-01-24 10:17:00,20,130,Alimento,4,150
33739,2024-01-24 10:18:00,32,87,Brinquedo,7,119
33740,2024-01-24 10:19:00,19,36,Móvel,1,55
33741,2024-01-24 10:20:00,112,29,Móvel,6,141
33742,2024-01-24 10:21:00,82,30,Eletrônico,4,112
33743,2024-01-24 10:22:00,94,172,Alimento,2,266
33744,2024-01-24 10:23:00,36,21,Alimento,8,57
33745,2024-01-24 10:24:00,23,123,Alimento,2,146
33746,2024-01-24 10:25:00,91,71,Móvel,3,162
33747,2024-01-24 10:26:00,96,114,Alimento,5,210
33748,2024-01-24 10:27:00,98,41,Brinquedo,2,139
33749,2024-01-24 10:28:00,29,21,Brinquedo,5,50
33750,2024-01-24 10:29:00,11,163,Eletrônico,3,174
33751,2024-01-24 10:30:00,32,55,Alimento,6,87
33752,2024-01-24 10:31:00,103,46,Móvel,1,149
33753,2024-01-24 10:32:00,31,159,Brinquedo,8,190
33754,2024-01-24 10:33:00,38,80,Vestuário,3,118
33755,2024-01-24 10:34:00,36,88,Vestuário,5,124
33756,2024-01-24 10:35:00,98,165,Móvel,1,263
33757,2024-01-24 10:36:00,110,102,Vestuário,6,212
33758,2024-01-24 10:37:00,24,94,Brinquedo,6,118
33759,2024-01-24 10:38:00,116,72,Eletrônico,6,188
33760,2024-01-24 10:39:00,28,102,Eletrônico,6,130
33761,2024-01-24 10:40:00,21,19,Vestuário,3,40
33762,2024-01-24 10:41:00,118,105,Móvel,9,223
33763,2024-01-24 10:42:00,108,166,Móvel,4,274
33764,2024-01-24 10:43:00,110,42,Vestuário,9,152
33765,2024-01-24 10:44:00,17,13,Móvel,8,30
33766,2024-01-24 10:45:00,109,98,Eletrônico,4,207
33767,2024-01-24 10:46:00,111,49,Brinquedo,3,160
33768,2024-01-24 10:47:00,50,65,Alimento,7,115
33769,2024-01-24 10:48:00,113,145,Brinquedo,4,258
33770,2024-01-24 10:49:00,15,53,Alimento,7,68
33771,2024-01-24 10:50:00,60,177,Móvel,9,237
33772,2024-01-24 10:51:00,117,115,Alimento,5,232
33773,2024-01-24 10:52:00,44,110,Móvel,9,154
33774,2024-01-24 10:53:00,41,164,Alimento,6,205
33775,2024-01-24 10:54:00,35,54,Vestuário,1,89
33776,2024-01-24 10:55:00,51,12,Alimento,9,63
33777,2024-01-24 10:56:00,96,60,Alimento,5,156
33778,2024-01-24 10:57:00,53,89,Brinquedo,5,142
33779,2024-01-24 10:58:00,110,90,Eletrônico,1,200
33780,2024-01-24 10:59:00,93,33,Móvel,3,126
33781,2024-01-24 11:00:00,57,75,Vestuário,4,132
33782,2024-01-24 11:01:00,32,169,Alimento,7,201
33783,2024-01-24 11:02:00,26,127,Brinquedo,9,153
33784,2024-01-24 11:03:00,83,103,Vestuário,2,186
33785,2024-01-24 11:04:00,60,150,Móvel,3,210
33786,2024-01-24 11:05:00,10,167,Móvel,6,177
33787,2024-01-24 11:06:00,49,31,Brinquedo,5,80
33788,2024-01-24 11:07:00,50,107,Vestuário,1,157
33789,2024-01-24 11:08:00,54,114,Vestuário,3,168
33790,2024-01-24 11:09:00,67,32,Eletrônico,8,99
33791,2024-01-24 11:10:00,42,97,Eletrônico,1,139
33792,2024-01-24 11:11:00,63,143,Alimento,6,206
33793,2024-01-24 11:12:00,21,46,Brinquedo,6,67
33794,2024-01-24 11:13:00,69,112,Móvel,2,181
33795,2024-01-24 11:14:00,29,129,Vestuário,5,158
33796,2024-01-24 11:15:00,82,24,Brinquedo,8,106
33797,2024-01-24 11:16:00,81,92,Alimento,1,173
33798,2024-01-24 11:17:00,60,152,Vestuário,1,212
33799,2024-01-24 11:18:00,99,42,Móvel,7,141
33800,2024-01-24 11:19:00,13,14,Vestuário,8,27
33801,2024-01-24 11:20:00,92,60,Móvel,1,152
33802,2024-01-24 11:21:00,95,61,Móvel,1,156
33803,2024-01-24 11:22:00,114,60,Brinquedo,3,174
33804,2024-01-24 11:23:00,23,134,Brinquedo,7,157
33805,2024-01-24 11:24:00,79,22,Alimento,8,101
33806,2024-01-24 11:25:00,47,135,Eletrônico,5,182
33807,2024-01-24 11:26:00,102,75,Móvel,2,177
33808,2024-01-24 11:27:00,93,145,Vestuário,1,238
33809,2024-01-24 11:28:00,82,14,Alimento,3,96
33810,2024-01-24 11:29:00,26,139,Eletrônico,6,165
33811,2024-01-24 11:30:00,112,117,Eletrônico,7,229
33812,2024-01-24 11:31:00,59,30,Vestuário,4,89
33813,2024-01-24 11:32:00,97,58,Eletrônico,6,155
33814,2024-01-24 11:33:00,43,64,Vestuário,4,107
33815,2024-01-24 11:34:00,70,35,Móvel,7,105
33816,2024-01-24 11:35:00,84,32,Brinquedo,3,116
33817,2024-01-24 11:36:00,62,15,Vestuário,9,77
33818,2024-01-24 11:37:00,25,166,Móvel,9,191
33819,2024-01-24 11:38:00,113,137,Brinquedo,2,250
33820,2024-01-24 11:39:00,64,93,Móvel,8,157
33821,2024-01-24 11:40:00,13,91,Eletrônico,3,104
33822,2024-01-24 11:41:00,85,179,Eletrônico,6,264
33823,2024-01-24 11:42:00,61,27,Eletrônico,6,88
33824,2024-01-24 11:43:00,59,61,Móvel,3,120
33825,2024-01-24 11:44:00,43,116,Eletrônico,5,159
33826,2024-01-24 11:45:00,50,160,Vestuário,1,210
33827,2024-01-24 11:46:00,54,28,Alimento,4,82
33828,2024-01-24 11:47:00,92,36,Vestuário,6,128
33829,2024-01-24 11:48:00,81,87,Vestuário,9,168
33830,2024-01-24 11:49:00,18,11,Móvel,3,29
33831,2024-01-24 11:50:00,61,142,Brinquedo,7,203
33832,2024-01-24 11:51:00,112,38,Móvel,4,150
33833,2024-01-24 11:52:00,30,84,Brinquedo,2,114
33834,2024-01-24 11:53:00,95,26,Móvel,9,121
33835,2024-01-24 11:54:00,93,78,Vestuário,2,171
33836,2024-01-24 11:55:00,50,142,Vestuário,3,192
33837,2024-01-24 11:56:00,51,137,Vestuário,7,188
33838,2024-01-24 11:57:00,58,89,Alimento,2,147
33839,2024-01-24 11:58:00,63,85,Brinquedo,6,148
33840,2024-01-24 11:59:00,10,65,Brinquedo,5,75
33841,2024-01-24 12:00:00,77,134,Brinquedo,8,211
33842,2024-01-24 12:01:00,100,63,Alimento,6,163
33843,2024-01-24 12:02:00,78,10,Alimento,4,88
33844,2024-01-24 12:03:00,84,97,Alimento,1,181
33845,2024-01-24 12:04:00,42,21,Brinquedo,3,63
33846,2024-01-24 12:05:00,56,30,Vestuário,4,86
33847,2024-01-24 12:06:00,86,47,Alimento,4,133
33848,2024-01-24 12:07:00,35,175,Alimento,3,210
33849,2024-01-24 12:08:00,88,31,Móvel,8,119
33850,2024-01-24 12:09:00,63,135,Eletrônico,5,198
33851,2024-01-24 12:10:00,91,52,Móvel,4,143
33852,2024-01-24 12:11:00,40,67,Eletrônico,6,107
33853,2024-01-24 12:12:00,16,84,Brinquedo,2,100
33854,2024-01-24 12:13:00,119,165,Brinquedo,1,284
33855,2024-01-24 12:14:00,17,88,Vestuário,7,105
33856,2024-01-24 12:15:00,61,105,Vestuário,1,166
33857,2024-01-24 12:16:00,67,177,Brinquedo,6,244
33858,2024-01-24 12:17:00,106,123,Brinquedo,4,229
33859,2024-01-24 12:18:00,74,37,Móvel,2,111
33860,2024-01-24 12:19:00,94,40,Alimento,9,134
33861,2024-01-24 12:20:00,33,78,Móvel,4,111
33862,2024-01-24 12:21:00,35,82,Brinquedo,2,117
33863,2024-01-24 12:22:00,37,167,Alimento,1,204
33864,2024-01-24 12:23:00,68,54,Alimento,1,122
33865,2024-01-24 12:24:00,13,176,Móvel,9,189
33866,2024-01-24 12:25:00,10,154,Eletrônico,6,164
33867,2024-01-24 12:26:00,52,35,Móvel,9,87
33868,2024-01-24 12:27:00,64,146,Vestuário,4,210
33869,2024-01-24 12:28:00,25,48,Brinquedo,5,73
33870,2024-01-24 12:29:00,78,169,Móvel,6,247
33871,2024-01-24 12:30:00,40,42,Móvel,3,82
33872,2024-01-24 12:31:00,50,152,Vestuário,4,202
33873,2024-01-24 12:32:00,42,100,Vestuário,9,142
33874,2024-01-24 12:33:00,20,149,Brinquedo,1,169
33875,2024-01-24 12:34:00,50,110,Brinquedo,6,160
33876,2024-01-24 12:35:00,68,117,Eletrônico,7,185
33877,2024-01-24 12:36:00,105,34,Eletrônico,7,139
33878,2024-01-24 12:37:00,97,35,Eletrônico,1,132
33879,2024-01-24 12:38:00,56,130,Eletrônico,8,186
33880,2024-01-24 12:39:00,17,115,Móvel,8,132
33881,2024-01-24 12:40:00,57,142,Móvel,8,199
33882,2024-01-24 12:41:00,29,165,Brinquedo,3,194
33883,2024-01-24 12:42:00,61,131,Brinquedo,7,192
33884,2024-01-24 12:43:00,75,79,Móvel,5,154
33885,2024-01-24 12:44:00,29,126,Alimento,4,155
33886,2024-01-24 12:45:00,53,117,Brinquedo,3,170
33887,2024-01-24 12:46:00,68,155,Alimento,7,223
33888,2024-01-24 12:47:00,86,112,Eletrônico,6,198
33889,2024-01-24 12:48:00,106,28,Brinquedo,6,134
33890,2024-01-24 12:49:00,16,166,Brinquedo,6,182
33891,2024-01-24 12:50:00,104,37,Alimento,8,141
33892,2024-01-24 12:51:00,44,55,Brinquedo,7,99
33893,2024-01-24 12:52:00,80,56,Vestuário,7,136
33894,2024-01-24 12:53:00,83,15,Móvel,8,98
33895,2024-01-24 12:54:00,111,131,Eletrônico,4,242
33896,2024-01-24 12:55:00,37,142,Vestuário,7,179
33897,2024-01-24 12:56:00,26,142,Vestuário,8,168
33898,2024-01-24 12:57:00,79,43,Móvel,9,122
33899,2024-01-24 12:58:00,18,92,Alimento,4,110
33900,2024-01-24 12:59:00,109,11,Vestuário,2,120
33901,2024-01-24 13:00:00,58,145,Móvel,1,203
33902,2024-01-24 13:01:00,89,34,Alimento,4,123
33903,2024-01-24 13:02:00,91,57,Brinquedo,4,148
33904,2024-01-24 13:03:00,10,157,Vestuário,8,167
33905,2024-01-24 13:04:00,57,165,Alimento,7,222
33906,2024-01-24 13:05:00,99,18,Eletrônico,7,117
33907,2024-01-24 13:06:00,34,162,Móvel,5,196
33908,2024-01-24 13:07:00,10,83,Móvel,5,93
33909,2024-01-24 13:08:00,19,131,Móvel,4,150
33910,2024-01-24 13:09:00,61,160,Alimento,6,221
33911,2024-01-24 13:10:00,28,35,Móvel,8,63
33912,2024-01-24 13:11:00,119,54,Vestuário,7,173
33913,2024-01-24 13:12:00,36,120,Vestuário,4,156
33914,2024-01-24 13:13:00,44,115,Móvel,4,159
33915,2024-01-24 13:14:00,68,88,Móvel,2,156
33916,2024-01-24 13:15:00,85,143,Eletrônico,8,228
33917,2024-01-24 13:16:00,77,145,Eletrônico,3,222
33918,2024-01-24 13:17:00,16,70,Móvel,3,86
33919,2024-01-24 13:18:00,77,70,Eletrônico,1,147
33920,2024-01-24 13:19:00,14,141,Vestuário,7,155
33921,2024-01-24 13:20:00,59,95,Vestuário,9,154
33922,2024-01-24 13:21:00,56,17,Alimento,3,73
33923,2024-01-24 13:22:00,14,92,Eletrônico,4,106
33924,2024-01-24 13:23:00,82,157,Eletrônico,9,239
33925,2024-01-24 13:24:00,110,138,Vestuário,2,248
33926,2024-01-24 13:25:00,51,63,Brinquedo,3,114
33927,2024-01-24 13:26:00,79,142,Vestuário,8,221
33928,2024-01-24 13:27:00,52,102,Brinquedo,1,154
33929,2024-01-24 13:28:00,51,13,Vestuário,1,64
33930,2024-01-24 13:29:00,13,118,Vestuário,1,131
33931,2024-01-24 13:30:00,77,64,Eletrônico,2,141
33932,2024-01-24 13:31:00,57,120,Eletrônico,6,177
33933,2024-01-24 13:32:00,85,77,Alimento,3,162
33934,2024-01-24 13:33:00,76,10,Vestuário,2,86
33935,2024-01-24 13:34:00,63,48,Brinquedo,9,111
33936,2024-01-24 13:35:00,25,17,Vestuário,3,42
33937,2024-01-24 13:36:00,33,48,Alimento,2,81
33938,2024-01-24 13:37:00,30,26,Eletrônico,1,56
33939,2024-01-24 13:38:00,95,165,Alimento,3,260
33940,2024-01-24 13:39:00,69,104,Móvel,6,173
33941,2024-01-24 13:40:00,105,19,Móvel,5,124
33942,2024-01-24 13:41:00,29,88,Vestuário,4,117
33943,2024-01-24 13:42:00,55,38,Eletrônico,1,93
33944,2024-01-24 13:43:00,41,156,Alimento,5,197
33945,2024-01-24 13:44:00,113,28,Brinquedo,6,141
33946,2024-01-24 13:45:00,21,41,Vestuário,8,62
33947,2024-01-24 13:46:00,37,62,Eletrônico,1,99
33948,2024-01-24 13:47:00,15,65,Vestuário,1,80
33949,2024-01-24 13:48:00,76,77,Vestuário,5,153
33950,2024-01-24 13:49:00,92,31,Móvel,2,123
33951,2024-01-24 13:50:00,51,148,Alimento,5,199
33952,2024-01-24 13:51:00,81,35,Brinquedo,6,116
33953,2024-01-24 13:52:00,21,106,Eletrônico,7,127
33954,2024-01-24 13:53:00,45,90,Eletrônico,4,135
33955,2024-01-24 13:54:00,117,77,Eletrônico,3,194
33956,2024-01-24 13:55:00,74,30,Vestuário,1,104
33957,2024-01-24 13:56:00,78,110,Móvel,7,188
33958,2024-01-24 13:57:00,28,64,Brinquedo,8,92
33959,2024-01-24 13:58:00,33,76,Brinquedo,9,109
33960,2024-01-24 13:59:00,66,145,Móvel,6,211
33961,2024-01-24 14:00:00,118,150,Eletrônico,4,268
33962,2024-01-24 14:01:00,109,58,Alimento,3,167
33963,2024-01-24 14:02:00,117,37,Brinquedo,9,154
33964,2024-01-24 14:03:00,42,36,Móvel,3,78
33965,2024-01-24 14:04:00,13,27,Vestuário,6,40
33966,2024-01-24 14:05:00,48,168,Brinquedo,3,216
33967,2024-01-24 14:06:00,101,133,Vestuário,5,234
33968,2024-01-24 14:07:00,78,175,Brinquedo,2,253
33969,2024-01-24 14:08:00,117,25,Brinquedo,8,142
33970,2024-01-24 14:09:00,42,125,Eletrônico,3,167
33971,2024-01-24 14:10:00,86,135,Brinquedo,2,221
33972,2024-01-24 14:11:00,19,45,Brinquedo,2,64
33973,2024-01-24 14:12:00,113,67,Eletrônico,1,180
33974,2024-01-24 14:13:00,61,111,Móvel,5,172
33975,2024-01-24 14:14:00,16,30,Brinquedo,3,46
33976,2024-01-24 14:15:00,21,108,Vestuário,7,129
33977,2024-01-24 14:16:00,23,91,Alimento,3,114
33978,2024-01-24 14:17:00,113,96,Brinquedo,3,209
33979,2024-01-24 14:18:00,57,117,Eletrônico,4,174
33980,2024-01-24 14:19:00,78,90,Alimento,4,168
33981,2024-01-24 14:20:00,80,30,Eletrônico,5,110
33982,2024-01-24 14:21:00,55,154,Brinquedo,6,209
33983,2024-01-24 14:22:00,43,96,Vestuário,1,139
33984,2024-01-24 14:23:00,89,131,Brinquedo,5,220
33985,2024-01-24 14:24:00,64,160,Eletrônico,7,224
33986,2024-01-24 14:25:00,58,176,Brinquedo,2,234
33987,2024-01-24 14:26:00,14,20,Alimento,8,34
33988,2024-01-24 14:27:00,15,161,Móvel,2,176
33989,2024-01-24 14:28:00,37,13,Brinquedo,3,50
33990,2024-01-24 14:29:00,75,165,Alimento,2,240
33991,2024-01-24 14:30:00,79,67,Alimento,6,146
33992,2024-01-24 14:31:00,69,61,Vestuário,4,130
33993,2024-01-24 14:32:00,91,145,Alimento,9,236
33994,2024-01-24 14:33:00,23,47,Eletrônico,8,70
33995,2024-01-24 14:34:00,47,130,Alimento,6,177
33996,2024-01-24 14:35:00,18,33,Eletrônico,7,51
33997,2024-01-24 14:36:00,21,70,Alimento,4,91
33998,2024-01-24 14:37:00,83,132,Brinquedo,7,215
33999,2024-01-24 14:38:00,56,114,Eletrônico,4,170
34000,2024-01-24 14:39:00,52,56,Alimento,4,108
34001,2024-01-24 14:40:00,13,76,Eletrônico,1,89
34002,2024-01-24 14:41:00,21,27,Alimento,9,48
34003,2024-01-24 14:42:00,98,65,Móvel,3,163
34004,2024-01-24 14:43:00,72,104,Brinquedo,6,176
34005,2024-01-24 14:44:00,69,153,Vestuário,1,222
34006,2024-01-24 14:45:00,20,42,Vestuário,3,62
34007,2024-01-24 14:46:00,18,47,Eletrônico,4,65
34008,2024-01-24 14:47:00,18,147,Brinquedo,2,165
34009,2024-01-24 14:48:00,43,100,Móvel,9,143
34010,2024-01-24 14:49:00,86,125,Móvel,7,211
34011,2024-01-24 14:50:00,70,63,Móvel,9,133
34012,2024-01-24 14:51:00,39,112,Móvel,7,151
34013,2024-01-24 14:52:00,38,100,Brinquedo,2,138
34014,2024-01-24 14:53:00,42,86,Móvel,9,128
34015,2024-01-24 14:54:00,21,134,Eletrônico,2,155
34016,2024-01-24 14:55:00,100,141,Vestuário,7,241
34017,2024-01-24 14:56:00,73,87,Móvel,2,160
34018,2024-01-24 14:57:00,33,80,Brinquedo,2,113
34019,2024-01-24 14:58:00,34,24,Vestuário,1,58
34020,2024-01-24 14:59:00,94,81,Eletrônico,2,175
34021,2024-01-24 15:00:00,113,34,Eletrônico,5,147
34022,2024-01-24 15:01:00,116,106,Vestuário,4,222
34023,2024-01-24 15:02:00,81,155,Móvel,3,236
34024,2024-01-24 15:03:00,104,44,Alimento,7,148
34025,2024-01-24 15:04:00,41,47,Móvel,6,88
34026,2024-01-24 15:05:00,101,117,Móvel,6,218
34027,2024-01-24 15:06:00,63,112,Alimento,4,175
34028,2024-01-24 15:07:00,107,104,Eletrônico,9,211
34029,2024-01-24 15:08:00,94,72,Vestuário,9,166
34030,2024-01-24 15:09:00,55,162,Brinquedo,1,217
34031,2024-01-24 15:10:00,113,157,Vestuário,8,270
34032,2024-01-24 15:11:00,99,149,Móvel,9,248
34033,2024-01-24 15:12:00,115,30,Vestuário,4,145
34034,2024-01-24 15:13:00,92,69,Móvel,9,161
34035,2024-01-24 15:14:00,45,95,Eletrônico,6,140
34036,2024-01-24 15:15:00,43,96,Móvel,2,139
34037,2024-01-24 15:16:00,12,56,Móvel,3,68
34038,2024-01-24 15:17:00,118,104,Vestuário,1,222
34039,2024-01-24 15:18:00,69,46,Alimento,6,115
34040,2024-01-24 15:19:00,52,122,Móvel,1,174
34041,2024-01-24 15:20:00,81,178,Vestuário,1,259
34042,2024-01-24 15:21:00,89,116,Alimento,5,205
34043,2024-01-24 15:22:00,13,53,Brinquedo,8,66
34044,2024-01-24 15:23:00,42,178,Móvel,1,220
34045,2024-01-24 15:24:00,45,117,Eletrônico,9,162
34046,2024-01-24 15:25:00,92,158,Eletrônico,2,250
34047,2024-01-24 15:26:00,117,138,Móvel,9,255
34048,2024-01-24 15:27:00,111,72,Móvel,7,183
34049,2024-01-24 15:28:00,44,179,Brinquedo,5,223
34050,2024-01-24 15:29:00,39,86,Eletrônico,5,125
34051,2024-01-24 15:30:00,15,49,Alimento,2,64
34052,2024-01-24 15:31:00,100,55,Móvel,1,155
34053,2024-01-24 15:32:00,115,160,Alimento,8,275
34054,2024-01-24 15:33:00,65,17,Móvel,9,82
34055,2024-01-24 15:34:00,61,177,Eletrônico,2,238
34056,2024-01-24 15:35:00,117,72,Alimento,1,189
34057,2024-01-24 15:36:00,73,139,Alimento,6,212
34058,2024-01-24 15:37:00,100,51,Alimento,3,151
34059,2024-01-24 15:38:00,96,176,Alimento,9,272
34060,2024-01-24 15:39:00,82,30,Brinquedo,6,112
34061,2024-01-24 15:40:00,37,24,Móvel,5,61
34062,2024-01-24 15:41:00,23,121,Brinquedo,9,144
34063,2024-01-24 15:42:00,14,83,Vestuário,7,97
34064,2024-01-24 15:43:00,95,43,Eletrônico,3,138
34065,2024-01-24 15:44:00,33,86,Eletrônico,7,119
34066,2024-01-24 15:45:00,102,177,Eletrônico,7,279
34067,2024-01-24 15:46:00,14,92,Eletrônico,1,106
34068,2024-01-24 15:47:00,79,46,Brinquedo,5,125
34069,2024-01-24 15:48:00,77,46,Eletrônico,6,123
34070,2024-01-24 15:49:00,40,120,Vestuário,8,160
34071,2024-01-24 15:50:00,83,170,Móvel,4,253
34072,2024-01-24 15:51:00,37,159,Brinquedo,6,196
34073,2024-01-24 15:52:00,82,98,Alimento,8,180
34074,2024-01-24 15:53:00,104,28,Móvel,4,132
34075,2024-01-24 15:54:00,51,70,Vestuário,9,121
34076,2024-01-24 15:55:00,35,117,Alimento,4,152
34077,2024-01-24 15:56:00,73,118,Móvel,3,191
34078,2024-01-24 15:57:00,19,153,Eletrônico,6,172
34079,2024-01-24 15:58:00,58,84,Brinquedo,1,142
34080,2024-01-24 15:59:00,34,88,Eletrônico,7,122
34081,2024-01-24 16:00:00,113,33,Eletrônico,8,146
34082,2024-01-24 16:01:00,97,156,Eletrônico,7,253
34083,2024-01-24 16:02:00,43,90,Vestuário,2,133
34084,2024-01-24 16:03:00,93,172,Móvel,8,265
34085,2024-01-24 16:04:00,40,44,Alimento,4,84
34086,2024-01-24 16:05:00,10,105,Brinquedo,8,115
34087,2024-01-24 16:06:00,103,71,Brinquedo,5,174
34088,2024-01-24 16:07:00,87,75,Alimento,3,162
34089,2024-01-24 16:08:00,12,23,Eletrônico,4,35
34090,2024-01-24 16:09:00,80,66,Eletrônico,4,146
34091,2024-01-24 16:10:00,71,135,Brinquedo,1,206
34092,2024-01-24 16:11:00,72,74,Vestuário,1,146
34093,2024-01-24 16:12:00,63,105,Eletrônico,3,168
34094,2024-01-24 16:13:00,15,153,Eletrônico,9,168
34095,2024-01-24 16:14:00,85,32,Móvel,5,117
34096,2024-01-24 16:15:00,87,140,Móvel,3,227
34097,2024-01-24 16:16:00,92,167,Brinquedo,3,259
34098,2024-01-24 16:17:00,109,109,Alimento,7,218
34099,2024-01-24 16:18:00,11,148,Alimento,7,159
34100,2024-01-24 16:19:00,39,135,Alimento,5,174
34101,2024-01-24 16:20:00,22,133,Eletrônico,4,155
34102,2024-01-24 16:21:00,69,112,Eletrônico,2,181
34103,2024-01-24 16:22:00,90,17,Móvel,5,107
34104,2024-01-24 16:23:00,53,31,Brinquedo,9,84
34105,2024-01-24 16:24:00,105,58,Alimento,5,163
34106,2024-01-24 16:25:00,85,19,Vestuário,9,104
34107,2024-01-24 16:26:00,119,88,Brinquedo,2,207
34108,2024-01-24 16:27:00,23,104,Vestuário,6,127
34109,2024-01-24 16:28:00,62,139,Móvel,4,201
34110,2024-01-24 16:29:00,21,135,Brinquedo,2,156
34111,2024-01-24 16:30:00,33,49,Vestuário,5,82
34112,2024-01-24 16:31:00,84,46,Vestuário,5,130
34113,2024-01-24 16:32:00,42,147,Brinquedo,5,189
34114,2024-01-24 16:33:00,91,72,Vestuário,6,163
34115,2024-01-24 16:34:00,31,127,Brinquedo,5,158
34116,2024-01-24 16:35:00,22,174,Vestuário,1,196
34117,2024-01-24 16:36:00,45,171,Móvel,4,216
34118,2024-01-24 16:37:00,72,70,Brinquedo,5,142
34119,2024-01-24 16:38:00,89,127,Móvel,7,216
34120,2024-01-24 16:39:00,20,148,Alimento,6,168
34121,2024-01-24 16:40:00,109,130,Móvel,3,239
34122,2024-01-24 16:41:00,85,173,Brinquedo,5,258
34123,2024-01-24 16:42:00,25,69,Vestuário,2,94
34124,2024-01-24 16:43:00,30,30,Brinquedo,2,60
34125,2024-01-24 16:44:00,10,55,Alimento,7,65
34126,2024-01-24 16:45:00,17,120,Vestuário,4,137
34127,2024-01-24 16:46:00,89,99,Vestuário,1,188
34128,2024-01-24 16:47:00,51,154,Vestuário,4,205
34129,2024-01-24 16:48:00,82,89,Alimento,4,171
34130,2024-01-24 16:49:00,99,153,Vestuário,4,252
34131,2024-01-24 16:50:00,119,34,Móvel,7,153
34132,2024-01-24 16:51:00,91,178,Móvel,5,269
34133,2024-01-24 16:52:00,113,104,Brinquedo,2,217
34134,2024-01-24 16:53:00,13,10,Vestuário,7,23
34135,2024-01-24 16:54:00,87,39,Alimento,4,126
34136,2024-01-24 16:55:00,61,13,Alimento,7,74
34137,2024-01-24 16:56:00,68,101,Alimento,2,169
34138,2024-01-24 16:57:00,29,160,Móvel,6,189
34139,2024-01-24 16:58:00,24,16,Vestuário,5,40
34140,2024-01-24 16:59:00,107,101,Brinquedo,4,208
34141,2024-01-24 17:00:00,111,45,Brinquedo,2,156
34142,2024-01-24 17:01:00,12,61,Alimento,8,73
34143,2024-01-24 17:02:00,15,35,Alimento,2,50
34144,2024-01-24 17:03:00,37,28,Brinquedo,2,65
34145,2024-01-24 17:04:00,109,32,Vestuário,3,141
34146,2024-01-24 17:05:00,103,96,Eletrônico,1,199
34147,2024-01-24 17:06:00,27,42,Móvel,2,69
34148,2024-01-24 17:07:00,85,139,Alimento,5,224
34149,2024-01-24 17:08:00,97,149,Móvel,9,246
34150,2024-01-24 17:09:00,63,145,Eletrônico,6,208
34151,2024-01-24 17:10:00,118,38,Móvel,3,156
34152,2024-01-24 17:11:00,67,154,Móvel,7,221
34153,2024-01-24 17:12:00,34,108,Brinquedo,6,142
34154,2024-01-24 17:13:00,78,63,Vestuário,6,141
34155,2024-01-24 17:14:00,36,36,Vestuário,2,72
34156,2024-01-24 17:15:00,118,36,Alimento,3,154
34157,2024-01-24 17:16:00,63,146,Eletrônico,8,209
34158,2024-01-24 17:17:00,111,47,Móvel,2,158
34159,2024-01-24 17:18:00,27,118,Móvel,3,145
34160,2024-01-24 17:19:00,90,82,Vestuário,8,172
34161,2024-01-24 17:20:00,83,56,Alimento,4,139
34162,2024-01-24 17:21:00,110,78,Vestuário,9,188
34163,2024-01-24 17:22:00,86,14,Alimento,7,100
34164,2024-01-24 17:23:00,18,143,Brinquedo,3,161
34165,2024-01-24 17:24:00,91,33,Móvel,8,124
34166,2024-01-24 17:25:00,86,67,Brinquedo,3,153
34167,2024-01-24 17:26:00,25,109,Eletrônico,6,134
34168,2024-01-24 17:27:00,44,96,Móvel,3,140
34169,2024-01-24 17:28:00,39,170,Alimento,2,209
34170,2024-01-24 17:29:00,47,91,Vestuário,2,138
34171,2024-01-24 17:30:00,13,69,Brinquedo,6,82
34172,2024-01-24 17:31:00,92,12,Brinquedo,9,104
34173,2024-01-24 17:32:00,12,11,Brinquedo,8,23
34174,2024-01-24 17:33:00,75,147,Alimento,8,222
34175,2024-01-24 17:34:00,88,20,Alimento,9,108
34176,2024-01-24 17:35:00,63,91,Móvel,9,154
34177,2024-01-24 17:36:00,55,100,Brinquedo,3,155
34178,2024-01-24 17:37:00,32,171,Alimento,4,203
34179,2024-01-24 17:38:00,39,132,Móvel,7,171
34180,2024-01-24 17:39:00,20,97,Móvel,7,117
34181,2024-01-24 17:40:00,113,65,Móvel,5,178
34182,2024-01-24 17:41:00,34,82,Móvel,1,116
34183,2024-01-24 17:42:00,51,79,Móvel,8,130
34184,2024-01-24 17:43:00,110,71,Eletrônico,9,181
34185,2024-01-24 17:44:00,117,175,Alimento,3,292
34186,2024-01-24 17:45:00,79,35,Alimento,7,114
34187,2024-01-24 17:46:00,55,122,Brinquedo,5,177
34188,2024-01-24 17:47:00,18,80,Móvel,2,98
34189,2024-01-24 17:48:00,116,44,Vestuário,3,160
34190,2024-01-24 17:49:00,66,16,Brinquedo,3,82
34191,2024-01-24 17:50:00,11,43,Alimento,7,54
34192,2024-01-24 17:51:00,81,117,Brinquedo,4,198
34193,2024-01-24 17:52:00,103,158,Eletrônico,7,261
34194,2024-01-24 17:53:00,24,14,Alimento,5,38
34195,2024-01-24 17:54:00,90,122,Alimento,6,212
34196,2024-01-24 17:55:00,64,54,Vestuário,2,118
34197,2024-01-24 17:56:00,65,12,Alimento,1,77
34198,2024-01-24 17:57:00,29,16,Brinquedo,7,45
34199,2024-01-24 17:58:00,34,67,Eletrônico,6,101
34200,2024-01-24 17:59:00,112,105,Móvel,2,217
34201,2024-01-24 18:00:00,30,154,Alimento,9,184
34202,2024-01-24 18:01:00,41,121,Brinquedo,9,162
34203,2024-01-24 18:02:00,71,17,Móvel,4,88
34204,2024-01-24 18:03:00,30,64,Brinquedo,9,94
34205,2024-01-24 18:04:00,28,168,Eletrônico,7,196
34206,2024-01-24 18:05:00,84,56,Vestuário,3,140
34207,2024-01-24 18:06:00,47,87,Vestuário,9,134
34208,2024-01-24 18:07:00,118,61,Brinquedo,8,179
34209,2024-01-24 18:08:00,102,166,Brinquedo,8,268
34210,2024-01-24 18:09:00,26,155,Vestuário,1,181
34211,2024-01-24 18:10:00,21,88,Eletrônico,5,109
34212,2024-01-24 18:11:00,29,51,Eletrônico,3,80
34213,2024-01-24 18:12:00,39,179,Móvel,6,218
34214,2024-01-24 18:13:00,118,14,Alimento,9,132
34215,2024-01-24 18:14:00,14,154,Eletrônico,4,168
34216,2024-01-24 18:15:00,108,154,Alimento,6,262
34217,2024-01-24 18:16:00,119,38,Alimento,9,157
34218,2024-01-24 18:17:00,20,59,Vestuário,6,79
34219,2024-01-24 18:18:00,99,140,Vestuário,1,239
34220,2024-01-24 18:19:00,68,41,Eletrônico,8,109
34221,2024-01-24 18:20:00,79,168,Móvel,2,247
34222,2024-01-24 18:21:00,119,149,Eletrônico,2,268
34223,2024-01-24 18:22:00,49,102,Móvel,4,151
34224,2024-01-24 18:23:00,16,94,Brinquedo,9,110
34225,2024-01-24 18:24:00,57,140,Alimento,9,197
34226,2024-01-24 18:25:00,76,147,Eletrônico,9,223
34227,2024-01-24 18:26:00,53,105,Eletrônico,7,158
34228,2024-01-24 18:27:00,95,66,Vestuário,1,161
34229,2024-01-24 18:28:00,87,142,Alimento,8,229
34230,2024-01-24 18:29:00,60,93,Móvel,5,153
34231,2024-01-24 18:30:00,13,153,Brinquedo,5,166
34232,2024-01-24 18:31:00,76,72,Vestuário,5,148
34233,2024-01-24 18:32:00,104,63,Eletrônico,6,167
34234,2024-01-24 18:33:00,67,76,Eletrônico,7,143
34235,2024-01-24 18:34:00,44,133,Vestuário,9,177
34236,2024-01-24 18:35:00,79,15,Móvel,4,94
34237,2024-01-24 18:36:00,85,139,Alimento,4,224
34238,2024-01-24 18:37:00,85,140,Eletrônico,9,225
34239,2024-01-24 18:38:00,66,17,Alimento,4,83
34240,2024-01-24 18:39:00,107,66,Vestuário,8,173
34241,2024-01-24 18:40:00,105,102,Eletrônico,1,207
34242,2024-01-24 18:41:00,50,145,Brinquedo,4,195
34243,2024-01-24 18:42:00,15,39,Vestuário,4,54
34244,2024-01-24 18:43:00,28,95,Brinquedo,4,123
34245,2024-01-24 18:44:00,13,125,Vestuário,3,138
34246,2024-01-24 18:45:00,99,173,Eletrônico,8,272
34247,2024-01-24 18:46:00,56,98,Alimento,8,154
34248,2024-01-24 18:47:00,13,163,Eletrônico,3,176
34249,2024-01-24 18:48:00,41,127,Brinquedo,1,168
34250,2024-01-24 18:49:00,36,83,Alimento,4,119
34251,2024-01-24 18:50:00,37,146,Brinquedo,3,183
34252,2024-01-24 18:51:00,17,90,Alimento,6,107
34253,2024-01-24 18:52:00,93,19,Alimento,2,112
34254,2024-01-24 18:53:00,11,149,Móvel,8,160
34255,2024-01-24 18:54:00,26,95,Móvel,4,121
34256,2024-01-24 18:55:00,84,21,Alimento,7,105
34257,2024-01-24 18:56:00,43,151,Alimento,3,194
34258,2024-01-24 18:57:00,36,49,Móvel,1,85
34259,2024-01-24 18:58:00,78,83,Alimento,6,161
34260,2024-01-24 18:59:00,90,81,Móvel,3,171
34261,2024-01-24 19:00:00,18,145,Alimento,9,163
34262,2024-01-24 19:01:00,75,113,Vestuário,3,188
34263,2024-01-24 19:02:00,112,69,Vestuário,7,181
34264,2024-01-24 19:03:00,93,36,Alimento,3,129
34265,2024-01-24 19:04:00,40,14,Vestuário,8,54
34266,2024-01-24 19:05:00,58,143,Eletrônico,7,201
34267,2024-01-24 19:06:00,65,86,Vestuário,3,151
34268,2024-01-24 19:07:00,44,74,Móvel,1,118
34269,2024-01-24 19:08:00,100,158,Vestuário,7,258
34270,2024-01-24 19:09:00,56,26,Brinquedo,9,82
34271,2024-01-24 19:10:00,58,141,Brinquedo,8,199
34272,2024-01-24 19:11:00,66,101,Eletrônico,7,167
34273,2024-01-24 19:12:00,45,150,Vestuário,3,195
34274,2024-01-24 19:13:00,84,64,Brinquedo,2,148
34275,2024-01-24 19:14:00,57,161,Eletrônico,1,218
34276,2024-01-24 19:15:00,69,81,Eletrônico,1,150
34277,2024-01-24 19:16:00,28,16,Eletrônico,5,44
34278,2024-01-24 19:17:00,70,106,Eletrônico,6,176
34279,2024-01-24 19:18:00,99,10,Eletrônico,5,109
34280,2024-01-24 19:19:00,111,42,Eletrônico,4,153
34281,2024-01-24 19:20:00,29,139,Eletrônico,7,168
34282,2024-01-24 19:21:00,118,170,Alimento,1,288
34283,2024-01-24 19:22:00,83,157,Alimento,8,240
34284,2024-01-24 19:23:00,11,48,Brinquedo,9,59
34285,2024-01-24 19:24:00,11,11,Alimento,8,22
34286,2024-01-24 19:25:00,26,127,Eletrônico,6,153
34287,2024-01-24 19:26:00,61,100,Eletrônico,5,161
34288,2024-01-24 19:27:00,117,12,Brinquedo,3,129
34289,2024-01-24 19:28:00,78,10,Alimento,7,88
34290,2024-01-24 19:29:00,17,143,Móvel,9,160
34291,2024-01-24 19:30:00,67,160,Móvel,1,227
34292,2024-01-24 19:31:00,99,70,Brinquedo,4,169
34293,2024-01-24 19:32:00,35,33,Brinquedo,9,68
34294,2024-01-24 19:33:00,38,173,Vestuário,9,211
34295,2024-01-24 19:34:00,68,118,Móvel,4,186
34296,2024-01-24 19:35:00,81,161,Brinquedo,4,242
34297,2024-01-24 19:36:00,10,107,Vestuário,5,117
34298,2024-01-24 19:37:00,59,113,Alimento,6,172
34299,2024-01-24 19:38:00,106,68,Móvel,8,174
34300,2024-01-24 19:39:00,52,116,Móvel,8,168
34301,2024-01-24 19:40:00,21,34,Eletrônico,7,55
34302,2024-01-24 19:41:00,88,159,Eletrônico,1,247
34303,2024-01-24 19:42:00,78,119,Brinquedo,3,197
34304,2024-01-24 19:43:00,26,127,Móvel,4,153
34305,2024-01-24 19:44:00,105,50,Móvel,2,155
34306,2024-01-24 19:45:00,103,90,Móvel,6,193
34307,2024-01-24 19:46:00,15,31,Eletrônico,3,46
34308,2024-01-24 19:47:00,83,156,Vestuário,2,239
34309,2024-01-24 19:48:00,44,76,Eletrônico,7,120
34310,2024-01-24 19:49:00,58,98,Brinquedo,3,156
34311,2024-01-24 19:50:00,107,153,Brinquedo,2,260
34312,2024-01-24 19:51:00,90,29,Vestuário,5,119
34313,2024-01-24 19:52:00,82,104,Móvel,2,186
34314,2024-01-24 19:53:00,103,87,Eletrônico,6,190
34315,2024-01-24 19:54:00,108,177,Alimento,1,285
34316,2024-01-24 19:55:00,69,138,Eletrônico,1,207
34317,2024-01-24 19:56:00,80,151,Vestuário,9,231
34318,2024-01-24 19:57:00,15,160,Brinquedo,2,175
34319,2024-01-24 19:58:00,44,59,Móvel,7,103
34320,2024-01-24 19:59:00,71,173,Vestuário,7,244
34321,2024-01-24 20:00:00,14,40,Alimento,3,54
34322,2024-01-24 20:01:00,14,144,Brinquedo,2,158
34323,2024-01-24 20:02:00,95,144,Brinquedo,4,239
34324,2024-01-24 20:03:00,24,32,Eletrônico,9,56
34325,2024-01-24 20:04:00,117,117,Brinquedo,7,234
34326,2024-01-24 20:05:00,86,53,Alimento,5,139
34327,2024-01-24 20:06:00,50,174,Brinquedo,7,224
34328,2024-01-24 20:07:00,88,50,Eletrônico,5,138
34329,2024-01-24 20:08:00,67,70,Brinquedo,7,137
34330,2024-01-24 20:09:00,10,159,Eletrônico,4,169
34331,2024-01-24 20:10:00,81,150,Alimento,3,231
34332,2024-01-24 20:11:00,61,81,Eletrônico,5,142
34333,2024-01-24 20:12:00,42,133,Móvel,7,175
34334,2024-01-24 20:13:00,59,41,Brinquedo,3,100
34335,2024-01-24 20:14:00,70,166,Vestuário,3,236
34336,2024-01-24 20:15:00,20,143,Eletrônico,7,163
34337,2024-01-24 20:16:00,106,70,Vestuário,2,176
34338,2024-01-24 20:17:00,104,161,Alimento,5,265
34339,2024-01-24 20:18:00,110,157,Vestuário,6,267
34340,2024-01-24 20:19:00,62,131,Vestuário,3,193
34341,2024-01-24 20:20:00,109,38,Móvel,6,147
34342,2024-01-24 20:21:00,87,127,Brinquedo,5,214
34343,2024-01-24 20:22:00,92,157,Móvel,3,249
34344,2024-01-24 20:23:00,39,139,Móvel,8,178
34345,2024-01-24 20:24:00,62,168,Brinquedo,9,230
34346,2024-01-24 20:25:00,50,16,Alimento,8,66
34347,2024-01-24 20:26:00,82,154,Eletrônico,5,236
34348,2024-01-24 20:27:00,34,163,Vestuário,7,197
34349,2024-01-24 20:28:00,11,176,Eletrônico,8,187
34350,2024-01-24 20:29:00,103,88,Alimento,8,191
34351,2024-01-24 20:30:00,29,120,Móvel,7,149
34352,2024-01-24 20:31:00,41,98,Brinquedo,9,139
34353,2024-01-24 20:32:00,53,84,Alimento,4,137
34354,2024-01-24 20:33:00,63,97,Vestuário,1,160
34355,2024-01-24 20:34:00,108,97,Vestuário,9,205
34356,2024-01-24 20:35:00,13,68,Alimento,1,81
34357,2024-01-24 20:36:00,84,145,Brinquedo,1,229
34358,2024-01-24 20:37:00,13,63,Eletrônico,1,76
34359,2024-01-24 20:38:00,45,12,Alimento,4,57
34360,2024-01-24 20:39:00,104,68,Eletrônico,6,172
34361,2024-01-24 20:40:00,69,117,Eletrônico,2,186
34362,2024-01-24 20:41:00,82,165,Brinquedo,9,247
34363,2024-01-24 20:42:00,69,145,Alimento,5,214
34364,2024-01-24 20:43:00,56,114,Alimento,5,170
34365,2024-01-24 20:44:00,81,107,Brinquedo,6,188
34366,2024-01-24 20:45:00,11,106,Móvel,4,117
34367,2024-01-24 20:46:00,36,163,Móvel,9,199
34368,2024-01-24 20:47:00,95,153,Brinquedo,4,248
34369,2024-01-24 20:48:00,33,142,Móvel,9,175
34370,2024-01-24 20:49:00,100,147,Eletrônico,8,247
34371,2024-01-24 20:50:00,72,101,Eletrônico,2,173
34372,2024-01-24 20:51:00,95,53,Vestuário,1,148
34373,2024-01-24 20:52:00,111,150,Móvel,4,261
34374,2024-01-24 20:53:00,17,77,Vestuário,3,94
34375,2024-01-24 20:54:00,14,27,Vestuário,8,41
34376,2024-01-24 20:55:00,69,38,Eletrônico,1,107
34377,2024-01-24 20:56:00,73,170,Brinquedo,8,243
34378,2024-01-24 20:57:00,83,48,Vestuário,7,131
34379,2024-01-24 20:58:00,96,63,Brinquedo,1,159
34380,2024-01-24 20:59:00,40,162,Móvel,6,202
34381,2024-01-24 21:00:00,13,135,Brinquedo,2,148
34382,2024-01-24 21:01:00,41,170,Brinquedo,9,211
34383,2024-01-24 21:02:00,78,172,Vestuário,7,250
34384,2024-01-24 21:03:00,94,58,Brinquedo,1,152
34385,2024-01-24 21:04:00,37,35,Alimento,3,72
34386,2024-01-24 21:05:00,84,30,Vestuário,9,114
34387,2024-01-24 21:06:00,17,56,Brinquedo,3,73
34388,2024-01-24 21:07:00,108,160,Móvel,3,268
34389,2024-01-24 21:08:00,86,11,Móvel,3,97
34390,2024-01-24 21:09:00,10,86,Eletrônico,2,96
34391,2024-01-24 21:10:00,12,98,Vestuário,8,110
34392,2024-01-24 21:11:00,14,10,Alimento,5,24
34393,2024-01-24 21:12:00,112,83,Eletrônico,4,195
34394,2024-01-24 21:13:00,32,59,Móvel,5,91
34395,2024-01-24 21:14:00,25,106,Brinquedo,1,131
34396,2024-01-24 21:15:00,64,134,Vestuário,8,198
34397,2024-01-24 21:16:00,100,27,Vestuário,7,127
34398,2024-01-24 21:17:00,36,45,Móvel,3,81
34399,2024-01-24 21:18:00,115,79,Móvel,8,194
34400,2024-01-24 21:19:00,25,111,Móvel,3,136
34401,2024-01-24 21:20:00,63,116,Alimento,9,179
34402,2024-01-24 21:21:00,62,94,Eletrônico,9,156
34403,2024-01-24 21:22:00,96,170,Eletrônico,1,266
34404,2024-01-24 21:23:00,35,113,Brinquedo,1,148
34405,2024-01-24 21:24:00,72,150,Móvel,7,222
34406,2024-01-24 21:25:00,57,138,Eletrônico,2,195
34407,2024-01-24 21:26:00,81,23,Alimento,2,104
34408,2024-01-24 21:27:00,27,136,Eletrônico,4,163
34409,2024-01-24 21:28:00,62,27,Alimento,7,89
34410,2024-01-24 21:29:00,18,56,Eletrônico,1,74
34411,2024-01-24 21:30:00,116,29,Móvel,1,145
34412,2024-01-24 21:31:00,77,131,Móvel,4,208
34413,2024-01-24 21:32:00,115,120,Alimento,8,235
34414,2024-01-24 21:33:00,51,55,Eletrônico,3,106
34415,2024-01-24 21:34:00,108,167,Vestuário,1,275
34416,2024-01-24 21:35:00,65,85,Móvel,4,150
34417,2024-01-24 21:36:00,72,72,Vestuário,9,144
34418,2024-01-24 21:37:00,14,131,Eletrônico,6,145
34419,2024-01-24 21:38:00,86,10,Móvel,4,96
34420,2024-01-24 21:39:00,13,161,Móvel,3,174
34421,2024-01-24 21:40:00,117,127,Vestuário,7,244
34422,2024-01-24 21:41:00,92,84,Móvel,8,176
34423,2024-01-24 21:42:00,102,164,Eletrônico,9,266
34424,2024-01-24 21:43:00,42,131,Vestuário,3,173
34425,2024-01-24 21:44:00,59,162,Vestuário,4,221
34426,2024-01-24 21:45:00,53,43,Brinquedo,3,96
34427,2024-01-24 21:46:00,81,54,Brinquedo,6,135
34428,2024-01-24 21:47:00,21,54,Brinquedo,1,75
34429,2024-01-24 21:48:00,90,175,Móvel,7,265
34430,2024-01-24 21:49:00,112,15,Móvel,3,127
34431,2024-01-24 21:50:00,75,15,Alimento,9,90
34432,2024-01-24 21:51:00,66,95,Brinquedo,7,161
34433,2024-01-24 21:52:00,93,42,Eletrônico,6,135
34434,2024-01-24 21:53:00,44,172,Vestuário,8,216
34435,2024-01-24 21:54:00,49,73,Vestuário,7,122
34436,2024-01-24 21:55:00,94,55,Móvel,1,149
34437,2024-01-24 21:56:00,71,70,Vestuário,6,141
34438,2024-01-24 21:57:00,101,154,Brinquedo,4,255
34439,2024-01-24 21:58:00,93,113,Brinquedo,3,206
34440,2024-01-24 21:59:00,28,167,Móvel,6,195
34441,2024-01-24 22:00:00,112,18,Alimento,3,130
34442,2024-01-24 22:01:00,62,152,Brinquedo,9,214
34443,2024-01-24 22:02:00,91,20,Vestuário,1,111
34444,2024-01-24 22:03:00,50,114,Vestuário,1,164
34445,2024-01-24 22:04:00,28,46,Eletrônico,3,74
34446,2024-01-24 22:05:00,81,122,Brinquedo,3,203
34447,2024-01-24 22:06:00,71,13,Eletrônico,3,84
34448,2024-01-24 22:07:00,62,169,Eletrônico,7,231
34449,2024-01-24 22:08:00,109,124,Móvel,6,233
34450,2024-01-24 22:09:00,81,84,Vestuário,5,165
34451,2024-01-24 22:10:00,79,69,Alimento,9,148
34452,2024-01-24 22:11:00,16,59,Móvel,8,75
34453,2024-01-24 22:12:00,94,172,Móvel,1,266
34454,2024-01-24 22:13:00,64,65,Eletrônico,5,129
34455,2024-01-24 22:14:00,58,34,Vestuário,9,92
34456,2024-01-24 22:15:00,73,76,Móvel,7,149
34457,2024-01-24 22:16:00,53,61,Vestuário,9,114
34458,2024-01-24 22:17:00,58,163,Brinquedo,5,221
34459,2024-01-24 22:18:00,32,141,Vestuário,8,173
34460,2024-01-24 22:19:00,112,73,Alimento,9,185
34461,2024-01-24 22:20:00,109,71,Vestuário,8,180
34462,2024-01-24 22:21:00,116,79,Eletrônico,1,195
34463,2024-01-24 22:22:00,58,111,Móvel,3,169
34464,2024-01-24 22:23:00,74,135,Eletrônico,9,209
34465,2024-01-24 22:24:00,102,178,Alimento,4,280
34466,2024-01-24 22:25:00,43,78,Eletrônico,7,121
34467,2024-01-24 22:26:00,15,68,Alimento,6,83
34468,2024-01-24 22:27:00,103,68,Alimento,7,171
34469,2024-01-24 22:28:00,42,172,Brinquedo,5,214
34470,2024-01-24 22:29:00,41,48,Alimento,6,89
34471,2024-01-24 22:30:00,106,91,Alimento,8,197
34472,2024-01-24 22:31:00,118,59,Móvel,6,177
34473,2024-01-24 22:32:00,79,77,Eletrônico,4,156
34474,2024-01-24 22:33:00,63,148,Eletrônico,8,211
34475,2024-01-24 22:34:00,39,21,Eletrônico,1,60
34476,2024-01-24 22:35:00,68,57,Vestuário,7,125
34477,2024-01-24 22:36:00,63,172,Brinquedo,4,235
34478,2024-01-24 22:37:00,89,139,Vestuário,6,228
34479,2024-01-24 22:38:00,76,20,Móvel,4,96
34480,2024-01-24 22:39:00,16,165,Brinquedo,7,181
34481,2024-01-24 22:40:00,38,175,Alimento,7,213
34482,2024-01-24 22:41:00,84,56,Móvel,2,140
34483,2024-01-24 22:42:00,94,109,Brinquedo,3,203
34484,2024-01-24 22:43:00,107,21,Eletrônico,4,128
34485,2024-01-24 22:44:00,39,114,Alimento,6,153
34486,2024-01-24 22:45:00,66,154,Móvel,1,220
34487,2024-01-24 22:46:00,46,171,Vestuário,6,217
34488,2024-01-24 22:47:00,59,55,Vestuário,6,114
34489,2024-01-24 22:48:00,47,121,Móvel,7,168
34490,2024-01-24 22:49:00,64,40,Vestuário,4,104
34491,2024-01-24 22:50:00,40,140,Móvel,9,180
34492,2024-01-24 22:51:00,75,37,Eletrônico,8,112
34493,2024-01-24 22:52:00,50,42,Eletrônico,9,92
34494,2024-01-24 22:53:00,93,172,Vestuário,9,265
34495,2024-01-24 22:54:00,32,85,Móvel,2,117
34496,2024-01-24 22:55:00,49,109,Móvel,1,158
34497,2024-01-24 22:56:00,44,65,Alimento,3,109
34498,2024-01-24 22:57:00,55,146,Eletrônico,8,201
34499,2024-01-24 22:58:00,100,142,Alimento,7,242
34500,2024-01-24 22:59:00,71,75,Brinquedo,5,146
34501,2024-01-24 23:00:00,57,149,Vestuário,9,206
34502,2024-01-24 23:01:00,19,150,Alimento,3,169
34503,2024-01-24 23:02:00,16,97,Móvel,7,113
34504,2024-01-24 23:03:00,73,114,Alimento,4,187
34505,2024-01-24 23:04:00,69,164,Vestuário,7,233
34506,2024-01-24 23:05:00,56,164,Vestuário,7,220
34507,2024-01-24 23:06:00,75,157,Vestuário,7,232
34508,2024-01-24 23:07:00,84,110,Vestuário,4,194
34509,2024-01-24 23:08:00,79,16,Alimento,8,95
34510,2024-01-24 23:09:00,114,146,Alimento,6,260
34511,2024-01-24 23:10:00,39,154,Brinquedo,9,193
34512,2024-01-24 23:11:00,16,141,Brinquedo,8,157
34513,2024-01-24 23:12:00,16,120,Eletrônico,3,136
34514,2024-01-24 23:13:00,76,145,Vestuário,1,221
34515,2024-01-24 23:14:00,14,133,Vestuário,8,147
34516,2024-01-24 23:15:00,50,135,Móvel,5,185
34517,2024-01-24 23:16:00,68,21,Eletrônico,1,89
34518,2024-01-24 23:17:00,82,20,Vestuário,7,102
34519,2024-01-24 23:18:00,54,50,Eletrônico,7,104
34520,2024-01-24 23:19:00,70,67,Eletrônico,4,137
34521,2024-01-24 23:20:00,23,106,Vestuário,9,129
34522,2024-01-24 23:21:00,43,139,Móvel,8,182
34523,2024-01-24 23:22:00,48,111,Móvel,3,159
34524,2024-01-24 23:23:00,96,17,Móvel,4,113
34525,2024-01-24 23:24:00,61,65,Vestuário,3,126
34526,2024-01-24 23:25:00,65,15,Brinquedo,1,80
34527,2024-01-24 23:26:00,13,100,Brinquedo,4,113
34528,2024-01-24 23:27:00,16,122,Móvel,4,138
34529,2024-01-24 23:28:00,31,11,Vestuário,6,42
34530,2024-01-24 23:29:00,117,122,Vestuário,6,239
34531,2024-01-24 23:30:00,42,73,Móvel,9,115
34532,2024-01-24 23:31:00,60,113,Alimento,2,173
34533,2024-01-24 23:32:00,47,59,Móvel,5,106
34534,2024-01-24 23:33:00,77,172,Vestuário,4,249
34535,2024-01-24 23:34:00,80,12,Alimento,7,92
34536,2024-01-24 23:35:00,91,144,Móvel,9,235
34537,2024-01-24 23:36:00,115,30,Brinquedo,9,145
34538,2024-01-24 23:37:00,107,87,Alimento,8,194
34539,2024-01-24 23:38:00,38,59,Eletrônico,9,97
34540,2024-01-24 23:39:00,56,23,Móvel,4,79
34541,2024-01-24 23:40:00,117,78,Eletrônico,1,195
34542,2024-01-24 23:41:00,24,48,Móvel,3,72
34543,2024-01-24 23:42:00,76,11,Móvel,7,87
34544,2024-01-24 23:43:00,103,173,Brinquedo,2,276
34545,2024-01-24 23:44:00,44,146,Móvel,9,190
34546,2024-01-24 23:45:00,101,96,Alimento,1,197
34547,2024-01-24 23:46:00,23,11,Brinquedo,7,34
34548,2024-01-24 23:47:00,98,148,Alimento,2,246
34549,2024-01-24 23:48:00,58,160,Alimento,3,218
34550,2024-01-24 23:49:00,45,43,Brinquedo,9,88
34551,2024-01-24 23:50:00,33,55,Vestuário,1,88
34552,2024-01-24 23:51:00,17,108,Móvel,2,125
34553,2024-01-24 23:52:00,118,91,Eletrônico,8,209
34554,2024-01-24 23:53:00,13,100,Vestuário,7,113
34555,2024-01-24 23:54:00,40,80,Brinquedo,9,120
34556,2024-01-24 23:55:00,78,22,Alimento,2,100
34557,2024-01-24 23:56:00,61,34,Brinquedo,5,95
34558,2024-01-24 23:57:00,96,61,Móvel,7,157
34559,2024-01-24 23:58:00,29,130,Móvel,8,159
34560,2024-01-24 23:59:00,38,172,Vestuário,7,210
34561,2024-01-25 00:00:00,52,117,Alimento,5,169
34562,2024-01-25 00:01:00,12,127,Eletrônico,2,139
34563,2024-01-25 00:02:00,50,107,Móvel,7,157
34564,2024-01-25 00:03:00,35,10,Alimento,7,45
34565,2024-01-25 00:04:00,23,161,Eletrônico,9,184
34566,2024-01-25 00:05:00,20,100,Brinquedo,7,120
34567,2024-01-25 00:06:00,82,173,Alimento,5,255
34568,2024-01-25 00:07:00,97,135,Eletrônico,9,232
34569,2024-01-25 00:08:00,117,62,Brinquedo,1,179
34570,2024-01-25 00:09:00,88,170,Eletrônico,8,258
34571,2024-01-25 00:10:00,19,29,Brinquedo,7,48
34572,2024-01-25 00:11:00,93,171,Eletrônico,6,264
34573,2024-01-25 00:12:00,60,61,Brinquedo,4,121
34574,2024-01-25 00:13:00,102,104,Eletrônico,8,206
34575,2024-01-25 00:14:00,95,45,Brinquedo,2,140
34576,2024-01-25 00:15:00,26,141,Eletrônico,5,167
34577,2024-01-25 00:16:00,73,151,Vestuário,2,224
34578,2024-01-25 00:17:00,47,142,Brinquedo,7,189
34579,2024-01-25 00:18:00,63,64,Vestuário,4,127
34580,2024-01-25 00:19:00,78,129,Móvel,9,207
34581,2024-01-25 00:20:00,24,84,Vestuário,4,108
34582,2024-01-25 00:21:00,26,66,Brinquedo,4,92
34583,2024-01-25 00:22:00,55,99,Brinquedo,2,154
34584,2024-01-25 00:23:00,51,123,Alimento,8,174
34585,2024-01-25 00:24:00,53,58,Eletrônico,8,111
34586,2024-01-25 00:25:00,35,102,Móvel,2,137
34587,2024-01-25 00:26:00,42,150,Brinquedo,9,192
34588,2024-01-25 00:27:00,34,126,Móvel,1,160
34589,2024-01-25 00:28:00,43,136,Brinquedo,2,179
34590,2024-01-25 00:29:00,110,91,Móvel,9,201
34591,2024-01-25 00:30:00,79,52,Vestuário,4,131
34592,2024-01-25 00:31:00,103,87,Vestuário,9,190
34593,2024-01-25 00:32:00,37,158,Vestuário,3,195
34594,2024-01-25 00:33:00,100,137,Vestuário,2,237
34595,2024-01-25 00:34:00,44,52,Alimento,9,96
34596,2024-01-25 00:35:00,87,174,Eletrônico,3,261
34597,2024-01-25 00:36:00,69,106,Alimento,6,175
34598,2024-01-25 00:37:00,72,23,Móvel,2,95
34599,2024-01-25 00:38:00,94,22,Alimento,7,116
34600,2024-01-25 00:39:00,28,51,Brinquedo,3,79
34601,2024-01-25 00:40:00,65,28,Vestuário,4,93
34602,2024-01-25 00:41:00,95,18,Vestuário,3,113
34603,2024-01-25 00:42:00,117,67,Móvel,6,184
34604,2024-01-25 00:43:00,77,37,Eletrônico,2,114
34605,2024-01-25 00:44:00,92,114,Eletrônico,6,206
34606,2024-01-25 00:45:00,99,50,Vestuário,1,149
34607,2024-01-25 00:46:00,17,139,Móvel,4,156
34608,2024-01-25 00:47:00,103,122,Vestuário,7,225
34609,2024-01-25 00:48:00,73,159,Vestuário,9,232
34610,2024-01-25 00:49:00,12,133,Móvel,3,145
34611,2024-01-25 00:50:00,17,123,Vestuário,2,140
34612,2024-01-25 00:51:00,16,131,Brinquedo,6,147
34613,2024-01-25 00:52:00,32,77,Móvel,3,109
34614,2024-01-25 00:53:00,67,68,Móvel,6,135
34615,2024-01-25 00:54:00,98,92,Alimento,4,190
34616,2024-01-25 00:55:00,84,67,Alimento,9,151
34617,2024-01-25 00:56:00,108,64,Eletrônico,8,172
34618,2024-01-25 00:57:00,43,55,Eletrônico,7,98
34619,2024-01-25 00:58:00,56,100,Brinquedo,3,156
34620,2024-01-25 00:59:00,117,140,Eletrônico,5,257
34621,2024-01-25 01:00:00,87,84,Vestuário,6,171
34622,2024-01-25 01:01:00,17,152,Vestuário,7,169
34623,2024-01-25 01:02:00,105,24,Brinquedo,8,129
34624,2024-01-25 01:03:00,105,20,Móvel,7,125
34625,2024-01-25 01:04:00,71,57,Vestuário,2,128
34626,2024-01-25 01:05:00,87,157,Eletrônico,9,244
34627,2024-01-25 01:06:00,16,171,Eletrônico,5,187
34628,2024-01-25 01:07:00,27,119,Móvel,5,146
34629,2024-01-25 01:08:00,67,26,Vestuário,8,93
34630,2024-01-25 01:09:00,78,135,Móvel,3,213
34631,2024-01-25 01:10:00,70,136,Eletrônico,2,206
34632,2024-01-25 01:11:00,49,89,Brinquedo,9,138
34633,2024-01-25 01:12:00,70,89,Vestuário,1,159
34634,2024-01-25 01:13:00,44,57,Alimento,6,101
34635,2024-01-25 01:14:00,50,149,Alimento,7,199
34636,2024-01-25 01:15:00,100,69,Eletrônico,5,169
34637,2024-01-25 01:16:00,85,105,Brinquedo,6,190
34638,2024-01-25 01:17:00,28,78,Eletrônico,6,106
34639,2024-01-25 01:18:00,117,161,Alimento,3,278
34640,2024-01-25 01:19:00,59,115,Alimento,1,174
34641,2024-01-25 01:20:00,92,174,Móvel,7,266
34642,2024-01-25 01:21:00,100,61,Móvel,2,161
34643,2024-01-25 01:22:00,81,81,Alimento,3,162
34644,2024-01-25 01:23:00,32,36,Brinquedo,1,68
34645,2024-01-25 01:24:00,38,132,Móvel,1,170
34646,2024-01-25 01:25:00,43,125,Eletrônico,6,168
34647,2024-01-25 01:26:00,13,22,Vestuário,7,35
34648,2024-01-25 01:27:00,107,158,Alimento,6,265
34649,2024-01-25 01:28:00,72,106,Brinquedo,3,178
34650,2024-01-25 01:29:00,63,35,Brinquedo,4,98
34651,2024-01-25 01:30:00,57,103,Brinquedo,5,160
34652,2024-01-25 01:31:00,51,59,Móvel,5,110
34653,2024-01-25 01:32:00,66,115,Eletrônico,8,181
34654,2024-01-25 01:33:00,45,19,Alimento,2,64
34655,2024-01-25 01:34:00,26,15,Alimento,6,41
34656,2024-01-25 01:35:00,35,105,Vestuário,5,140
34657,2024-01-25 01:36:00,65,140,Alimento,8,205
34658,2024-01-25 01:37:00,18,92,Alimento,3,110
34659,2024-01-25 01:38:00,45,12,Vestuário,1,57
34660,2024-01-25 01:39:00,37,77,Vestuário,2,114
34661,2024-01-25 01:40:00,39,63,Vestuário,7,102
34662,2024-01-25 01:41:00,43,45,Eletrônico,9,88
34663,2024-01-25 01:42:00,35,28,Vestuário,1,63
34664,2024-01-25 01:43:00,35,127,Alimento,9,162
34665,2024-01-25 01:44:00,16,21,Eletrônico,2,37
34666,2024-01-25 01:45:00,80,106,Eletrônico,5,186
34667,2024-01-25 01:46:00,22,85,Móvel,9,107
34668,2024-01-25 01:47:00,12,178,Alimento,3,190
34669,2024-01-25 01:48:00,70,156,Alimento,4,226
34670,2024-01-25 01:49:00,25,118,Vestuário,9,143
34671,2024-01-25 01:50:00,27,19,Eletrônico,6,46
34672,2024-01-25 01:51:00,65,74,Eletrônico,5,139
34673,2024-01-25 01:52:00,68,82,Vestuário,5,150
34674,2024-01-25 01:53:00,26,109,Móvel,2,135
34675,2024-01-25 01:54:00,35,123,Móvel,3,158
34676,2024-01-25 01:55:00,107,140,Eletrônico,9,247
34677,2024-01-25 01:56:00,49,102,Móvel,2,151
34678,2024-01-25 01:57:00,36,160,Alimento,1,196
34679,2024-01-25 01:58:00,98,23,Alimento,5,121
34680,2024-01-25 01:59:00,74,89,Móvel,3,163
34681,2024-01-25 02:00:00,88,16,Brinquedo,3,104
34682,2024-01-25 02:01:00,103,77,Brinquedo,7,180
34683,2024-01-25 02:02:00,114,89,Brinquedo,8,203
34684,2024-01-25 02:03:00,87,66,Brinquedo,2,153
34685,2024-01-25 02:04:00,49,151,Alimento,8,200
34686,2024-01-25 02:05:00,28,112,Brinquedo,4,140
34687,2024-01-25 02:06:00,111,42,Brinquedo,6,153
34688,2024-01-25 02:07:00,84,54,Brinquedo,4,138
34689,2024-01-25 02:08:00,83,39,Eletrônico,3,122
34690,2024-01-25 02:09:00,14,104,Alimento,8,118
34691,2024-01-25 02:10:00,55,84,Vestuário,8,139
34692,2024-01-25 02:11:00,107,132,Alimento,4,239
34693,2024-01-25 02:12:00,32,111,Móvel,6,143
34694,2024-01-25 02:13:00,48,117,Alimento,1,165
34695,2024-01-25 02:14:00,82,61,Móvel,6,143
34696,2024-01-25 02:15:00,91,138,Vestuário,4,229
34697,2024-01-25 02:16:00,64,30,Vestuário,2,94
34698,2024-01-25 02:17:00,94,97,Eletrônico,9,191
34699,2024-01-25 02:18:00,64,31,Alimento,1,95
34700,2024-01-25 02:19:00,87,173,Móvel,6,260
34701,2024-01-25 02:20:00,69,84,Móvel,9,153
34702,2024-01-25 02:21:00,30,61,Eletrônico,3,91
34703,2024-01-25 02:22:00,45,65,Móvel,8,110
34704,2024-01-25 02:23:00,65,32,Móvel,1,97
34705,2024-01-25 02:24:00,30,81,Vestuário,6,111
34706,2024-01-25 02:25:00,76,28,Alimento,7,104
34707,2024-01-25 02:26:00,36,115,Vestuário,4,151
34708,2024-01-25 02:27:00,29,108,Eletrônico,7,137
34709,2024-01-25 02:28:00,72,82,Brinquedo,7,154
34710,2024-01-25 02:29:00,52,138,Vestuário,9,190
34711,2024-01-25 02:30:00,53,116,Vestuário,1,169
34712,2024-01-25 02:31:00,107,24,Móvel,6,131
34713,2024-01-25 02:32:00,12,68,Brinquedo,5,80
34714,2024-01-25 02:33:00,114,77,Eletrônico,9,191
34715,2024-01-25 02:34:00,108,38,Brinquedo,4,146
34716,2024-01-25 02:35:00,65,54,Móvel,9,119
34717,2024-01-25 02:36:00,44,24,Eletrônico,4,68
34718,2024-01-25 02:37:00,96,31,Móvel,5,127
34719,2024-01-25 02:38:00,16,165,Brinquedo,3,181
34720,2024-01-25 02:39:00,110,169,Vestuário,2,279
34721,2024-01-25 02:40:00,85,110,Alimento,3,195
34722,2024-01-25 02:41:00,80,146,Brinquedo,8,226
34723,2024-01-25 02:42:00,54,106,Alimento,9,160
34724,2024-01-25 02:43:00,115,175,Vestuário,4,290
34725,2024-01-25 02:44:00,112,117,Alimento,7,229
34726,2024-01-25 02:45:00,32,160,Brinquedo,1,192
34727,2024-01-25 02:46:00,12,179,Alimento,3,191
34728,2024-01-25 02:47:00,71,101,Alimento,1,172
34729,2024-01-25 02:48:00,38,72,Alimento,2,110
34730,2024-01-25 02:49:00,72,32,Eletrônico,3,104
34731,2024-01-25 02:50:00,108,65,Eletrônico,7,173
34732,2024-01-25 02:51:00,20,31,Eletrônico,5,51
34733,2024-01-25 02:52:00,33,153,Móvel,1,186
34734,2024-01-25 02:53:00,73,66,Eletrônico,8,139
34735,2024-01-25 02:54:00,70,66,Brinquedo,9,136
34736,2024-01-25 02:55:00,11,59,Móvel,8,70
34737,2024-01-25 02:56:00,52,42,Móvel,1,94
34738,2024-01-25 02:57:00,65,112,Eletrônico,3,177
34739,2024-01-25 02:58:00,29,94,Brinquedo,4,123
34740,2024-01-25 02:59:00,90,177,Alimento,4,267
34741,2024-01-25 03:00:00,18,26,Alimento,3,44
34742,2024-01-25 03:01:00,24,26,Eletrônico,7,50
34743,2024-01-25 03:02:00,53,142,Móvel,2,195
34744,2024-01-25 03:03:00,74,20,Eletrônico,4,94
34745,2024-01-25 03:04:00,61,170,Eletrônico,3,231
34746,2024-01-25 03:05:00,35,146,Móvel,7,181
34747,2024-01-25 03:06:00,119,62,Alimento,7,181
34748,2024-01-25 03:07:00,66,139,Móvel,8,205
34749,2024-01-25 03:08:00,29,97,Eletrônico,1,126
34750,2024-01-25 03:09:00,54,163,Móvel,9,217
34751,2024-01-25 03:10:00,55,172,Eletrônico,5,227
34752,2024-01-25 03:11:00,104,112,Brinquedo,2,216
34753,2024-01-25 03:12:00,84,45,Alimento,4,129
34754,2024-01-25 03:13:00,30,11,Vestuário,8,41
34755,2024-01-25 03:14:00,75,90,Brinquedo,5,165
34756,2024-01-25 03:15:00,26,161,Brinquedo,4,187
34757,2024-01-25 03:16:00,80,115,Alimento,2,195
34758,2024-01-25 03:17:00,72,137,Móvel,2,209
34759,2024-01-25 03:18:00,100,80,Alimento,8,180
34760,2024-01-25 03:19:00,93,161,Alimento,9,254
34761,2024-01-25 03:20:00,21,124,Brinquedo,8,145
34762,2024-01-25 03:21:00,31,96,Eletrônico,4,127
34763,2024-01-25 03:22:00,47,99,Alimento,5,146
34764,2024-01-25 03:23:00,55,18,Vestuário,3,73
34765,2024-01-25 03:24:00,76,136,Brinquedo,8,212
34766,2024-01-25 03:25:00,15,96,Vestuário,1,111
34767,2024-01-25 03:26:00,116,111,Brinquedo,7,227
34768,2024-01-25 03:27:00,54,20,Móvel,6,74
34769,2024-01-25 03:28:00,78,147,Alimento,9,225
34770,2024-01-25 03:29:00,44,62,Vestuário,8,106
34771,2024-01-25 03:30:00,24,143,Eletrônico,2,167
34772,2024-01-25 03:31:00,95,38,Móvel,6,133
34773,2024-01-25 03:32:00,112,65,Eletrônico,8,177
34774,2024-01-25 03:33:00,113,107,Alimento,2,220
34775,2024-01-25 03:34:00,76,164,Móvel,6,240
34776,2024-01-25 03:35:00,34,12,Vestuário,3,46
34777,2024-01-25 03:36:00,63,31,Móvel,5,94
34778,2024-01-25 03:37:00,62,167,Móvel,3,229
34779,2024-01-25 03:38:00,40,64,Móvel,7,104
34780,2024-01-25 03:39:00,19,143,Alimento,9,162
34781,2024-01-25 03:40:00,111,44,Vestuário,2,155
34782,2024-01-25 03:41:00,77,171,Eletrônico,9,248
34783,2024-01-25 03:42:00,30,123,Brinquedo,3,153
34784,2024-01-25 03:43:00,41,105,Alimento,7,146
34785,2024-01-25 03:44:00,60,10,Brinquedo,4,70
34786,2024-01-25 03:45:00,105,56,Eletrônico,9,161
34787,2024-01-25 03:46:00,29,69,Eletrônico,1,98
34788,2024-01-25 03:47:00,83,175,Móvel,2,258
34789,2024-01-25 03:48:00,42,140,Móvel,9,182
34790,2024-01-25 03:49:00,33,13,Brinquedo,8,46
34791,2024-01-25 03:50:00,85,21,Alimento,8,106
34792,2024-01-25 03:51:00,28,146,Vestuário,5,174
34793,2024-01-25 03:52:00,57,21,Vestuário,1,78
34794,2024-01-25 03:53:00,74,36,Eletrônico,1,110
34795,2024-01-25 03:54:00,114,146,Vestuário,5,260
34796,2024-01-25 03:55:00,10,33,Brinquedo,7,43
34797,2024-01-25 03:56:00,31,59,Alimento,1,90
34798,2024-01-25 03:57:00,76,137,Alimento,4,213
34799,2024-01-25 03:58:00,13,115,Alimento,8,128
34800,2024-01-25 03:59:00,77,134,Alimento,7,211
34801,2024-01-25 04:00:00,52,12,Alimento,8,64
34802,2024-01-25 04:01:00,69,155,Móvel,7,224
34803,2024-01-25 04:02:00,114,70,Alimento,6,184
34804,2024-01-25 04:03:00,97,70,Alimento,1,167
34805,2024-01-25 04:04:00,45,73,Móvel,5,118
34806,2024-01-25 04:05:00,43,139,Brinquedo,3,182
34807,2024-01-25 04:06:00,62,36,Brinquedo,1,98
34808,2024-01-25 04:07:00,106,162,Brinquedo,2,268
34809,2024-01-25 04:08:00,34,27,Móvel,4,61
34810,2024-01-25 04:09:00,119,48,Alimento,5,167
34811,2024-01-25 04:10:00,96,122,Móvel,7,218
34812,2024-01-25 04:11:00,14,72,Brinquedo,4,86
34813,2024-01-25 04:12:00,48,76,Vestuário,4,124
34814,2024-01-25 04:13:00,20,129,Móvel,4,149
34815,2024-01-25 04:14:00,97,179,Móvel,6,276
34816,2024-01-25 04:15:00,29,79,Alimento,9,108
34817,2024-01-25 04:16:00,100,67,Vestuário,1,167
34818,2024-01-25 04:17:00,80,32,Alimento,5,112
34819,2024-01-25 04:18:00,16,18,Móvel,2,34
34820,2024-01-25 04:19:00,104,144,Alimento,3,248
34821,2024-01-25 04:20:00,89,106,Eletrônico,9,195
34822,2024-01-25 04:21:00,72,136,Brinquedo,6,208
34823,2024-01-25 04:22:00,119,115,Vestuário,5,234
34824,2024-01-25 04:23:00,54,172,Móvel,5,226
34825,2024-01-25 04:24:00,64,51,Brinquedo,7,115
34826,2024-01-25 04:25:00,86,127,Móvel,6,213
34827,2024-01-25 04:26:00,18,79,Eletrônico,5,97
34828,2024-01-25 04:27:00,37,30,Móvel,4,67
34829,2024-01-25 04:28:00,40,115,Móvel,5,155
34830,2024-01-25 04:29:00,40,15,Eletrônico,1,55
34831,2024-01-25 04:30:00,11,102,Alimento,9,113
34832,2024-01-25 04:31:00,119,41,Alimento,8,160
34833,2024-01-25 04:32:00,46,172,Alimento,3,218
34834,2024-01-25 04:33:00,73,13,Alimento,4,86
34835,2024-01-25 04:34:00,60,157,Brinquedo,7,217
34836,2024-01-25 04:35:00,11,18,Móvel,2,29
34837,2024-01-25 04:36:00,81,115,Brinquedo,3,196
34838,2024-01-25 04:37:00,42,74,Brinquedo,2,116
34839,2024-01-25 04:38:00,80,52,Eletrônico,5,132
34840,2024-01-25 04:39:00,54,132,Vestuário,2,186
34841,2024-01-25 04:40:00,66,55,Eletrônico,3,121
34842,2024-01-25 04:41:00,74,64,Alimento,2,138
34843,2024-01-25 04:42:00,80,14,Eletrônico,2,94
34844,2024-01-25 04:43:00,99,97,Vestuário,6,196
34845,2024-01-25 04:44:00,22,120,Móvel,1,142
34846,2024-01-25 04:45:00,33,120,Brinquedo,3,153
34847,2024-01-25 04:46:00,116,155,Vestuário,9,271
34848,2024-01-25 04:47:00,86,92,Móvel,2,178
34849,2024-01-25 04:48:00,101,153,Móvel,5,254
34850,2024-01-25 04:49:00,119,70,Móvel,7,189
34851,2024-01-25 04:50:00,79,113,Móvel,4,192
34852,2024-01-25 04:51:00,15,53,Brinquedo,9,68
34853,2024-01-25 04:52:00,19,65,Brinquedo,1,84
34854,2024-01-25 04:53:00,104,112,Brinquedo,6,216
34855,2024-01-25 04:54:00,71,131,Brinquedo,1,202
34856,2024-01-25 04:55:00,13,110,Brinquedo,4,123
34857,2024-01-25 04:56:00,106,43,Alimento,8,149
34858,2024-01-25 04:57:00,41,26,Vestuário,4,67
34859,2024-01-25 04:58:00,85,173,Móvel,4,258
34860,2024-01-25 04:59:00,96,101,Móvel,4,197
34861,2024-01-25 05:00:00,68,155,Brinquedo,6,223
34862,2024-01-25 05:01:00,93,72,Alimento,8,165
34863,2024-01-25 05:02:00,84,39,Vestuário,9,123
34864,2024-01-25 05:03:00,41,126,Móvel,1,167
34865,2024-01-25 05:04:00,61,56,Eletrônico,5,117
34866,2024-01-25 05:05:00,110,57,Alimento,9,167
34867,2024-01-25 05:06:00,72,148,Vestuário,7,220
34868,2024-01-25 05:07:00,117,76,Alimento,4,193
34869,2024-01-25 05:08:00,49,38,Alimento,9,87
34870,2024-01-25 05:09:00,67,78,Móvel,6,145
34871,2024-01-25 05:10:00,110,92,Alimento,3,202
34872,2024-01-25 05:11:00,85,76,Móvel,4,161
34873,2024-01-25 05:12:00,46,169,Alimento,2,215
34874,2024-01-25 05:13:00,64,146,Alimento,3,210
34875,2024-01-25 05:14:00,80,178,Eletrônico,4,258
34876,2024-01-25 05:15:00,63,159,Móvel,6,222
34877,2024-01-25 05:16:00,35,120,Brinquedo,3,155
34878,2024-01-25 05:17:00,94,102,Vestuário,7,196
34879,2024-01-25 05:18:00,30,49,Móvel,8,79
34880,2024-01-25 05:19:00,112,28,Alimento,8,140
34881,2024-01-25 05:20:00,43,32,Móvel,9,75
34882,2024-01-25 05:21:00,109,14,Alimento,1,123
34883,2024-01-25 05:22:00,39,54,Vestuário,9,93
34884,2024-01-25 05:23:00,65,18,Alimento,3,83
34885,2024-01-25 05:24:00,55,160,Alimento,9,215
34886,2024-01-25 05:25:00,100,33,Móvel,3,133
34887,2024-01-25 05:26:00,38,81,Vestuário,7,119
34888,2024-01-25 05:27:00,49,10,Vestuário,4,59
34889,2024-01-25 05:28:00,59,114,Móvel,2,173
34890,2024-01-25 05:29:00,60,58,Eletrônico,6,118
34891,2024-01-25 05:30:00,99,83,Eletrônico,2,182
34892,2024-01-25 05:31:00,12,13,Móvel,7,25
34893,2024-01-25 05:32:00,45,59,Vestuário,3,104
34894,2024-01-25 05:33:00,44,98,Eletrônico,1,142
34895,2024-01-25 05:34:00,72,128,Eletrônico,2,200
34896,2024-01-25 05:35:00,96,35,Brinquedo,1,131
34897,2024-01-25 05:36:00,92,103,Móvel,5,195
34898,2024-01-25 05:37:00,83,140,Eletrônico,7,223
34899,2024-01-25 05:38:00,103,48,Vestuário,1,151
34900,2024-01-25 05:39:00,22,118,Alimento,8,140
34901,2024-01-25 05:40:00,110,27,Móvel,3,137
34902,2024-01-25 05:41:00,70,44,Eletrônico,8,114
34903,2024-01-25 05:42:00,39,111,Eletrônico,2,150
34904,2024-01-25 05:43:00,90,147,Vestuário,6,237
34905,2024-01-25 05:44:00,34,66,Eletrônico,8,100
34906,2024-01-25 05:45:00,35,158,Eletrônico,4,193
34907,2024-01-25 05:46:00,104,168,Vestuário,8,272
34908,2024-01-25 05:47:00,96,23,Alimento,1,119
34909,2024-01-25 05:48:00,36,171,Móvel,8,207
34910,2024-01-25 05:49:00,37,126,Eletrônico,9,163
34911,2024-01-25 05:50:00,72,110,Vestuário,3,182
34912,2024-01-25 05:51:00,80,38,Vestuário,7,118
34913,2024-01-25 05:52:00,58,26,Alimento,2,84
34914,2024-01-25 05:53:00,113,37,Alimento,6,150
34915,2024-01-25 05:54:00,83,136,Móvel,6,219
34916,2024-01-25 05:55:00,103,141,Eletrônico,8,244
34917,2024-01-25 05:56:00,110,79,Brinquedo,3,189
34918,2024-01-25 05:57:00,82,107,Brinquedo,6,189
34919,2024-01-25 05:58:00,98,14,Alimento,8,112
34920,2024-01-25 05:59:00,92,124,Eletrônico,2,216
34921,2024-01-25 06:00:00,36,156,Brinquedo,3,192
34922,2024-01-25 06:01:00,11,24,Eletrônico,4,35
34923,2024-01-25 06:02:00,43,74,Eletrônico,3,117
34924,2024-01-25 06:03:00,56,156,Alimento,1,212
34925,2024-01-25 06:04:00,34,101,Brinquedo,4,135
34926,2024-01-25 06:05:00,12,100,Brinquedo,7,112
34927,2024-01-25 06:06:00,70,39,Alimento,7,109
34928,2024-01-25 06:07:00,14,91,Vestuário,8,105
34929,2024-01-25 06:08:00,103,77,Eletrônico,7,180
34930,2024-01-25 06:09:00,29,40,Eletrônico,5,69
34931,2024-01-25 06:10:00,79,132,Eletrônico,2,211
34932,2024-01-25 06:11:00,97,79,Alimento,7,176
34933,2024-01-25 06:12:00,11,140,Móvel,6,151
34934,2024-01-25 06:13:00,51,134,Brinquedo,4,185
34935,2024-01-25 06:14:00,96,96,Vestuário,3,192
34936,2024-01-25 06:15:00,115,132,Alimento,6,247
34937,2024-01-25 06:16:00,68,156,Móvel,8,224
34938,2024-01-25 06:17:00,69,41,Brinquedo,1,110
34939,2024-01-25 06:18:00,19,118,Vestuário,7,137
34940,2024-01-25 06:19:00,103,133,Brinquedo,1,236
34941,2024-01-25 06:20:00,52,137,Vestuário,4,189
34942,2024-01-25 06:21:00,14,62,Alimento,5,76
34943,2024-01-25 06:22:00,65,76,Móvel,2,141
34944,2024-01-25 06:23:00,57,70,Eletrônico,9,127
34945,2024-01-25 06:24:00,75,145,Brinquedo,9,220
34946,2024-01-25 06:25:00,75,161,Brinquedo,5,236
34947,2024-01-25 06:26:00,88,175,Vestuário,6,263
34948,2024-01-25 06:27:00,48,102,Eletrônico,8,150
34949,2024-01-25 06:28:00,81,136,Alimento,9,217
34950,2024-01-25 06:29:00,92,122,Móvel,7,214
34951,2024-01-25 06:30:00,99,69,Brinquedo,9,168
34952,2024-01-25 06:31:00,35,176,Brinquedo,5,211
34953,2024-01-25 06:32:00,96,69,Eletrônico,8,165
34954,2024-01-25 06:33:00,78,51,Móvel,2,129
34955,2024-01-25 06:34:00,25,117,Vestuário,5,142
34956,2024-01-25 06:35:00,85,27,Móvel,4,112
34957,2024-01-25 06:36:00,30,17,Brinquedo,3,47
34958,2024-01-25 06:37:00,72,91,Móvel,6,163
34959,2024-01-25 06:38:00,77,118,Móvel,4,195
34960,2024-01-25 06:39:00,86,117,Vestuário,3,203
34961,2024-01-25 06:40:00,53,130,Brinquedo,6,183
34962,2024-01-25 06:41:00,33,80,Eletrônico,1,113
34963,2024-01-25 06:42:00,54,161,Móvel,7,215
34964,2024-01-25 06:43:00,16,113,Móvel,2,129
34965,2024-01-25 06:44:00,56,43,Brinquedo,1,99
34966,2024-01-25 06:45:00,65,98,Móvel,9,163
34967,2024-01-25 06:46:00,51,76,Móvel,4,127
34968,2024-01-25 06:47:00,96,13,Brinquedo,7,109
34969,2024-01-25 06:48:00,75,58,Vestuário,2,133
34970,2024-01-25 06:49:00,113,158,Móvel,4,271
34971,2024-01-25 06:50:00,106,106,Alimento,7,212
34972,2024-01-25 06:51:00,81,29,Eletrônico,2,110
34973,2024-01-25 06:52:00,54,110,Alimento,3,164
34974,2024-01-25 06:53:00,116,10,Eletrônico,2,126
34975,2024-01-25 06:54:00,79,130,Alimento,6,209
34976,2024-01-25 06:55:00,43,166,Vestuário,6,209
34977,2024-01-25 06:56:00,82,17,Móvel,7,99
34978,2024-01-25 06:57:00,115,163,Alimento,1,278
34979,2024-01-25 06:58:00,71,47,Móvel,7,118
34980,2024-01-25 06:59:00,44,33,Brinquedo,6,77
34981,2024-01-25 07:00:00,59,17,Alimento,3,76
34982,2024-01-25 07:01:00,44,102,Eletrônico,3,146
34983,2024-01-25 07:02:00,103,56,Móvel,4,159
34984,2024-01-25 07:03:00,78,167,Móvel,1,245
34985,2024-01-25 07:04:00,76,101,Vestuário,2,177
34986,2024-01-25 07:05:00,70,55,Vestuário,4,125
34987,2024-01-25 07:06:00,74,103,Alimento,3,177
34988,2024-01-25 07:07:00,118,135,Alimento,6,253
34989,2024-01-25 07:08:00,104,56,Alimento,9,160
34990,2024-01-25 07:09:00,115,161,Alimento,9,276
34991,2024-01-25 07:10:00,115,27,Alimento,3,142
34992,2024-01-25 07:11:00,33,159,Móvel,6,192
34993,2024-01-25 07:12:00,71,169,Vestuário,2,240
34994,2024-01-25 07:13:00,113,155,Vestuário,2,268
34995,2024-01-25 07:14:00,60,110,Brinquedo,9,170
34996,2024-01-25 07:15:00,74,58,Móvel,3,132
34997,2024-01-25 07:16:00,29,170,Eletrônico,7,199
34998,2024-01-25 07:17:00,57,132,Alimento,5,189
34999,2024-01-25 07:18:00,89,173,Eletrônico,7,262
35000,2024-01-25 07:19:00,55,14,Alimento,2,69
35001,2024-01-25 07:20:00,42,113,Alimento,6,155
35002,2024-01-25 07:21:00,77,162,Eletrônico,3,239
35003,2024-01-25 07:22:00,115,60,Alimento,2,175
35004,2024-01-25 07:23:00,79,88,Alimento,5,167
35005,2024-01-25 07:24:00,96,82,Alimento,4,178
35006,2024-01-25 07:25:00,77,33,Vestuário,5,110
35007,2024-01-25 07:26:00,43,147,Móvel,6,190
35008,2024-01-25 07:27:00,31,38,Móvel,9,69
35009,2024-01-25 07:28:00,93,92,Brinquedo,5,185
35010,2024-01-25 07:29:00,85,49,Alimento,1,134
35011,2024-01-25 07:30:00,86,18,Móvel,8,104
35012,2024-01-25 07:31:00,23,146,Alimento,5,169
35013,2024-01-25 07:32:00,101,20,Eletrônico,7,121
35014,2024-01-25 07:33:00,103,130,Vestuário,2,233
35015,2024-01-25 07:34:00,79,38,Móvel,4,117
35016,2024-01-25 07:35:00,94,138,Brinquedo,4,232
35017,2024-01-25 07:36:00,26,103,Brinquedo,5,129
35018,2024-01-25 07:37:00,104,140,Vestuário,9,244
35019,2024-01-25 07:38:00,113,130,Vestuário,2,243
35020,2024-01-25 07:39:00,34,91,Alimento,2,125
35021,2024-01-25 07:40:00,36,72,Brinquedo,9,108
35022,2024-01-25 07:41:00,60,160,Alimento,1,220
35023,2024-01-25 07:42:00,79,68,Alimento,7,147
35024,2024-01-25 07:43:00,24,125,Alimento,3,149
35025,2024-01-25 07:44:00,72,30,Alimento,6,102
35026,2024-01-25 07:45:00,59,103,Brinquedo,8,162
35027,2024-01-25 07:46:00,94,85,Eletrônico,7,179
35028,2024-01-25 07:47:00,41,47,Móvel,7,88
35029,2024-01-25 07:48:00,56,86,Vestuário,5,142
35030,2024-01-25 07:49:00,67,15,Alimento,9,82
35031,2024-01-25 07:50:00,63,42,Vestuário,5,105
35032,2024-01-25 07:51:00,29,167,Alimento,9,196
35033,2024-01-25 07:52:00,17,172,Eletrônico,7,189
35034,2024-01-25 07:53:00,102,159,Alimento,2,261
35035,2024-01-25 07:54:00,94,65,Vestuário,4,159
35036,2024-01-25 07:55:00,78,57,Vestuário,5,135
35037,2024-01-25 07:56:00,83,118,Eletrônico,1,201
35038,2024-01-25 07:57:00,10,122,Móvel,6,132
35039,2024-01-25 07:58:00,53,93,Eletrônico,6,146
35040,2024-01-25 07:59:00,110,103,Alimento,9,213
35041,2024-01-25 08:00:00,71,115,Eletrônico,6,186
35042,2024-01-25 08:01:00,86,30,Brinquedo,9,116
35043,2024-01-25 08:02:00,34,14,Brinquedo,1,48
35044,2024-01-25 08:03:00,62,20,Móvel,7,82
35045,2024-01-25 08:04:00,95,157,Alimento,5,252
35046,2024-01-25 08:05:00,46,31,Eletrônico,4,77
35047,2024-01-25 08:06:00,45,89,Móvel,6,134
35048,2024-01-25 08:07:00,62,141,Móvel,9,203
35049,2024-01-25 08:08:00,84,61,Vestuário,2,145
35050,2024-01-25 08:09:00,42,28,Alimento,3,70
35051,2024-01-25 08:10:00,29,157,Alimento,7,186
35052,2024-01-25 08:11:00,73,37,Brinquedo,4,110
35053,2024-01-25 08:12:00,98,143,Alimento,5,241
35054,2024-01-25 08:13:00,70,53,Móvel,8,123
35055,2024-01-25 08:14:00,56,59,Brinquedo,7,115
35056,2024-01-25 08:15:00,32,123,Alimento,8,155
35057,2024-01-25 08:16:00,18,116,Vestuário,2,134
35058,2024-01-25 08:17:00,30,40,Vestuário,6,70
35059,2024-01-25 08:18:00,53,143,Vestuário,3,196
35060,2024-01-25 08:19:00,88,49,Brinquedo,6,137
35061,2024-01-25 08:20:00,19,134,Alimento,8,153
35062,2024-01-25 08:21:00,66,132,Brinquedo,7,198
35063,2024-01-25 08:22:00,68,157,Móvel,6,225
35064,2024-01-25 08:23:00,21,179,Eletrônico,8,200
35065,2024-01-25 08:24:00,103,112,Móvel,8,215
35066,2024-01-25 08:25:00,80,47,Eletrônico,5,127
35067,2024-01-25 08:26:00,98,28,Eletrônico,5,126
35068,2024-01-25 08:27:00,35,17,Vestuário,4,52
35069,2024-01-25 08:28:00,102,79,Alimento,1,181
35070,2024-01-25 08:29:00,64,89,Brinquedo,8,153
35071,2024-01-25 08:30:00,87,74,Móvel,4,161
35072,2024-01-25 08:31:00,59,135,Eletrônico,7,194
35073,2024-01-25 08:32:00,112,77,Alimento,6,189
35074,2024-01-25 08:33:00,26,154,Eletrônico,7,180
35075,2024-01-25 08:34:00,32,101,Brinquedo,3,133
35076,2024-01-25 08:35:00,73,119,Eletrônico,4,192
35077,2024-01-25 08:36:00,100,136,Brinquedo,3,236
35078,2024-01-25 08:37:00,72,45,Vestuário,3,117
35079,2024-01-25 08:38:00,56,171,Móvel,2,227
35080,2024-01-25 08:39:00,20,118,Móvel,3,138
35081,2024-01-25 08:40:00,66,106,Móvel,1,172
35082,2024-01-25 08:41:00,83,42,Móvel,5,125
35083,2024-01-25 08:42:00,64,56,Brinquedo,8,120
35084,2024-01-25 08:43:00,113,37,Móvel,9,150
35085,2024-01-25 08:44:00,65,111,Eletrônico,1,176
35086,2024-01-25 08:45:00,107,155,Móvel,5,262
35087,2024-01-25 08:46:00,13,176,Brinquedo,2,189
35088,2024-01-25 08:47:00,106,22,Alimento,4,128
35089,2024-01-25 08:48:00,29,25,Brinquedo,1,54
35090,2024-01-25 08:49:00,35,80,Alimento,4,115
35091,2024-01-25 08:50:00,78,78,Brinquedo,5,156
35092,2024-01-25 08:51:00,36,111,Móvel,4,147
35093,2024-01-25 08:52:00,31,82,Eletrônico,8,113
35094,2024-01-25 08:53:00,22,39,Alimento,9,61
35095,2024-01-25 08:54:00,64,92,Vestuário,1,156
35096,2024-01-25 08:55:00,39,149,Móvel,9,188
35097,2024-01-25 08:56:00,14,45,Eletrônico,2,59
35098,2024-01-25 08:57:00,67,174,Brinquedo,1,241
35099,2024-01-25 08:58:00,70,151,Alimento,4,221
35100,2024-01-25 08:59:00,66,101,Vestuário,8,167
35101,2024-01-25 09:00:00,71,170,Móvel,6,241
35102,2024-01-25 09:01:00,26,43,Brinquedo,9,69
35103,2024-01-25 09:02:00,80,152,Eletrônico,3,232
35104,2024-01-25 09:03:00,55,18,Eletrônico,6,73
35105,2024-01-25 09:04:00,87,98,Móvel,3,185
35106,2024-01-25 09:05:00,17,13,Móvel,7,30
35107,2024-01-25 09:06:00,68,46,Brinquedo,6,114
35108,2024-01-25 09:07:00,109,17,Eletrônico,9,126
35109,2024-01-25 09:08:00,90,111,Vestuário,6,201
35110,2024-01-25 09:09:00,57,39,Eletrônico,4,96
35111,2024-01-25 09:10:00,97,142,Eletrônico,9,239
35112,2024-01-25 09:11:00,68,165,Alimento,1,233
35113,2024-01-25 09:12:00,41,87,Vestuário,7,128
35114,2024-01-25 09:13:00,116,174,Alimento,4,290
35115,2024-01-25 09:14:00,62,132,Alimento,8,194
35116,2024-01-25 09:15:00,114,175,Vestuário,5,289
35117,2024-01-25 09:16:00,69,172,Alimento,1,241
35118,2024-01-25 09:17:00,30,141,Eletrônico,1,171
35119,2024-01-25 09:18:00,41,73,Vestuário,2,114
35120,2024-01-25 09:19:00,85,115,Brinquedo,1,200
35121,2024-01-25 09:20:00,106,34,Vestuário,3,140
35122,2024-01-25 09:21:00,88,158,Vestuário,3,246
35123,2024-01-25 09:22:00,94,167,Eletrônico,3,261
35124,2024-01-25 09:23:00,85,29,Alimento,3,114
35125,2024-01-25 09:24:00,45,115,Móvel,4,160
35126,2024-01-25 09:25:00,79,101,Móvel,9,180
35127,2024-01-25 09:26:00,20,31,Brinquedo,1,51
35128,2024-01-25 09:27:00,96,55,Alimento,6,151
35129,2024-01-25 09:28:00,102,28,Alimento,4,130
35130,2024-01-25 09:29:00,60,132,Móvel,1,192
35131,2024-01-25 09:30:00,64,67,Eletrônico,3,131
35132,2024-01-25 09:31:00,73,121,Eletrônico,4,194
35133,2024-01-25 09:32:00,64,44,Vestuário,8,108
35134,2024-01-25 09:33:00,22,138,Eletrônico,2,160
35135,2024-01-25 09:34:00,83,126,Vestuário,4,209
35136,2024-01-25 09:35:00,80,171,Vestuário,9,251
35137,2024-01-25 09:36:00,71,66,Móvel,3,137
35138,2024-01-25 09:37:00,79,76,Eletrônico,8,155
35139,2024-01-25 09:38:00,104,83,Eletrônico,9,187
35140,2024-01-25 09:39:00,91,155,Eletrônico,7,246
35141,2024-01-25 09:40:00,39,91,Brinquedo,6,130
35142,2024-01-25 09:41:00,111,30,Móvel,4,141
35143,2024-01-25 09:42:00,12,121,Alimento,5,133
35144,2024-01-25 09:43:00,40,50,Móvel,8,90
35145,2024-01-25 09:44:00,23,155,Eletrônico,8,178
35146,2024-01-25 09:45:00,51,72,Alimento,8,123
35147,2024-01-25 09:46:00,114,78,Vestuário,3,192
35148,2024-01-25 09:47:00,57,177,Brinquedo,2,234
35149,2024-01-25 09:48:00,51,105,Vestuário,2,156
35150,2024-01-25 09:49:00,95,50,Eletrônico,1,145
35151,2024-01-25 09:50:00,53,52,Eletrônico,6,105
35152,2024-01-25 09:51:00,80,18,Brinquedo,7,98
35153,2024-01-25 09:52:00,18,70,Eletrônico,3,88
35154,2024-01-25 09:53:00,74,25,Móvel,2,99
35155,2024-01-25 09:54:00,100,68,Eletrônico,8,168
35156,2024-01-25 09:55:00,61,167,Brinquedo,7,228
35157,2024-01-25 09:56:00,49,172,Brinquedo,5,221
35158,2024-01-25 09:57:00,109,91,Brinquedo,5,200
35159,2024-01-25 09:58:00,101,93,Alimento,3,194
35160,2024-01-25 09:59:00,29,55,Vestuário,9,84
35161,2024-01-25 10:00:00,111,91,Brinquedo,4,202
35162,2024-01-25 10:01:00,88,154,Vestuário,6,242
35163,2024-01-25 10:02:00,89,19,Vestuário,1,108
35164,2024-01-25 10:03:00,30,82,Eletrônico,9,112
35165,2024-01-25 10:04:00,107,35,Alimento,1,142
35166,2024-01-25 10:05:00,24,47,Vestuário,2,71
35167,2024-01-25 10:06:00,53,91,Alimento,8,144
35168,2024-01-25 10:07:00,88,52,Alimento,8,140
35169,2024-01-25 10:08:00,103,46,Brinquedo,8,149
35170,2024-01-25 10:09:00,76,150,Eletrônico,7,226
35171,2024-01-25 10:10:00,74,179,Móvel,3,253
35172,2024-01-25 10:11:00,101,160,Vestuário,4,261
35173,2024-01-25 10:12:00,73,169,Móvel,7,242
35174,2024-01-25 10:13:00,113,166,Vestuário,3,279
35175,2024-01-25 10:14:00,104,16,Móvel,3,120
35176,2024-01-25 10:15:00,24,59,Móvel,2,83
35177,2024-01-25 10:16:00,111,60,Brinquedo,8,171
35178,2024-01-25 10:17:00,18,55,Alimento,4,73
35179,2024-01-25 10:18:00,35,139,Brinquedo,6,174
35180,2024-01-25 10:19:00,92,160,Brinquedo,7,252
35181,2024-01-25 10:20:00,67,172,Eletrônico,6,239
35182,2024-01-25 10:21:00,84,28,Alimento,7,112
35183,2024-01-25 10:22:00,52,113,Alimento,8,165
35184,2024-01-25 10:23:00,42,153,Brinquedo,8,195
35185,2024-01-25 10:24:00,92,12,Eletrônico,4,104
35186,2024-01-25 10:25:00,36,74,Brinquedo,5,110
35187,2024-01-25 10:26:00,63,89,Alimento,9,152
35188,2024-01-25 10:27:00,113,130,Eletrônico,4,243
35189,2024-01-25 10:28:00,49,57,Vestuário,5,106
35190,2024-01-25 10:29:00,68,72,Vestuário,7,140
35191,2024-01-25 10:30:00,38,60,Alimento,3,98
35192,2024-01-25 10:31:00,31,121,Vestuário,3,152
35193,2024-01-25 10:32:00,41,112,Móvel,8,153
35194,2024-01-25 10:33:00,44,67,Eletrônico,2,111
35195,2024-01-25 10:34:00,78,75,Móvel,3,153
35196,2024-01-25 10:35:00,31,166,Brinquedo,9,197
35197,2024-01-25 10:36:00,80,169,Eletrônico,2,249
35198,2024-01-25 10:37:00,40,127,Eletrônico,4,167
35199,2024-01-25 10:38:00,99,66,Vestuário,1,165
35200,2024-01-25 10:39:00,48,65,Móvel,1,113
35201,2024-01-25 10:40:00,57,124,Alimento,7,181
35202,2024-01-25 10:41:00,43,85,Eletrônico,6,128
35203,2024-01-25 10:42:00,47,126,Móvel,3,173
35204,2024-01-25 10:43:00,66,33,Eletrônico,4,99
35205,2024-01-25 10:44:00,91,148,Vestuário,3,239
35206,2024-01-25 10:45:00,31,155,Brinquedo,3,186
35207,2024-01-25 10:46:00,32,21,Brinquedo,7,53
35208,2024-01-25 10:47:00,109,77,Móvel,8,186
35209,2024-01-25 10:48:00,110,164,Alimento,4,274
35210,2024-01-25 10:49:00,26,36,Vestuário,9,62
35211,2024-01-25 10:50:00,103,36,Móvel,8,139
35212,2024-01-25 10:51:00,81,80,Móvel,2,161
35213,2024-01-25 10:52:00,48,81,Alimento,7,129
35214,2024-01-25 10:53:00,59,134,Móvel,4,193
35215,2024-01-25 10:54:00,59,171,Móvel,9,230
35216,2024-01-25 10:55:00,60,50,Alimento,3,110
35217,2024-01-25 10:56:00,99,163,Vestuário,3,262
35218,2024-01-25 10:57:00,35,60,Eletrônico,3,95
35219,2024-01-25 10:58:00,104,149,Alimento,4,253
35220,2024-01-25 10:59:00,72,82,Alimento,9,154
35221,2024-01-25 11:00:00,44,45,Móvel,4,89
35222,2024-01-25 11:01:00,59,23,Vestuário,3,82
35223,2024-01-25 11:02:00,52,69,Alimento,9,121
35224,2024-01-25 11:03:00,19,104,Alimento,3,123
35225,2024-01-25 11:04:00,11,61,Vestuário,5,72
35226,2024-01-25 11:05:00,92,116,Brinquedo,3,208
35227,2024-01-25 11:06:00,35,45,Vestuário,5,80
35228,2024-01-25 11:07:00,42,35,Alimento,6,77
35229,2024-01-25 11:08:00,64,106,Eletrônico,2,170
35230,2024-01-25 11:09:00,79,124,Eletrônico,1,203
35231,2024-01-25 11:10:00,86,69,Brinquedo,7,155
35232,2024-01-25 11:11:00,110,158,Brinquedo,2,268
35233,2024-01-25 11:12:00,14,164,Brinquedo,2,178
35234,2024-01-25 11:13:00,81,50,Alimento,6,131
35235,2024-01-25 11:14:00,58,19,Móvel,9,77
35236,2024-01-25 11:15:00,116,104,Eletrônico,8,220
35237,2024-01-25 11:16:00,115,55,Móvel,3,170
35238,2024-01-25 11:17:00,32,86,Móvel,3,118
35239,2024-01-25 11:18:00,26,34,Móvel,9,60
35240,2024-01-25 11:19:00,17,170,Móvel,2,187
35241,2024-01-25 11:20:00,40,26,Móvel,3,66
35242,2024-01-25 11:21:00,112,61,Brinquedo,9,173
35243,2024-01-25 11:22:00,16,139,Alimento,5,155
35244,2024-01-25 11:23:00,44,36,Brinquedo,5,80
35245,2024-01-25 11:24:00,46,131,Eletrônico,3,177
35246,2024-01-25 11:25:00,45,156,Vestuário,3,201
35247,2024-01-25 11:26:00,21,43,Brinquedo,4,64
35248,2024-01-25 11:27:00,72,114,Alimento,7,186
35249,2024-01-25 11:28:00,104,73,Móvel,3,177
35250,2024-01-25 11:29:00,90,171,Alimento,7,261
35251,2024-01-25 11:30:00,58,81,Móvel,8,139
35252,2024-01-25 11:31:00,15,73,Alimento,1,88
35253,2024-01-25 11:32:00,38,85,Móvel,2,123
35254,2024-01-25 11:33:00,78,63,Móvel,4,141
35255,2024-01-25 11:34:00,114,111,Eletrônico,8,225
35256,2024-01-25 11:35:00,77,74,Eletrônico,4,151
35257,2024-01-25 11:36:00,49,117,Vestuário,2,166
35258,2024-01-25 11:37:00,79,124,Eletrônico,8,203
35259,2024-01-25 11:38:00,108,71,Móvel,9,179
35260,2024-01-25 11:39:00,57,70,Brinquedo,2,127
35261,2024-01-25 11:40:00,107,130,Brinquedo,9,237
35262,2024-01-25 11:41:00,12,49,Móvel,6,61
35263,2024-01-25 11:42:00,104,17,Eletrônico,6,121
35264,2024-01-25 11:43:00,81,130,Móvel,6,211
35265,2024-01-25 11:44:00,72,84,Alimento,5,156
35266,2024-01-25 11:45:00,47,130,Alimento,4,177
35267,2024-01-25 11:46:00,100,152,Móvel,6,252
35268,2024-01-25 11:47:00,72,143,Brinquedo,4,215
35269,2024-01-25 11:48:00,66,120,Alimento,4,186
35270,2024-01-25 11:49:00,47,39,Eletrônico,4,86
35271,2024-01-25 11:50:00,86,171,Eletrônico,1,257
35272,2024-01-25 11:51:00,119,10,Alimento,4,129
35273,2024-01-25 11:52:00,35,66,Alimento,7,101
35274,2024-01-25 11:53:00,32,51,Alimento,2,83
35275,2024-01-25 11:54:00,115,120,Eletrônico,6,235
35276,2024-01-25 11:55:00,95,12,Brinquedo,7,107
35277,2024-01-25 11:56:00,82,116,Móvel,5,198
35278,2024-01-25 11:57:00,75,52,Brinquedo,8,127
35279,2024-01-25 11:58:00,111,153,Alimento,5,264
35280,2024-01-25 11:59:00,78,98,Brinquedo,1,176
35281,2024-01-25 12:00:00,97,104,Eletrônico,1,201
35282,2024-01-25 12:01:00,87,176,Móvel,9,263
35283,2024-01-25 12:02:00,37,164,Brinquedo,9,201
35284,2024-01-25 12:03:00,34,142,Brinquedo,1,176
35285,2024-01-25 12:04:00,99,14,Alimento,2,113
35286,2024-01-25 12:05:00,103,70,Brinquedo,3,173
35287,2024-01-25 12:06:00,48,73,Móvel,1,121
35288,2024-01-25 12:07:00,11,46,Eletrônico,1,57
35289,2024-01-25 12:08:00,99,171,Vestuário,7,270
35290,2024-01-25 12:09:00,77,69,Móvel,8,146
35291,2024-01-25 12:10:00,82,20,Brinquedo,2,102
35292,2024-01-25 12:11:00,13,177,Vestuário,3,190
35293,2024-01-25 12:12:00,12,75,Eletrônico,5,87
35294,2024-01-25 12:13:00,104,44,Brinquedo,3,148
35295,2024-01-25 12:14:00,89,61,Eletrônico,8,150
35296,2024-01-25 12:15:00,63,75,Móvel,1,138
35297,2024-01-25 12:16:00,26,53,Brinquedo,8,79
35298,2024-01-25 12:17:00,23,91,Vestuário,6,114
35299,2024-01-25 12:18:00,14,151,Móvel,9,165
35300,2024-01-25 12:19:00,63,99,Eletrônico,3,162
35301,2024-01-25 12:20:00,59,35,Eletrônico,4,94
35302,2024-01-25 12:21:00,32,177,Vestuário,2,209
35303,2024-01-25 12:22:00,81,151,Eletrônico,1,232
35304,2024-01-25 12:23:00,51,140,Brinquedo,8,191
35305,2024-01-25 12:24:00,12,68,Alimento,2,80
35306,2024-01-25 12:25:00,45,164,Alimento,6,209
35307,2024-01-25 12:26:00,81,168,Brinquedo,3,249
35308,2024-01-25 12:27:00,24,73,Brinquedo,7,97
35309,2024-01-25 12:28:00,11,132,Eletrônico,9,143
35310,2024-01-25 12:29:00,31,128,Móvel,3,159
35311,2024-01-25 12:30:00,82,53,Alimento,3,135
35312,2024-01-25 12:31:00,13,179,Alimento,7,192
35313,2024-01-25 12:32:00,115,105,Vestuário,9,220
35314,2024-01-25 12:33:00,51,116,Vestuário,6,167
35315,2024-01-25 12:34:00,57,174,Vestuário,4,231
35316,2024-01-25 12:35:00,113,13,Móvel,8,126
35317,2024-01-25 12:36:00,72,166,Vestuário,2,238
35318,2024-01-25 12:37:00,49,39,Alimento,8,88
35319,2024-01-25 12:38:00,81,160,Eletrônico,6,241
35320,2024-01-25 12:39:00,62,91,Brinquedo,3,153
35321,2024-01-25 12:40:00,10,142,Vestuário,5,152
35322,2024-01-25 12:41:00,97,44,Eletrônico,7,141
35323,2024-01-25 12:42:00,70,163,Alimento,4,233
35324,2024-01-25 12:43:00,106,66,Eletrônico,3,172
35325,2024-01-25 12:44:00,91,173,Brinquedo,6,264
35326,2024-01-25 12:45:00,41,141,Eletrônico,4,182
35327,2024-01-25 12:46:00,32,124,Móvel,8,156
35328,2024-01-25 12:47:00,15,104,Vestuário,9,119
35329,2024-01-25 12:48:00,119,10,Vestuário,7,129
35330,2024-01-25 12:49:00,67,79,Eletrônico,2,146
35331,2024-01-25 12:50:00,55,108,Eletrônico,2,163
35332,2024-01-25 12:51:00,34,14,Vestuário,3,48
35333,2024-01-25 12:52:00,118,173,Móvel,7,291
35334,2024-01-25 12:53:00,20,128,Alimento,3,148
35335,2024-01-25 12:54:00,106,98,Alimento,3,204
35336,2024-01-25 12:55:00,59,75,Eletrônico,4,134
35337,2024-01-25 12:56:00,90,98,Alimento,7,188
35338,2024-01-25 12:57:00,22,13,Vestuário,2,35
35339,2024-01-25 12:58:00,11,179,Móvel,6,190
35340,2024-01-25 12:59:00,76,161,Brinquedo,6,237
35341,2024-01-25 13:00:00,93,11,Brinquedo,2,104
35342,2024-01-25 13:01:00,64,11,Brinquedo,8,75
35343,2024-01-25 13:02:00,98,48,Alimento,9,146
35344,2024-01-25 13:03:00,57,149,Brinquedo,7,206
35345,2024-01-25 13:04:00,59,103,Eletrônico,9,162
35346,2024-01-25 13:05:00,46,35,Brinquedo,2,81
35347,2024-01-25 13:06:00,61,173,Vestuário,9,234
35348,2024-01-25 13:07:00,48,93,Eletrônico,8,141
35349,2024-01-25 13:08:00,65,176,Alimento,8,241
35350,2024-01-25 13:09:00,17,170,Alimento,7,187
35351,2024-01-25 13:10:00,14,179,Vestuário,5,193
35352,2024-01-25 13:11:00,77,93,Móvel,7,170
35353,2024-01-25 13:12:00,77,43,Brinquedo,8,120
35354,2024-01-25 13:13:00,31,70,Eletrônico,3,101
35355,2024-01-25 13:14:00,66,141,Brinquedo,4,207
35356,2024-01-25 13:15:00,50,36,Alimento,5,86
35357,2024-01-25 13:16:00,80,74,Alimento,1,154
35358,2024-01-25 13:17:00,115,119,Eletrônico,5,234
35359,2024-01-25 13:18:00,20,171,Eletrônico,4,191
35360,2024-01-25 13:19:00,76,171,Eletrônico,9,247
35361,2024-01-25 13:20:00,57,173,Eletrônico,6,230
35362,2024-01-25 13:21:00,59,125,Eletrônico,1,184
35363,2024-01-25 13:22:00,11,178,Eletrônico,8,189
35364,2024-01-25 13:23:00,110,161,Móvel,2,271
35365,2024-01-25 13:24:00,90,179,Eletrônico,8,269
35366,2024-01-25 13:25:00,62,111,Brinquedo,8,173
35367,2024-01-25 13:26:00,52,31,Móvel,7,83
35368,2024-01-25 13:27:00,34,165,Brinquedo,1,199
35369,2024-01-25 13:28:00,114,99,Alimento,5,213
35370,2024-01-25 13:29:00,47,12,Brinquedo,7,59
35371,2024-01-25 13:30:00,47,70,Vestuário,6,117
35372,2024-01-25 13:31:00,70,142,Brinquedo,4,212
35373,2024-01-25 13:32:00,64,98,Brinquedo,6,162
35374,2024-01-25 13:33:00,51,93,Vestuário,2,144
35375,2024-01-25 13:34:00,69,167,Móvel,6,236
35376,2024-01-25 13:35:00,33,90,Eletrônico,8,123
35377,2024-01-25 13:36:00,27,104,Brinquedo,7,131
35378,2024-01-25 13:37:00,65,13,Vestuário,7,78
35379,2024-01-25 13:38:00,34,83,Vestuário,5,117
35380,2024-01-25 13:39:00,92,32,Vestuário,3,124
35381,2024-01-25 13:40:00,99,40,Vestuário,7,139
35382,2024-01-25 13:41:00,86,20,Brinquedo,7,106
35383,2024-01-25 13:42:00,94,116,Brinquedo,3,210
35384,2024-01-25 13:43:00,56,42,Vestuário,7,98
35385,2024-01-25 13:44:00,21,87,Móvel,3,108
35386,2024-01-25 13:45:00,84,11,Alimento,8,95
35387,2024-01-25 13:46:00,90,58,Alimento,4,148
35388,2024-01-25 13:47:00,36,78,Alimento,2,114
35389,2024-01-25 13:48:00,88,70,Móvel,4,158
35390,2024-01-25 13:49:00,57,53,Vestuário,5,110
35391,2024-01-25 13:50:00,97,152,Brinquedo,9,249
35392,2024-01-25 13:51:00,66,152,Alimento,9,218
35393,2024-01-25 13:52:00,103,70,Vestuário,7,173
35394,2024-01-25 13:53:00,98,73,Brinquedo,2,171
35395,2024-01-25 13:54:00,118,83,Alimento,2,201
35396,2024-01-25 13:55:00,46,15,Vestuário,2,61
35397,2024-01-25 13:56:00,119,40,Vestuário,4,159
35398,2024-01-25 13:57:00,106,111,Vestuário,1,217
35399,2024-01-25 13:58:00,112,129,Móvel,7,241
35400,2024-01-25 13:59:00,47,54,Brinquedo,5,101
35401,2024-01-25 14:00:00,15,78,Alimento,6,93
35402,2024-01-25 14:01:00,36,69,Móvel,8,105
35403,2024-01-25 14:02:00,106,172,Móvel,6,278
35404,2024-01-25 14:03:00,18,40,Vestuário,3,58
35405,2024-01-25 14:04:00,47,118,Eletrônico,4,165
35406,2024-01-25 14:05:00,111,175,Brinquedo,4,286
35407,2024-01-25 14:06:00,57,26,Móvel,6,83
35408,2024-01-25 14:07:00,82,46,Eletrônico,5,128
35409,2024-01-25 14:08:00,81,150,Móvel,2,231
35410,2024-01-25 14:09:00,110,49,Móvel,7,159
35411,2024-01-25 14:10:00,30,55,Vestuário,4,85
35412,2024-01-25 14:11:00,13,161,Alimento,6,174
35413,2024-01-25 14:12:00,74,178,Móvel,6,252
35414,2024-01-25 14:13:00,36,110,Brinquedo,8,146
35415,2024-01-25 14:14:00,111,28,Vestuário,2,139
35416,2024-01-25 14:15:00,62,136,Móvel,4,198
35417,2024-01-25 14:16:00,61,45,Alimento,4,106
35418,2024-01-25 14:17:00,111,129,Móvel,9,240
35419,2024-01-25 14:18:00,46,164,Alimento,7,210
35420,2024-01-25 14:19:00,62,79,Vestuário,5,141
35421,2024-01-25 14:20:00,114,40,Móvel,4,154
35422,2024-01-25 14:21:00,80,12,Brinquedo,8,92
35423,2024-01-25 14:22:00,77,159,Alimento,3,236
35424,2024-01-25 14:23:00,42,77,Eletrônico,9,119
35425,2024-01-25 14:24:00,88,10,Vestuário,5,98
35426,2024-01-25 14:25:00,86,101,Brinquedo,6,187
35427,2024-01-25 14:26:00,72,82,Brinquedo,9,154
35428,2024-01-25 14:27:00,31,122,Brinquedo,1,153
35429,2024-01-25 14:28:00,117,64,Brinquedo,9,181
35430,2024-01-25 14:29:00,30,143,Vestuário,6,173
35431,2024-01-25 14:30:00,47,117,Brinquedo,6,164
35432,2024-01-25 14:31:00,69,43,Vestuário,3,112
35433,2024-01-25 14:32:00,43,76,Eletrônico,6,119
35434,2024-01-25 14:33:00,58,170,Vestuário,6,228
35435,2024-01-25 14:34:00,11,74,Eletrônico,7,85
35436,2024-01-25 14:35:00,48,21,Móvel,1,69
35437,2024-01-25 14:36:00,109,76,Móvel,5,185
35438,2024-01-25 14:37:00,109,10,Brinquedo,1,119
35439,2024-01-25 14:38:00,41,10,Eletrônico,4,51
35440,2024-01-25 14:39:00,74,35,Móvel,2,109
35441,2024-01-25 14:40:00,119,13,Eletrônico,4,132
35442,2024-01-25 14:41:00,35,170,Vestuário,4,205
35443,2024-01-25 14:42:00,68,163,Brinquedo,6,231
35444,2024-01-25 14:43:00,107,63,Alimento,5,170
35445,2024-01-25 14:44:00,89,46,Alimento,5,135
35446,2024-01-25 14:45:00,14,92,Eletrônico,9,106
35447,2024-01-25 14:46:00,82,129,Móvel,3,211
35448,2024-01-25 14:47:00,94,166,Vestuário,4,260
35449,2024-01-25 14:48:00,97,41,Móvel,2,138
35450,2024-01-25 14:49:00,94,67,Brinquedo,7,161
35451,2024-01-25 14:50:00,90,143,Eletrônico,6,233
35452,2024-01-25 14:51:00,73,168,Brinquedo,1,241
35453,2024-01-25 14:52:00,24,82,Móvel,2,106
35454,2024-01-25 14:53:00,106,160,Vestuário,6,266
35455,2024-01-25 14:54:00,61,155,Alimento,9,216
35456,2024-01-25 14:55:00,100,51,Eletrônico,4,151
35457,2024-01-25 14:56:00,70,165,Alimento,4,235
35458,2024-01-25 14:57:00,91,127,Vestuário,2,218
35459,2024-01-25 14:58:00,93,173,Alimento,6,266
35460,2024-01-25 14:59:00,30,69,Móvel,7,99
35461,2024-01-25 15:00:00,57,42,Brinquedo,8,99
35462,2024-01-25 15:01:00,11,175,Alimento,9,186
35463,2024-01-25 15:02:00,92,116,Brinquedo,8,208
35464,2024-01-25 15:03:00,92,64,Eletrônico,7,156
35465,2024-01-25 15:04:00,112,129,Vestuário,9,241
35466,2024-01-25 15:05:00,44,66,Móvel,9,110
35467,2024-01-25 15:06:00,16,44,Alimento,7,60
35468,2024-01-25 15:07:00,82,85,Brinquedo,4,167
35469,2024-01-25 15:08:00,46,162,Eletrônico,3,208
35470,2024-01-25 15:09:00,15,98,Móvel,8,113
35471,2024-01-25 15:10:00,115,101,Brinquedo,8,216
35472,2024-01-25 15:11:00,14,19,Móvel,8,33
35473,2024-01-25 15:12:00,16,42,Brinquedo,8,58
35474,2024-01-25 15:13:00,88,79,Móvel,1,167
35475,2024-01-25 15:14:00,75,102,Alimento,5,177
35476,2024-01-25 15:15:00,110,135,Alimento,2,245
35477,2024-01-25 15:16:00,75,156,Alimento,1,231
35478,2024-01-25 15:17:00,75,103,Eletrônico,5,178
35479,2024-01-25 15:18:00,89,58,Alimento,4,147
35480,2024-01-25 15:19:00,27,103,Vestuário,4,130
35481,2024-01-25 15:20:00,48,29,Vestuário,7,77
35482,2024-01-25 15:21:00,87,99,Móvel,1,186
35483,2024-01-25 15:22:00,52,40,Vestuário,4,92
35484,2024-01-25 15:23:00,15,147,Móvel,8,162
35485,2024-01-25 15:24:00,81,22,Vestuário,9,103
35486,2024-01-25 15:25:00,14,151,Alimento,6,165
35487,2024-01-25 15:26:00,32,168,Brinquedo,6,200
35488,2024-01-25 15:27:00,95,20,Móvel,1,115
35489,2024-01-25 15:28:00,43,61,Alimento,2,104
35490,2024-01-25 15:29:00,71,13,Eletrônico,5,84
35491,2024-01-25 15:30:00,41,105,Alimento,6,146
35492,2024-01-25 15:31:00,28,31,Alimento,5,59
35493,2024-01-25 15:32:00,71,156,Eletrônico,8,227
35494,2024-01-25 15:33:00,60,45,Brinquedo,3,105
35495,2024-01-25 15:34:00,37,32,Brinquedo,9,69
35496,2024-01-25 15:35:00,64,155,Móvel,8,219
35497,2024-01-25 15:36:00,58,106,Alimento,5,164
35498,2024-01-25 15:37:00,59,154,Eletrônico,4,213
35499,2024-01-25 15:38:00,105,82,Alimento,3,187
35500,2024-01-25 15:39:00,53,13,Alimento,1,66
35501,2024-01-25 15:40:00,25,97,Móvel,5,122
35502,2024-01-25 15:41:00,91,24,Vestuário,6,115
35503,2024-01-25 15:42:00,90,162,Eletrônico,3,252
35504,2024-01-25 15:43:00,119,85,Alimento,4,204
35505,2024-01-25 15:44:00,69,171,Eletrônico,9,240
35506,2024-01-25 15:45:00,68,60,Eletrônico,5,128
35507,2024-01-25 15:46:00,85,56,Vestuário,8,141
35508,2024-01-25 15:47:00,100,77,Eletrônico,2,177
35509,2024-01-25 15:48:00,37,132,Vestuário,4,169
35510,2024-01-25 15:49:00,55,166,Móvel,4,221
35511,2024-01-25 15:50:00,31,125,Vestuário,3,156
35512,2024-01-25 15:51:00,51,154,Eletrônico,5,205
35513,2024-01-25 15:52:00,62,49,Brinquedo,3,111
35514,2024-01-25 15:53:00,83,99,Móvel,2,182
35515,2024-01-25 15:54:00,46,15,Alimento,8,61
35516,2024-01-25 15:55:00,66,179,Alimento,1,245
35517,2024-01-25 15:56:00,45,46,Móvel,6,91
35518,2024-01-25 15:57:00,40,41,Móvel,1,81
35519,2024-01-25 15:58:00,105,125,Eletrônico,3,230
35520,2024-01-25 15:59:00,93,84,Brinquedo,7,177
35521,2024-01-25 16:00:00,76,163,Eletrônico,1,239
35522,2024-01-25 16:01:00,98,161,Vestuário,7,259
35523,2024-01-25 16:02:00,34,46,Alimento,2,80
35524,2024-01-25 16:03:00,113,61,Eletrônico,3,174
35525,2024-01-25 16:04:00,18,16,Móvel,8,34
35526,2024-01-25 16:05:00,77,151,Alimento,7,228
35527,2024-01-25 16:06:00,95,172,Móvel,8,267
35528,2024-01-25 16:07:00,66,40,Alimento,1,106
35529,2024-01-25 16:08:00,17,174,Vestuário,2,191
35530,2024-01-25 16:09:00,75,18,Vestuário,6,93
35531,2024-01-25 16:10:00,84,46,Vestuário,1,130
35532,2024-01-25 16:11:00,86,58,Eletrônico,5,144
35533,2024-01-25 16:12:00,32,136,Eletrônico,6,168
35534,2024-01-25 16:13:00,112,136,Brinquedo,7,248
35535,2024-01-25 16:14:00,59,50,Móvel,2,109
35536,2024-01-25 16:15:00,21,86,Eletrônico,1,107
35537,2024-01-25 16:16:00,58,104,Vestuário,2,162
35538,2024-01-25 16:17:00,65,118,Brinquedo,1,183
35539,2024-01-25 16:18:00,85,51,Eletrônico,6,136
35540,2024-01-25 16:19:00,106,148,Alimento,6,254
35541,2024-01-25 16:20:00,61,66,Móvel,5,127
35542,2024-01-25 16:21:00,65,122,Eletrônico,4,187
35543,2024-01-25 16:22:00,109,65,Brinquedo,1,174
35544,2024-01-25 16:23:00,95,63,Alimento,3,158
35545,2024-01-25 16:24:00,78,119,Eletrônico,8,197
35546,2024-01-25 16:25:00,32,105,Vestuário,1,137
35547,2024-01-25 16:26:00,13,143,Vestuário,8,156
35548,2024-01-25 16:27:00,55,15,Brinquedo,4,70
35549,2024-01-25 16:28:00,65,163,Brinquedo,9,228
35550,2024-01-25 16:29:00,61,160,Brinquedo,3,221
35551,2024-01-25 16:30:00,20,104,Brinquedo,6,124
35552,2024-01-25 16:31:00,16,139,Vestuário,4,155
35553,2024-01-25 16:32:00,23,73,Alimento,1,96
35554,2024-01-25 16:33:00,78,11,Eletrônico,9,89
35555,2024-01-25 16:34:00,64,124,Eletrônico,2,188
35556,2024-01-25 16:35:00,22,63,Móvel,8,85
35557,2024-01-25 16:36:00,20,121,Móvel,7,141
35558,2024-01-25 16:37:00,94,154,Alimento,4,248
35559,2024-01-25 16:38:00,111,156,Eletrônico,5,267
35560,2024-01-25 16:39:00,80,55,Brinquedo,3,135
35561,2024-01-25 16:40:00,113,12,Eletrônico,4,125
35562,2024-01-25 16:41:00,24,140,Eletrônico,5,164
35563,2024-01-25 16:42:00,28,131,Brinquedo,6,159
35564,2024-01-25 16:43:00,36,71,Vestuário,6,107
35565,2024-01-25 16:44:00,114,160,Eletrônico,3,274
35566,2024-01-25 16:45:00,112,54,Alimento,1,166
35567,2024-01-25 16:46:00,52,47,Móvel,5,99
35568,2024-01-25 16:47:00,69,52,Eletrônico,2,121
35569,2024-01-25 16:48:00,43,51,Eletrônico,4,94
35570,2024-01-25 16:49:00,49,164,Móvel,8,213
35571,2024-01-25 16:50:00,81,25,Alimento,2,106
35572,2024-01-25 16:51:00,107,127,Brinquedo,5,234
35573,2024-01-25 16:52:00,78,92,Móvel,9,170
35574,2024-01-25 16:53:00,108,67,Alimento,3,175
35575,2024-01-25 16:54:00,70,11,Móvel,2,81
35576,2024-01-25 16:55:00,42,114,Vestuário,3,156
35577,2024-01-25 16:56:00,26,31,Vestuário,7,57
35578,2024-01-25 16:57:00,16,33,Móvel,4,49
35579,2024-01-25 16:58:00,77,18,Vestuário,7,95
35580,2024-01-25 16:59:00,116,99,Brinquedo,2,215
35581,2024-01-25 17:00:00,42,46,Móvel,3,88
35582,2024-01-25 17:01:00,84,169,Vestuário,3,253
35583,2024-01-25 17:02:00,46,142,Brinquedo,6,188
35584,2024-01-25 17:03:00,109,56,Vestuário,5,165
35585,2024-01-25 17:04:00,28,168,Eletrônico,8,196
35586,2024-01-25 17:05:00,113,98,Eletrônico,9,211
35587,2024-01-25 17:06:00,15,116,Móvel,9,131
35588,2024-01-25 17:07:00,28,170,Brinquedo,4,198
35589,2024-01-25 17:08:00,20,15,Vestuário,3,35
35590,2024-01-25 17:09:00,38,22,Alimento,2,60
35591,2024-01-25 17:10:00,38,176,Brinquedo,5,214
35592,2024-01-25 17:11:00,99,179,Móvel,8,278
35593,2024-01-25 17:12:00,82,169,Brinquedo,8,251
35594,2024-01-25 17:13:00,75,63,Eletrônico,9,138
35595,2024-01-25 17:14:00,73,113,Brinquedo,9,186
35596,2024-01-25 17:15:00,59,10,Vestuário,4,69
35597,2024-01-25 17:16:00,17,58,Eletrônico,6,75
35598,2024-01-25 17:17:00,59,110,Eletrônico,1,169
35599,2024-01-25 17:18:00,69,165,Móvel,6,234
35600,2024-01-25 17:19:00,71,132,Móvel,2,203
35601,2024-01-25 17:20:00,70,95,Móvel,5,165
35602,2024-01-25 17:21:00,38,88,Brinquedo,4,126
35603,2024-01-25 17:22:00,11,56,Móvel,6,67
35604,2024-01-25 17:23:00,10,164,Alimento,1,174
35605,2024-01-25 17:24:00,27,95,Vestuário,5,122
35606,2024-01-25 17:25:00,95,118,Brinquedo,7,213
35607,2024-01-25 17:26:00,96,103,Brinquedo,6,199
35608,2024-01-25 17:27:00,47,147,Alimento,4,194
35609,2024-01-25 17:28:00,86,54,Alimento,7,140
35610,2024-01-25 17:29:00,10,142,Vestuário,5,152
35611,2024-01-25 17:30:00,19,153,Vestuário,7,172
35612,2024-01-25 17:31:00,64,161,Eletrônico,6,225
35613,2024-01-25 17:32:00,61,177,Brinquedo,6,238
35614,2024-01-25 17:33:00,30,139,Alimento,4,169
35615,2024-01-25 17:34:00,89,29,Vestuário,2,118
35616,2024-01-25 17:35:00,55,123,Brinquedo,7,178
35617,2024-01-25 17:36:00,31,147,Móvel,9,178
35618,2024-01-25 17:37:00,63,79,Alimento,7,142
35619,2024-01-25 17:38:00,41,122,Eletrônico,9,163
35620,2024-01-25 17:39:00,68,65,Vestuário,9,133
35621,2024-01-25 17:40:00,58,173,Móvel,6,231
35622,2024-01-25 17:41:00,88,109,Móvel,5,197
35623,2024-01-25 17:42:00,59,43,Vestuário,2,102
35624,2024-01-25 17:43:00,62,62,Eletrônico,4,124
35625,2024-01-25 17:44:00,78,159,Vestuário,1,237
35626,2024-01-25 17:45:00,101,69,Alimento,7,170
35627,2024-01-25 17:46:00,23,113,Vestuário,8,136
35628,2024-01-25 17:47:00,47,17,Alimento,5,64
35629,2024-01-25 17:48:00,40,110,Alimento,1,150
35630,2024-01-25 17:49:00,54,75,Alimento,7,129
35631,2024-01-25 17:50:00,56,86,Vestuário,7,142
35632,2024-01-25 17:51:00,29,120,Móvel,8,149
35633,2024-01-25 17:52:00,18,148,Móvel,5,166
35634,2024-01-25 17:53:00,56,37,Vestuário,5,93
35635,2024-01-25 17:54:00,58,102,Móvel,5,160
35636,2024-01-25 17:55:00,75,102,Móvel,9,177
35637,2024-01-25 17:56:00,74,137,Brinquedo,4,211
35638,2024-01-25 17:57:00,26,107,Vestuário,9,133
35639,2024-01-25 17:58:00,115,105,Vestuário,8,220
35640,2024-01-25 17:59:00,87,148,Alimento,3,235
35641,2024-01-25 18:00:00,67,69,Brinquedo,1,136
35642,2024-01-25 18:01:00,42,155,Eletrônico,9,197
35643,2024-01-25 18:02:00,64,13,Alimento,4,77
35644,2024-01-25 18:03:00,89,153,Móvel,8,242
35645,2024-01-25 18:04:00,116,94,Alimento,7,210
35646,2024-01-25 18:05:00,109,173,Alimento,1,282
35647,2024-01-25 18:06:00,41,55,Alimento,1,96
35648,2024-01-25 18:07:00,77,144,Móvel,2,221
35649,2024-01-25 18:08:00,53,14,Vestuário,3,67
35650,2024-01-25 18:09:00,63,70,Eletrônico,5,133
35651,2024-01-25 18:10:00,82,37,Vestuário,4,119
35652,2024-01-25 18:11:00,72,110,Eletrônico,6,182
35653,2024-01-25 18:12:00,28,107,Vestuário,7,135
35654,2024-01-25 18:13:00,35,120,Eletrônico,3,155
35655,2024-01-25 18:14:00,115,52,Brinquedo,4,167
35656,2024-01-25 18:15:00,119,54,Eletrônico,7,173
35657,2024-01-25 18:16:00,103,124,Móvel,8,227
35658,2024-01-25 18:17:00,77,173,Brinquedo,4,250
35659,2024-01-25 18:18:00,98,50,Vestuário,5,148
35660,2024-01-25 18:19:00,13,167,Eletrônico,1,180
35661,2024-01-25 18:20:00,27,104,Alimento,9,131
35662,2024-01-25 18:21:00,37,138,Eletrônico,5,175
35663,2024-01-25 18:22:00,25,152,Vestuário,2,177
35664,2024-01-25 18:23:00,98,128,Vestuário,5,226
35665,2024-01-25 18:24:00,114,84,Vestuário,8,198
35666,2024-01-25 18:25:00,15,159,Alimento,3,174
35667,2024-01-25 18:26:00,87,40,Alimento,6,127
35668,2024-01-25 18:27:00,87,116,Alimento,9,203
35669,2024-01-25 18:28:00,103,32,Móvel,8,135
35670,2024-01-25 18:29:00,24,143,Alimento,3,167
35671,2024-01-25 18:30:00,63,174,Vestuário,2,237
35672,2024-01-25 18:31:00,106,44,Vestuário,7,150
35673,2024-01-25 18:32:00,20,103,Brinquedo,9,123
35674,2024-01-25 18:33:00,29,88,Eletrônico,8,117
35675,2024-01-25 18:34:00,10,150,Brinquedo,8,160
35676,2024-01-25 18:35:00,27,112,Vestuário,9,139
35677,2024-01-25 18:36:00,19,126,Brinquedo,5,145
35678,2024-01-25 18:37:00,59,119,Vestuário,2,178
35679,2024-01-25 18:38:00,45,25,Eletrônico,1,70
35680,2024-01-25 18:39:00,18,109,Alimento,4,127
35681,2024-01-25 18:40:00,14,131,Vestuário,4,145
35682,2024-01-25 18:41:00,13,177,Brinquedo,7,190
35683,2024-01-25 18:42:00,73,101,Vestuário,4,174
35684,2024-01-25 18:43:00,56,148,Eletrônico,1,204
35685,2024-01-25 18:44:00,114,97,Brinquedo,7,211
35686,2024-01-25 18:45:00,95,54,Eletrônico,7,149
35687,2024-01-25 18:46:00,68,173,Vestuário,6,241
35688,2024-01-25 18:47:00,54,165,Alimento,2,219
35689,2024-01-25 18:48:00,106,120,Alimento,2,226
35690,2024-01-25 18:49:00,96,14,Vestuário,5,110
35691,2024-01-25 18:50:00,32,55,Eletrônico,9,87
35692,2024-01-25 18:51:00,69,110,Brinquedo,7,179
35693,2024-01-25 18:52:00,14,135,Vestuário,7,149
35694,2024-01-25 18:53:00,41,161,Eletrônico,6,202
35695,2024-01-25 18:54:00,13,57,Brinquedo,5,70
35696,2024-01-25 18:55:00,13,91,Móvel,9,104
35697,2024-01-25 18:56:00,42,66,Eletrônico,5,108
35698,2024-01-25 18:57:00,91,134,Eletrônico,8,225
35699,2024-01-25 18:58:00,83,27,Vestuário,2,110
35700,2024-01-25 18:59:00,118,128,Brinquedo,7,246
35701,2024-01-25 19:00:00,119,167,Brinquedo,4,286
35702,2024-01-25 19:01:00,32,101,Eletrônico,5,133
35703,2024-01-25 19:02:00,119,143,Brinquedo,2,262
35704,2024-01-25 19:03:00,15,149,Eletrônico,5,164
35705,2024-01-25 19:04:00,12,146,Móvel,7,158
35706,2024-01-25 19:05:00,99,153,Brinquedo,8,252
35707,2024-01-25 19:06:00,65,63,Vestuário,2,128
35708,2024-01-25 19:07:00,96,73,Brinquedo,8,169
35709,2024-01-25 19:08:00,15,25,Alimento,6,40
35710,2024-01-25 19:09:00,35,150,Móvel,9,185
35711,2024-01-25 19:10:00,42,177,Brinquedo,4,219
35712,2024-01-25 19:11:00,44,139,Eletrônico,1,183
35713,2024-01-25 19:12:00,24,36,Brinquedo,4,60
35714,2024-01-25 19:13:00,12,133,Brinquedo,6,145
35715,2024-01-25 19:14:00,34,70,Móvel,4,104
35716,2024-01-25 19:15:00,65,146,Eletrônico,4,211
35717,2024-01-25 19:16:00,113,127,Eletrônico,9,240
35718,2024-01-25 19:17:00,40,158,Alimento,8,198
35719,2024-01-25 19:18:00,14,42,Alimento,3,56
35720,2024-01-25 19:19:00,78,157,Móvel,3,235
35721,2024-01-25 19:20:00,60,26,Eletrônico,8,86
35722,2024-01-25 19:21:00,102,78,Alimento,7,180
35723,2024-01-25 19:22:00,68,30,Móvel,6,98
35724,2024-01-25 19:23:00,118,59,Brinquedo,4,177
35725,2024-01-25 19:24:00,34,174,Brinquedo,6,208
35726,2024-01-25 19:25:00,33,137,Móvel,8,170
35727,2024-01-25 19:26:00,110,61,Brinquedo,8,171
35728,2024-01-25 19:27:00,45,140,Móvel,2,185
35729,2024-01-25 19:28:00,64,167,Vestuário,7,231
35730,2024-01-25 19:29:00,81,80,Alimento,3,161
35731,2024-01-25 19:30:00,38,177,Alimento,8,215
35732,2024-01-25 19:31:00,69,106,Vestuário,6,175
35733,2024-01-25 19:32:00,35,75,Alimento,6,110
35734,2024-01-25 19:33:00,37,83,Alimento,7,120
35735,2024-01-25 19:34:00,47,149,Eletrônico,3,196
35736,2024-01-25 19:35:00,89,152,Móvel,4,241
35737,2024-01-25 19:36:00,19,164,Alimento,7,183
35738,2024-01-25 19:37:00,61,173,Vestuário,6,234
35739,2024-01-25 19:38:00,14,166,Eletrônico,6,180
35740,2024-01-25 19:39:00,110,146,Vestuário,9,256
35741,2024-01-25 19:40:00,77,32,Móvel,4,109
35742,2024-01-25 19:41:00,22,171,Móvel,3,193
35743,2024-01-25 19:42:00,16,88,Alimento,7,104
35744,2024-01-25 19:43:00,99,71,Móvel,9,170
35745,2024-01-25 19:44:00,36,21,Brinquedo,8,57
35746,2024-01-25 19:45:00,10,44,Brinquedo,3,54
35747,2024-01-25 19:46:00,36,131,Vestuário,1,167
35748,2024-01-25 19:47:00,105,114,Vestuário,3,219
35749,2024-01-25 19:48:00,66,126,Vestuário,6,192
35750,2024-01-25 19:49:00,56,47,Vestuário,5,103
35751,2024-01-25 19:50:00,89,70,Brinquedo,3,159
35752,2024-01-25 19:51:00,20,69,Vestuário,6,89
35753,2024-01-25 19:52:00,119,25,Vestuário,5,144
35754,2024-01-25 19:53:00,25,135,Vestuário,9,160
35755,2024-01-25 19:54:00,13,38,Eletrônico,8,51
35756,2024-01-25 19:55:00,86,108,Brinquedo,4,194
35757,2024-01-25 19:56:00,19,146,Eletrônico,9,165
35758,2024-01-25 19:57:00,96,170,Alimento,5,266
35759,2024-01-25 19:58:00,69,17,Brinquedo,2,86
35760,2024-01-25 19:59:00,59,143,Vestuário,1,202
35761,2024-01-25 20:00:00,83,11,Vestuário,8,94
35762,2024-01-25 20:01:00,37,33,Brinquedo,6,70
35763,2024-01-25 20:02:00,108,85,Brinquedo,7,193
35764,2024-01-25 20:03:00,58,165,Eletrônico,9,223
35765,2024-01-25 20:04:00,76,100,Brinquedo,7,176
35766,2024-01-25 20:05:00,90,58,Alimento,8,148
35767,2024-01-25 20:06:00,68,100,Vestuário,3,168
35768,2024-01-25 20:07:00,60,96,Eletrônico,9,156
35769,2024-01-25 20:08:00,115,29,Móvel,7,144
35770,2024-01-25 20:09:00,94,36,Vestuário,1,130
35771,2024-01-25 20:10:00,47,161,Eletrônico,2,208
35772,2024-01-25 20:11:00,89,59,Vestuário,6,148
35773,2024-01-25 20:12:00,63,98,Móvel,5,161
35774,2024-01-25 20:13:00,49,142,Vestuário,7,191
35775,2024-01-25 20:14:00,107,128,Eletrônico,7,235
35776,2024-01-25 20:15:00,107,161,Móvel,9,268
35777,2024-01-25 20:16:00,49,121,Brinquedo,3,170
35778,2024-01-25 20:17:00,118,111,Móvel,7,229
35779,2024-01-25 20:18:00,102,126,Brinquedo,4,228
35780,2024-01-25 20:19:00,22,133,Brinquedo,8,155
35781,2024-01-25 20:20:00,84,123,Móvel,4,207
35782,2024-01-25 20:21:00,20,145,Eletrônico,1,165
35783,2024-01-25 20:22:00,50,136,Vestuário,7,186
35784,2024-01-25 20:23:00,114,74,Eletrônico,8,188
35785,2024-01-25 20:24:00,117,37,Móvel,7,154
35786,2024-01-25 20:25:00,15,73,Eletrônico,1,88
35787,2024-01-25 20:26:00,42,37,Móvel,8,79
35788,2024-01-25 20:27:00,93,86,Alimento,6,179
35789,2024-01-25 20:28:00,60,25,Brinquedo,1,85
35790,2024-01-25 20:29:00,34,98,Alimento,7,132
35791,2024-01-25 20:30:00,65,150,Móvel,9,215
35792,2024-01-25 20:31:00,51,160,Vestuário,2,211
35793,2024-01-25 20:32:00,85,126,Alimento,8,211
35794,2024-01-25 20:33:00,12,81,Vestuário,8,93
35795,2024-01-25 20:34:00,88,138,Brinquedo,6,226
35796,2024-01-25 20:35:00,54,100,Vestuário,5,154
35797,2024-01-25 20:36:00,17,174,Móvel,8,191
35798,2024-01-25 20:37:00,108,62,Eletrônico,6,170
35799,2024-01-25 20:38:00,38,23,Eletrônico,7,61
35800,2024-01-25 20:39:00,33,44,Vestuário,6,77
35801,2024-01-25 20:40:00,35,34,Alimento,4,69
35802,2024-01-25 20:41:00,72,66,Brinquedo,5,138
35803,2024-01-25 20:42:00,51,126,Brinquedo,2,177
35804,2024-01-25 20:43:00,51,91,Vestuário,6,142
35805,2024-01-25 20:44:00,93,97,Eletrônico,5,190
35806,2024-01-25 20:45:00,23,145,Vestuário,8,168
35807,2024-01-25 20:46:00,98,115,Alimento,9,213
35808,2024-01-25 20:47:00,104,85,Vestuário,1,189
35809,2024-01-25 20:48:00,96,123,Móvel,1,219
35810,2024-01-25 20:49:00,14,17,Móvel,7,31
35811,2024-01-25 20:50:00,31,50,Móvel,1,81
35812,2024-01-25 20:51:00,19,171,Brinquedo,4,190
35813,2024-01-25 20:52:00,19,158,Alimento,8,177
35814,2024-01-25 20:53:00,70,154,Vestuário,2,224
35815,2024-01-25 20:54:00,94,167,Alimento,6,261
35816,2024-01-25 20:55:00,114,35,Alimento,6,149
35817,2024-01-25 20:56:00,91,162,Eletrônico,3,253
35818,2024-01-25 20:57:00,91,147,Alimento,8,238
35819,2024-01-25 20:58:00,53,31,Alimento,8,84
35820,2024-01-25 20:59:00,72,110,Vestuário,6,182
35821,2024-01-25 21:00:00,40,21,Eletrônico,7,61
35822,2024-01-25 21:01:00,16,138,Móvel,4,154
35823,2024-01-25 21:02:00,22,120,Vestuário,4,142
35824,2024-01-25 21:03:00,114,163,Móvel,7,277
35825,2024-01-25 21:04:00,103,87,Alimento,1,190
35826,2024-01-25 21:05:00,13,122,Móvel,4,135
35827,2024-01-25 21:06:00,88,88,Móvel,3,176
35828,2024-01-25 21:07:00,35,58,Eletrônico,1,93
35829,2024-01-25 21:08:00,59,159,Eletrônico,3,218
35830,2024-01-25 21:09:00,77,162,Móvel,3,239
35831,2024-01-25 21:10:00,100,116,Vestuário,2,216
35832,2024-01-25 21:11:00,95,161,Brinquedo,8,256
35833,2024-01-25 21:12:00,67,120,Vestuário,9,187
35834,2024-01-25 21:13:00,83,149,Alimento,9,232
35835,2024-01-25 21:14:00,47,14,Móvel,7,61
35836,2024-01-25 21:15:00,117,62,Vestuário,6,179
35837,2024-01-25 21:16:00,89,111,Brinquedo,3,200
35838,2024-01-25 21:17:00,10,31,Brinquedo,3,41
35839,2024-01-25 21:18:00,44,114,Alimento,6,158
35840,2024-01-25 21:19:00,72,111,Alimento,9,183
35841,2024-01-25 21:20:00,21,170,Alimento,9,191
35842,2024-01-25 21:21:00,113,84,Eletrônico,6,197
35843,2024-01-25 21:22:00,22,67,Brinquedo,9,89
35844,2024-01-25 21:23:00,77,34,Eletrônico,2,111
35845,2024-01-25 21:24:00,70,165,Eletrônico,3,235
35846,2024-01-25 21:25:00,14,67,Móvel,7,81
35847,2024-01-25 21:26:00,50,95,Móvel,7,145
35848,2024-01-25 21:27:00,56,172,Eletrônico,8,228
35849,2024-01-25 21:28:00,21,22,Vestuário,9,43
35850,2024-01-25 21:29:00,105,11,Móvel,5,116
35851,2024-01-25 21:30:00,40,27,Eletrônico,7,67
35852,2024-01-25 21:31:00,95,94,Alimento,7,189
35853,2024-01-25 21:32:00,18,139,Brinquedo,7,157
35854,2024-01-25 21:33:00,54,43,Brinquedo,5,97
35855,2024-01-25 21:34:00,52,102,Vestuário,2,154
35856,2024-01-25 21:35:00,56,58,Alimento,6,114
35857,2024-01-25 21:36:00,77,172,Eletrônico,3,249
35858,2024-01-25 21:37:00,93,115,Alimento,4,208
35859,2024-01-25 21:38:00,80,137,Brinquedo,5,217
35860,2024-01-25 21:39:00,111,120,Brinquedo,2,231
35861,2024-01-25 21:40:00,56,82,Vestuário,8,138
35862,2024-01-25 21:41:00,67,53,Brinquedo,5,120
35863,2024-01-25 21:42:00,67,50,Alimento,6,117
35864,2024-01-25 21:43:00,100,115,Móvel,1,215
35865,2024-01-25 21:44:00,66,79,Vestuário,5,145
35866,2024-01-25 21:45:00,71,166,Alimento,1,237
35867,2024-01-25 21:46:00,32,136,Alimento,3,168
35868,2024-01-25 21:47:00,72,119,Brinquedo,9,191
35869,2024-01-25 21:48:00,81,81,Alimento,7,162
35870,2024-01-25 21:49:00,43,65,Móvel,7,108
35871,2024-01-25 21:50:00,28,138,Vestuário,3,166
35872,2024-01-25 21:51:00,56,126,Brinquedo,1,182
35873,2024-01-25 21:52:00,84,176,Alimento,7,260
35874,2024-01-25 21:53:00,33,63,Brinquedo,5,96
35875,2024-01-25 21:54:00,83,79,Alimento,2,162
35876,2024-01-25 21:55:00,70,152,Alimento,9,222
35877,2024-01-25 21:56:00,105,55,Eletrônico,1,160
35878,2024-01-25 21:57:00,60,20,Brinquedo,2,80
35879,2024-01-25 21:58:00,30,58,Móvel,1,88
35880,2024-01-25 21:59:00,57,70,Eletrônico,1,127
35881,2024-01-25 22:00:00,15,31,Alimento,9,46
35882,2024-01-25 22:01:00,97,72,Alimento,6,169
35883,2024-01-25 22:02:00,61,129,Alimento,4,190
35884,2024-01-25 22:03:00,51,23,Alimento,1,74
35885,2024-01-25 22:04:00,21,121,Móvel,9,142
35886,2024-01-25 22:05:00,25,16,Móvel,7,41
35887,2024-01-25 22:06:00,71,117,Eletrônico,8,188
35888,2024-01-25 22:07:00,51,97,Vestuário,6,148
35889,2024-01-25 22:08:00,44,178,Móvel,1,222
35890,2024-01-25 22:09:00,90,45,Eletrônico,8,135
35891,2024-01-25 22:10:00,75,165,Vestuário,3,240
35892,2024-01-25 22:11:00,100,172,Brinquedo,2,272
35893,2024-01-25 22:12:00,92,81,Alimento,4,173
35894,2024-01-25 22:13:00,76,71,Móvel,8,147
35895,2024-01-25 22:14:00,108,130,Vestuário,6,238
35896,2024-01-25 22:15:00,66,158,Eletrônico,7,224
35897,2024-01-25 22:16:00,64,135,Vestuário,6,199
35898,2024-01-25 22:17:00,42,76,Móvel,4,118
35899,2024-01-25 22:18:00,99,176,Móvel,2,275
35900,2024-01-25 22:19:00,72,11,Alimento,6,83
35901,2024-01-25 22:20:00,11,137,Vestuário,6,148
35902,2024-01-25 22:21:00,43,153,Brinquedo,5,196
35903,2024-01-25 22:22:00,13,13,Móvel,9,26
35904,2024-01-25 22:23:00,118,60,Vestuário,1,178
35905,2024-01-25 22:24:00,104,37,Móvel,9,141
35906,2024-01-25 22:25:00,86,58,Móvel,8,144
35907,2024-01-25 22:26:00,104,30,Móvel,9,134
35908,2024-01-25 22:27:00,100,164,Vestuário,6,264
35909,2024-01-25 22:28:00,76,47,Móvel,2,123
35910,2024-01-25 22:29:00,81,170,Móvel,2,251
35911,2024-01-25 22:30:00,80,71,Eletrônico,5,151
35912,2024-01-25 22:31:00,45,14,Eletrônico,7,59
35913,2024-01-25 22:32:00,63,150,Brinquedo,3,213
35914,2024-01-25 22:33:00,58,166,Brinquedo,4,224
35915,2024-01-25 22:34:00,22,53,Brinquedo,4,75
35916,2024-01-25 22:35:00,107,69,Brinquedo,7,176
35917,2024-01-25 22:36:00,66,119,Eletrônico,5,185
35918,2024-01-25 22:37:00,103,178,Eletrônico,2,281
35919,2024-01-25 22:38:00,67,164,Brinquedo,5,231
35920,2024-01-25 22:39:00,85,61,Eletrônico,8,146
35921,2024-01-25 22:40:00,58,39,Brinquedo,7,97
35922,2024-01-25 22:41:00,83,175,Móvel,1,258
35923,2024-01-25 22:42:00,88,91,Alimento,8,179
35924,2024-01-25 22:43:00,40,161,Eletrônico,1,201
35925,2024-01-25 22:44:00,92,108,Móvel,3,200
35926,2024-01-25 22:45:00,23,54,Móvel,2,77
35927,2024-01-25 22:46:00,29,144,Móvel,2,173
35928,2024-01-25 22:47:00,53,48,Vestuário,3,101
35929,2024-01-25 22:48:00,64,157,Alimento,9,221
35930,2024-01-25 22:49:00,40,23,Vestuário,9,63
35931,2024-01-25 22:50:00,27,112,Vestuário,5,139
35932,2024-01-25 22:51:00,69,61,Alimento,7,130
35933,2024-01-25 22:52:00,22,156,Eletrônico,7,178
35934,2024-01-25 22:53:00,79,14,Eletrônico,5,93
35935,2024-01-25 22:54:00,29,52,Vestuário,2,81
35936,2024-01-25 22:55:00,117,130,Alimento,1,247
35937,2024-01-25 22:56:00,12,88,Alimento,3,100
35938,2024-01-25 22:57:00,22,37,Alimento,3,59
35939,2024-01-25 22:58:00,56,49,Móvel,3,105
35940,2024-01-25 22:59:00,40,43,Brinquedo,2,83
35941,2024-01-25 23:00:00,97,23,Móvel,8,120
35942,2024-01-25 23:01:00,70,32,Vestuário,3,102
35943,2024-01-25 23:02:00,117,136,Eletrônico,7,253
35944,2024-01-25 23:03:00,60,31,Alimento,5,91
35945,2024-01-25 23:04:00,26,104,Alimento,8,130
35946,2024-01-25 23:05:00,42,108,Vestuário,1,150
35947,2024-01-25 23:06:00,24,104,Móvel,3,128
35948,2024-01-25 23:07:00,10,96,Móvel,4,106
35949,2024-01-25 23:08:00,47,169,Alimento,9,216
35950,2024-01-25 23:09:00,20,89,Móvel,6,109
35951,2024-01-25 23:10:00,26,158,Eletrônico,4,184
35952,2024-01-25 23:11:00,119,43,Vestuário,4,162
35953,2024-01-25 23:12:00,64,77,Brinquedo,1,141
35954,2024-01-25 23:13:00,35,173,Móvel,4,208
35955,2024-01-25 23:14:00,114,88,Brinquedo,4,202
35956,2024-01-25 23:15:00,52,157,Alimento,9,209
35957,2024-01-25 23:16:00,108,26,Eletrônico,9,134
35958,2024-01-25 23:17:00,14,163,Brinquedo,1,177
35959,2024-01-25 23:18:00,68,39,Móvel,2,107
35960,2024-01-25 23:19:00,80,171,Móvel,7,251
35961,2024-01-25 23:20:00,59,56,Eletrônico,8,115
35962,2024-01-25 23:21:00,12,44,Móvel,9,56
35963,2024-01-25 23:22:00,24,160,Vestuário,5,184
35964,2024-01-25 23:23:00,11,172,Eletrônico,6,183
35965,2024-01-25 23:24:00,112,147,Eletrônico,5,259
35966,2024-01-25 23:25:00,57,166,Móvel,9,223
35967,2024-01-25 23:26:00,114,117,Móvel,2,231
35968,2024-01-25 23:27:00,38,101,Vestuário,2,139
35969,2024-01-25 23:28:00,69,18,Alimento,6,87
35970,2024-01-25 23:29:00,22,56,Alimento,3,78
35971,2024-01-25 23:30:00,91,47,Eletrônico,9,138
35972,2024-01-25 23:31:00,31,23,Móvel,2,54
35973,2024-01-25 23:32:00,10,173,Brinquedo,4,183
35974,2024-01-25 23:33:00,34,52,Móvel,5,86
35975,2024-01-25 23:34:00,37,112,Eletrônico,8,149
35976,2024-01-25 23:35:00,58,70,Vestuário,1,128
35977,2024-01-25 23:36:00,78,87,Brinquedo,3,165
35978,2024-01-25 23:37:00,32,150,Alimento,3,182
35979,2024-01-25 23:38:00,103,23,Eletrônico,9,126
35980,2024-01-25 23:39:00,79,84,Vestuário,6,163
35981,2024-01-25 23:40:00,114,126,Eletrônico,1,240
35982,2024-01-25 23:41:00,102,172,Móvel,4,274
35983,2024-01-25 23:42:00,103,44,Vestuário,5,147
35984,2024-01-25 23:43:00,29,142,Móvel,6,171
35985,2024-01-25 23:44:00,12,149,Eletrônico,4,161
35986,2024-01-25 23:45:00,97,78,Eletrônico,6,175
35987,2024-01-25 23:46:00,48,115,Vestuário,1,163
35988,2024-01-25 23:47:00,10,121,Eletrônico,6,131
35989,2024-01-25 23:48:00,21,88,Eletrônico,5,109
35990,2024-01-25 23:49:00,100,102,Eletrônico,3,202
35991,2024-01-25 23:50:00,45,144,Brinquedo,8,189
35992,2024-01-25 23:51:00,100,114,Alimento,7,214
35993,2024-01-25 23:52:00,10,172,Eletrônico,6,182
35994,2024-01-25 23:53:00,61,172,Brinquedo,7,233
35995,2024-01-25 23:54:00,106,147,Eletrônico,7,253
35996,2024-01-25 23:55:00,13,133,Móvel,6,146
35997,2024-01-25 23:56:00,42,58,Eletrônico,4,100
35998,2024-01-25 23:57:00,11,173,Móvel,1,184
35999,2024-01-25 23:58:00,14,32,Alimento,2,46
36000,2024-01-25 23:59:00,67,95,Alimento,7,162
36001,2024-01-26 00:00:00,82,37,Brinquedo,2,119
36002,2024-01-26 00:01:00,61,58,Brinquedo,3,119
36003,2024-01-26 00:02:00,10,76,Vestuário,7,86
36004,2024-01-26 00:03:00,117,41,Vestuário,6,158
36005,2024-01-26 00:04:00,70,61,Brinquedo,9,131
36006,2024-01-26 00:05:00,96,150,Móvel,3,246
36007,2024-01-26 00:06:00,101,73,Brinquedo,3,174
36008,2024-01-26 00:07:00,25,142,Eletrônico,7,167
36009,2024-01-26 00:08:00,54,111,Móvel,3,165
36010,2024-01-26 00:09:00,85,67,Móvel,1,152
36011,2024-01-26 00:10:00,85,65,Alimento,2,150
36012,2024-01-26 00:11:00,97,119,Alimento,5,216
36013,2024-01-26 00:12:00,86,175,Eletrônico,7,261
36014,2024-01-26 00:13:00,87,129,Eletrônico,6,216
36015,2024-01-26 00:14:00,49,160,Brinquedo,2,209
36016,2024-01-26 00:15:00,37,82,Vestuário,3,119
36017,2024-01-26 00:16:00,110,28,Vestuário,4,138
36018,2024-01-26 00:17:00,119,92,Móvel,3,211
36019,2024-01-26 00:18:00,119,45,Móvel,7,164
36020,2024-01-26 00:19:00,77,22,Alimento,7,99
36021,2024-01-26 00:20:00,106,20,Eletrônico,9,126
36022,2024-01-26 00:21:00,23,111,Brinquedo,6,134
36023,2024-01-26 00:22:00,73,53,Móvel,7,126
36024,2024-01-26 00:23:00,24,119,Móvel,1,143
36025,2024-01-26 00:24:00,30,21,Brinquedo,9,51
36026,2024-01-26 00:25:00,100,14,Brinquedo,1,114
36027,2024-01-26 00:26:00,83,17,Brinquedo,5,100
36028,2024-01-26 00:27:00,56,124,Eletrônico,9,180
36029,2024-01-26 00:28:00,100,71,Móvel,2,171
36030,2024-01-26 00:29:00,80,24,Brinquedo,6,104
36031,2024-01-26 00:30:00,88,140,Brinquedo,3,228
36032,2024-01-26 00:31:00,69,85,Móvel,4,154
36033,2024-01-26 00:32:00,14,178,Vestuário,5,192
36034,2024-01-26 00:33:00,97,58,Brinquedo,4,155
36035,2024-01-26 00:34:00,45,58,Eletrônico,2,103
36036,2024-01-26 00:35:00,85,169,Móvel,9,254
36037,2024-01-26 00:36:00,40,178,Eletrônico,8,218
36038,2024-01-26 00:37:00,100,87,Vestuário,4,187
36039,2024-01-26 00:38:00,31,153,Alimento,3,184
36040,2024-01-26 00:39:00,74,108,Móvel,9,182
36041,2024-01-26 00:40:00,114,111,Eletrônico,1,225
36042,2024-01-26 00:41:00,39,49,Alimento,4,88
36043,2024-01-26 00:42:00,64,75,Eletrônico,7,139
36044,2024-01-26 00:43:00,80,64,Eletrônico,5,144
36045,2024-01-26 00:44:00,108,59,Brinquedo,5,167
36046,2024-01-26 00:45:00,84,127,Vestuário,6,211
36047,2024-01-26 00:46:00,53,122,Alimento,6,175
36048,2024-01-26 00:47:00,54,113,Eletrônico,7,167
36049,2024-01-26 00:48:00,11,147,Alimento,9,158
36050,2024-01-26 00:49:00,13,68,Brinquedo,6,81
36051,2024-01-26 00:50:00,36,167,Brinquedo,1,203
36052,2024-01-26 00:51:00,12,135,Brinquedo,3,147
36053,2024-01-26 00:52:00,58,140,Alimento,4,198
36054,2024-01-26 00:53:00,100,25,Alimento,1,125
36055,2024-01-26 00:54:00,41,116,Móvel,9,157
36056,2024-01-26 00:55:00,96,129,Móvel,7,225
36057,2024-01-26 00:56:00,113,69,Vestuário,2,182
36058,2024-01-26 00:57:00,116,172,Móvel,7,288
36059,2024-01-26 00:58:00,14,36,Eletrônico,1,50
36060,2024-01-26 00:59:00,82,63,Móvel,1,145
36061,2024-01-26 01:00:00,76,162,Brinquedo,8,238
36062,2024-01-26 01:01:00,102,105,Brinquedo,5,207
36063,2024-01-26 01:02:00,51,82,Vestuário,4,133
36064,2024-01-26 01:03:00,10,60,Vestuário,3,70
36065,2024-01-26 01:04:00,80,43,Alimento,8,123
36066,2024-01-26 01:05:00,13,114,Vestuário,6,127
36067,2024-01-26 01:06:00,82,60,Alimento,4,142
36068,2024-01-26 01:07:00,37,112,Vestuário,5,149
36069,2024-01-26 01:08:00,32,85,Móvel,5,117
36070,2024-01-26 01:09:00,70,169,Eletrônico,1,239
36071,2024-01-26 01:10:00,42,148,Brinquedo,9,190
36072,2024-01-26 01:11:00,30,168,Móvel,9,198
36073,2024-01-26 01:12:00,96,90,Eletrônico,4,186
36074,2024-01-26 01:13:00,39,127,Móvel,5,166
36075,2024-01-26 01:14:00,81,110,Vestuário,8,191
36076,2024-01-26 01:15:00,72,68,Eletrônico,9,140
36077,2024-01-26 01:16:00,72,55,Brinquedo,5,127
36078,2024-01-26 01:17:00,15,110,Vestuário,4,125
36079,2024-01-26 01:18:00,96,73,Alimento,6,169
36080,2024-01-26 01:19:00,37,86,Alimento,3,123
36081,2024-01-26 01:20:00,105,88,Alimento,8,193
36082,2024-01-26 01:21:00,67,174,Eletrônico,4,241
36083,2024-01-26 01:22:00,74,128,Vestuário,5,202
36084,2024-01-26 01:23:00,83,20,Brinquedo,8,103
36085,2024-01-26 01:24:00,33,95,Móvel,8,128
36086,2024-01-26 01:25:00,15,119,Eletrônico,3,134
36087,2024-01-26 01:26:00,87,149,Alimento,2,236
36088,2024-01-26 01:27:00,29,116,Vestuário,5,145
36089,2024-01-26 01:28:00,119,33,Alimento,7,152
36090,2024-01-26 01:29:00,81,52,Alimento,4,133
36091,2024-01-26 01:30:00,86,138,Vestuário,5,224
36092,2024-01-26 01:31:00,103,121,Brinquedo,7,224
36093,2024-01-26 01:32:00,96,168,Eletrônico,6,264
36094,2024-01-26 01:33:00,43,72,Eletrônico,7,115
36095,2024-01-26 01:34:00,34,172,Vestuário,5,206
36096,2024-01-26 01:35:00,114,64,Alimento,7,178
36097,2024-01-26 01:36:00,49,32,Móvel,2,81
36098,2024-01-26 01:37:00,95,45,Eletrônico,1,140
36099,2024-01-26 01:38:00,67,10,Alimento,5,77
36100,2024-01-26 01:39:00,31,166,Alimento,6,197
36101,2024-01-26 01:40:00,84,32,Alimento,2,116
36102,2024-01-26 01:41:00,57,150,Móvel,9,207
36103,2024-01-26 01:42:00,59,118,Móvel,2,177
36104,2024-01-26 01:43:00,109,40,Eletrônico,5,149
36105,2024-01-26 01:44:00,37,20,Brinquedo,9,57
36106,2024-01-26 01:45:00,24,132,Eletrônico,4,156
36107,2024-01-26 01:46:00,97,45,Brinquedo,8,142
36108,2024-01-26 01:47:00,32,149,Móvel,7,181
36109,2024-01-26 01:48:00,15,53,Brinquedo,8,68
36110,2024-01-26 01:49:00,16,143,Brinquedo,2,159
36111,2024-01-26 01:50:00,94,145,Eletrônico,4,239
36112,2024-01-26 01:51:00,97,164,Móvel,7,261
36113,2024-01-26 01:52:00,54,178,Eletrônico,3,232
36114,2024-01-26 01:53:00,42,12,Vestuário,5,54
36115,2024-01-26 01:54:00,119,91,Eletrônico,6,210
36116,2024-01-26 01:55:00,79,27,Vestuário,8,106
36117,2024-01-26 01:56:00,17,157,Alimento,2,174
36118,2024-01-26 01:57:00,23,168,Eletrônico,3,191
36119,2024-01-26 01:58:00,29,67,Alimento,4,96
36120,2024-01-26 01:59:00,34,130,Eletrônico,4,164
36121,2024-01-26 02:00:00,101,168,Móvel,7,269
36122,2024-01-26 02:01:00,55,178,Móvel,4,233
36123,2024-01-26 02:02:00,55,38,Alimento,3,93
36124,2024-01-26 02:03:00,102,102,Brinquedo,8,204
36125,2024-01-26 02:04:00,30,176,Brinquedo,4,206
36126,2024-01-26 02:05:00,13,32,Brinquedo,4,45
36127,2024-01-26 02:06:00,90,10,Alimento,7,100
36128,2024-01-26 02:07:00,104,78,Vestuário,4,182
36129,2024-01-26 02:08:00,40,63,Móvel,2,103
36130,2024-01-26 02:09:00,38,83,Eletrônico,4,121
36131,2024-01-26 02:10:00,88,59,Vestuário,5,147
36132,2024-01-26 02:11:00,10,176,Vestuário,4,186
36133,2024-01-26 02:12:00,67,45,Alimento,1,112
36134,2024-01-26 02:13:00,63,111,Eletrônico,1,174
36135,2024-01-26 02:14:00,11,84,Eletrônico,1,95
36136,2024-01-26 02:15:00,60,131,Vestuário,1,191
36137,2024-01-26 02:16:00,76,65,Alimento,3,141
36138,2024-01-26 02:17:00,65,159,Eletrônico,3,224
36139,2024-01-26 02:18:00,75,82,Alimento,7,157
36140,2024-01-26 02:19:00,115,165,Brinquedo,2,280
36141,2024-01-26 02:20:00,32,68,Brinquedo,3,100
36142,2024-01-26 02:21:00,48,73,Alimento,2,121
36143,2024-01-26 02:22:00,67,20,Eletrônico,8,87
36144,2024-01-26 02:23:00,12,54,Brinquedo,9,66
36145,2024-01-26 02:24:00,80,63,Vestuário,8,143
36146,2024-01-26 02:25:00,48,22,Brinquedo,5,70
36147,2024-01-26 02:26:00,98,170,Brinquedo,3,268
36148,2024-01-26 02:27:00,117,23,Eletrônico,8,140
36149,2024-01-26 02:28:00,94,112,Brinquedo,5,206
36150,2024-01-26 02:29:00,54,62,Alimento,7,116
36151,2024-01-26 02:30:00,101,60,Brinquedo,4,161
36152,2024-01-26 02:31:00,54,178,Móvel,8,232
36153,2024-01-26 02:32:00,32,89,Alimento,5,121
36154,2024-01-26 02:33:00,97,129,Vestuário,8,226
36155,2024-01-26 02:34:00,15,51,Brinquedo,7,66
36156,2024-01-26 02:35:00,61,19,Alimento,2,80
36157,2024-01-26 02:36:00,61,173,Brinquedo,6,234
36158,2024-01-26 02:37:00,73,178,Móvel,6,251
36159,2024-01-26 02:38:00,67,119,Brinquedo,3,186
36160,2024-01-26 02:39:00,18,63,Alimento,1,81
36161,2024-01-26 02:40:00,115,27,Vestuário,3,142
36162,2024-01-26 02:41:00,73,19,Brinquedo,1,92
36163,2024-01-26 02:42:00,70,169,Vestuário,9,239
36164,2024-01-26 02:43:00,10,161,Móvel,7,171
36165,2024-01-26 02:44:00,65,157,Brinquedo,9,222
36166,2024-01-26 02:45:00,105,30,Eletrônico,5,135
36167,2024-01-26 02:46:00,11,82,Brinquedo,5,93
36168,2024-01-26 02:47:00,107,78,Alimento,4,185
36169,2024-01-26 02:48:00,50,134,Alimento,4,184
36170,2024-01-26 02:49:00,57,32,Eletrônico,9,89
36171,2024-01-26 02:50:00,55,16,Brinquedo,4,71
36172,2024-01-26 02:51:00,85,128,Móvel,8,213
36173,2024-01-26 02:52:00,32,106,Móvel,6,138
36174,2024-01-26 02:53:00,72,126,Móvel,3,198
36175,2024-01-26 02:54:00,80,31,Vestuário,2,111
36176,2024-01-26 02:55:00,58,77,Vestuário,8,135
36177,2024-01-26 02:56:00,25,92,Vestuário,4,117
36178,2024-01-26 02:57:00,119,54,Móvel,3,173
36179,2024-01-26 02:58:00,19,75,Vestuário,3,94
36180,2024-01-26 02:59:00,105,80,Brinquedo,5,185
36181,2024-01-26 03:00:00,28,131,Móvel,6,159
36182,2024-01-26 03:01:00,75,38,Móvel,5,113
36183,2024-01-26 03:02:00,24,39,Móvel,4,63
36184,2024-01-26 03:03:00,25,42,Vestuário,6,67
36185,2024-01-26 03:04:00,36,10,Eletrônico,2,46
36186,2024-01-26 03:05:00,96,127,Alimento,5,223
36187,2024-01-26 03:06:00,105,45,Vestuário,6,150
36188,2024-01-26 03:07:00,37,154,Eletrônico,8,191
36189,2024-01-26 03:08:00,72,12,Eletrônico,7,84
36190,2024-01-26 03:09:00,36,24,Alimento,6,60
36191,2024-01-26 03:10:00,113,158,Alimento,5,271
36192,2024-01-26 03:11:00,71,92,Brinquedo,9,163
36193,2024-01-26 03:12:00,101,54,Móvel,9,155
36194,2024-01-26 03:13:00,75,21,Brinquedo,9,96
36195,2024-01-26 03:14:00,40,145,Vestuário,9,185
36196,2024-01-26 03:15:00,98,119,Alimento,7,217
36197,2024-01-26 03:16:00,27,121,Vestuário,6,148
36198,2024-01-26 03:17:00,107,50,Vestuário,1,157
36199,2024-01-26 03:18:00,44,156,Vestuário,2,200
36200,2024-01-26 03:19:00,73,151,Móvel,4,224
36201,2024-01-26 03:20:00,20,70,Vestuário,7,90
36202,2024-01-26 03:21:00,64,14,Alimento,2,78
36203,2024-01-26 03:22:00,119,169,Vestuário,3,288
36204,2024-01-26 03:23:00,110,50,Alimento,9,160
36205,2024-01-26 03:24:00,20,129,Móvel,5,149
36206,2024-01-26 03:25:00,101,34,Móvel,5,135
36207,2024-01-26 03:26:00,61,113,Eletrônico,9,174
36208,2024-01-26 03:27:00,10,173,Alimento,3,183
36209,2024-01-26 03:28:00,76,91,Alimento,3,167
36210,2024-01-26 03:29:00,68,125,Vestuário,8,193
36211,2024-01-26 03:30:00,105,20,Vestuário,1,125
36212,2024-01-26 03:31:00,97,51,Brinquedo,6,148
36213,2024-01-26 03:32:00,91,54,Vestuário,4,145
36214,2024-01-26 03:33:00,90,137,Móvel,1,227
36215,2024-01-26 03:34:00,15,123,Brinquedo,9,138
36216,2024-01-26 03:35:00,116,153,Brinquedo,7,269
36217,2024-01-26 03:36:00,19,67,Alimento,7,86
36218,2024-01-26 03:37:00,77,145,Móvel,4,222
36219,2024-01-26 03:38:00,40,67,Brinquedo,9,107
36220,2024-01-26 03:39:00,11,130,Vestuário,9,141
36221,2024-01-26 03:40:00,93,15,Vestuário,7,108
36222,2024-01-26 03:41:00,92,112,Eletrônico,2,204
36223,2024-01-26 03:42:00,52,58,Eletrônico,9,110
36224,2024-01-26 03:43:00,99,18,Alimento,4,117
36225,2024-01-26 03:44:00,116,49,Eletrônico,5,165
36226,2024-01-26 03:45:00,57,147,Vestuário,1,204
36227,2024-01-26 03:46:00,110,179,Brinquedo,9,289
36228,2024-01-26 03:47:00,33,66,Brinquedo,6,99
36229,2024-01-26 03:48:00,99,169,Vestuário,6,268
36230,2024-01-26 03:49:00,46,68,Brinquedo,9,114
36231,2024-01-26 03:50:00,19,48,Alimento,9,67
36232,2024-01-26 03:51:00,100,115,Eletrônico,9,215
36233,2024-01-26 03:52:00,60,73,Alimento,6,133
36234,2024-01-26 03:53:00,18,62,Vestuário,5,80
36235,2024-01-26 03:54:00,84,125,Brinquedo,3,209
36236,2024-01-26 03:55:00,23,117,Móvel,9,140
36237,2024-01-26 03:56:00,73,65,Móvel,1,138
36238,2024-01-26 03:57:00,87,70,Móvel,5,157
36239,2024-01-26 03:58:00,60,159,Eletrônico,9,219
36240,2024-01-26 03:59:00,119,32,Brinquedo,4,151
36241,2024-01-26 04:00:00,32,135,Brinquedo,5,167
36242,2024-01-26 04:01:00,38,10,Vestuário,9,48
36243,2024-01-26 04:02:00,95,96,Alimento,7,191
36244,2024-01-26 04:03:00,28,126,Móvel,5,154
36245,2024-01-26 04:04:00,21,177,Móvel,8,198
36246,2024-01-26 04:05:00,112,30,Alimento,3,142
36247,2024-01-26 04:06:00,27,161,Móvel,6,188
36248,2024-01-26 04:07:00,69,72,Alimento,3,141
36249,2024-01-26 04:08:00,76,109,Alimento,8,185
36250,2024-01-26 04:09:00,113,22,Brinquedo,6,135
36251,2024-01-26 04:10:00,73,36,Brinquedo,7,109
36252,2024-01-26 04:11:00,28,24,Brinquedo,2,52
36253,2024-01-26 04:12:00,56,72,Vestuário,6,128
36254,2024-01-26 04:13:00,105,149,Brinquedo,8,254
36255,2024-01-26 04:14:00,14,93,Vestuário,8,107
36256,2024-01-26 04:15:00,55,62,Brinquedo,6,117
36257,2024-01-26 04:16:00,43,125,Alimento,2,168
36258,2024-01-26 04:17:00,110,161,Brinquedo,9,271
36259,2024-01-26 04:18:00,16,88,Brinquedo,9,104
36260,2024-01-26 04:19:00,55,80,Vestuário,6,135
36261,2024-01-26 04:20:00,72,76,Móvel,6,148
36262,2024-01-26 04:21:00,107,69,Alimento,3,176
36263,2024-01-26 04:22:00,26,105,Eletrônico,7,131
36264,2024-01-26 04:23:00,111,86,Vestuário,7,197
36265,2024-01-26 04:24:00,35,58,Eletrônico,6,93
36266,2024-01-26 04:25:00,35,149,Brinquedo,4,184
36267,2024-01-26 04:26:00,30,17,Alimento,5,47
36268,2024-01-26 04:27:00,43,49,Móvel,1,92
36269,2024-01-26 04:28:00,34,110,Alimento,3,144
36270,2024-01-26 04:29:00,68,33,Vestuário,3,101
36271,2024-01-26 04:30:00,73,87,Brinquedo,3,160
36272,2024-01-26 04:31:00,99,93,Brinquedo,6,192
36273,2024-01-26 04:32:00,73,110,Móvel,7,183
36274,2024-01-26 04:33:00,116,48,Eletrônico,2,164
36275,2024-01-26 04:34:00,94,27,Eletrônico,9,121
36276,2024-01-26 04:35:00,43,22,Móvel,2,65
36277,2024-01-26 04:36:00,11,115,Alimento,4,126
36278,2024-01-26 04:37:00,24,145,Brinquedo,4,169
36279,2024-01-26 04:38:00,77,26,Eletrônico,3,103
36280,2024-01-26 04:39:00,104,61,Brinquedo,7,165
36281,2024-01-26 04:40:00,88,87,Móvel,4,175
36282,2024-01-26 04:41:00,103,19,Móvel,9,122
36283,2024-01-26 04:42:00,108,103,Vestuário,6,211
36284,2024-01-26 04:43:00,77,175,Alimento,1,252
36285,2024-01-26 04:44:00,75,75,Brinquedo,3,150
36286,2024-01-26 04:45:00,15,41,Brinquedo,3,56
36287,2024-01-26 04:46:00,73,70,Móvel,9,143
36288,2024-01-26 04:47:00,34,155,Móvel,8,189
36289,2024-01-26 04:48:00,72,88,Brinquedo,4,160
36290,2024-01-26 04:49:00,92,29,Vestuário,1,121
36291,2024-01-26 04:50:00,26,112,Eletrônico,3,138
36292,2024-01-26 04:51:00,79,47,Vestuário,4,126
36293,2024-01-26 04:52:00,63,148,Alimento,6,211
36294,2024-01-26 04:53:00,72,168,Alimento,2,240
36295,2024-01-26 04:54:00,78,63,Móvel,7,141
36296,2024-01-26 04:55:00,41,93,Eletrônico,6,134
36297,2024-01-26 04:56:00,55,105,Brinquedo,7,160
36298,2024-01-26 04:57:00,97,75,Alimento,4,172
36299,2024-01-26 04:58:00,74,32,Alimento,3,106
36300,2024-01-26 04:59:00,35,92,Eletrônico,8,127
36301,2024-01-26 05:00:00,23,71,Vestuário,9,94
36302,2024-01-26 05:01:00,13,25,Alimento,5,38
36303,2024-01-26 05:02:00,48,93,Móvel,7,141
36304,2024-01-26 05:03:00,55,33,Brinquedo,5,88
36305,2024-01-26 05:04:00,79,57,Alimento,3,136
36306,2024-01-26 05:05:00,29,28,Alimento,3,57
36307,2024-01-26 05:06:00,85,96,Alimento,7,181
36308,2024-01-26 05:07:00,79,75,Vestuário,2,154
36309,2024-01-26 05:08:00,64,114,Brinquedo,4,178
36310,2024-01-26 05:09:00,106,14,Alimento,2,120
36311,2024-01-26 05:10:00,46,114,Vestuário,2,160
36312,2024-01-26 05:11:00,45,31,Eletrônico,1,76
36313,2024-01-26 05:12:00,92,62,Alimento,3,154
36314,2024-01-26 05:13:00,18,32,Móvel,9,50
36315,2024-01-26 05:14:00,23,40,Alimento,6,63
36316,2024-01-26 05:15:00,116,172,Alimento,4,288
36317,2024-01-26 05:16:00,46,111,Brinquedo,7,157
36318,2024-01-26 05:17:00,91,37,Alimento,8,128
36319,2024-01-26 05:18:00,102,176,Vestuário,5,278
36320,2024-01-26 05:19:00,49,99,Alimento,5,148
36321,2024-01-26 05:20:00,55,100,Brinquedo,4,155
36322,2024-01-26 05:21:00,97,173,Vestuário,5,270
36323,2024-01-26 05:22:00,116,63,Brinquedo,4,179
36324,2024-01-26 05:23:00,94,49,Eletrônico,1,143
36325,2024-01-26 05:24:00,90,113,Móvel,1,203
36326,2024-01-26 05:25:00,25,117,Brinquedo,9,142
36327,2024-01-26 05:26:00,68,156,Brinquedo,1,224
36328,2024-01-26 05:27:00,117,20,Alimento,3,137
36329,2024-01-26 05:28:00,41,80,Alimento,7,121
36330,2024-01-26 05:29:00,24,39,Móvel,6,63
36331,2024-01-26 05:30:00,23,60,Vestuário,3,83
36332,2024-01-26 05:31:00,39,21,Móvel,6,60
36333,2024-01-26 05:32:00,65,54,Vestuário,7,119
36334,2024-01-26 05:33:00,57,162,Brinquedo,1,219
36335,2024-01-26 05:34:00,105,111,Eletrônico,3,216
36336,2024-01-26 05:35:00,14,124,Brinquedo,6,138
36337,2024-01-26 05:36:00,105,142,Brinquedo,2,247
36338,2024-01-26 05:37:00,30,166,Vestuário,9,196
36339,2024-01-26 05:38:00,73,168,Brinquedo,5,241
36340,2024-01-26 05:39:00,85,178,Alimento,8,263
36341,2024-01-26 05:40:00,76,18,Alimento,5,94
36342,2024-01-26 05:41:00,75,19,Brinquedo,6,94
36343,2024-01-26 05:42:00,51,65,Brinquedo,8,116
36344,2024-01-26 05:43:00,51,33,Móvel,6,84
36345,2024-01-26 05:44:00,57,71,Móvel,7,128
36346,2024-01-26 05:45:00,17,80,Brinquedo,3,97
36347,2024-01-26 05:46:00,39,53,Vestuário,8,92
36348,2024-01-26 05:47:00,109,136,Vestuário,8,245
36349,2024-01-26 05:48:00,79,109,Brinquedo,1,188
36350,2024-01-26 05:49:00,84,24,Móvel,4,108
36351,2024-01-26 05:50:00,16,35,Móvel,8,51
36352,2024-01-26 05:51:00,96,19,Vestuário,2,115
36353,2024-01-26 05:52:00,54,94,Alimento,4,148
36354,2024-01-26 05:53:00,102,136,Brinquedo,7,238
36355,2024-01-26 05:54:00,17,26,Brinquedo,4,43
36356,2024-01-26 05:55:00,29,84,Alimento,6,113
36357,2024-01-26 05:56:00,65,62,Eletrônico,9,127
36358,2024-01-26 05:57:00,71,72,Brinquedo,2,143
36359,2024-01-26 05:58:00,69,13,Móvel,7,82
36360,2024-01-26 05:59:00,45,106,Móvel,9,151
36361,2024-01-26 06:00:00,93,144,Brinquedo,3,237
36362,2024-01-26 06:01:00,56,122,Móvel,1,178
36363,2024-01-26 06:02:00,48,69,Eletrônico,7,117
36364,2024-01-26 06:03:00,23,80,Alimento,7,103
36365,2024-01-26 06:04:00,47,167,Alimento,1,214
36366,2024-01-26 06:05:00,80,139,Vestuário,5,219
36367,2024-01-26 06:06:00,33,116,Brinquedo,7,149
36368,2024-01-26 06:07:00,57,72,Vestuário,6,129
36369,2024-01-26 06:08:00,12,161,Eletrônico,9,173
36370,2024-01-26 06:09:00,102,29,Alimento,9,131
36371,2024-01-26 06:10:00,99,152,Eletrônico,1,251
36372,2024-01-26 06:11:00,18,106,Brinquedo,5,124
36373,2024-01-26 06:12:00,65,79,Móvel,9,144
36374,2024-01-26 06:13:00,45,78,Vestuário,4,123
36375,2024-01-26 06:14:00,113,157,Alimento,7,270
36376,2024-01-26 06:15:00,103,103,Eletrônico,7,206
36377,2024-01-26 06:16:00,83,146,Vestuário,1,229
36378,2024-01-26 06:17:00,78,76,Eletrônico,1,154
36379,2024-01-26 06:18:00,68,124,Eletrônico,3,192
36380,2024-01-26 06:19:00,62,39,Eletrônico,4,101
36381,2024-01-26 06:20:00,84,177,Vestuário,9,261
36382,2024-01-26 06:21:00,90,155,Brinquedo,3,245
36383,2024-01-26 06:22:00,22,155,Brinquedo,2,177
36384,2024-01-26 06:23:00,65,105,Eletrônico,2,170
36385,2024-01-26 06:24:00,51,139,Alimento,8,190
36386,2024-01-26 06:25:00,61,138,Vestuário,4,199
36387,2024-01-26 06:26:00,34,16,Vestuário,8,50
36388,2024-01-26 06:27:00,65,27,Vestuário,8,92
36389,2024-01-26 06:28:00,31,121,Móvel,8,152
36390,2024-01-26 06:29:00,33,12,Brinquedo,6,45
36391,2024-01-26 06:30:00,77,24,Vestuário,5,101
36392,2024-01-26 06:31:00,48,38,Eletrônico,8,86
36393,2024-01-26 06:32:00,76,179,Eletrônico,9,255
36394,2024-01-26 06:33:00,104,64,Vestuário,6,168
36395,2024-01-26 06:34:00,59,110,Vestuário,8,169
36396,2024-01-26 06:35:00,88,166,Brinquedo,5,254
36397,2024-01-26 06:36:00,70,162,Móvel,6,232
36398,2024-01-26 06:37:00,11,66,Vestuário,1,77
36399,2024-01-26 06:38:00,84,114,Vestuário,8,198
36400,2024-01-26 06:39:00,51,115,Móvel,9,166
36401,2024-01-26 06:40:00,53,137,Móvel,6,190
36402,2024-01-26 06:41:00,20,22,Eletrônico,3,42
36403,2024-01-26 06:42:00,33,22,Eletrônico,7,55
36404,2024-01-26 06:43:00,103,161,Brinquedo,1,264
36405,2024-01-26 06:44:00,42,99,Vestuário,1,141
36406,2024-01-26 06:45:00,115,98,Eletrônico,6,213
36407,2024-01-26 06:46:00,73,67,Alimento,9,140
36408,2024-01-26 06:47:00,43,27,Brinquedo,4,70
36409,2024-01-26 06:48:00,109,116,Alimento,9,225
36410,2024-01-26 06:49:00,47,11,Brinquedo,8,58
36411,2024-01-26 06:50:00,15,114,Móvel,6,129
36412,2024-01-26 06:51:00,82,130,Móvel,4,212
36413,2024-01-26 06:52:00,20,153,Vestuário,4,173
36414,2024-01-26 06:53:00,119,167,Móvel,3,286
36415,2024-01-26 06:54:00,89,82,Eletrônico,6,171
36416,2024-01-26 06:55:00,34,166,Eletrônico,8,200
36417,2024-01-26 06:56:00,115,36,Alimento,4,151
36418,2024-01-26 06:57:00,93,90,Móvel,5,183
36419,2024-01-26 06:58:00,62,33,Móvel,1,95
36420,2024-01-26 06:59:00,73,55,Móvel,1,128
36421,2024-01-26 07:00:00,35,29,Alimento,6,64
36422,2024-01-26 07:01:00,107,94,Móvel,6,201
36423,2024-01-26 07:02:00,81,99,Brinquedo,5,180
36424,2024-01-26 07:03:00,66,58,Vestuário,5,124
36425,2024-01-26 07:04:00,103,100,Brinquedo,3,203
36426,2024-01-26 07:05:00,102,136,Móvel,1,238
36427,2024-01-26 07:06:00,86,176,Eletrônico,2,262
36428,2024-01-26 07:07:00,13,63,Alimento,8,76
36429,2024-01-26 07:08:00,32,64,Vestuário,9,96
36430,2024-01-26 07:09:00,67,159,Alimento,2,226
36431,2024-01-26 07:10:00,58,24,Eletrônico,2,82
36432,2024-01-26 07:11:00,51,135,Eletrônico,5,186
36433,2024-01-26 07:12:00,22,70,Alimento,3,92
36434,2024-01-26 07:13:00,67,29,Móvel,8,96
36435,2024-01-26 07:14:00,61,11,Móvel,2,72
36436,2024-01-26 07:15:00,46,68,Brinquedo,1,114
36437,2024-01-26 07:16:00,91,34,Alimento,4,125
36438,2024-01-26 07:17:00,15,38,Móvel,4,53
36439,2024-01-26 07:18:00,79,120,Brinquedo,9,199
36440,2024-01-26 07:19:00,75,62,Alimento,1,137
36441,2024-01-26 07:20:00,81,124,Brinquedo,2,205
36442,2024-01-26 07:21:00,38,27,Brinquedo,1,65
36443,2024-01-26 07:22:00,51,154,Eletrônico,1,205
36444,2024-01-26 07:23:00,81,124,Brinquedo,2,205
36445,2024-01-26 07:24:00,12,17,Eletrônico,7,29
36446,2024-01-26 07:25:00,78,118,Vestuário,3,196
36447,2024-01-26 07:26:00,112,89,Móvel,3,201
36448,2024-01-26 07:27:00,71,90,Eletrônico,5,161
36449,2024-01-26 07:28:00,49,16,Brinquedo,8,65
36450,2024-01-26 07:29:00,15,82,Eletrônico,8,97
36451,2024-01-26 07:30:00,40,32,Alimento,2,72
36452,2024-01-26 07:31:00,101,18,Móvel,9,119
36453,2024-01-26 07:32:00,73,134,Vestuário,5,207
36454,2024-01-26 07:33:00,116,166,Móvel,3,282
36455,2024-01-26 07:34:00,81,11,Eletrônico,8,92
36456,2024-01-26 07:35:00,49,169,Eletrônico,3,218
36457,2024-01-26 07:36:00,100,34,Vestuário,4,134
36458,2024-01-26 07:37:00,59,112,Eletrônico,2,171
36459,2024-01-26 07:38:00,30,23,Eletrônico,1,53
36460,2024-01-26 07:39:00,68,75,Eletrônico,1,143
36461,2024-01-26 07:40:00,119,18,Alimento,2,137
36462,2024-01-26 07:41:00,13,179,Alimento,8,192
36463,2024-01-26 07:42:00,82,84,Vestuário,2,166
36464,2024-01-26 07:43:00,52,163,Vestuário,1,215
36465,2024-01-26 07:44:00,26,163,Vestuário,5,189
36466,2024-01-26 07:45:00,36,117,Eletrônico,8,153
36467,2024-01-26 07:46:00,96,59,Alimento,7,155
36468,2024-01-26 07:47:00,39,110,Alimento,1,149
36469,2024-01-26 07:48:00,97,104,Vestuário,6,201
36470,2024-01-26 07:49:00,110,123,Brinquedo,1,233
36471,2024-01-26 07:50:00,31,177,Alimento,4,208
36472,2024-01-26 07:51:00,106,141,Móvel,3,247
36473,2024-01-26 07:52:00,114,60,Vestuário,2,174
36474,2024-01-26 07:53:00,51,98,Vestuário,3,149
36475,2024-01-26 07:54:00,58,57,Alimento,8,115
36476,2024-01-26 07:55:00,12,129,Brinquedo,6,141
36477,2024-01-26 07:56:00,15,152,Alimento,5,167
36478,2024-01-26 07:57:00,25,157,Móvel,8,182
36479,2024-01-26 07:58:00,89,130,Vestuário,8,219
36480,2024-01-26 07:59:00,34,91,Brinquedo,3,125
36481,2024-01-26 08:00:00,106,49,Móvel,4,155
36482,2024-01-26 08:01:00,105,126,Eletrônico,2,231
36483,2024-01-26 08:02:00,103,100,Alimento,1,203
36484,2024-01-26 08:03:00,60,119,Móvel,3,179
36485,2024-01-26 08:04:00,24,135,Brinquedo,9,159
36486,2024-01-26 08:05:00,47,165,Móvel,9,212
36487,2024-01-26 08:06:00,54,123,Vestuário,4,177
36488,2024-01-26 08:07:00,30,52,Eletrônico,3,82
36489,2024-01-26 08:08:00,21,170,Móvel,1,191
36490,2024-01-26 08:09:00,114,132,Brinquedo,8,246
36491,2024-01-26 08:10:00,94,167,Eletrônico,8,261
36492,2024-01-26 08:11:00,110,91,Móvel,2,201
36493,2024-01-26 08:12:00,33,72,Eletrônico,6,105
36494,2024-01-26 08:13:00,53,98,Eletrônico,8,151
36495,2024-01-26 08:14:00,41,84,Vestuário,7,125
36496,2024-01-26 08:15:00,20,58,Móvel,9,78
36497,2024-01-26 08:16:00,89,171,Alimento,9,260
36498,2024-01-26 08:17:00,87,10,Eletrônico,1,97
36499,2024-01-26 08:18:00,68,179,Móvel,9,247
36500,2024-01-26 08:19:00,98,42,Vestuário,2,140
36501,2024-01-26 08:20:00,91,17,Vestuário,6,108
36502,2024-01-26 08:21:00,77,109,Móvel,3,186
36503,2024-01-26 08:22:00,92,89,Vestuário,3,181
36504,2024-01-26 08:23:00,88,57,Vestuário,4,145
36505,2024-01-26 08:24:00,52,114,Vestuário,9,166
36506,2024-01-26 08:25:00,92,114,Alimento,5,206
36507,2024-01-26 08:26:00,33,35,Eletrônico,2,68
36508,2024-01-26 08:27:00,104,58,Brinquedo,3,162
36509,2024-01-26 08:28:00,78,56,Alimento,2,134
36510,2024-01-26 08:29:00,69,73,Móvel,4,142
36511,2024-01-26 08:30:00,116,162,Móvel,3,278
36512,2024-01-26 08:31:00,32,35,Brinquedo,4,67
36513,2024-01-26 08:32:00,25,116,Alimento,4,141
36514,2024-01-26 08:33:00,45,112,Eletrônico,8,157
36515,2024-01-26 08:34:00,78,145,Brinquedo,1,223
36516,2024-01-26 08:35:00,30,127,Brinquedo,2,157
36517,2024-01-26 08:36:00,26,85,Brinquedo,7,111
36518,2024-01-26 08:37:00,75,125,Brinquedo,8,200
36519,2024-01-26 08:38:00,91,13,Móvel,9,104
36520,2024-01-26 08:39:00,110,31,Vestuário,7,141
36521,2024-01-26 08:40:00,82,147,Móvel,5,229
36522,2024-01-26 08:41:00,60,124,Eletrônico,3,184
36523,2024-01-26 08:42:00,14,121,Vestuário,3,135
36524,2024-01-26 08:43:00,106,49,Brinquedo,8,155
36525,2024-01-26 08:44:00,84,31,Brinquedo,3,115
36526,2024-01-26 08:45:00,64,83,Vestuário,2,147
36527,2024-01-26 08:46:00,22,25,Eletrônico,9,47
36528,2024-01-26 08:47:00,91,155,Alimento,5,246
36529,2024-01-26 08:48:00,49,170,Brinquedo,7,219
36530,2024-01-26 08:49:00,22,109,Vestuário,7,131
36531,2024-01-26 08:50:00,73,73,Alimento,1,146
36532,2024-01-26 08:51:00,50,142,Vestuário,8,192
36533,2024-01-26 08:52:00,48,22,Vestuário,2,70
36534,2024-01-26 08:53:00,50,175,Eletrônico,5,225
36535,2024-01-26 08:54:00,109,72,Brinquedo,8,181
36536,2024-01-26 08:55:00,55,153,Brinquedo,8,208
36537,2024-01-26 08:56:00,68,169,Vestuário,5,237
36538,2024-01-26 08:57:00,33,114,Alimento,4,147
36539,2024-01-26 08:58:00,28,127,Móvel,5,155
36540,2024-01-26 08:59:00,56,65,Vestuário,5,121
36541,2024-01-26 09:00:00,94,52,Alimento,5,146
36542,2024-01-26 09:01:00,34,68,Brinquedo,6,102
36543,2024-01-26 09:02:00,24,17,Eletrônico,2,41
36544,2024-01-26 09:03:00,54,37,Vestuário,3,91
36545,2024-01-26 09:04:00,67,178,Eletrônico,5,245
36546,2024-01-26 09:05:00,67,139,Alimento,8,206
36547,2024-01-26 09:06:00,102,92,Eletrônico,1,194
36548,2024-01-26 09:07:00,33,70,Eletrônico,7,103
36549,2024-01-26 09:08:00,111,131,Vestuário,9,242
36550,2024-01-26 09:09:00,20,16,Eletrônico,3,36
36551,2024-01-26 09:10:00,19,176,Móvel,8,195
36552,2024-01-26 09:11:00,26,126,Móvel,9,152
36553,2024-01-26 09:12:00,18,32,Móvel,2,50
36554,2024-01-26 09:13:00,85,109,Eletrônico,4,194
36555,2024-01-26 09:14:00,64,140,Brinquedo,1,204
36556,2024-01-26 09:15:00,40,123,Móvel,9,163
36557,2024-01-26 09:16:00,88,156,Vestuário,2,244
36558,2024-01-26 09:17:00,40,36,Eletrônico,7,76
36559,2024-01-26 09:18:00,85,69,Alimento,5,154
36560,2024-01-26 09:19:00,87,16,Alimento,3,103
36561,2024-01-26 09:20:00,54,41,Vestuário,4,95
36562,2024-01-26 09:21:00,107,25,Alimento,6,132
36563,2024-01-26 09:22:00,75,46,Alimento,8,121
36564,2024-01-26 09:23:00,38,69,Eletrônico,3,107
36565,2024-01-26 09:24:00,107,132,Alimento,9,239
36566,2024-01-26 09:25:00,110,152,Eletrônico,4,262
36567,2024-01-26 09:26:00,10,106,Brinquedo,7,116
36568,2024-01-26 09:27:00,42,95,Vestuário,8,137
36569,2024-01-26 09:28:00,108,70,Alimento,9,178
36570,2024-01-26 09:29:00,68,111,Alimento,1,179
36571,2024-01-26 09:30:00,82,39,Eletrônico,8,121
36572,2024-01-26 09:31:00,108,147,Alimento,1,255
36573,2024-01-26 09:32:00,31,128,Móvel,7,159
36574,2024-01-26 09:33:00,41,65,Vestuário,4,106
36575,2024-01-26 09:34:00,88,91,Móvel,8,179
36576,2024-01-26 09:35:00,40,15,Alimento,2,55
36577,2024-01-26 09:36:00,33,23,Brinquedo,1,56
36578,2024-01-26 09:37:00,58,172,Eletrônico,9,230
36579,2024-01-26 09:38:00,98,80,Alimento,5,178
36580,2024-01-26 09:39:00,25,47,Alimento,9,72
36581,2024-01-26 09:40:00,88,147,Vestuário,3,235
36582,2024-01-26 09:41:00,53,53,Brinquedo,2,106
36583,2024-01-26 09:42:00,46,142,Eletrônico,6,188
36584,2024-01-26 09:43:00,23,30,Vestuário,1,53
36585,2024-01-26 09:44:00,26,98,Alimento,1,124
36586,2024-01-26 09:45:00,73,153,Alimento,4,226
36587,2024-01-26 09:46:00,36,87,Brinquedo,1,123
36588,2024-01-26 09:47:00,101,162,Brinquedo,1,263
36589,2024-01-26 09:48:00,55,152,Brinquedo,7,207
36590,2024-01-26 09:49:00,18,107,Eletrônico,1,125
36591,2024-01-26 09:50:00,15,68,Móvel,9,83
36592,2024-01-26 09:51:00,36,56,Vestuário,4,92
36593,2024-01-26 09:52:00,54,89,Brinquedo,1,143
36594,2024-01-26 09:53:00,111,38,Móvel,2,149
36595,2024-01-26 09:54:00,27,10,Eletrônico,2,37
36596,2024-01-26 09:55:00,52,91,Brinquedo,5,143
36597,2024-01-26 09:56:00,29,33,Brinquedo,7,62
36598,2024-01-26 09:57:00,104,44,Brinquedo,1,148
36599,2024-01-26 09:58:00,22,119,Móvel,6,141
36600,2024-01-26 09:59:00,95,174,Alimento,1,269
36601,2024-01-26 10:00:00,91,105,Brinquedo,8,196
36602,2024-01-26 10:01:00,75,164,Vestuário,1,239
36603,2024-01-26 10:02:00,53,24,Eletrônico,8,77
36604,2024-01-26 10:03:00,60,115,Brinquedo,2,175
36605,2024-01-26 10:04:00,56,13,Vestuário,9,69
36606,2024-01-26 10:05:00,70,83,Alimento,2,153
36607,2024-01-26 10:06:00,92,131,Brinquedo,5,223
36608,2024-01-26 10:07:00,39,77,Eletrônico,4,116
36609,2024-01-26 10:08:00,72,144,Brinquedo,1,216
36610,2024-01-26 10:09:00,98,176,Eletrônico,1,274
36611,2024-01-26 10:10:00,53,145,Eletrônico,7,198
36612,2024-01-26 10:11:00,57,144,Brinquedo,5,201
36613,2024-01-26 10:12:00,69,137,Alimento,3,206
36614,2024-01-26 10:13:00,59,159,Móvel,7,218
36615,2024-01-26 10:14:00,108,134,Vestuário,9,242
36616,2024-01-26 10:15:00,35,32,Eletrônico,9,67
36617,2024-01-26 10:16:00,18,35,Móvel,4,53
36618,2024-01-26 10:17:00,33,139,Alimento,7,172
36619,2024-01-26 10:18:00,16,50,Móvel,7,66
36620,2024-01-26 10:19:00,98,107,Vestuário,3,205
36621,2024-01-26 10:20:00,79,11,Brinquedo,3,90
36622,2024-01-26 10:21:00,58,61,Vestuário,3,119
36623,2024-01-26 10:22:00,108,122,Eletrônico,1,230
36624,2024-01-26 10:23:00,18,55,Alimento,4,73
36625,2024-01-26 10:24:00,73,10,Alimento,4,83
36626,2024-01-26 10:25:00,100,29,Vestuário,9,129
36627,2024-01-26 10:26:00,10,116,Alimento,3,126
36628,2024-01-26 10:27:00,39,119,Alimento,1,158
36629,2024-01-26 10:28:00,28,63,Móvel,7,91
36630,2024-01-26 10:29:00,84,140,Móvel,7,224
36631,2024-01-26 10:30:00,71,34,Vestuário,1,105
36632,2024-01-26 10:31:00,50,102,Alimento,2,152
36633,2024-01-26 10:32:00,105,163,Móvel,1,268
36634,2024-01-26 10:33:00,65,111,Vestuário,4,176
36635,2024-01-26 10:34:00,67,176,Eletrônico,8,243
36636,2024-01-26 10:35:00,54,91,Brinquedo,1,145
36637,2024-01-26 10:36:00,102,142,Vestuário,4,244
36638,2024-01-26 10:37:00,75,100,Eletrônico,8,175
36639,2024-01-26 10:38:00,56,154,Alimento,3,210
36640,2024-01-26 10:39:00,64,119,Brinquedo,6,183
36641,2024-01-26 10:40:00,59,141,Vestuário,6,200
36642,2024-01-26 10:41:00,109,137,Brinquedo,7,246
36643,2024-01-26 10:42:00,38,156,Eletrônico,9,194
36644,2024-01-26 10:43:00,59,74,Vestuário,1,133
36645,2024-01-26 10:44:00,116,47,Vestuário,3,163
36646,2024-01-26 10:45:00,65,171,Móvel,1,236
36647,2024-01-26 10:46:00,94,75,Móvel,1,169
36648,2024-01-26 10:47:00,99,172,Brinquedo,5,271
36649,2024-01-26 10:48:00,27,23,Vestuário,7,50
36650,2024-01-26 10:49:00,99,167,Eletrônico,9,266
36651,2024-01-26 10:50:00,66,123,Eletrônico,7,189
36652,2024-01-26 10:51:00,33,39,Eletrônico,3,72
36653,2024-01-26 10:52:00,114,152,Vestuário,9,266
36654,2024-01-26 10:53:00,25,31,Brinquedo,9,56
36655,2024-01-26 10:54:00,50,11,Brinquedo,6,61
36656,2024-01-26 10:55:00,97,119,Eletrônico,8,216
36657,2024-01-26 10:56:00,50,17,Vestuário,4,67
36658,2024-01-26 10:57:00,17,38,Eletrônico,5,55
36659,2024-01-26 10:58:00,44,79,Eletrônico,2,123
36660,2024-01-26 10:59:00,47,89,Alimento,2,136
36661,2024-01-26 11:00:00,22,147,Alimento,6,169
36662,2024-01-26 11:01:00,100,167,Alimento,9,267
36663,2024-01-26 11:02:00,114,42,Alimento,4,156
36664,2024-01-26 11:03:00,21,80,Vestuário,1,101
36665,2024-01-26 11:04:00,109,124,Eletrônico,8,233
36666,2024-01-26 11:05:00,86,55,Eletrônico,5,141
36667,2024-01-26 11:06:00,113,13,Vestuário,9,126
36668,2024-01-26 11:07:00,29,62,Vestuário,3,91
36669,2024-01-26 11:08:00,91,138,Eletrônico,5,229
36670,2024-01-26 11:09:00,22,166,Alimento,3,188
36671,2024-01-26 11:10:00,55,22,Vestuário,5,77
36672,2024-01-26 11:11:00,106,99,Alimento,8,205
36673,2024-01-26 11:12:00,93,48,Eletrônico,4,141
36674,2024-01-26 11:13:00,45,122,Alimento,8,167
36675,2024-01-26 11:14:00,69,109,Vestuário,8,178
36676,2024-01-26 11:15:00,32,159,Vestuário,4,191
36677,2024-01-26 11:16:00,40,129,Móvel,6,169
36678,2024-01-26 11:17:00,27,24,Móvel,4,51
36679,2024-01-26 11:18:00,64,151,Brinquedo,3,215
36680,2024-01-26 11:19:00,101,99,Brinquedo,1,200
36681,2024-01-26 11:20:00,77,153,Alimento,8,230
36682,2024-01-26 11:21:00,107,170,Alimento,3,277
36683,2024-01-26 11:22:00,84,73,Alimento,3,157
36684,2024-01-26 11:23:00,97,70,Brinquedo,6,167
36685,2024-01-26 11:24:00,41,52,Brinquedo,7,93
36686,2024-01-26 11:25:00,36,128,Vestuário,5,164
36687,2024-01-26 11:26:00,41,111,Móvel,8,152
36688,2024-01-26 11:27:00,51,156,Alimento,4,207
36689,2024-01-26 11:28:00,68,127,Alimento,5,195
36690,2024-01-26 11:29:00,76,143,Móvel,1,219
36691,2024-01-26 11:30:00,56,148,Vestuário,1,204
36692,2024-01-26 11:31:00,30,178,Brinquedo,4,208
36693,2024-01-26 11:32:00,19,121,Vestuário,2,140
36694,2024-01-26 11:33:00,65,34,Móvel,4,99
36695,2024-01-26 11:34:00,68,150,Alimento,1,218
36696,2024-01-26 11:35:00,84,14,Eletrônico,2,98
36697,2024-01-26 11:36:00,80,128,Alimento,2,208
36698,2024-01-26 11:37:00,37,163,Vestuário,1,200
36699,2024-01-26 11:38:00,112,75,Vestuário,3,187
36700,2024-01-26 11:39:00,40,129,Móvel,8,169
36701,2024-01-26 11:40:00,87,149,Vestuário,1,236
36702,2024-01-26 11:41:00,95,36,Móvel,2,131
36703,2024-01-26 11:42:00,105,44,Móvel,8,149
36704,2024-01-26 11:43:00,67,22,Móvel,5,89
36705,2024-01-26 11:44:00,25,102,Eletrônico,4,127
36706,2024-01-26 11:45:00,97,34,Vestuário,4,131
36707,2024-01-26 11:46:00,48,55,Vestuário,2,103
36708,2024-01-26 11:47:00,55,167,Móvel,7,222
36709,2024-01-26 11:48:00,17,172,Alimento,8,189
36710,2024-01-26 11:49:00,89,10,Eletrônico,5,99
36711,2024-01-26 11:50:00,43,66,Eletrônico,4,109
36712,2024-01-26 11:51:00,87,30,Eletrônico,8,117
36713,2024-01-26 11:52:00,43,106,Móvel,8,149
36714,2024-01-26 11:53:00,26,46,Vestuário,4,72
36715,2024-01-26 11:54:00,94,48,Móvel,6,142
36716,2024-01-26 11:55:00,89,136,Brinquedo,2,225
36717,2024-01-26 11:56:00,95,172,Alimento,7,267
36718,2024-01-26 11:57:00,26,57,Móvel,3,83
36719,2024-01-26 11:58:00,24,73,Eletrônico,6,97
36720,2024-01-26 11:59:00,17,125,Vestuário,1,142
36721,2024-01-26 12:00:00,110,99,Vestuário,4,209
36722,2024-01-26 12:01:00,53,26,Alimento,4,79
36723,2024-01-26 12:02:00,31,177,Vestuário,4,208
36724,2024-01-26 12:03:00,107,62,Eletrônico,5,169
36725,2024-01-26 12:04:00,87,21,Vestuário,9,108
36726,2024-01-26 12:05:00,16,75,Brinquedo,4,91
36727,2024-01-26 12:06:00,61,166,Móvel,2,227
36728,2024-01-26 12:07:00,41,119,Vestuário,8,160
36729,2024-01-26 12:08:00,43,52,Móvel,9,95
36730,2024-01-26 12:09:00,83,32,Alimento,8,115
36731,2024-01-26 12:10:00,110,47,Vestuário,5,157
36732,2024-01-26 12:11:00,75,157,Vestuário,7,232
36733,2024-01-26 12:12:00,25,100,Móvel,6,125
36734,2024-01-26 12:13:00,74,86,Eletrônico,8,160
36735,2024-01-26 12:14:00,87,18,Móvel,8,105
36736,2024-01-26 12:15:00,108,85,Móvel,3,193
36737,2024-01-26 12:16:00,13,20,Móvel,1,33
36738,2024-01-26 12:17:00,107,27,Móvel,7,134
36739,2024-01-26 12:18:00,66,115,Vestuário,8,181
36740,2024-01-26 12:19:00,32,169,Brinquedo,5,201
36741,2024-01-26 12:20:00,47,121,Eletrônico,2,168
36742,2024-01-26 12:21:00,15,124,Móvel,8,139
36743,2024-01-26 12:22:00,28,88,Eletrônico,8,116
36744,2024-01-26 12:23:00,41,106,Eletrônico,2,147
36745,2024-01-26 12:24:00,14,18,Móvel,4,32
36746,2024-01-26 12:25:00,81,154,Brinquedo,9,235
36747,2024-01-26 12:26:00,89,151,Eletrônico,8,240
36748,2024-01-26 12:27:00,53,125,Móvel,5,178
36749,2024-01-26 12:28:00,103,162,Vestuário,5,265
36750,2024-01-26 12:29:00,114,89,Brinquedo,6,203
36751,2024-01-26 12:30:00,23,28,Móvel,4,51
36752,2024-01-26 12:31:00,23,132,Alimento,6,155
36753,2024-01-26 12:32:00,109,137,Alimento,4,246
36754,2024-01-26 12:33:00,106,149,Móvel,5,255
36755,2024-01-26 12:34:00,65,13,Brinquedo,8,78
36756,2024-01-26 12:35:00,101,58,Móvel,6,159
36757,2024-01-26 12:36:00,65,96,Vestuário,7,161
36758,2024-01-26 12:37:00,77,131,Eletrônico,3,208
36759,2024-01-26 12:38:00,48,168,Brinquedo,6,216
36760,2024-01-26 12:39:00,46,118,Vestuário,6,164
36761,2024-01-26 12:40:00,82,23,Vestuário,6,105
36762,2024-01-26 12:41:00,74,104,Brinquedo,5,178
36763,2024-01-26 12:42:00,90,92,Alimento,9,182
36764,2024-01-26 12:43:00,119,61,Móvel,2,180
36765,2024-01-26 12:44:00,21,76,Brinquedo,3,97
36766,2024-01-26 12:45:00,110,167,Brinquedo,7,277
36767,2024-01-26 12:46:00,109,12,Vestuário,2,121
36768,2024-01-26 12:47:00,79,113,Eletrônico,8,192
36769,2024-01-26 12:48:00,75,116,Brinquedo,7,191
36770,2024-01-26 12:49:00,41,165,Vestuário,8,206
36771,2024-01-26 12:50:00,86,150,Eletrônico,4,236
36772,2024-01-26 12:51:00,96,112,Brinquedo,3,208
36773,2024-01-26 12:52:00,100,159,Vestuário,1,259
36774,2024-01-26 12:53:00,113,94,Alimento,6,207
36775,2024-01-26 12:54:00,46,90,Eletrônico,7,136
36776,2024-01-26 12:55:00,75,96,Móvel,3,171
36777,2024-01-26 12:56:00,50,163,Alimento,7,213
36778,2024-01-26 12:57:00,16,44,Eletrônico,9,60
36779,2024-01-26 12:58:00,79,131,Móvel,1,210
36780,2024-01-26 12:59:00,40,49,Brinquedo,5,89
36781,2024-01-26 13:00:00,14,114,Móvel,8,128
36782,2024-01-26 13:01:00,51,147,Eletrônico,2,198
36783,2024-01-26 13:02:00,63,31,Vestuário,8,94
36784,2024-01-26 13:03:00,78,100,Brinquedo,6,178
36785,2024-01-26 13:04:00,36,53,Brinquedo,1,89
36786,2024-01-26 13:05:00,59,138,Móvel,1,197
36787,2024-01-26 13:06:00,27,137,Alimento,9,164
36788,2024-01-26 13:07:00,80,127,Eletrônico,6,207
36789,2024-01-26 13:08:00,95,177,Brinquedo,7,272
36790,2024-01-26 13:09:00,58,128,Vestuário,3,186
36791,2024-01-26 13:10:00,94,56,Eletrônico,8,150
36792,2024-01-26 13:11:00,53,13,Móvel,9,66
36793,2024-01-26 13:12:00,92,109,Vestuário,7,201
36794,2024-01-26 13:13:00,55,102,Móvel,9,157
36795,2024-01-26 13:14:00,70,62,Móvel,1,132
36796,2024-01-26 13:15:00,98,69,Eletrônico,6,167
36797,2024-01-26 13:16:00,85,71,Brinquedo,8,156
36798,2024-01-26 13:17:00,99,115,Brinquedo,6,214
36799,2024-01-26 13:18:00,53,66,Vestuário,1,119
36800,2024-01-26 13:19:00,87,118,Vestuário,4,205
36801,2024-01-26 13:20:00,49,20,Brinquedo,7,69
36802,2024-01-26 13:21:00,41,101,Eletrônico,7,142
36803,2024-01-26 13:22:00,55,139,Alimento,4,194
36804,2024-01-26 13:23:00,89,149,Móvel,7,238
36805,2024-01-26 13:24:00,97,161,Móvel,2,258
36806,2024-01-26 13:25:00,87,87,Brinquedo,9,174
36807,2024-01-26 13:26:00,59,74,Vestuário,2,133
36808,2024-01-26 13:27:00,18,31,Vestuário,8,49
36809,2024-01-26 13:28:00,112,118,Móvel,3,230
36810,2024-01-26 13:29:00,61,17,Alimento,9,78
36811,2024-01-26 13:30:00,78,43,Eletrônico,2,121
36812,2024-01-26 13:31:00,41,162,Eletrônico,4,203
36813,2024-01-26 13:32:00,88,95,Eletrônico,2,183
36814,2024-01-26 13:33:00,64,171,Eletrônico,7,235
36815,2024-01-26 13:34:00,29,129,Móvel,7,158
36816,2024-01-26 13:35:00,33,163,Brinquedo,4,196
36817,2024-01-26 13:36:00,104,24,Alimento,8,128
36818,2024-01-26 13:37:00,88,39,Brinquedo,8,127
36819,2024-01-26 13:38:00,87,102,Alimento,3,189
36820,2024-01-26 13:39:00,16,145,Móvel,3,161
36821,2024-01-26 13:40:00,109,41,Móvel,2,150
36822,2024-01-26 13:41:00,21,134,Alimento,8,155
36823,2024-01-26 13:42:00,103,57,Vestuário,8,160
36824,2024-01-26 13:43:00,109,92,Eletrônico,3,201
36825,2024-01-26 13:44:00,49,53,Eletrônico,9,102
36826,2024-01-26 13:45:00,84,133,Eletrônico,1,217
36827,2024-01-26 13:46:00,81,22,Brinquedo,3,103
36828,2024-01-26 13:47:00,12,34,Eletrônico,1,46
36829,2024-01-26 13:48:00,58,82,Vestuário,4,140
36830,2024-01-26 13:49:00,74,96,Brinquedo,2,170
36831,2024-01-26 13:50:00,29,161,Móvel,9,190
36832,2024-01-26 13:51:00,95,36,Móvel,4,131
36833,2024-01-26 13:52:00,27,127,Móvel,4,154
36834,2024-01-26 13:53:00,56,138,Eletrônico,6,194
36835,2024-01-26 13:54:00,13,94,Móvel,2,107
36836,2024-01-26 13:55:00,47,56,Móvel,9,103
36837,2024-01-26 13:56:00,80,132,Móvel,2,212
36838,2024-01-26 13:57:00,54,15,Eletrônico,7,69
36839,2024-01-26 13:58:00,105,18,Brinquedo,5,123
36840,2024-01-26 13:59:00,62,26,Brinquedo,1,88
36841,2024-01-26 14:00:00,38,60,Móvel,3,98
36842,2024-01-26 14:01:00,82,22,Brinquedo,9,104
36843,2024-01-26 14:02:00,32,108,Vestuário,9,140
36844,2024-01-26 14:03:00,15,46,Brinquedo,6,61
36845,2024-01-26 14:04:00,62,173,Alimento,6,235
36846,2024-01-26 14:05:00,106,86,Eletrônico,7,192
36847,2024-01-26 14:06:00,89,127,Eletrônico,6,216
36848,2024-01-26 14:07:00,71,61,Brinquedo,8,132
36849,2024-01-26 14:08:00,74,95,Eletrônico,3,169
36850,2024-01-26 14:09:00,73,23,Eletrônico,9,96
36851,2024-01-26 14:10:00,32,142,Móvel,8,174
36852,2024-01-26 14:11:00,36,57,Alimento,8,93
36853,2024-01-26 14:12:00,116,54,Alimento,7,170
36854,2024-01-26 14:13:00,100,97,Eletrônico,9,197
36855,2024-01-26 14:14:00,96,161,Alimento,1,257
36856,2024-01-26 14:15:00,96,39,Vestuário,2,135
36857,2024-01-26 14:16:00,114,119,Eletrônico,8,233
36858,2024-01-26 14:17:00,119,59,Vestuário,1,178
36859,2024-01-26 14:18:00,97,41,Eletrônico,3,138
36860,2024-01-26 14:19:00,21,177,Vestuário,9,198
36861,2024-01-26 14:20:00,46,142,Móvel,9,188
36862,2024-01-26 14:21:00,20,106,Brinquedo,9,126
36863,2024-01-26 14:22:00,116,43,Brinquedo,5,159
36864,2024-01-26 14:23:00,15,127,Alimento,3,142
36865,2024-01-26 14:24:00,49,86,Móvel,6,135
36866,2024-01-26 14:25:00,54,89,Móvel,2,143
36867,2024-01-26 14:26:00,91,12,Móvel,2,103
36868,2024-01-26 14:27:00,39,139,Móvel,7,178
36869,2024-01-26 14:28:00,84,163,Brinquedo,8,247
36870,2024-01-26 14:29:00,39,105,Móvel,2,144
36871,2024-01-26 14:30:00,63,63,Alimento,3,126
36872,2024-01-26 14:31:00,27,43,Alimento,6,70
36873,2024-01-26 14:32:00,94,20,Móvel,8,114
36874,2024-01-26 14:33:00,114,24,Alimento,9,138
36875,2024-01-26 14:34:00,26,81,Brinquedo,7,107
36876,2024-01-26 14:35:00,85,11,Alimento,8,96
36877,2024-01-26 14:36:00,60,69,Móvel,9,129
36878,2024-01-26 14:37:00,98,36,Móvel,7,134
36879,2024-01-26 14:38:00,22,94,Eletrônico,6,116
36880,2024-01-26 14:39:00,51,105,Alimento,7,156
36881,2024-01-26 14:40:00,106,58,Móvel,2,164
36882,2024-01-26 14:41:00,92,54,Brinquedo,9,146
36883,2024-01-26 14:42:00,33,143,Vestuário,9,176
36884,2024-01-26 14:43:00,88,113,Brinquedo,9,201
36885,2024-01-26 14:44:00,83,138,Brinquedo,7,221
36886,2024-01-26 14:45:00,108,59,Alimento,2,167
36887,2024-01-26 14:46:00,116,40,Vestuário,3,156
36888,2024-01-26 14:47:00,101,163,Alimento,6,264
36889,2024-01-26 14:48:00,48,28,Alimento,2,76
36890,2024-01-26 14:49:00,54,154,Eletrônico,8,208
36891,2024-01-26 14:50:00,53,102,Eletrônico,2,155
36892,2024-01-26 14:51:00,40,139,Brinquedo,6,179
36893,2024-01-26 14:52:00,90,59,Eletrônico,5,149
36894,2024-01-26 14:53:00,23,34,Vestuário,3,57
36895,2024-01-26 14:54:00,89,27,Vestuário,1,116
36896,2024-01-26 14:55:00,119,35,Eletrônico,2,154
36897,2024-01-26 14:56:00,104,28,Brinquedo,7,132
36898,2024-01-26 14:57:00,25,98,Brinquedo,2,123
36899,2024-01-26 14:58:00,23,31,Alimento,8,54
36900,2024-01-26 14:59:00,13,59,Brinquedo,5,72
36901,2024-01-26 15:00:00,79,155,Brinquedo,9,234
36902,2024-01-26 15:01:00,17,100,Móvel,6,117
36903,2024-01-26 15:02:00,57,98,Móvel,8,155
36904,2024-01-26 15:03:00,108,153,Alimento,9,261
36905,2024-01-26 15:04:00,93,116,Brinquedo,9,209
36906,2024-01-26 15:05:00,109,53,Alimento,4,162
36907,2024-01-26 15:06:00,99,34,Eletrônico,3,133
36908,2024-01-26 15:07:00,33,167,Eletrônico,3,200
36909,2024-01-26 15:08:00,103,124,Brinquedo,3,227
36910,2024-01-26 15:09:00,49,109,Móvel,9,158
36911,2024-01-26 15:10:00,50,52,Brinquedo,8,102
36912,2024-01-26 15:11:00,54,24,Alimento,9,78
36913,2024-01-26 15:12:00,47,36,Eletrônico,5,83
36914,2024-01-26 15:13:00,107,107,Brinquedo,3,214
36915,2024-01-26 15:14:00,91,95,Brinquedo,6,186
36916,2024-01-26 15:15:00,15,12,Alimento,4,27
36917,2024-01-26 15:16:00,49,89,Móvel,1,138
36918,2024-01-26 15:17:00,87,116,Vestuário,1,203
36919,2024-01-26 15:18:00,74,115,Alimento,9,189
36920,2024-01-26 15:19:00,65,152,Brinquedo,5,217
36921,2024-01-26 15:20:00,79,117,Vestuário,2,196
36922,2024-01-26 15:21:00,46,10,Eletrônico,1,56
36923,2024-01-26 15:22:00,52,110,Móvel,8,162
36924,2024-01-26 15:23:00,95,41,Alimento,2,136
36925,2024-01-26 15:24:00,22,22,Móvel,2,44
36926,2024-01-26 15:25:00,94,145,Alimento,7,239
36927,2024-01-26 15:26:00,98,60,Vestuário,3,158
36928,2024-01-26 15:27:00,24,76,Eletrônico,6,100
36929,2024-01-26 15:28:00,12,131,Vestuário,5,143
36930,2024-01-26 15:29:00,39,151,Eletrônico,5,190
36931,2024-01-26 15:30:00,77,11,Eletrônico,2,88
36932,2024-01-26 15:31:00,41,179,Eletrônico,2,220
36933,2024-01-26 15:32:00,88,166,Alimento,7,254
36934,2024-01-26 15:33:00,82,130,Móvel,3,212
36935,2024-01-26 15:34:00,79,132,Brinquedo,7,211
36936,2024-01-26 15:35:00,17,134,Brinquedo,1,151
36937,2024-01-26 15:36:00,41,71,Brinquedo,9,112
36938,2024-01-26 15:37:00,103,37,Móvel,3,140
36939,2024-01-26 15:38:00,119,55,Eletrônico,3,174
36940,2024-01-26 15:39:00,42,141,Móvel,3,183
36941,2024-01-26 15:40:00,56,97,Brinquedo,8,153
36942,2024-01-26 15:41:00,62,119,Brinquedo,1,181
36943,2024-01-26 15:42:00,65,162,Brinquedo,6,227
36944,2024-01-26 15:43:00,109,38,Eletrônico,5,147
36945,2024-01-26 15:44:00,63,142,Vestuário,1,205
36946,2024-01-26 15:45:00,84,156,Eletrônico,1,240
36947,2024-01-26 15:46:00,98,16,Eletrônico,2,114
36948,2024-01-26 15:47:00,117,93,Alimento,5,210
36949,2024-01-26 15:48:00,45,178,Alimento,4,223
36950,2024-01-26 15:49:00,26,135,Alimento,2,161
36951,2024-01-26 15:50:00,33,104,Alimento,3,137
36952,2024-01-26 15:51:00,92,129,Móvel,4,221
36953,2024-01-26 15:52:00,24,154,Alimento,6,178
36954,2024-01-26 15:53:00,25,81,Brinquedo,6,106
36955,2024-01-26 15:54:00,41,45,Móvel,6,86
36956,2024-01-26 15:55:00,20,158,Alimento,7,178
36957,2024-01-26 15:56:00,41,169,Móvel,8,210
36958,2024-01-26 15:57:00,20,147,Móvel,3,167
36959,2024-01-26 15:58:00,74,33,Brinquedo,4,107
36960,2024-01-26 15:59:00,39,63,Móvel,9,102
36961,2024-01-26 16:00:00,91,13,Brinquedo,8,104
36962,2024-01-26 16:01:00,62,58,Vestuário,6,120
36963,2024-01-26 16:02:00,43,106,Eletrônico,4,149
36964,2024-01-26 16:03:00,28,44,Vestuário,4,72
36965,2024-01-26 16:04:00,72,45,Brinquedo,8,117
36966,2024-01-26 16:05:00,109,24,Móvel,9,133
36967,2024-01-26 16:06:00,109,45,Eletrônico,8,154
36968,2024-01-26 16:07:00,21,50,Móvel,3,71
36969,2024-01-26 16:08:00,90,97,Eletrônico,4,187
36970,2024-01-26 16:09:00,90,152,Móvel,3,242
36971,2024-01-26 16:10:00,93,46,Eletrônico,3,139
36972,2024-01-26 16:11:00,90,19,Eletrônico,6,109
36973,2024-01-26 16:12:00,53,93,Eletrônico,6,146
36974,2024-01-26 16:13:00,107,116,Eletrônico,7,223
36975,2024-01-26 16:14:00,114,104,Vestuário,2,218
36976,2024-01-26 16:15:00,43,145,Móvel,1,188
36977,2024-01-26 16:16:00,14,141,Brinquedo,6,155
36978,2024-01-26 16:17:00,67,133,Eletrônico,2,200
36979,2024-01-26 16:18:00,105,48,Brinquedo,4,153
36980,2024-01-26 16:19:00,73,20,Alimento,8,93
36981,2024-01-26 16:20:00,97,92,Vestuário,4,189
36982,2024-01-26 16:21:00,51,33,Móvel,1,84
36983,2024-01-26 16:22:00,31,135,Móvel,6,166
36984,2024-01-26 16:23:00,11,28,Vestuário,7,39
36985,2024-01-26 16:24:00,12,177,Brinquedo,2,189
36986,2024-01-26 16:25:00,41,176,Brinquedo,2,217
36987,2024-01-26 16:26:00,73,125,Brinquedo,2,198
36988,2024-01-26 16:27:00,70,53,Móvel,8,123
36989,2024-01-26 16:28:00,52,33,Brinquedo,9,85
36990,2024-01-26 16:29:00,41,162,Alimento,6,203
36991,2024-01-26 16:30:00,41,147,Alimento,9,188
36992,2024-01-26 16:31:00,25,132,Eletrônico,6,157
36993,2024-01-26 16:32:00,36,167,Móvel,4,203
36994,2024-01-26 16:33:00,111,155,Móvel,1,266
36995,2024-01-26 16:34:00,17,142,Eletrônico,1,159
36996,2024-01-26 16:35:00,76,66,Eletrônico,3,142
36997,2024-01-26 16:36:00,20,56,Móvel,4,76
36998,2024-01-26 16:37:00,42,111,Eletrônico,6,153
36999,2024-01-26 16:38:00,80,50,Móvel,7,130
37000,2024-01-26 16:39:00,51,15,Brinquedo,5,66
37001,2024-01-26 16:40:00,96,60,Vestuário,2,156
37002,2024-01-26 16:41:00,104,45,Eletrônico,3,149
37003,2024-01-26 16:42:00,34,122,Brinquedo,4,156
37004,2024-01-26 16:43:00,77,34,Vestuário,3,111
37005,2024-01-26 16:44:00,21,96,Alimento,2,117
37006,2024-01-26 16:45:00,96,152,Móvel,9,248
37007,2024-01-26 16:46:00,25,101,Brinquedo,1,126
37008,2024-01-26 16:47:00,16,150,Brinquedo,6,166
37009,2024-01-26 16:48:00,23,179,Móvel,2,202
37010,2024-01-26 16:49:00,55,120,Alimento,3,175
37011,2024-01-26 16:50:00,47,154,Vestuário,5,201
37012,2024-01-26 16:51:00,79,67,Brinquedo,7,146
37013,2024-01-26 16:52:00,81,160,Alimento,6,241
37014,2024-01-26 16:53:00,55,98,Vestuário,1,153
37015,2024-01-26 16:54:00,67,62,Brinquedo,9,129
37016,2024-01-26 16:55:00,116,20,Vestuário,8,136
37017,2024-01-26 16:56:00,78,12,Vestuário,9,90
37018,2024-01-26 16:57:00,55,138,Eletrônico,1,193
37019,2024-01-26 16:58:00,71,177,Móvel,5,248
37020,2024-01-26 16:59:00,34,174,Vestuário,4,208
37021,2024-01-26 17:00:00,72,102,Alimento,7,174
37022,2024-01-26 17:01:00,19,20,Móvel,6,39
37023,2024-01-26 17:02:00,77,45,Brinquedo,8,122
37024,2024-01-26 17:03:00,92,137,Eletrônico,7,229
37025,2024-01-26 17:04:00,28,136,Brinquedo,3,164
37026,2024-01-26 17:05:00,24,63,Alimento,9,87
37027,2024-01-26 17:06:00,94,140,Eletrônico,3,234
37028,2024-01-26 17:07:00,12,115,Móvel,7,127
37029,2024-01-26 17:08:00,114,137,Vestuário,5,251
37030,2024-01-26 17:09:00,63,65,Vestuário,9,128
37031,2024-01-26 17:10:00,99,14,Alimento,6,113
37032,2024-01-26 17:11:00,17,37,Eletrônico,6,54
37033,2024-01-26 17:12:00,16,92,Vestuário,9,108
37034,2024-01-26 17:13:00,46,92,Eletrônico,6,138
37035,2024-01-26 17:14:00,78,24,Eletrônico,5,102
37036,2024-01-26 17:15:00,45,64,Alimento,2,109
37037,2024-01-26 17:16:00,107,76,Vestuário,8,183
37038,2024-01-26 17:17:00,54,88,Eletrônico,2,142
37039,2024-01-26 17:18:00,75,82,Brinquedo,8,157
37040,2024-01-26 17:19:00,79,133,Brinquedo,2,212
37041,2024-01-26 17:20:00,25,171,Brinquedo,2,196
37042,2024-01-26 17:21:00,25,87,Alimento,2,112
37043,2024-01-26 17:22:00,112,68,Eletrônico,8,180
37044,2024-01-26 17:23:00,52,21,Vestuário,5,73
37045,2024-01-26 17:24:00,100,30,Eletrônico,7,130
37046,2024-01-26 17:25:00,50,136,Móvel,3,186
37047,2024-01-26 17:26:00,14,67,Brinquedo,5,81
37048,2024-01-26 17:27:00,113,119,Vestuário,2,232
37049,2024-01-26 17:28:00,91,121,Vestuário,6,212
37050,2024-01-26 17:29:00,80,20,Eletrônico,1,100
37051,2024-01-26 17:30:00,108,109,Móvel,1,217
37052,2024-01-26 17:31:00,38,43,Eletrônico,7,81
37053,2024-01-26 17:32:00,62,142,Brinquedo,9,204
37054,2024-01-26 17:33:00,37,39,Móvel,8,76
37055,2024-01-26 17:34:00,56,84,Eletrônico,1,140
37056,2024-01-26 17:35:00,21,38,Vestuário,2,59
37057,2024-01-26 17:36:00,33,157,Alimento,9,190
37058,2024-01-26 17:37:00,61,166,Móvel,2,227
37059,2024-01-26 17:38:00,89,177,Eletrônico,2,266
37060,2024-01-26 17:39:00,12,91,Vestuário,4,103
37061,2024-01-26 17:40:00,30,88,Brinquedo,2,118
37062,2024-01-26 17:41:00,60,131,Alimento,9,191
37063,2024-01-26 17:42:00,11,77,Móvel,5,88
37064,2024-01-26 17:43:00,78,172,Eletrônico,8,250
37065,2024-01-26 17:44:00,66,108,Móvel,1,174
37066,2024-01-26 17:45:00,70,60,Vestuário,8,130
37067,2024-01-26 17:46:00,82,122,Brinquedo,4,204
37068,2024-01-26 17:47:00,11,31,Eletrônico,4,42
37069,2024-01-26 17:48:00,40,121,Móvel,4,161
37070,2024-01-26 17:49:00,31,117,Alimento,7,148
37071,2024-01-26 17:50:00,115,92,Eletrônico,9,207
37072,2024-01-26 17:51:00,92,142,Eletrônico,1,234
37073,2024-01-26 17:52:00,60,99,Móvel,4,159
37074,2024-01-26 17:53:00,58,88,Vestuário,4,146
37075,2024-01-26 17:54:00,74,98,Móvel,3,172
37076,2024-01-26 17:55:00,23,102,Brinquedo,1,125
37077,2024-01-26 17:56:00,93,30,Móvel,5,123
37078,2024-01-26 17:57:00,77,34,Brinquedo,7,111
37079,2024-01-26 17:58:00,106,95,Vestuário,9,201
37080,2024-01-26 17:59:00,19,29,Eletrônico,2,48
37081,2024-01-26 18:00:00,99,172,Brinquedo,2,271
37082,2024-01-26 18:01:00,114,101,Vestuário,6,215
37083,2024-01-26 18:02:00,103,111,Alimento,2,214
37084,2024-01-26 18:03:00,44,149,Brinquedo,3,193
37085,2024-01-26 18:04:00,42,148,Móvel,7,190
37086,2024-01-26 18:05:00,57,21,Eletrônico,8,78
37087,2024-01-26 18:06:00,72,155,Vestuário,7,227
37088,2024-01-26 18:07:00,77,41,Eletrônico,4,118
37089,2024-01-26 18:08:00,92,97,Vestuário,8,189
37090,2024-01-26 18:09:00,119,126,Eletrônico,4,245
37091,2024-01-26 18:10:00,92,66,Móvel,1,158
37092,2024-01-26 18:11:00,83,129,Móvel,6,212
37093,2024-01-26 18:12:00,99,129,Eletrônico,8,228
37094,2024-01-26 18:13:00,114,10,Eletrônico,7,124
37095,2024-01-26 18:14:00,83,131,Eletrônico,4,214
37096,2024-01-26 18:15:00,78,115,Móvel,8,193
37097,2024-01-26 18:16:00,101,143,Brinquedo,8,244
37098,2024-01-26 18:17:00,77,113,Brinquedo,1,190
37099,2024-01-26 18:18:00,11,111,Brinquedo,9,122
37100,2024-01-26 18:19:00,30,85,Vestuário,2,115
37101,2024-01-26 18:20:00,27,52,Brinquedo,1,79
37102,2024-01-26 18:21:00,107,178,Eletrônico,2,285
37103,2024-01-26 18:22:00,56,167,Vestuário,8,223
37104,2024-01-26 18:23:00,44,150,Móvel,7,194
37105,2024-01-26 18:24:00,77,49,Brinquedo,7,126
37106,2024-01-26 18:25:00,110,17,Móvel,4,127
37107,2024-01-26 18:26:00,20,170,Brinquedo,6,190
37108,2024-01-26 18:27:00,118,92,Alimento,9,210
37109,2024-01-26 18:28:00,108,14,Brinquedo,3,122
37110,2024-01-26 18:29:00,47,89,Vestuário,1,136
37111,2024-01-26 18:30:00,19,162,Móvel,1,181
37112,2024-01-26 18:31:00,41,118,Móvel,6,159
37113,2024-01-26 18:32:00,58,94,Eletrônico,1,152
37114,2024-01-26 18:33:00,65,177,Eletrônico,1,242
37115,2024-01-26 18:34:00,15,94,Brinquedo,6,109
37116,2024-01-26 18:35:00,86,65,Alimento,9,151
37117,2024-01-26 18:36:00,58,28,Eletrônico,5,86
37118,2024-01-26 18:37:00,48,110,Vestuário,7,158
37119,2024-01-26 18:38:00,40,145,Alimento,4,185
37120,2024-01-26 18:39:00,59,166,Móvel,7,225
37121,2024-01-26 18:40:00,12,81,Eletrônico,9,93
37122,2024-01-26 18:41:00,112,44,Móvel,2,156
37123,2024-01-26 18:42:00,37,135,Vestuário,2,172
37124,2024-01-26 18:43:00,39,117,Vestuário,7,156
37125,2024-01-26 18:44:00,92,113,Móvel,5,205
37126,2024-01-26 18:45:00,108,52,Eletrônico,1,160
37127,2024-01-26 18:46:00,77,63,Eletrônico,4,140
37128,2024-01-26 18:47:00,112,76,Móvel,5,188
37129,2024-01-26 18:48:00,82,120,Móvel,9,202
37130,2024-01-26 18:49:00,41,13,Brinquedo,3,54
37131,2024-01-26 18:50:00,21,36,Móvel,8,57
37132,2024-01-26 18:51:00,26,70,Alimento,9,96
37133,2024-01-26 18:52:00,119,93,Brinquedo,4,212
37134,2024-01-26 18:53:00,66,69,Vestuário,1,135
37135,2024-01-26 18:54:00,56,161,Móvel,4,217
37136,2024-01-26 18:55:00,52,31,Eletrônico,3,83
37137,2024-01-26 18:56:00,56,179,Brinquedo,1,235
37138,2024-01-26 18:57:00,27,164,Vestuário,6,191
37139,2024-01-26 18:58:00,96,69,Eletrônico,3,165
37140,2024-01-26 18:59:00,106,27,Móvel,5,133
37141,2024-01-26 19:00:00,86,144,Móvel,5,230
37142,2024-01-26 19:01:00,75,110,Vestuário,3,185
37143,2024-01-26 19:02:00,95,114,Vestuário,8,209
37144,2024-01-26 19:03:00,93,51,Alimento,1,144
37145,2024-01-26 19:04:00,102,51,Vestuário,3,153
37146,2024-01-26 19:05:00,102,96,Móvel,7,198
37147,2024-01-26 19:06:00,113,123,Brinquedo,7,236
37148,2024-01-26 19:07:00,103,93,Móvel,7,196
37149,2024-01-26 19:08:00,68,144,Vestuário,2,212
37150,2024-01-26 19:09:00,43,105,Vestuário,5,148
37151,2024-01-26 19:10:00,33,94,Vestuário,7,127
37152,2024-01-26 19:11:00,59,143,Alimento,8,202
37153,2024-01-26 19:12:00,67,70,Móvel,7,137
37154,2024-01-26 19:13:00,80,40,Vestuário,3,120
37155,2024-01-26 19:14:00,19,137,Eletrônico,6,156
37156,2024-01-26 19:15:00,88,39,Eletrônico,2,127
37157,2024-01-26 19:16:00,108,36,Móvel,4,144
37158,2024-01-26 19:17:00,25,50,Vestuário,2,75
37159,2024-01-26 19:18:00,98,168,Brinquedo,8,266
37160,2024-01-26 19:19:00,43,90,Móvel,6,133
37161,2024-01-26 19:20:00,64,123,Vestuário,9,187
37162,2024-01-26 19:21:00,70,134,Vestuário,3,204
37163,2024-01-26 19:22:00,59,33,Alimento,2,92
37164,2024-01-26 19:23:00,93,83,Móvel,4,176
37165,2024-01-26 19:24:00,94,108,Brinquedo,6,202
37166,2024-01-26 19:25:00,23,72,Brinquedo,6,95
37167,2024-01-26 19:26:00,111,137,Eletrônico,5,248
37168,2024-01-26 19:27:00,99,82,Alimento,4,181
37169,2024-01-26 19:28:00,52,127,Vestuário,4,179
37170,2024-01-26 19:29:00,86,179,Brinquedo,5,265
37171,2024-01-26 19:30:00,33,38,Vestuário,7,71
37172,2024-01-26 19:31:00,64,153,Vestuário,7,217
37173,2024-01-26 19:32:00,27,107,Brinquedo,9,134
37174,2024-01-26 19:33:00,53,34,Eletrônico,4,87
37175,2024-01-26 19:34:00,88,98,Móvel,2,186
37176,2024-01-26 19:35:00,89,125,Eletrônico,5,214
37177,2024-01-26 19:36:00,98,166,Móvel,5,264
37178,2024-01-26 19:37:00,57,142,Alimento,9,199
37179,2024-01-26 19:38:00,118,63,Móvel,6,181
37180,2024-01-26 19:39:00,45,85,Eletrônico,2,130
37181,2024-01-26 19:40:00,90,18,Eletrônico,6,108
37182,2024-01-26 19:41:00,53,90,Móvel,6,143
37183,2024-01-26 19:42:00,30,167,Móvel,6,197
37184,2024-01-26 19:43:00,66,66,Móvel,9,132
37185,2024-01-26 19:44:00,92,71,Alimento,7,163
37186,2024-01-26 19:45:00,92,162,Eletrônico,2,254
37187,2024-01-26 19:46:00,80,127,Vestuário,6,207
37188,2024-01-26 19:47:00,52,160,Eletrônico,1,212
37189,2024-01-26 19:48:00,75,56,Brinquedo,5,131
37190,2024-01-26 19:49:00,13,81,Alimento,8,94
37191,2024-01-26 19:50:00,95,159,Brinquedo,3,254
37192,2024-01-26 19:51:00,47,21,Alimento,4,68
37193,2024-01-26 19:52:00,101,121,Móvel,6,222
37194,2024-01-26 19:53:00,110,60,Eletrônico,5,170
37195,2024-01-26 19:54:00,63,23,Eletrônico,7,86
37196,2024-01-26 19:55:00,97,87,Alimento,1,184
37197,2024-01-26 19:56:00,46,171,Brinquedo,4,217
37198,2024-01-26 19:57:00,42,141,Móvel,5,183
37199,2024-01-26 19:58:00,54,43,Eletrônico,3,97
37200,2024-01-26 19:59:00,22,22,Móvel,5,44
37201,2024-01-26 20:00:00,26,130,Alimento,3,156
37202,2024-01-26 20:01:00,18,55,Alimento,8,73
37203,2024-01-26 20:02:00,95,57,Alimento,5,152
37204,2024-01-26 20:03:00,95,141,Eletrônico,9,236
37205,2024-01-26 20:04:00,44,96,Móvel,4,140
37206,2024-01-26 20:05:00,35,174,Brinquedo,8,209
37207,2024-01-26 20:06:00,11,59,Eletrônico,2,70
37208,2024-01-26 20:07:00,93,123,Brinquedo,5,216
37209,2024-01-26 20:08:00,103,160,Brinquedo,8,263
37210,2024-01-26 20:09:00,53,54,Eletrônico,5,107
37211,2024-01-26 20:10:00,64,108,Brinquedo,7,172
37212,2024-01-26 20:11:00,84,33,Eletrônico,6,117
37213,2024-01-26 20:12:00,75,121,Eletrônico,5,196
37214,2024-01-26 20:13:00,50,29,Alimento,4,79
37215,2024-01-26 20:14:00,49,83,Eletrônico,8,132
37216,2024-01-26 20:15:00,81,93,Brinquedo,9,174
37217,2024-01-26 20:16:00,100,92,Móvel,2,192
37218,2024-01-26 20:17:00,19,88,Vestuário,7,107
37219,2024-01-26 20:18:00,28,74,Alimento,8,102
37220,2024-01-26 20:19:00,79,20,Eletrônico,6,99
37221,2024-01-26 20:20:00,115,66,Alimento,7,181
37222,2024-01-26 20:21:00,50,165,Móvel,4,215
37223,2024-01-26 20:22:00,26,81,Móvel,6,107
37224,2024-01-26 20:23:00,52,90,Alimento,5,142
37225,2024-01-26 20:24:00,110,109,Eletrônico,2,219
37226,2024-01-26 20:25:00,90,91,Brinquedo,8,181
37227,2024-01-26 20:26:00,111,128,Eletrônico,6,239
37228,2024-01-26 20:27:00,14,68,Brinquedo,2,82
37229,2024-01-26 20:28:00,111,142,Brinquedo,4,253
37230,2024-01-26 20:29:00,86,83,Móvel,9,169
37231,2024-01-26 20:30:00,116,78,Eletrônico,6,194
37232,2024-01-26 20:31:00,23,159,Móvel,7,182
37233,2024-01-26 20:32:00,89,109,Móvel,7,198
37234,2024-01-26 20:33:00,90,150,Vestuário,4,240
37235,2024-01-26 20:34:00,77,17,Brinquedo,1,94
37236,2024-01-26 20:35:00,26,134,Brinquedo,9,160
37237,2024-01-26 20:36:00,37,144,Móvel,3,181
37238,2024-01-26 20:37:00,58,24,Eletrônico,3,82
37239,2024-01-26 20:38:00,113,122,Móvel,7,235
37240,2024-01-26 20:39:00,14,72,Brinquedo,5,86
37241,2024-01-26 20:40:00,96,153,Eletrônico,4,249
37242,2024-01-26 20:41:00,12,133,Vestuário,6,145
37243,2024-01-26 20:42:00,93,166,Brinquedo,4,259
37244,2024-01-26 20:43:00,39,60,Eletrônico,9,99
37245,2024-01-26 20:44:00,15,60,Eletrônico,9,75
37246,2024-01-26 20:45:00,21,81,Eletrônico,6,102
37247,2024-01-26 20:46:00,91,80,Alimento,9,171
37248,2024-01-26 20:47:00,40,25,Vestuário,8,65
37249,2024-01-26 20:48:00,16,150,Vestuário,5,166
37250,2024-01-26 20:49:00,58,151,Móvel,6,209
37251,2024-01-26 20:50:00,17,138,Alimento,5,155
37252,2024-01-26 20:51:00,40,103,Vestuário,6,143
37253,2024-01-26 20:52:00,91,61,Brinquedo,9,152
37254,2024-01-26 20:53:00,27,57,Vestuário,9,84
37255,2024-01-26 20:54:00,35,12,Brinquedo,7,47
37256,2024-01-26 20:55:00,93,121,Brinquedo,4,214
37257,2024-01-26 20:56:00,26,83,Móvel,4,109
37258,2024-01-26 20:57:00,59,80,Eletrônico,7,139
37259,2024-01-26 20:58:00,78,72,Vestuário,6,150
37260,2024-01-26 20:59:00,58,158,Alimento,5,216
37261,2024-01-26 21:00:00,98,42,Móvel,4,140
37262,2024-01-26 21:01:00,83,158,Vestuário,2,241
37263,2024-01-26 21:02:00,17,145,Eletrônico,6,162
37264,2024-01-26 21:03:00,94,22,Eletrônico,9,116
37265,2024-01-26 21:04:00,11,98,Vestuário,2,109
37266,2024-01-26 21:05:00,13,168,Alimento,7,181
37267,2024-01-26 21:06:00,18,88,Eletrônico,3,106
37268,2024-01-26 21:07:00,105,56,Alimento,8,161
37269,2024-01-26 21:08:00,93,67,Eletrônico,1,160
37270,2024-01-26 21:09:00,57,13,Móvel,4,70
37271,2024-01-26 21:10:00,54,134,Eletrônico,1,188
37272,2024-01-26 21:11:00,56,164,Móvel,4,220
37273,2024-01-26 21:12:00,96,162,Brinquedo,5,258
37274,2024-01-26 21:13:00,34,80,Móvel,5,114
37275,2024-01-26 21:14:00,76,100,Brinquedo,9,176
37276,2024-01-26 21:15:00,42,83,Eletrônico,4,125
37277,2024-01-26 21:16:00,42,84,Alimento,3,126
37278,2024-01-26 21:17:00,90,81,Eletrônico,2,171
37279,2024-01-26 21:18:00,29,179,Vestuário,1,208
37280,2024-01-26 21:19:00,65,97,Alimento,2,162
37281,2024-01-26 21:20:00,22,39,Alimento,9,61
37282,2024-01-26 21:21:00,57,66,Eletrônico,3,123
37283,2024-01-26 21:22:00,105,146,Móvel,6,251
37284,2024-01-26 21:23:00,31,143,Brinquedo,4,174
37285,2024-01-26 21:24:00,108,134,Vestuário,7,242
37286,2024-01-26 21:25:00,108,92,Vestuário,4,200
37287,2024-01-26 21:26:00,28,95,Brinquedo,1,123
37288,2024-01-26 21:27:00,52,162,Brinquedo,5,214
37289,2024-01-26 21:28:00,52,74,Brinquedo,7,126
37290,2024-01-26 21:29:00,17,101,Eletrônico,6,118
37291,2024-01-26 21:30:00,116,39,Vestuário,8,155
37292,2024-01-26 21:31:00,84,78,Alimento,7,162
37293,2024-01-26 21:32:00,35,171,Móvel,2,206
37294,2024-01-26 21:33:00,102,17,Móvel,3,119
37295,2024-01-26 21:34:00,91,110,Alimento,4,201
37296,2024-01-26 21:35:00,95,54,Brinquedo,4,149
37297,2024-01-26 21:36:00,75,73,Eletrônico,2,148
37298,2024-01-26 21:37:00,30,104,Eletrônico,3,134
37299,2024-01-26 21:38:00,106,85,Alimento,4,191
37300,2024-01-26 21:39:00,84,129,Móvel,9,213
37301,2024-01-26 21:40:00,57,62,Móvel,7,119
37302,2024-01-26 21:41:00,96,99,Eletrônico,8,195
37303,2024-01-26 21:42:00,18,160,Móvel,6,178
37304,2024-01-26 21:43:00,43,49,Móvel,7,92
37305,2024-01-26 21:44:00,24,154,Alimento,1,178
37306,2024-01-26 21:45:00,66,176,Eletrônico,8,242
37307,2024-01-26 21:46:00,98,148,Vestuário,8,246
37308,2024-01-26 21:47:00,71,69,Vestuário,6,140
37309,2024-01-26 21:48:00,10,111,Vestuário,6,121
37310,2024-01-26 21:49:00,25,49,Vestuário,5,74
37311,2024-01-26 21:50:00,20,56,Alimento,9,76
37312,2024-01-26 21:51:00,76,31,Brinquedo,6,107
37313,2024-01-26 21:52:00,24,85,Brinquedo,5,109
37314,2024-01-26 21:53:00,82,111,Alimento,8,193
37315,2024-01-26 21:54:00,101,129,Eletrônico,6,230
37316,2024-01-26 21:55:00,87,80,Vestuário,4,167
37317,2024-01-26 21:56:00,86,81,Alimento,4,167
37318,2024-01-26 21:57:00,106,112,Vestuário,1,218
37319,2024-01-26 21:58:00,118,34,Vestuário,7,152
37320,2024-01-26 21:59:00,110,139,Móvel,3,249
37321,2024-01-26 22:00:00,48,76,Eletrônico,8,124
37322,2024-01-26 22:01:00,90,24,Vestuário,2,114
37323,2024-01-26 22:02:00,97,52,Eletrônico,4,149
37324,2024-01-26 22:03:00,63,105,Móvel,3,168
37325,2024-01-26 22:04:00,77,25,Móvel,2,102
37326,2024-01-26 22:05:00,45,57,Alimento,2,102
37327,2024-01-26 22:06:00,83,87,Eletrônico,6,170
37328,2024-01-26 22:07:00,98,31,Vestuário,7,129
37329,2024-01-26 22:08:00,104,122,Móvel,5,226
37330,2024-01-26 22:09:00,66,23,Alimento,5,89
37331,2024-01-26 22:10:00,16,78,Móvel,7,94
37332,2024-01-26 22:11:00,47,172,Eletrônico,8,219
37333,2024-01-26 22:12:00,92,52,Brinquedo,4,144
37334,2024-01-26 22:13:00,115,95,Vestuário,4,210
37335,2024-01-26 22:14:00,24,134,Brinquedo,3,158
37336,2024-01-26 22:15:00,95,146,Brinquedo,8,241
37337,2024-01-26 22:16:00,11,107,Eletrônico,2,118
37338,2024-01-26 22:17:00,96,109,Vestuário,2,205
37339,2024-01-26 22:18:00,110,114,Móvel,5,224
37340,2024-01-26 22:19:00,100,170,Alimento,1,270
37341,2024-01-26 22:20:00,94,66,Vestuário,9,160
37342,2024-01-26 22:21:00,23,34,Brinquedo,5,57
37343,2024-01-26 22:22:00,12,137,Eletrônico,2,149
37344,2024-01-26 22:23:00,69,143,Vestuário,9,212
37345,2024-01-26 22:24:00,71,87,Móvel,5,158
37346,2024-01-26 22:25:00,34,177,Vestuário,3,211
37347,2024-01-26 22:26:00,51,81,Móvel,9,132
37348,2024-01-26 22:27:00,97,170,Vestuário,7,267
37349,2024-01-26 22:28:00,21,155,Vestuário,4,176
37350,2024-01-26 22:29:00,66,157,Móvel,2,223
37351,2024-01-26 22:30:00,51,29,Brinquedo,6,80
37352,2024-01-26 22:31:00,30,120,Alimento,1,150
37353,2024-01-26 22:32:00,19,63,Móvel,6,82
37354,2024-01-26 22:33:00,12,11,Vestuário,1,23
37355,2024-01-26 22:34:00,16,112,Brinquedo,2,128
37356,2024-01-26 22:35:00,12,87,Brinquedo,6,99
37357,2024-01-26 22:36:00,67,157,Eletrônico,1,224
37358,2024-01-26 22:37:00,51,162,Vestuário,5,213
37359,2024-01-26 22:38:00,35,35,Vestuário,9,70
37360,2024-01-26 22:39:00,52,89,Móvel,5,141
37361,2024-01-26 22:40:00,58,137,Brinquedo,6,195
37362,2024-01-26 22:41:00,76,101,Alimento,4,177
37363,2024-01-26 22:42:00,65,74,Móvel,4,139
37364,2024-01-26 22:43:00,34,78,Móvel,5,112
37365,2024-01-26 22:44:00,29,116,Alimento,4,145
37366,2024-01-26 22:45:00,84,12,Brinquedo,1,96
37367,2024-01-26 22:46:00,81,118,Alimento,5,199
37368,2024-01-26 22:47:00,11,29,Alimento,1,40
37369,2024-01-26 22:48:00,28,172,Eletrônico,6,200
37370,2024-01-26 22:49:00,90,85,Brinquedo,1,175
37371,2024-01-26 22:50:00,48,62,Eletrônico,3,110
37372,2024-01-26 22:51:00,63,91,Eletrônico,8,154
37373,2024-01-26 22:52:00,52,14,Alimento,3,66
37374,2024-01-26 22:53:00,45,92,Alimento,9,137
37375,2024-01-26 22:54:00,105,170,Brinquedo,9,275
37376,2024-01-26 22:55:00,14,150,Móvel,5,164
37377,2024-01-26 22:56:00,70,44,Vestuário,6,114
37378,2024-01-26 22:57:00,99,100,Eletrônico,9,199
37379,2024-01-26 22:58:00,28,175,Móvel,1,203
37380,2024-01-26 22:59:00,16,15,Brinquedo,2,31
37381,2024-01-26 23:00:00,67,147,Móvel,8,214
37382,2024-01-26 23:01:00,37,96,Brinquedo,4,133
37383,2024-01-26 23:02:00,44,91,Móvel,2,135
37384,2024-01-26 23:03:00,52,52,Alimento,6,104
37385,2024-01-26 23:04:00,114,145,Alimento,8,259
37386,2024-01-26 23:05:00,51,85,Móvel,9,136
37387,2024-01-26 23:06:00,57,144,Brinquedo,1,201
37388,2024-01-26 23:07:00,61,158,Eletrônico,7,219
37389,2024-01-26 23:08:00,57,118,Vestuário,6,175
37390,2024-01-26 23:09:00,53,83,Brinquedo,1,136
37391,2024-01-26 23:10:00,51,43,Móvel,9,94
37392,2024-01-26 23:11:00,17,176,Móvel,4,193
37393,2024-01-26 23:12:00,91,92,Vestuário,8,183
37394,2024-01-26 23:13:00,89,41,Alimento,5,130
37395,2024-01-26 23:14:00,81,90,Brinquedo,4,171
37396,2024-01-26 23:15:00,62,92,Móvel,5,154
37397,2024-01-26 23:16:00,81,144,Alimento,3,225
37398,2024-01-26 23:17:00,69,125,Eletrônico,4,194
37399,2024-01-26 23:18:00,58,136,Alimento,5,194
37400,2024-01-26 23:19:00,94,100,Alimento,1,194
37401,2024-01-26 23:20:00,26,22,Alimento,6,48
37402,2024-01-26 23:21:00,36,110,Eletrônico,8,146
37403,2024-01-26 23:22:00,108,96,Brinquedo,7,204
37404,2024-01-26 23:23:00,69,100,Vestuário,5,169
37405,2024-01-26 23:24:00,93,26,Alimento,3,119
37406,2024-01-26 23:25:00,16,130,Vestuário,3,146
37407,2024-01-26 23:26:00,54,88,Brinquedo,2,142
37408,2024-01-26 23:27:00,87,80,Móvel,9,167
37409,2024-01-26 23:28:00,83,124,Eletrônico,9,207
37410,2024-01-26 23:29:00,109,116,Alimento,2,225
37411,2024-01-26 23:30:00,59,95,Brinquedo,9,154
37412,2024-01-26 23:31:00,57,126,Vestuário,7,183
37413,2024-01-26 23:32:00,91,121,Eletrônico,1,212
37414,2024-01-26 23:33:00,32,83,Brinquedo,9,115
37415,2024-01-26 23:34:00,108,143,Móvel,8,251
37416,2024-01-26 23:35:00,57,103,Móvel,7,160
37417,2024-01-26 23:36:00,86,33,Vestuário,4,119
37418,2024-01-26 23:37:00,56,38,Vestuário,7,94
37419,2024-01-26 23:38:00,87,66,Vestuário,5,153
37420,2024-01-26 23:39:00,17,161,Brinquedo,9,178
37421,2024-01-26 23:40:00,37,63,Alimento,8,100
37422,2024-01-26 23:41:00,22,144,Vestuário,1,166
37423,2024-01-26 23:42:00,100,33,Eletrônico,7,133
37424,2024-01-26 23:43:00,37,79,Brinquedo,7,116
37425,2024-01-26 23:44:00,45,99,Vestuário,3,144
37426,2024-01-26 23:45:00,42,82,Vestuário,8,124
37427,2024-01-26 23:46:00,15,143,Móvel,3,158
37428,2024-01-26 23:47:00,38,114,Vestuário,3,152
37429,2024-01-26 23:48:00,62,173,Alimento,2,235
37430,2024-01-26 23:49:00,119,136,Eletrônico,5,255
37431,2024-01-26 23:50:00,106,94,Alimento,9,200
37432,2024-01-26 23:51:00,61,133,Vestuário,2,194
37433,2024-01-26 23:52:00,82,71,Vestuário,9,153
37434,2024-01-26 23:53:00,98,23,Móvel,4,121
37435,2024-01-26 23:54:00,18,35,Alimento,3,53
37436,2024-01-26 23:55:00,92,176,Eletrônico,5,268
37437,2024-01-26 23:56:00,68,173,Alimento,1,241
37438,2024-01-26 23:57:00,97,20,Alimento,3,117
37439,2024-01-26 23:58:00,96,77,Eletrônico,3,173
37440,2024-01-26 23:59:00,48,55,Vestuário,7,103
37441,2024-01-27 00:00:00,39,177,Alimento,9,216
37442,2024-01-27 00:01:00,37,23,Eletrônico,3,60
37443,2024-01-27 00:02:00,74,134,Eletrônico,6,208
37444,2024-01-27 00:03:00,28,154,Eletrônico,2,182
37445,2024-01-27 00:04:00,46,55,Eletrônico,9,101
37446,2024-01-27 00:05:00,30,155,Móvel,5,185
37447,2024-01-27 00:06:00,32,154,Móvel,8,186
37448,2024-01-27 00:07:00,14,177,Eletrônico,9,191
37449,2024-01-27 00:08:00,29,165,Vestuário,2,194
37450,2024-01-27 00:09:00,69,133,Brinquedo,9,202
37451,2024-01-27 00:10:00,27,91,Brinquedo,9,118
37452,2024-01-27 00:11:00,17,28,Móvel,4,45
37453,2024-01-27 00:12:00,20,49,Brinquedo,7,69
37454,2024-01-27 00:13:00,87,84,Móvel,8,171
37455,2024-01-27 00:14:00,103,123,Alimento,5,226
37456,2024-01-27 00:15:00,70,66,Alimento,7,136
37457,2024-01-27 00:16:00,45,104,Alimento,7,149
37458,2024-01-27 00:17:00,45,143,Móvel,5,188
37459,2024-01-27 00:18:00,42,144,Vestuário,3,186
37460,2024-01-27 00:19:00,67,163,Móvel,7,230
37461,2024-01-27 00:20:00,49,34,Eletrônico,5,83
37462,2024-01-27 00:21:00,24,148,Móvel,9,172
37463,2024-01-27 00:22:00,92,169,Vestuário,1,261
37464,2024-01-27 00:23:00,91,24,Móvel,4,115
37465,2024-01-27 00:24:00,28,78,Alimento,1,106
37466,2024-01-27 00:25:00,59,101,Móvel,6,160
37467,2024-01-27 00:26:00,32,44,Brinquedo,7,76
37468,2024-01-27 00:27:00,43,96,Móvel,6,139
37469,2024-01-27 00:28:00,80,73,Alimento,6,153
37470,2024-01-27 00:29:00,66,69,Alimento,2,135
37471,2024-01-27 00:30:00,54,78,Brinquedo,1,132
37472,2024-01-27 00:31:00,55,47,Vestuário,3,102
37473,2024-01-27 00:32:00,80,104,Brinquedo,5,184
37474,2024-01-27 00:33:00,83,33,Brinquedo,4,116
37475,2024-01-27 00:34:00,87,36,Brinquedo,4,123
37476,2024-01-27 00:35:00,26,94,Eletrônico,1,120
37477,2024-01-27 00:36:00,89,11,Eletrônico,7,100
37478,2024-01-27 00:37:00,109,160,Alimento,2,269
37479,2024-01-27 00:38:00,112,40,Vestuário,6,152
37480,2024-01-27 00:39:00,90,99,Brinquedo,9,189
37481,2024-01-27 00:40:00,76,144,Móvel,2,220
37482,2024-01-27 00:41:00,60,12,Vestuário,8,72
37483,2024-01-27 00:42:00,10,114,Móvel,2,124
37484,2024-01-27 00:43:00,76,178,Móvel,6,254
37485,2024-01-27 00:44:00,35,135,Eletrônico,2,170
37486,2024-01-27 00:45:00,31,59,Vestuário,7,90
37487,2024-01-27 00:46:00,67,71,Brinquedo,6,138
37488,2024-01-27 00:47:00,26,104,Eletrônico,7,130
37489,2024-01-27 00:48:00,86,54,Alimento,4,140
37490,2024-01-27 00:49:00,58,20,Alimento,5,78
37491,2024-01-27 00:50:00,83,48,Alimento,8,131
37492,2024-01-27 00:51:00,35,41,Eletrônico,7,76
37493,2024-01-27 00:52:00,112,42,Eletrônico,4,154
37494,2024-01-27 00:53:00,107,157,Brinquedo,7,264
37495,2024-01-27 00:54:00,111,68,Brinquedo,9,179
37496,2024-01-27 00:55:00,97,74,Móvel,9,171
37497,2024-01-27 00:56:00,73,18,Brinquedo,1,91
37498,2024-01-27 00:57:00,13,119,Vestuário,5,132
37499,2024-01-27 00:58:00,98,147,Vestuário,5,245
37500,2024-01-27 00:59:00,115,69,Brinquedo,2,184
37501,2024-01-27 01:00:00,79,148,Vestuário,2,227
37502,2024-01-27 01:01:00,23,40,Vestuário,5,63
37503,2024-01-27 01:02:00,66,63,Vestuário,5,129
37504,2024-01-27 01:03:00,107,14,Eletrônico,9,121
37505,2024-01-27 01:04:00,67,153,Brinquedo,8,220
37506,2024-01-27 01:05:00,68,120,Móvel,8,188
37507,2024-01-27 01:06:00,54,56,Vestuário,1,110
37508,2024-01-27 01:07:00,45,84,Alimento,2,129
37509,2024-01-27 01:08:00,84,110,Brinquedo,1,194
37510,2024-01-27 01:09:00,90,84,Eletrônico,3,174
37511,2024-01-27 01:10:00,61,170,Eletrônico,8,231
37512,2024-01-27 01:11:00,95,98,Alimento,5,193
37513,2024-01-27 01:12:00,74,102,Eletrônico,1,176
37514,2024-01-27 01:13:00,87,36,Alimento,6,123
37515,2024-01-27 01:14:00,22,107,Eletrônico,2,129
37516,2024-01-27 01:15:00,91,107,Eletrônico,4,198
37517,2024-01-27 01:16:00,78,77,Alimento,1,155
37518,2024-01-27 01:17:00,97,158,Eletrônico,5,255
37519,2024-01-27 01:18:00,70,67,Eletrônico,4,137
37520,2024-01-27 01:19:00,29,110,Alimento,4,139
37521,2024-01-27 01:20:00,108,79,Eletrônico,5,187
37522,2024-01-27 01:21:00,104,176,Vestuário,4,280
37523,2024-01-27 01:22:00,36,26,Alimento,2,62
37524,2024-01-27 01:23:00,71,89,Brinquedo,1,160
37525,2024-01-27 01:24:00,89,107,Alimento,5,196
37526,2024-01-27 01:25:00,78,134,Móvel,1,212
37527,2024-01-27 01:26:00,118,41,Alimento,5,159
37528,2024-01-27 01:27:00,43,158,Brinquedo,7,201
37529,2024-01-27 01:28:00,60,38,Brinquedo,1,98
37530,2024-01-27 01:29:00,94,69,Eletrônico,4,163
37531,2024-01-27 01:30:00,56,116,Eletrônico,6,172
37532,2024-01-27 01:31:00,39,17,Alimento,4,56
37533,2024-01-27 01:32:00,87,56,Eletrônico,3,143
37534,2024-01-27 01:33:00,12,79,Móvel,2,91
37535,2024-01-27 01:34:00,33,171,Móvel,2,204
37536,2024-01-27 01:35:00,45,127,Brinquedo,8,172
37537,2024-01-27 01:36:00,110,100,Alimento,3,210
37538,2024-01-27 01:37:00,63,65,Alimento,4,128
37539,2024-01-27 01:38:00,19,149,Vestuário,3,168
37540,2024-01-27 01:39:00,78,27,Eletrônico,2,105
37541,2024-01-27 01:40:00,15,75,Alimento,3,90
37542,2024-01-27 01:41:00,48,23,Brinquedo,6,71
37543,2024-01-27 01:42:00,81,38,Móvel,4,119
37544,2024-01-27 01:43:00,104,108,Alimento,5,212
37545,2024-01-27 01:44:00,87,145,Eletrônico,9,232
37546,2024-01-27 01:45:00,39,157,Eletrônico,3,196
37547,2024-01-27 01:46:00,95,135,Brinquedo,8,230
37548,2024-01-27 01:47:00,49,50,Vestuário,8,99
37549,2024-01-27 01:48:00,31,33,Brinquedo,1,64
37550,2024-01-27 01:49:00,40,13,Alimento,2,53
37551,2024-01-27 01:50:00,34,14,Móvel,8,48
37552,2024-01-27 01:51:00,82,53,Móvel,8,135
37553,2024-01-27 01:52:00,104,103,Alimento,9,207
37554,2024-01-27 01:53:00,51,107,Alimento,3,158
37555,2024-01-27 01:54:00,77,145,Móvel,3,222
37556,2024-01-27 01:55:00,16,84,Alimento,8,100
37557,2024-01-27 01:56:00,79,17,Eletrônico,2,96
37558,2024-01-27 01:57:00,88,52,Eletrônico,2,140
37559,2024-01-27 01:58:00,118,77,Vestuário,3,195
37560,2024-01-27 01:59:00,104,110,Vestuário,8,214
37561,2024-01-27 02:00:00,53,108,Vestuário,8,161
37562,2024-01-27 02:01:00,95,26,Alimento,5,121
37563,2024-01-27 02:02:00,52,101,Eletrônico,5,153
37564,2024-01-27 02:03:00,78,87,Vestuário,2,165
37565,2024-01-27 02:04:00,42,18,Vestuário,9,60
37566,2024-01-27 02:05:00,100,45,Alimento,5,145
37567,2024-01-27 02:06:00,71,134,Alimento,5,205
37568,2024-01-27 02:07:00,102,143,Eletrônico,3,245
37569,2024-01-27 02:08:00,71,11,Eletrônico,5,82
37570,2024-01-27 02:09:00,25,43,Brinquedo,5,68
37571,2024-01-27 02:10:00,92,44,Vestuário,2,136
37572,2024-01-27 02:11:00,19,76,Brinquedo,6,95
37573,2024-01-27 02:12:00,118,101,Móvel,2,219
37574,2024-01-27 02:13:00,82,147,Móvel,4,229
37575,2024-01-27 02:14:00,91,39,Móvel,7,130
37576,2024-01-27 02:15:00,50,105,Móvel,5,155
37577,2024-01-27 02:16:00,95,99,Vestuário,9,194
37578,2024-01-27 02:17:00,47,17,Eletrônico,3,64
37579,2024-01-27 02:18:00,59,26,Alimento,3,85
37580,2024-01-27 02:19:00,11,154,Eletrônico,2,165
37581,2024-01-27 02:20:00,16,86,Alimento,2,102
37582,2024-01-27 02:21:00,111,51,Móvel,2,162
37583,2024-01-27 02:22:00,96,149,Alimento,2,245
37584,2024-01-27 02:23:00,43,11,Eletrônico,1,54
37585,2024-01-27 02:24:00,31,179,Móvel,2,210
37586,2024-01-27 02:25:00,94,45,Brinquedo,7,139
37587,2024-01-27 02:26:00,77,84,Alimento,5,161
37588,2024-01-27 02:27:00,13,16,Móvel,1,29
37589,2024-01-27 02:28:00,119,156,Eletrônico,9,275
37590,2024-01-27 02:29:00,35,90,Brinquedo,8,125
37591,2024-01-27 02:30:00,34,139,Vestuário,3,173
37592,2024-01-27 02:31:00,98,81,Brinquedo,8,179
37593,2024-01-27 02:32:00,17,70,Móvel,3,87
37594,2024-01-27 02:33:00,87,105,Brinquedo,5,192
37595,2024-01-27 02:34:00,60,159,Vestuário,4,219
37596,2024-01-27 02:35:00,46,134,Eletrônico,1,180
37597,2024-01-27 02:36:00,79,161,Eletrônico,3,240
37598,2024-01-27 02:37:00,51,13,Vestuário,9,64
37599,2024-01-27 02:38:00,47,40,Móvel,5,87
37600,2024-01-27 02:39:00,79,44,Brinquedo,5,123
37601,2024-01-27 02:40:00,64,124,Móvel,2,188
37602,2024-01-27 02:41:00,48,61,Móvel,1,109
37603,2024-01-27 02:42:00,70,155,Vestuário,5,225
37604,2024-01-27 02:43:00,60,125,Alimento,5,185
37605,2024-01-27 02:44:00,83,27,Vestuário,5,110
37606,2024-01-27 02:45:00,87,163,Eletrônico,4,250
37607,2024-01-27 02:46:00,10,60,Alimento,5,70
37608,2024-01-27 02:47:00,119,53,Móvel,8,172
37609,2024-01-27 02:48:00,69,70,Brinquedo,9,139
37610,2024-01-27 02:49:00,81,65,Brinquedo,3,146
37611,2024-01-27 02:50:00,41,150,Móvel,3,191
37612,2024-01-27 02:51:00,65,117,Alimento,4,182
37613,2024-01-27 02:52:00,96,92,Brinquedo,8,188
37614,2024-01-27 02:53:00,25,13,Brinquedo,3,38
37615,2024-01-27 02:54:00,83,176,Eletrônico,4,259
37616,2024-01-27 02:55:00,67,51,Brinquedo,5,118
37617,2024-01-27 02:56:00,81,94,Eletrônico,9,175
37618,2024-01-27 02:57:00,37,147,Móvel,5,184
37619,2024-01-27 02:58:00,110,31,Brinquedo,9,141
37620,2024-01-27 02:59:00,59,33,Brinquedo,3,92
37621,2024-01-27 03:00:00,42,111,Alimento,2,153
37622,2024-01-27 03:01:00,89,146,Alimento,4,235
37623,2024-01-27 03:02:00,97,39,Vestuário,8,136
37624,2024-01-27 03:03:00,20,143,Brinquedo,1,163
37625,2024-01-27 03:04:00,99,78,Vestuário,8,177
37626,2024-01-27 03:05:00,42,174,Eletrônico,2,216
37627,2024-01-27 03:06:00,57,34,Móvel,4,91
37628,2024-01-27 03:07:00,47,77,Alimento,4,124
37629,2024-01-27 03:08:00,33,31,Móvel,5,64
37630,2024-01-27 03:09:00,25,103,Eletrônico,6,128
37631,2024-01-27 03:10:00,80,72,Alimento,7,152
37632,2024-01-27 03:11:00,97,75,Eletrônico,3,172
37633,2024-01-27 03:12:00,80,84,Eletrônico,4,164
37634,2024-01-27 03:13:00,96,40,Eletrônico,1,136
37635,2024-01-27 03:14:00,37,128,Eletrônico,1,165
37636,2024-01-27 03:15:00,115,19,Brinquedo,3,134
37637,2024-01-27 03:16:00,35,139,Brinquedo,5,174
37638,2024-01-27 03:17:00,68,12,Vestuário,8,80
37639,2024-01-27 03:18:00,105,156,Vestuário,8,261
37640,2024-01-27 03:19:00,21,104,Alimento,3,125
37641,2024-01-27 03:20:00,31,143,Eletrônico,6,174
37642,2024-01-27 03:21:00,99,77,Brinquedo,2,176
37643,2024-01-27 03:22:00,63,50,Vestuário,7,113
37644,2024-01-27 03:23:00,43,128,Alimento,4,171
37645,2024-01-27 03:24:00,94,58,Alimento,5,152
37646,2024-01-27 03:25:00,93,19,Móvel,4,112
37647,2024-01-27 03:26:00,78,59,Brinquedo,3,137
37648,2024-01-27 03:27:00,110,21,Alimento,2,131
37649,2024-01-27 03:28:00,56,51,Eletrônico,5,107
37650,2024-01-27 03:29:00,113,105,Móvel,5,218
37651,2024-01-27 03:30:00,117,72,Eletrônico,4,189
37652,2024-01-27 03:31:00,69,66,Eletrônico,6,135
37653,2024-01-27 03:32:00,45,28,Alimento,8,73
37654,2024-01-27 03:33:00,61,127,Brinquedo,2,188
37655,2024-01-27 03:34:00,61,44,Brinquedo,8,105
37656,2024-01-27 03:35:00,55,42,Eletrônico,4,97
37657,2024-01-27 03:36:00,103,64,Vestuário,7,167
37658,2024-01-27 03:37:00,10,88,Eletrônico,6,98
37659,2024-01-27 03:38:00,57,129,Eletrônico,3,186
37660,2024-01-27 03:39:00,39,83,Vestuário,3,122
37661,2024-01-27 03:40:00,80,143,Brinquedo,4,223
37662,2024-01-27 03:41:00,37,37,Eletrônico,9,74
37663,2024-01-27 03:42:00,36,109,Brinquedo,8,145
37664,2024-01-27 03:43:00,109,115,Eletrônico,4,224
37665,2024-01-27 03:44:00,99,104,Alimento,6,203
37666,2024-01-27 03:45:00,34,41,Vestuário,3,75
37667,2024-01-27 03:46:00,70,43,Brinquedo,4,113
37668,2024-01-27 03:47:00,69,68,Alimento,4,137
37669,2024-01-27 03:48:00,65,138,Eletrônico,4,203
37670,2024-01-27 03:49:00,90,175,Brinquedo,3,265
37671,2024-01-27 03:50:00,115,123,Alimento,4,238
37672,2024-01-27 03:51:00,28,92,Alimento,7,120
37673,2024-01-27 03:52:00,62,132,Vestuário,5,194
37674,2024-01-27 03:53:00,80,58,Vestuário,2,138
37675,2024-01-27 03:54:00,21,57,Vestuário,1,78
37676,2024-01-27 03:55:00,60,21,Eletrônico,9,81
37677,2024-01-27 03:56:00,82,161,Vestuário,4,243
37678,2024-01-27 03:57:00,44,19,Eletrônico,2,63
37679,2024-01-27 03:58:00,35,69,Alimento,9,104
37680,2024-01-27 03:59:00,104,88,Móvel,9,192
37681,2024-01-27 04:00:00,69,139,Alimento,2,208
37682,2024-01-27 04:01:00,91,93,Eletrônico,8,184
37683,2024-01-27 04:02:00,102,13,Vestuário,1,115
37684,2024-01-27 04:03:00,92,88,Móvel,8,180
37685,2024-01-27 04:04:00,11,151,Vestuário,6,162
37686,2024-01-27 04:05:00,55,117,Brinquedo,9,172
37687,2024-01-27 04:06:00,10,121,Alimento,9,131
37688,2024-01-27 04:07:00,32,149,Brinquedo,7,181
37689,2024-01-27 04:08:00,40,165,Brinquedo,3,205
37690,2024-01-27 04:09:00,55,134,Móvel,8,189
37691,2024-01-27 04:10:00,112,51,Vestuário,2,163
37692,2024-01-27 04:11:00,28,151,Vestuário,4,179
37693,2024-01-27 04:12:00,30,134,Móvel,9,164
37694,2024-01-27 04:13:00,28,151,Vestuário,3,179
37695,2024-01-27 04:14:00,87,89,Eletrônico,7,176
37696,2024-01-27 04:15:00,40,62,Alimento,4,102
37697,2024-01-27 04:16:00,108,93,Alimento,6,201
37698,2024-01-27 04:17:00,96,177,Brinquedo,9,273
37699,2024-01-27 04:18:00,59,76,Eletrônico,8,135
37700,2024-01-27 04:19:00,90,36,Vestuário,8,126
37701,2024-01-27 04:20:00,60,123,Eletrônico,3,183
37702,2024-01-27 04:21:00,69,97,Alimento,5,166
37703,2024-01-27 04:22:00,96,92,Alimento,2,188
37704,2024-01-27 04:23:00,50,68,Brinquedo,8,118
37705,2024-01-27 04:24:00,83,99,Eletrônico,1,182
37706,2024-01-27 04:25:00,51,165,Alimento,8,216
37707,2024-01-27 04:26:00,74,28,Móvel,3,102
37708,2024-01-27 04:27:00,32,146,Brinquedo,2,178
37709,2024-01-27 04:28:00,65,79,Móvel,8,144
37710,2024-01-27 04:29:00,44,166,Alimento,5,210
37711,2024-01-27 04:30:00,110,91,Vestuário,3,201
37712,2024-01-27 04:31:00,91,50,Móvel,9,141
37713,2024-01-27 04:32:00,46,98,Vestuário,9,144
37714,2024-01-27 04:33:00,18,134,Alimento,3,152
37715,2024-01-27 04:34:00,80,33,Alimento,5,113
37716,2024-01-27 04:35:00,53,172,Eletrônico,7,225
37717,2024-01-27 04:36:00,57,47,Móvel,2,104
37718,2024-01-27 04:37:00,74,27,Vestuário,9,101
37719,2024-01-27 04:38:00,14,85,Alimento,1,99
37720,2024-01-27 04:39:00,99,45,Alimento,6,144
37721,2024-01-27 04:40:00,31,74,Alimento,3,105
37722,2024-01-27 04:41:00,37,130,Brinquedo,1,167
37723,2024-01-27 04:42:00,82,69,Brinquedo,4,151
37724,2024-01-27 04:43:00,94,35,Eletrônico,1,129
37725,2024-01-27 04:44:00,47,55,Brinquedo,6,102
37726,2024-01-27 04:45:00,117,65,Brinquedo,5,182
37727,2024-01-27 04:46:00,22,44,Móvel,6,66
37728,2024-01-27 04:47:00,64,148,Alimento,8,212
37729,2024-01-27 04:48:00,30,17,Móvel,8,47
37730,2024-01-27 04:49:00,37,176,Eletrônico,7,213
37731,2024-01-27 04:50:00,110,38,Eletrônico,6,148
37732,2024-01-27 04:51:00,117,162,Móvel,1,279
37733,2024-01-27 04:52:00,30,158,Eletrônico,1,188
37734,2024-01-27 04:53:00,99,43,Vestuário,2,142
37735,2024-01-27 04:54:00,72,166,Eletrônico,7,238
37736,2024-01-27 04:55:00,16,47,Alimento,5,63
37737,2024-01-27 04:56:00,93,43,Vestuário,3,136
37738,2024-01-27 04:57:00,37,19,Eletrônico,2,56
37739,2024-01-27 04:58:00,78,85,Brinquedo,3,163
37740,2024-01-27 04:59:00,96,23,Brinquedo,4,119
37741,2024-01-27 05:00:00,113,118,Brinquedo,4,231
37742,2024-01-27 05:01:00,89,14,Alimento,9,103
37743,2024-01-27 05:02:00,31,28,Alimento,4,59
37744,2024-01-27 05:03:00,90,48,Alimento,1,138
37745,2024-01-27 05:04:00,89,25,Brinquedo,4,114
37746,2024-01-27 05:05:00,109,108,Móvel,1,217
37747,2024-01-27 05:06:00,99,126,Vestuário,9,225
37748,2024-01-27 05:07:00,98,84,Eletrônico,2,182
37749,2024-01-27 05:08:00,54,134,Móvel,7,188
37750,2024-01-27 05:09:00,19,174,Brinquedo,3,193
37751,2024-01-27 05:10:00,111,62,Vestuário,7,173
37752,2024-01-27 05:11:00,62,101,Móvel,7,163
37753,2024-01-27 05:12:00,83,162,Vestuário,6,245
37754,2024-01-27 05:13:00,107,46,Alimento,7,153
37755,2024-01-27 05:14:00,20,39,Eletrônico,3,59
37756,2024-01-27 05:15:00,93,86,Móvel,1,179
37757,2024-01-27 05:16:00,38,158,Vestuário,1,196
37758,2024-01-27 05:17:00,116,68,Alimento,5,184
37759,2024-01-27 05:18:00,49,98,Brinquedo,4,147
37760,2024-01-27 05:19:00,114,37,Vestuário,5,151
37761,2024-01-27 05:20:00,61,93,Brinquedo,7,154
37762,2024-01-27 05:21:00,49,142,Eletrônico,3,191
37763,2024-01-27 05:22:00,51,138,Móvel,8,189
37764,2024-01-27 05:23:00,111,66,Móvel,8,177
37765,2024-01-27 05:24:00,20,117,Eletrônico,8,137
37766,2024-01-27 05:25:00,13,57,Vestuário,6,70
37767,2024-01-27 05:26:00,12,166,Móvel,9,178
37768,2024-01-27 05:27:00,46,129,Eletrônico,7,175
37769,2024-01-27 05:28:00,25,79,Eletrônico,4,104
37770,2024-01-27 05:29:00,49,147,Alimento,8,196
37771,2024-01-27 05:30:00,55,46,Brinquedo,9,101
37772,2024-01-27 05:31:00,54,10,Móvel,9,64
37773,2024-01-27 05:32:00,16,70,Vestuário,9,86
37774,2024-01-27 05:33:00,118,122,Eletrônico,6,240
37775,2024-01-27 05:34:00,116,129,Eletrônico,3,245
37776,2024-01-27 05:35:00,37,152,Brinquedo,1,189
37777,2024-01-27 05:36:00,78,112,Vestuário,8,190
37778,2024-01-27 05:37:00,82,71,Alimento,2,153
37779,2024-01-27 05:38:00,63,102,Alimento,3,165
37780,2024-01-27 05:39:00,109,173,Eletrônico,5,282
37781,2024-01-27 05:40:00,39,22,Alimento,9,61
37782,2024-01-27 05:41:00,29,75,Vestuário,4,104
37783,2024-01-27 05:42:00,58,100,Alimento,4,158
37784,2024-01-27 05:43:00,110,72,Alimento,7,182
37785,2024-01-27 05:44:00,65,120,Eletrônico,6,185
37786,2024-01-27 05:45:00,17,119,Móvel,3,136
37787,2024-01-27 05:46:00,80,171,Eletrônico,8,251
37788,2024-01-27 05:47:00,77,152,Móvel,4,229
37789,2024-01-27 05:48:00,70,72,Eletrônico,7,142
37790,2024-01-27 05:49:00,101,130,Vestuário,5,231
37791,2024-01-27 05:50:00,73,44,Vestuário,7,117
37792,2024-01-27 05:51:00,11,37,Eletrônico,9,48
37793,2024-01-27 05:52:00,21,69,Alimento,6,90
37794,2024-01-27 05:53:00,58,91,Vestuário,1,149
37795,2024-01-27 05:54:00,32,157,Eletrônico,8,189
37796,2024-01-27 05:55:00,88,80,Eletrônico,7,168
37797,2024-01-27 05:56:00,101,86,Eletrônico,3,187
37798,2024-01-27 05:57:00,75,52,Vestuário,9,127
37799,2024-01-27 05:58:00,18,44,Alimento,7,62
37800,2024-01-27 05:59:00,49,45,Móvel,5,94
37801,2024-01-27 06:00:00,55,112,Brinquedo,3,167
37802,2024-01-27 06:01:00,93,37,Móvel,7,130
37803,2024-01-27 06:02:00,35,16,Eletrônico,7,51
37804,2024-01-27 06:03:00,90,75,Eletrônico,5,165
37805,2024-01-27 06:04:00,78,61,Brinquedo,6,139
37806,2024-01-27 06:05:00,27,15,Alimento,3,42
37807,2024-01-27 06:06:00,54,46,Alimento,8,100
37808,2024-01-27 06:07:00,17,125,Móvel,4,142
37809,2024-01-27 06:08:00,42,91,Vestuário,3,133
37810,2024-01-27 06:09:00,16,16,Vestuário,5,32
37811,2024-01-27 06:10:00,93,165,Brinquedo,9,258
37812,2024-01-27 06:11:00,93,72,Móvel,6,165
37813,2024-01-27 06:12:00,16,18,Brinquedo,4,34
37814,2024-01-27 06:13:00,36,39,Brinquedo,6,75
37815,2024-01-27 06:14:00,53,32,Vestuário,8,85
37816,2024-01-27 06:15:00,62,46,Brinquedo,8,108
37817,2024-01-27 06:16:00,18,29,Alimento,3,47
37818,2024-01-27 06:17:00,29,147,Eletrônico,1,176
37819,2024-01-27 06:18:00,30,55,Brinquedo,3,85
37820,2024-01-27 06:19:00,89,64,Alimento,3,153
37821,2024-01-27 06:20:00,20,53,Eletrônico,7,73
37822,2024-01-27 06:21:00,35,89,Vestuário,2,124
37823,2024-01-27 06:22:00,98,103,Vestuário,4,201
37824,2024-01-27 06:23:00,14,64,Móvel,4,78
37825,2024-01-27 06:24:00,44,39,Móvel,4,83
37826,2024-01-27 06:25:00,74,44,Eletrônico,5,118
37827,2024-01-27 06:26:00,97,146,Vestuário,8,243
37828,2024-01-27 06:27:00,65,115,Vestuário,1,180
37829,2024-01-27 06:28:00,107,126,Móvel,8,233
37830,2024-01-27 06:29:00,78,46,Brinquedo,5,124
37831,2024-01-27 06:30:00,68,84,Alimento,1,152
37832,2024-01-27 06:31:00,68,98,Brinquedo,9,166
37833,2024-01-27 06:32:00,40,34,Alimento,3,74
37834,2024-01-27 06:33:00,48,47,Móvel,1,95
37835,2024-01-27 06:34:00,59,89,Alimento,5,148
37836,2024-01-27 06:35:00,47,149,Brinquedo,8,196
37837,2024-01-27 06:36:00,112,35,Vestuário,8,147
37838,2024-01-27 06:37:00,49,96,Móvel,6,145
37839,2024-01-27 06:38:00,63,32,Alimento,4,95
37840,2024-01-27 06:39:00,44,81,Alimento,2,125
37841,2024-01-27 06:40:00,33,113,Brinquedo,9,146
37842,2024-01-27 06:41:00,22,19,Vestuário,8,41
37843,2024-01-27 06:42:00,74,148,Vestuário,6,222
37844,2024-01-27 06:43:00,110,117,Alimento,2,227
37845,2024-01-27 06:44:00,24,64,Eletrônico,1,88
37846,2024-01-27 06:45:00,110,58,Alimento,1,168
37847,2024-01-27 06:46:00,87,150,Alimento,9,237
37848,2024-01-27 06:47:00,90,38,Eletrônico,5,128
37849,2024-01-27 06:48:00,77,20,Eletrônico,7,97
37850,2024-01-27 06:49:00,74,70,Móvel,8,144
37851,2024-01-27 06:50:00,17,46,Móvel,4,63
37852,2024-01-27 06:51:00,47,30,Móvel,1,77
37853,2024-01-27 06:52:00,81,136,Móvel,5,217
37854,2024-01-27 06:53:00,103,175,Móvel,2,278
37855,2024-01-27 06:54:00,30,116,Brinquedo,7,146
37856,2024-01-27 06:55:00,112,155,Brinquedo,6,267
37857,2024-01-27 06:56:00,115,31,Eletrônico,9,146
37858,2024-01-27 06:57:00,88,16,Móvel,4,104
37859,2024-01-27 06:58:00,64,110,Eletrônico,8,174
37860,2024-01-27 06:59:00,74,174,Eletrônico,7,248
37861,2024-01-27 07:00:00,11,133,Móvel,2,144
37862,2024-01-27 07:01:00,19,98,Alimento,5,117
37863,2024-01-27 07:02:00,69,132,Móvel,4,201
37864,2024-01-27 07:03:00,51,168,Eletrônico,1,219
37865,2024-01-27 07:04:00,75,23,Alimento,2,98
37866,2024-01-27 07:05:00,83,93,Vestuário,2,176
37867,2024-01-27 07:06:00,84,78,Móvel,8,162
37868,2024-01-27 07:07:00,40,21,Vestuário,4,61
37869,2024-01-27 07:08:00,103,58,Móvel,3,161
37870,2024-01-27 07:09:00,64,176,Alimento,6,240
37871,2024-01-27 07:10:00,88,29,Vestuário,1,117
37872,2024-01-27 07:11:00,38,96,Brinquedo,1,134
37873,2024-01-27 07:12:00,30,61,Móvel,5,91
37874,2024-01-27 07:13:00,29,124,Alimento,5,153
37875,2024-01-27 07:14:00,96,15,Brinquedo,3,111
37876,2024-01-27 07:15:00,97,70,Brinquedo,4,167
37877,2024-01-27 07:16:00,55,143,Alimento,3,198
37878,2024-01-27 07:17:00,27,175,Alimento,2,202
37879,2024-01-27 07:18:00,110,18,Vestuário,3,128
37880,2024-01-27 07:19:00,89,139,Vestuário,8,228
37881,2024-01-27 07:20:00,10,38,Brinquedo,2,48
37882,2024-01-27 07:21:00,23,95,Brinquedo,8,118
37883,2024-01-27 07:22:00,68,95,Alimento,3,163
37884,2024-01-27 07:23:00,88,164,Alimento,1,252
37885,2024-01-27 07:24:00,31,94,Alimento,7,125
37886,2024-01-27 07:25:00,23,75,Eletrônico,2,98
37887,2024-01-27 07:26:00,100,142,Alimento,1,242
37888,2024-01-27 07:27:00,10,173,Brinquedo,2,183
37889,2024-01-27 07:28:00,62,178,Vestuário,4,240
37890,2024-01-27 07:29:00,95,53,Alimento,5,148
37891,2024-01-27 07:30:00,51,53,Eletrônico,9,104
37892,2024-01-27 07:31:00,42,140,Móvel,1,182
37893,2024-01-27 07:32:00,70,10,Brinquedo,6,80
37894,2024-01-27 07:33:00,95,41,Vestuário,4,136
37895,2024-01-27 07:34:00,105,38,Eletrônico,3,143
37896,2024-01-27 07:35:00,66,149,Brinquedo,2,215
37897,2024-01-27 07:36:00,55,75,Móvel,3,130
37898,2024-01-27 07:37:00,29,44,Brinquedo,6,73
37899,2024-01-27 07:38:00,57,114,Alimento,1,171
37900,2024-01-27 07:39:00,74,74,Eletrônico,4,148
37901,2024-01-27 07:40:00,33,12,Eletrônico,1,45
37902,2024-01-27 07:41:00,119,30,Eletrônico,3,149
37903,2024-01-27 07:42:00,75,60,Alimento,6,135
37904,2024-01-27 07:43:00,78,76,Móvel,8,154
37905,2024-01-27 07:44:00,77,129,Móvel,4,206
37906,2024-01-27 07:45:00,109,56,Eletrônico,8,165
37907,2024-01-27 07:46:00,99,53,Brinquedo,4,152
37908,2024-01-27 07:47:00,86,23,Eletrônico,2,109
37909,2024-01-27 07:48:00,46,110,Móvel,9,156
37910,2024-01-27 07:49:00,94,66,Vestuário,1,160
37911,2024-01-27 07:50:00,68,90,Brinquedo,9,158
37912,2024-01-27 07:51:00,38,156,Alimento,5,194
37913,2024-01-27 07:52:00,65,152,Móvel,4,217
37914,2024-01-27 07:53:00,91,10,Móvel,9,101
37915,2024-01-27 07:54:00,17,178,Alimento,7,195
37916,2024-01-27 07:55:00,67,178,Eletrônico,3,245
37917,2024-01-27 07:56:00,60,23,Brinquedo,2,83
37918,2024-01-27 07:57:00,11,72,Brinquedo,8,83
37919,2024-01-27 07:58:00,93,19,Móvel,5,112
37920,2024-01-27 07:59:00,56,87,Móvel,7,143
37921,2024-01-27 08:00:00,78,176,Móvel,2,254
37922,2024-01-27 08:01:00,89,18,Alimento,7,107
37923,2024-01-27 08:02:00,38,98,Eletrônico,6,136
37924,2024-01-27 08:03:00,52,22,Móvel,1,74
37925,2024-01-27 08:04:00,109,113,Eletrônico,9,222
37926,2024-01-27 08:05:00,113,138,Brinquedo,3,251
37927,2024-01-27 08:06:00,95,109,Alimento,6,204
37928,2024-01-27 08:07:00,82,77,Alimento,5,159
37929,2024-01-27 08:08:00,86,106,Brinquedo,2,192
37930,2024-01-27 08:09:00,107,34,Móvel,5,141
37931,2024-01-27 08:10:00,17,133,Eletrônico,2,150
37932,2024-01-27 08:11:00,45,117,Vestuário,1,162
37933,2024-01-27 08:12:00,112,34,Alimento,8,146
37934,2024-01-27 08:13:00,15,86,Alimento,4,101
37935,2024-01-27 08:14:00,90,95,Móvel,7,185
37936,2024-01-27 08:15:00,108,90,Eletrônico,1,198
37937,2024-01-27 08:16:00,111,178,Alimento,9,289
37938,2024-01-27 08:17:00,58,27,Eletrônico,7,85
37939,2024-01-27 08:18:00,30,67,Alimento,5,97
37940,2024-01-27 08:19:00,107,167,Vestuário,5,274
37941,2024-01-27 08:20:00,29,98,Eletrônico,8,127
37942,2024-01-27 08:21:00,79,75,Eletrônico,5,154
37943,2024-01-27 08:22:00,110,67,Alimento,4,177
37944,2024-01-27 08:23:00,11,92,Eletrônico,2,103
37945,2024-01-27 08:24:00,80,14,Alimento,4,94
37946,2024-01-27 08:25:00,77,142,Móvel,1,219
37947,2024-01-27 08:26:00,10,120,Alimento,5,130
37948,2024-01-27 08:27:00,40,129,Brinquedo,6,169
37949,2024-01-27 08:28:00,107,27,Alimento,8,134
37950,2024-01-27 08:29:00,56,45,Móvel,5,101
37951,2024-01-27 08:30:00,77,42,Alimento,2,119
37952,2024-01-27 08:31:00,38,151,Brinquedo,1,189
37953,2024-01-27 08:32:00,35,172,Brinquedo,3,207
37954,2024-01-27 08:33:00,49,87,Vestuário,7,136
37955,2024-01-27 08:34:00,33,42,Eletrônico,9,75
37956,2024-01-27 08:35:00,99,93,Alimento,9,192
37957,2024-01-27 08:36:00,77,24,Brinquedo,7,101
37958,2024-01-27 08:37:00,44,54,Alimento,6,98
37959,2024-01-27 08:38:00,74,142,Móvel,2,216
37960,2024-01-27 08:39:00,93,106,Alimento,1,199
37961,2024-01-27 08:40:00,79,18,Alimento,7,97
37962,2024-01-27 08:41:00,42,63,Móvel,7,105
37963,2024-01-27 08:42:00,10,97,Móvel,7,107
37964,2024-01-27 08:43:00,24,161,Alimento,9,185
37965,2024-01-27 08:44:00,76,176,Eletrônico,6,252
37966,2024-01-27 08:45:00,112,143,Alimento,7,255
37967,2024-01-27 08:46:00,79,72,Alimento,1,151
37968,2024-01-27 08:47:00,79,90,Brinquedo,4,169
37969,2024-01-27 08:48:00,74,103,Vestuário,5,177
37970,2024-01-27 08:49:00,77,144,Vestuário,4,221
37971,2024-01-27 08:50:00,118,91,Vestuário,4,209
37972,2024-01-27 08:51:00,47,56,Móvel,6,103
37973,2024-01-27 08:52:00,40,73,Vestuário,2,113
37974,2024-01-27 08:53:00,81,174,Brinquedo,6,255
37975,2024-01-27 08:54:00,26,142,Móvel,7,168
37976,2024-01-27 08:55:00,78,69,Eletrônico,4,147
37977,2024-01-27 08:56:00,21,123,Brinquedo,5,144
37978,2024-01-27 08:57:00,100,163,Brinquedo,7,263
37979,2024-01-27 08:58:00,99,20,Móvel,3,119
37980,2024-01-27 08:59:00,85,119,Vestuário,4,204
37981,2024-01-27 09:00:00,16,14,Alimento,2,30
37982,2024-01-27 09:01:00,23,160,Vestuário,4,183
37983,2024-01-27 09:02:00,42,137,Móvel,8,179
37984,2024-01-27 09:03:00,102,176,Vestuário,2,278
37985,2024-01-27 09:04:00,113,151,Móvel,4,264
37986,2024-01-27 09:05:00,14,176,Brinquedo,6,190
37987,2024-01-27 09:06:00,11,43,Alimento,6,54
37988,2024-01-27 09:07:00,25,82,Brinquedo,3,107
37989,2024-01-27 09:08:00,33,81,Brinquedo,5,114
37990,2024-01-27 09:09:00,26,25,Vestuário,1,51
37991,2024-01-27 09:10:00,81,44,Móvel,6,125
37992,2024-01-27 09:11:00,99,46,Vestuário,9,145
37993,2024-01-27 09:12:00,40,76,Vestuário,7,116
37994,2024-01-27 09:13:00,76,128,Alimento,6,204
37995,2024-01-27 09:14:00,71,111,Móvel,3,182
37996,2024-01-27 09:15:00,31,56,Eletrônico,7,87
37997,2024-01-27 09:16:00,46,12,Alimento,2,58
37998,2024-01-27 09:17:00,118,162,Brinquedo,4,280
37999,2024-01-27 09:18:00,95,173,Eletrônico,9,268
38000,2024-01-27 09:19:00,105,105,Alimento,8,210
38001,2024-01-27 09:20:00,64,31,Vestuário,6,95
38002,2024-01-27 09:21:00,105,95,Eletrônico,2,200
38003,2024-01-27 09:22:00,109,141,Móvel,9,250
38004,2024-01-27 09:23:00,47,104,Vestuário,3,151
38005,2024-01-27 09:24:00,106,158,Móvel,1,264
38006,2024-01-27 09:25:00,101,76,Móvel,2,177
38007,2024-01-27 09:26:00,74,58,Brinquedo,6,132
38008,2024-01-27 09:27:00,21,91,Móvel,9,112
38009,2024-01-27 09:28:00,89,42,Vestuário,4,131
38010,2024-01-27 09:29:00,76,132,Vestuário,5,208
38011,2024-01-27 09:30:00,86,25,Vestuário,2,111
38012,2024-01-27 09:31:00,40,167,Móvel,1,207
38013,2024-01-27 09:32:00,10,79,Brinquedo,5,89
38014,2024-01-27 09:33:00,62,53,Brinquedo,9,115
38015,2024-01-27 09:34:00,50,66,Vestuário,8,116
38016,2024-01-27 09:35:00,81,138,Alimento,4,219
38017,2024-01-27 09:36:00,14,32,Vestuário,2,46
38018,2024-01-27 09:37:00,49,143,Brinquedo,2,192
38019,2024-01-27 09:38:00,61,20,Móvel,2,81
38020,2024-01-27 09:39:00,39,26,Móvel,9,65
38021,2024-01-27 09:40:00,64,69,Eletrônico,3,133
38022,2024-01-27 09:41:00,39,162,Vestuário,2,201
38023,2024-01-27 09:42:00,47,30,Alimento,3,77
38024,2024-01-27 09:43:00,19,124,Móvel,6,143
38025,2024-01-27 09:44:00,79,131,Vestuário,5,210
38026,2024-01-27 09:45:00,70,170,Vestuário,7,240
38027,2024-01-27 09:46:00,45,25,Móvel,5,70
38028,2024-01-27 09:47:00,110,84,Eletrônico,8,194
38029,2024-01-27 09:48:00,54,120,Móvel,8,174
38030,2024-01-27 09:49:00,47,143,Eletrônico,5,190
38031,2024-01-27 09:50:00,109,132,Eletrônico,1,241
38032,2024-01-27 09:51:00,89,57,Brinquedo,4,146
38033,2024-01-27 09:52:00,113,142,Móvel,7,255
38034,2024-01-27 09:53:00,96,22,Móvel,6,118
38035,2024-01-27 09:54:00,107,81,Brinquedo,2,188
38036,2024-01-27 09:55:00,116,76,Alimento,4,192
38037,2024-01-27 09:56:00,32,116,Vestuário,8,148
38038,2024-01-27 09:57:00,15,107,Vestuário,1,122
38039,2024-01-27 09:58:00,64,175,Alimento,8,239
38040,2024-01-27 09:59:00,24,113,Brinquedo,1,137
38041,2024-01-27 10:00:00,41,35,Alimento,5,76
38042,2024-01-27 10:01:00,50,38,Brinquedo,6,88
38043,2024-01-27 10:02:00,53,106,Brinquedo,2,159
38044,2024-01-27 10:03:00,70,116,Vestuário,8,186
38045,2024-01-27 10:04:00,43,151,Alimento,9,194
38046,2024-01-27 10:05:00,30,96,Alimento,5,126
38047,2024-01-27 10:06:00,54,16,Alimento,2,70
38048,2024-01-27 10:07:00,72,171,Vestuário,4,243
38049,2024-01-27 10:08:00,65,27,Brinquedo,9,92
38050,2024-01-27 10:09:00,71,173,Brinquedo,3,244
38051,2024-01-27 10:10:00,77,85,Vestuário,4,162
38052,2024-01-27 10:11:00,34,155,Alimento,6,189
38053,2024-01-27 10:12:00,88,71,Alimento,6,159
38054,2024-01-27 10:13:00,67,126,Vestuário,9,193
38055,2024-01-27 10:14:00,66,20,Eletrônico,9,86
38056,2024-01-27 10:15:00,60,128,Alimento,9,188
38057,2024-01-27 10:16:00,81,13,Vestuário,2,94
38058,2024-01-27 10:17:00,17,122,Alimento,7,139
38059,2024-01-27 10:18:00,24,168,Vestuário,5,192
38060,2024-01-27 10:19:00,13,125,Vestuário,4,138
38061,2024-01-27 10:20:00,83,156,Vestuário,8,239
38062,2024-01-27 10:21:00,67,136,Eletrônico,2,203
38063,2024-01-27 10:22:00,81,177,Eletrônico,3,258
38064,2024-01-27 10:23:00,35,113,Alimento,8,148
38065,2024-01-27 10:24:00,118,104,Móvel,3,222
38066,2024-01-27 10:25:00,106,152,Eletrônico,5,258
38067,2024-01-27 10:26:00,72,77,Alimento,2,149
38068,2024-01-27 10:27:00,78,115,Vestuário,9,193
38069,2024-01-27 10:28:00,74,147,Eletrônico,2,221
38070,2024-01-27 10:29:00,59,146,Eletrônico,1,205
38071,2024-01-27 10:30:00,67,125,Brinquedo,8,192
38072,2024-01-27 10:31:00,37,65,Alimento,1,102
38073,2024-01-27 10:32:00,17,14,Móvel,7,31
38074,2024-01-27 10:33:00,97,145,Vestuário,5,242
38075,2024-01-27 10:34:00,107,60,Alimento,8,167
38076,2024-01-27 10:35:00,100,19,Eletrônico,8,119
38077,2024-01-27 10:36:00,73,63,Brinquedo,7,136
38078,2024-01-27 10:37:00,56,102,Eletrônico,4,158
38079,2024-01-27 10:38:00,14,38,Eletrônico,5,52
38080,2024-01-27 10:39:00,63,23,Eletrônico,5,86
38081,2024-01-27 10:40:00,13,154,Alimento,4,167
38082,2024-01-27 10:41:00,98,11,Eletrônico,3,109
38083,2024-01-27 10:42:00,71,53,Móvel,7,124
38084,2024-01-27 10:43:00,65,141,Alimento,6,206
38085,2024-01-27 10:44:00,45,140,Brinquedo,4,185
38086,2024-01-27 10:45:00,67,10,Móvel,5,77
38087,2024-01-27 10:46:00,116,76,Eletrônico,4,192
38088,2024-01-27 10:47:00,75,18,Alimento,7,93
38089,2024-01-27 10:48:00,45,55,Eletrônico,3,100
38090,2024-01-27 10:49:00,61,62,Vestuário,7,123
38091,2024-01-27 10:50:00,100,97,Vestuário,4,197
38092,2024-01-27 10:51:00,99,10,Móvel,4,109
38093,2024-01-27 10:52:00,82,111,Vestuário,6,193
38094,2024-01-27 10:53:00,117,166,Móvel,5,283
38095,2024-01-27 10:54:00,103,115,Brinquedo,6,218
38096,2024-01-27 10:55:00,95,156,Móvel,2,251
38097,2024-01-27 10:56:00,34,101,Vestuário,2,135
38098,2024-01-27 10:57:00,56,60,Móvel,8,116
38099,2024-01-27 10:58:00,33,146,Eletrônico,7,179
38100,2024-01-27 10:59:00,18,89,Eletrônico,8,107
38101,2024-01-27 11:00:00,67,98,Móvel,7,165
38102,2024-01-27 11:01:00,95,116,Móvel,8,211
38103,2024-01-27 11:02:00,62,60,Móvel,4,122
38104,2024-01-27 11:03:00,54,27,Móvel,2,81
38105,2024-01-27 11:04:00,102,154,Alimento,1,256
38106,2024-01-27 11:05:00,27,86,Móvel,7,113
38107,2024-01-27 11:06:00,73,123,Brinquedo,8,196
38108,2024-01-27 11:07:00,61,110,Brinquedo,6,171
38109,2024-01-27 11:08:00,80,96,Eletrônico,3,176
38110,2024-01-27 11:09:00,37,99,Vestuário,5,136
38111,2024-01-27 11:10:00,25,18,Brinquedo,4,43
38112,2024-01-27 11:11:00,60,175,Móvel,8,235
38113,2024-01-27 11:12:00,101,68,Móvel,7,169
38114,2024-01-27 11:13:00,50,36,Eletrônico,6,86
38115,2024-01-27 11:14:00,16,27,Móvel,5,43
38116,2024-01-27 11:15:00,20,84,Vestuário,8,104
38117,2024-01-27 11:16:00,77,74,Vestuário,3,151
38118,2024-01-27 11:17:00,28,66,Eletrônico,8,94
38119,2024-01-27 11:18:00,113,173,Móvel,1,286
38120,2024-01-27 11:19:00,58,135,Móvel,7,193
38121,2024-01-27 11:20:00,13,13,Móvel,1,26
38122,2024-01-27 11:21:00,51,179,Eletrônico,6,230
38123,2024-01-27 11:22:00,17,137,Brinquedo,5,154
38124,2024-01-27 11:23:00,54,102,Móvel,5,156
38125,2024-01-27 11:24:00,112,95,Eletrônico,2,207
38126,2024-01-27 11:25:00,89,157,Vestuário,9,246
38127,2024-01-27 11:26:00,113,34,Alimento,3,147
38128,2024-01-27 11:27:00,30,16,Vestuário,4,46
38129,2024-01-27 11:28:00,52,126,Móvel,6,178
38130,2024-01-27 11:29:00,77,148,Vestuário,7,225
38131,2024-01-27 11:30:00,15,171,Alimento,8,186
38132,2024-01-27 11:31:00,100,70,Móvel,6,170
38133,2024-01-27 11:32:00,14,52,Vestuário,1,66
38134,2024-01-27 11:33:00,117,88,Eletrônico,1,205
38135,2024-01-27 11:34:00,13,121,Alimento,1,134
38136,2024-01-27 11:35:00,48,57,Móvel,4,105
38137,2024-01-27 11:36:00,63,69,Eletrônico,1,132
38138,2024-01-27 11:37:00,95,54,Vestuário,2,149
38139,2024-01-27 11:38:00,78,38,Brinquedo,2,116
38140,2024-01-27 11:39:00,85,50,Brinquedo,3,135
38141,2024-01-27 11:40:00,18,110,Brinquedo,3,128
38142,2024-01-27 11:41:00,113,93,Móvel,3,206
38143,2024-01-27 11:42:00,75,112,Alimento,2,187
38144,2024-01-27 11:43:00,104,157,Brinquedo,1,261
38145,2024-01-27 11:44:00,82,13,Eletrônico,9,95
38146,2024-01-27 11:45:00,98,52,Brinquedo,3,150
38147,2024-01-27 11:46:00,87,43,Móvel,8,130
38148,2024-01-27 11:47:00,97,82,Alimento,9,179
38149,2024-01-27 11:48:00,27,137,Brinquedo,9,164
38150,2024-01-27 11:49:00,37,145,Brinquedo,7,182
38151,2024-01-27 11:50:00,99,64,Vestuário,1,163
38152,2024-01-27 11:51:00,41,98,Móvel,9,139
38153,2024-01-27 11:52:00,115,63,Eletrônico,4,178
38154,2024-01-27 11:53:00,27,134,Alimento,2,161
38155,2024-01-27 11:54:00,27,139,Vestuário,6,166
38156,2024-01-27 11:55:00,45,112,Brinquedo,3,157
38157,2024-01-27 11:56:00,89,54,Brinquedo,4,143
38158,2024-01-27 11:57:00,35,110,Brinquedo,3,145
38159,2024-01-27 11:58:00,95,85,Alimento,3,180
38160,2024-01-27 11:59:00,27,73,Vestuário,4,100
38161,2024-01-27 12:00:00,115,147,Eletrônico,5,262
38162,2024-01-27 12:01:00,87,126,Vestuário,8,213
38163,2024-01-27 12:02:00,101,14,Móvel,4,115
38164,2024-01-27 12:03:00,59,43,Brinquedo,6,102
38165,2024-01-27 12:04:00,33,116,Eletrônico,2,149
38166,2024-01-27 12:05:00,56,158,Alimento,7,214
38167,2024-01-27 12:06:00,38,46,Eletrônico,7,84
38168,2024-01-27 12:07:00,48,158,Brinquedo,5,206
38169,2024-01-27 12:08:00,91,102,Vestuário,2,193
38170,2024-01-27 12:09:00,91,114,Alimento,2,205
38171,2024-01-27 12:10:00,31,102,Eletrônico,3,133
38172,2024-01-27 12:11:00,119,118,Eletrônico,5,237
38173,2024-01-27 12:12:00,79,144,Eletrônico,3,223
38174,2024-01-27 12:13:00,61,99,Móvel,6,160
38175,2024-01-27 12:14:00,117,71,Vestuário,9,188
38176,2024-01-27 12:15:00,86,134,Vestuário,8,220
38177,2024-01-27 12:16:00,77,57,Móvel,5,134
38178,2024-01-27 12:17:00,103,104,Vestuário,2,207
38179,2024-01-27 12:18:00,63,19,Brinquedo,7,82
38180,2024-01-27 12:19:00,31,40,Eletrônico,2,71
38181,2024-01-27 12:20:00,100,40,Alimento,9,140
38182,2024-01-27 12:21:00,105,138,Móvel,4,243
38183,2024-01-27 12:22:00,53,83,Vestuário,1,136
38184,2024-01-27 12:23:00,49,118,Alimento,7,167
38185,2024-01-27 12:24:00,98,143,Vestuário,4,241
38186,2024-01-27 12:25:00,46,172,Móvel,4,218
38187,2024-01-27 12:26:00,117,156,Eletrônico,5,273
38188,2024-01-27 12:27:00,113,111,Brinquedo,7,224
38189,2024-01-27 12:28:00,33,61,Eletrônico,2,94
38190,2024-01-27 12:29:00,52,82,Eletrônico,6,134
38191,2024-01-27 12:30:00,41,113,Vestuário,3,154
38192,2024-01-27 12:31:00,106,136,Brinquedo,1,242
38193,2024-01-27 12:32:00,63,109,Móvel,2,172
38194,2024-01-27 12:33:00,104,31,Alimento,7,135
38195,2024-01-27 12:34:00,81,137,Alimento,7,218
38196,2024-01-27 12:35:00,14,64,Alimento,3,78
38197,2024-01-27 12:36:00,14,88,Vestuário,4,102
38198,2024-01-27 12:37:00,64,108,Eletrônico,5,172
38199,2024-01-27 12:38:00,34,95,Brinquedo,2,129
38200,2024-01-27 12:39:00,47,40,Vestuário,7,87
38201,2024-01-27 12:40:00,84,124,Eletrônico,5,208
38202,2024-01-27 12:41:00,50,41,Alimento,2,91
38203,2024-01-27 12:42:00,94,109,Eletrônico,8,203
38204,2024-01-27 12:43:00,95,129,Vestuário,1,224
38205,2024-01-27 12:44:00,70,149,Brinquedo,4,219
38206,2024-01-27 12:45:00,25,102,Móvel,5,127
38207,2024-01-27 12:46:00,40,10,Brinquedo,5,50
38208,2024-01-27 12:47:00,87,152,Móvel,1,239
38209,2024-01-27 12:48:00,101,28,Vestuário,3,129
38210,2024-01-27 12:49:00,53,101,Vestuário,6,154
38211,2024-01-27 12:50:00,91,154,Brinquedo,1,245
38212,2024-01-27 12:51:00,24,46,Vestuário,1,70
38213,2024-01-27 12:52:00,53,106,Brinquedo,3,159
38214,2024-01-27 12:53:00,46,18,Eletrônico,6,64
38215,2024-01-27 12:54:00,79,130,Brinquedo,6,209
38216,2024-01-27 12:55:00,107,47,Móvel,5,154
38217,2024-01-27 12:56:00,93,140,Móvel,8,233
38218,2024-01-27 12:57:00,112,39,Móvel,2,151
38219,2024-01-27 12:58:00,94,56,Alimento,2,150
38220,2024-01-27 12:59:00,64,139,Móvel,8,203
38221,2024-01-27 13:00:00,89,150,Brinquedo,4,239
38222,2024-01-27 13:01:00,48,152,Brinquedo,5,200
38223,2024-01-27 13:02:00,44,42,Alimento,8,86
38224,2024-01-27 13:03:00,101,173,Vestuário,9,274
38225,2024-01-27 13:04:00,11,160,Brinquedo,8,171
38226,2024-01-27 13:05:00,74,129,Alimento,3,203
38227,2024-01-27 13:06:00,51,42,Móvel,6,93
38228,2024-01-27 13:07:00,92,91,Vestuário,3,183
38229,2024-01-27 13:08:00,35,177,Móvel,9,212
38230,2024-01-27 13:09:00,63,108,Eletrônico,8,171
38231,2024-01-27 13:10:00,116,171,Vestuário,6,287
38232,2024-01-27 13:11:00,93,40,Brinquedo,9,133
38233,2024-01-27 13:12:00,68,91,Vestuário,7,159
38234,2024-01-27 13:13:00,86,94,Brinquedo,6,180
38235,2024-01-27 13:14:00,79,140,Vestuário,7,219
38236,2024-01-27 13:15:00,106,82,Brinquedo,8,188
38237,2024-01-27 13:16:00,63,146,Vestuário,1,209
38238,2024-01-27 13:17:00,83,65,Vestuário,8,148
38239,2024-01-27 13:18:00,105,85,Brinquedo,1,190
38240,2024-01-27 13:19:00,106,143,Brinquedo,2,249
38241,2024-01-27 13:20:00,26,128,Eletrônico,9,154
38242,2024-01-27 13:21:00,36,19,Eletrônico,2,55
38243,2024-01-27 13:22:00,53,91,Vestuário,1,144
38244,2024-01-27 13:23:00,49,124,Alimento,4,173
38245,2024-01-27 13:24:00,104,101,Alimento,3,205
38246,2024-01-27 13:25:00,32,138,Vestuário,6,170
38247,2024-01-27 13:26:00,109,51,Alimento,4,160
38248,2024-01-27 13:27:00,48,31,Alimento,1,79
38249,2024-01-27 13:28:00,71,113,Móvel,2,184
38250,2024-01-27 13:29:00,110,65,Móvel,9,175
38251,2024-01-27 13:30:00,30,155,Brinquedo,1,185
38252,2024-01-27 13:31:00,95,46,Vestuário,5,141
38253,2024-01-27 13:32:00,53,149,Vestuário,8,202
38254,2024-01-27 13:33:00,115,18,Eletrônico,5,133
38255,2024-01-27 13:34:00,68,132,Móvel,2,200
38256,2024-01-27 13:35:00,67,69,Brinquedo,5,136
38257,2024-01-27 13:36:00,22,28,Alimento,1,50
38258,2024-01-27 13:37:00,25,33,Vestuário,8,58
38259,2024-01-27 13:38:00,75,14,Eletrônico,2,89
38260,2024-01-27 13:39:00,46,66,Móvel,9,112
38261,2024-01-27 13:40:00,49,157,Móvel,3,206
38262,2024-01-27 13:41:00,58,55,Vestuário,7,113
38263,2024-01-27 13:42:00,36,13,Móvel,5,49
38264,2024-01-27 13:43:00,119,132,Vestuário,3,251
38265,2024-01-27 13:44:00,81,89,Brinquedo,2,170
38266,2024-01-27 13:45:00,91,135,Vestuário,8,226
38267,2024-01-27 13:46:00,55,55,Vestuário,8,110
38268,2024-01-27 13:47:00,51,104,Vestuário,2,155
38269,2024-01-27 13:48:00,87,54,Vestuário,7,141
38270,2024-01-27 13:49:00,34,128,Móvel,3,162
38271,2024-01-27 13:50:00,45,73,Vestuário,9,118
38272,2024-01-27 13:51:00,47,156,Vestuário,9,203
38273,2024-01-27 13:52:00,55,59,Eletrônico,8,114
38274,2024-01-27 13:53:00,107,66,Eletrônico,8,173
38275,2024-01-27 13:54:00,24,121,Móvel,6,145
38276,2024-01-27 13:55:00,98,145,Móvel,6,243
38277,2024-01-27 13:56:00,49,74,Brinquedo,9,123
38278,2024-01-27 13:57:00,33,61,Alimento,5,94
38279,2024-01-27 13:58:00,23,26,Vestuário,2,49
38280,2024-01-27 13:59:00,12,73,Móvel,9,85
38281,2024-01-27 14:00:00,20,99,Eletrônico,2,119
38282,2024-01-27 14:01:00,83,172,Móvel,9,255
38283,2024-01-27 14:02:00,53,97,Vestuário,2,150
38284,2024-01-27 14:03:00,20,82,Móvel,3,102
38285,2024-01-27 14:04:00,53,164,Brinquedo,9,217
38286,2024-01-27 14:05:00,80,123,Alimento,3,203
38287,2024-01-27 14:06:00,29,136,Vestuário,8,165
38288,2024-01-27 14:07:00,86,113,Eletrônico,2,199
38289,2024-01-27 14:08:00,29,140,Brinquedo,2,169
38290,2024-01-27 14:09:00,107,46,Vestuário,1,153
38291,2024-01-27 14:10:00,22,62,Alimento,9,84
38292,2024-01-27 14:11:00,70,21,Móvel,5,91
38293,2024-01-27 14:12:00,77,36,Alimento,6,113
38294,2024-01-27 14:13:00,24,99,Eletrônico,7,123
38295,2024-01-27 14:14:00,95,79,Eletrônico,6,174
38296,2024-01-27 14:15:00,55,120,Móvel,9,175
38297,2024-01-27 14:16:00,61,73,Eletrônico,4,134
38298,2024-01-27 14:17:00,78,128,Alimento,7,206
38299,2024-01-27 14:18:00,88,102,Alimento,7,190
38300,2024-01-27 14:19:00,24,166,Móvel,9,190
38301,2024-01-27 14:20:00,38,57,Vestuário,8,95
38302,2024-01-27 14:21:00,75,132,Vestuário,4,207
38303,2024-01-27 14:22:00,21,176,Móvel,1,197
38304,2024-01-27 14:23:00,49,173,Brinquedo,1,222
38305,2024-01-27 14:24:00,115,179,Eletrônico,1,294
38306,2024-01-27 14:25:00,32,154,Móvel,1,186
38307,2024-01-27 14:26:00,86,57,Eletrônico,3,143
38308,2024-01-27 14:27:00,38,41,Vestuário,8,79
38309,2024-01-27 14:28:00,68,171,Alimento,6,239
38310,2024-01-27 14:29:00,65,25,Vestuário,5,90
38311,2024-01-27 14:30:00,114,166,Vestuário,8,280
38312,2024-01-27 14:31:00,118,76,Brinquedo,7,194
38313,2024-01-27 14:32:00,100,86,Vestuário,8,186
38314,2024-01-27 14:33:00,112,71,Móvel,6,183
38315,2024-01-27 14:34:00,35,133,Móvel,9,168
38316,2024-01-27 14:35:00,75,151,Vestuário,1,226
38317,2024-01-27 14:36:00,71,26,Alimento,2,97
38318,2024-01-27 14:37:00,32,15,Brinquedo,2,47
38319,2024-01-27 14:38:00,105,54,Eletrônico,2,159
38320,2024-01-27 14:39:00,24,57,Móvel,6,81
38321,2024-01-27 14:40:00,61,65,Eletrônico,6,126
38322,2024-01-27 14:41:00,12,141,Alimento,7,153
38323,2024-01-27 14:42:00,92,131,Eletrônico,5,223
38324,2024-01-27 14:43:00,109,61,Eletrônico,4,170
38325,2024-01-27 14:44:00,93,161,Alimento,7,254
38326,2024-01-27 14:45:00,76,140,Alimento,3,216
38327,2024-01-27 14:46:00,10,21,Vestuário,7,31
38328,2024-01-27 14:47:00,34,156,Alimento,9,190
38329,2024-01-27 14:48:00,103,148,Móvel,6,251
38330,2024-01-27 14:49:00,21,142,Alimento,3,163
38331,2024-01-27 14:50:00,118,58,Alimento,7,176
38332,2024-01-27 14:51:00,33,144,Alimento,5,177
38333,2024-01-27 14:52:00,86,94,Móvel,1,180
38334,2024-01-27 14:53:00,113,148,Brinquedo,2,261
38335,2024-01-27 14:54:00,68,95,Vestuário,8,163
38336,2024-01-27 14:55:00,72,10,Móvel,8,82
38337,2024-01-27 14:56:00,91,166,Vestuário,4,257
38338,2024-01-27 14:57:00,118,45,Brinquedo,9,163
38339,2024-01-27 14:58:00,116,31,Alimento,3,147
38340,2024-01-27 14:59:00,81,63,Móvel,1,144
38341,2024-01-27 15:00:00,72,20,Alimento,9,92
38342,2024-01-27 15:01:00,110,120,Vestuário,3,230
38343,2024-01-27 15:02:00,26,130,Móvel,7,156
38344,2024-01-27 15:03:00,90,52,Móvel,6,142
38345,2024-01-27 15:04:00,78,31,Móvel,1,109
38346,2024-01-27 15:05:00,94,129,Vestuário,6,223
38347,2024-01-27 15:06:00,95,168,Alimento,4,263
38348,2024-01-27 15:07:00,35,35,Alimento,1,70
38349,2024-01-27 15:08:00,111,24,Alimento,2,135
38350,2024-01-27 15:09:00,98,130,Alimento,5,228
38351,2024-01-27 15:10:00,27,17,Brinquedo,1,44
38352,2024-01-27 15:11:00,85,71,Eletrônico,6,156
38353,2024-01-27 15:12:00,47,122,Brinquedo,2,169
38354,2024-01-27 15:13:00,41,167,Móvel,4,208
38355,2024-01-27 15:14:00,109,161,Brinquedo,4,270
38356,2024-01-27 15:15:00,117,50,Vestuário,3,167
38357,2024-01-27 15:16:00,44,80,Vestuário,6,124
38358,2024-01-27 15:17:00,110,29,Brinquedo,9,139
38359,2024-01-27 15:18:00,13,67,Brinquedo,7,80
38360,2024-01-27 15:19:00,100,63,Brinquedo,6,163
38361,2024-01-27 15:20:00,94,40,Alimento,9,134
38362,2024-01-27 15:21:00,101,142,Brinquedo,5,243
38363,2024-01-27 15:22:00,86,104,Eletrônico,9,190
38364,2024-01-27 15:23:00,80,91,Eletrônico,6,171
38365,2024-01-27 15:24:00,86,94,Alimento,7,180
38366,2024-01-27 15:25:00,22,74,Alimento,1,96
38367,2024-01-27 15:26:00,78,57,Alimento,5,135
38368,2024-01-27 15:27:00,32,30,Vestuário,7,62
38369,2024-01-27 15:28:00,13,131,Brinquedo,7,144
38370,2024-01-27 15:29:00,36,164,Alimento,3,200
38371,2024-01-27 15:30:00,33,106,Alimento,5,139
38372,2024-01-27 15:31:00,92,151,Eletrônico,8,243
38373,2024-01-27 15:32:00,112,141,Brinquedo,8,253
38374,2024-01-27 15:33:00,48,27,Brinquedo,1,75
38375,2024-01-27 15:34:00,35,55,Vestuário,6,90
38376,2024-01-27 15:35:00,61,15,Vestuário,8,76
38377,2024-01-27 15:36:00,52,141,Móvel,9,193
38378,2024-01-27 15:37:00,22,22,Eletrônico,4,44
38379,2024-01-27 15:38:00,61,76,Vestuário,5,137
38380,2024-01-27 15:39:00,78,25,Eletrônico,7,103
38381,2024-01-27 15:40:00,15,47,Brinquedo,8,62
38382,2024-01-27 15:41:00,75,176,Eletrônico,5,251
38383,2024-01-27 15:42:00,110,12,Móvel,6,122
38384,2024-01-27 15:43:00,48,93,Eletrônico,9,141
38385,2024-01-27 15:44:00,25,71,Móvel,3,96
38386,2024-01-27 15:45:00,71,53,Brinquedo,6,124
38387,2024-01-27 15:46:00,37,146,Eletrônico,9,183
38388,2024-01-27 15:47:00,115,134,Brinquedo,2,249
38389,2024-01-27 15:48:00,108,69,Brinquedo,1,177
38390,2024-01-27 15:49:00,70,121,Vestuário,7,191
38391,2024-01-27 15:50:00,99,15,Alimento,4,114
38392,2024-01-27 15:51:00,96,100,Alimento,3,196
38393,2024-01-27 15:52:00,90,169,Vestuário,3,259
38394,2024-01-27 15:53:00,14,30,Eletrônico,8,44
38395,2024-01-27 15:54:00,51,10,Alimento,5,61
38396,2024-01-27 15:55:00,63,80,Eletrônico,6,143
38397,2024-01-27 15:56:00,119,133,Brinquedo,7,252
38398,2024-01-27 15:57:00,12,37,Brinquedo,5,49
38399,2024-01-27 15:58:00,28,25,Brinquedo,2,53
38400,2024-01-27 15:59:00,116,70,Vestuário,9,186
38401,2024-01-27 16:00:00,14,60,Brinquedo,7,74
38402,2024-01-27 16:01:00,103,70,Móvel,3,173
38403,2024-01-27 16:02:00,88,125,Eletrônico,4,213
38404,2024-01-27 16:03:00,44,83,Brinquedo,3,127
38405,2024-01-27 16:04:00,47,87,Eletrônico,5,134
38406,2024-01-27 16:05:00,110,158,Eletrônico,4,268
38407,2024-01-27 16:06:00,30,155,Eletrônico,4,185
38408,2024-01-27 16:07:00,116,55,Vestuário,2,171
38409,2024-01-27 16:08:00,83,14,Eletrônico,5,97
38410,2024-01-27 16:09:00,83,46,Eletrônico,2,129
38411,2024-01-27 16:10:00,25,170,Brinquedo,7,195
38412,2024-01-27 16:11:00,105,16,Brinquedo,7,121
38413,2024-01-27 16:12:00,86,82,Móvel,1,168
38414,2024-01-27 16:13:00,75,173,Móvel,1,248
38415,2024-01-27 16:14:00,66,57,Alimento,1,123
38416,2024-01-27 16:15:00,52,132,Brinquedo,6,184
38417,2024-01-27 16:16:00,47,166,Vestuário,1,213
38418,2024-01-27 16:17:00,51,155,Móvel,6,206
38419,2024-01-27 16:18:00,44,74,Móvel,3,118
38420,2024-01-27 16:19:00,48,115,Brinquedo,7,163
38421,2024-01-27 16:20:00,67,99,Alimento,9,166
38422,2024-01-27 16:21:00,96,115,Brinquedo,3,211
38423,2024-01-27 16:22:00,11,137,Brinquedo,4,148
38424,2024-01-27 16:23:00,110,76,Vestuário,9,186
38425,2024-01-27 16:24:00,92,147,Eletrônico,1,239
38426,2024-01-27 16:25:00,10,111,Brinquedo,3,121
38427,2024-01-27 16:26:00,48,65,Alimento,9,113
38428,2024-01-27 16:27:00,35,168,Vestuário,6,203
38429,2024-01-27 16:28:00,98,112,Móvel,2,210
38430,2024-01-27 16:29:00,70,122,Vestuário,4,192
38431,2024-01-27 16:30:00,44,64,Alimento,1,108
38432,2024-01-27 16:31:00,74,171,Eletrônico,8,245
38433,2024-01-27 16:32:00,64,130,Vestuário,1,194
38434,2024-01-27 16:33:00,20,111,Brinquedo,6,131
38435,2024-01-27 16:34:00,16,62,Móvel,3,78
38436,2024-01-27 16:35:00,12,35,Eletrônico,3,47
38437,2024-01-27 16:36:00,24,41,Brinquedo,5,65
38438,2024-01-27 16:37:00,63,27,Vestuário,8,90
38439,2024-01-27 16:38:00,37,69,Móvel,6,106
38440,2024-01-27 16:39:00,31,162,Eletrônico,5,193
38441,2024-01-27 16:40:00,50,20,Eletrônico,1,70
38442,2024-01-27 16:41:00,67,119,Brinquedo,3,186
38443,2024-01-27 16:42:00,86,69,Eletrônico,3,155
38444,2024-01-27 16:43:00,49,164,Alimento,8,213
38445,2024-01-27 16:44:00,100,74,Vestuário,6,174
38446,2024-01-27 16:45:00,74,76,Alimento,4,150
38447,2024-01-27 16:46:00,108,157,Brinquedo,7,265
38448,2024-01-27 16:47:00,12,90,Eletrônico,8,102
38449,2024-01-27 16:48:00,28,109,Brinquedo,3,137
38450,2024-01-27 16:49:00,23,132,Móvel,9,155
38451,2024-01-27 16:50:00,65,17,Eletrônico,1,82
38452,2024-01-27 16:51:00,50,10,Eletrônico,1,60
38453,2024-01-27 16:52:00,14,18,Vestuário,8,32
38454,2024-01-27 16:53:00,105,113,Móvel,9,218
38455,2024-01-27 16:54:00,107,127,Alimento,9,234
38456,2024-01-27 16:55:00,103,37,Brinquedo,7,140
38457,2024-01-27 16:56:00,11,82,Brinquedo,9,93
38458,2024-01-27 16:57:00,107,143,Alimento,7,250
38459,2024-01-27 16:58:00,87,152,Vestuário,7,239
38460,2024-01-27 16:59:00,94,153,Alimento,3,247
38461,2024-01-27 17:00:00,49,28,Eletrônico,2,77
38462,2024-01-27 17:01:00,11,79,Brinquedo,1,90
38463,2024-01-27 17:02:00,106,119,Brinquedo,9,225
38464,2024-01-27 17:03:00,119,71,Alimento,7,190
38465,2024-01-27 17:04:00,69,89,Alimento,1,158
38466,2024-01-27 17:05:00,88,158,Eletrônico,2,246
38467,2024-01-27 17:06:00,112,131,Brinquedo,1,243
38468,2024-01-27 17:07:00,27,72,Móvel,3,99
38469,2024-01-27 17:08:00,20,13,Eletrônico,5,33
38470,2024-01-27 17:09:00,28,39,Eletrônico,1,67
38471,2024-01-27 17:10:00,39,65,Vestuário,1,104
38472,2024-01-27 17:11:00,79,48,Eletrônico,2,127
38473,2024-01-27 17:12:00,59,145,Alimento,4,204
38474,2024-01-27 17:13:00,85,143,Brinquedo,6,228
38475,2024-01-27 17:14:00,85,27,Vestuário,3,112
38476,2024-01-27 17:15:00,70,26,Vestuário,5,96
38477,2024-01-27 17:16:00,114,28,Móvel,9,142
38478,2024-01-27 17:17:00,117,68,Brinquedo,9,185
38479,2024-01-27 17:18:00,13,35,Eletrônico,2,48
38480,2024-01-27 17:19:00,113,106,Brinquedo,6,219
38481,2024-01-27 17:20:00,111,81,Eletrônico,7,192
38482,2024-01-27 17:21:00,67,72,Brinquedo,6,139
38483,2024-01-27 17:22:00,27,128,Brinquedo,8,155
38484,2024-01-27 17:23:00,28,44,Móvel,6,72
38485,2024-01-27 17:24:00,60,90,Eletrônico,4,150
38486,2024-01-27 17:25:00,47,74,Alimento,5,121
38487,2024-01-27 17:26:00,111,117,Móvel,5,228
38488,2024-01-27 17:27:00,95,75,Eletrônico,8,170
38489,2024-01-27 17:28:00,71,34,Móvel,7,105
38490,2024-01-27 17:29:00,26,174,Eletrônico,1,200
38491,2024-01-27 17:30:00,119,109,Eletrônico,5,228
38492,2024-01-27 17:31:00,74,22,Vestuário,9,96
38493,2024-01-27 17:32:00,113,41,Vestuário,6,154
38494,2024-01-27 17:33:00,12,84,Móvel,5,96
38495,2024-01-27 17:34:00,115,152,Brinquedo,5,267
38496,2024-01-27 17:35:00,88,57,Eletrônico,2,145
38497,2024-01-27 17:36:00,108,21,Eletrônico,6,129
38498,2024-01-27 17:37:00,17,123,Eletrônico,1,140
38499,2024-01-27 17:38:00,99,94,Eletrônico,8,193
38500,2024-01-27 17:39:00,42,87,Eletrônico,2,129
38501,2024-01-27 17:40:00,106,19,Eletrônico,6,125
38502,2024-01-27 17:41:00,26,81,Alimento,5,107
38503,2024-01-27 17:42:00,86,152,Móvel,9,238
38504,2024-01-27 17:43:00,71,163,Alimento,3,234
38505,2024-01-27 17:44:00,31,124,Eletrônico,2,155
38506,2024-01-27 17:45:00,40,67,Alimento,7,107
38507,2024-01-27 17:46:00,90,113,Vestuário,6,203
38508,2024-01-27 17:47:00,31,124,Brinquedo,1,155
38509,2024-01-27 17:48:00,18,92,Eletrônico,9,110
38510,2024-01-27 17:49:00,86,158,Brinquedo,8,244
38511,2024-01-27 17:50:00,112,90,Eletrônico,4,202
38512,2024-01-27 17:51:00,112,12,Móvel,6,124
38513,2024-01-27 17:52:00,115,22,Eletrônico,2,137
38514,2024-01-27 17:53:00,104,161,Brinquedo,9,265
38515,2024-01-27 17:54:00,69,106,Móvel,8,175
38516,2024-01-27 17:55:00,15,165,Alimento,6,180
38517,2024-01-27 17:56:00,110,93,Móvel,4,203
38518,2024-01-27 17:57:00,73,48,Móvel,4,121
38519,2024-01-27 17:58:00,86,59,Eletrônico,8,145
38520,2024-01-27 17:59:00,49,48,Vestuário,6,97
38521,2024-01-27 18:00:00,59,61,Alimento,4,120
38522,2024-01-27 18:01:00,62,36,Móvel,3,98
38523,2024-01-27 18:02:00,26,28,Alimento,8,54
38524,2024-01-27 18:03:00,90,115,Móvel,5,205
38525,2024-01-27 18:04:00,79,22,Móvel,3,101
38526,2024-01-27 18:05:00,63,47,Eletrônico,5,110
38527,2024-01-27 18:06:00,67,30,Eletrônico,6,97
38528,2024-01-27 18:07:00,83,94,Brinquedo,3,177
38529,2024-01-27 18:08:00,60,159,Alimento,8,219
38530,2024-01-27 18:09:00,40,76,Vestuário,6,116
38531,2024-01-27 18:10:00,23,145,Alimento,6,168
38532,2024-01-27 18:11:00,19,77,Móvel,1,96
38533,2024-01-27 18:12:00,77,51,Móvel,3,128
38534,2024-01-27 18:13:00,66,73,Móvel,5,139
38535,2024-01-27 18:14:00,98,74,Brinquedo,5,172
38536,2024-01-27 18:15:00,83,66,Vestuário,5,149
38537,2024-01-27 18:16:00,38,177,Eletrônico,8,215
38538,2024-01-27 18:17:00,16,88,Vestuário,4,104
38539,2024-01-27 18:18:00,12,95,Brinquedo,4,107
38540,2024-01-27 18:19:00,35,43,Brinquedo,6,78
38541,2024-01-27 18:20:00,15,80,Alimento,4,95
38542,2024-01-27 18:21:00,76,60,Alimento,4,136
38543,2024-01-27 18:22:00,60,150,Vestuário,6,210
38544,2024-01-27 18:23:00,84,98,Eletrônico,2,182
38545,2024-01-27 18:24:00,71,91,Vestuário,3,162
38546,2024-01-27 18:25:00,37,155,Móvel,3,192
38547,2024-01-27 18:26:00,91,84,Vestuário,2,175
38548,2024-01-27 18:27:00,10,67,Eletrônico,9,77
38549,2024-01-27 18:28:00,91,177,Vestuário,1,268
38550,2024-01-27 18:29:00,104,96,Eletrônico,8,200
38551,2024-01-27 18:30:00,119,28,Alimento,9,147
38552,2024-01-27 18:31:00,98,105,Vestuário,7,203
38553,2024-01-27 18:32:00,66,168,Vestuário,9,234
38554,2024-01-27 18:33:00,96,107,Alimento,6,203
38555,2024-01-27 18:34:00,117,157,Vestuário,7,274
38556,2024-01-27 18:35:00,29,13,Alimento,7,42
38557,2024-01-27 18:36:00,89,176,Vestuário,3,265
38558,2024-01-27 18:37:00,101,47,Eletrônico,2,148
38559,2024-01-27 18:38:00,42,30,Eletrônico,4,72
38560,2024-01-27 18:39:00,20,89,Eletrônico,1,109
38561,2024-01-27 18:40:00,115,22,Móvel,7,137
38562,2024-01-27 18:41:00,61,10,Eletrônico,9,71
38563,2024-01-27 18:42:00,62,106,Brinquedo,1,168
38564,2024-01-27 18:43:00,14,66,Vestuário,7,80
38565,2024-01-27 18:44:00,114,102,Brinquedo,9,216
38566,2024-01-27 18:45:00,14,100,Alimento,2,114
38567,2024-01-27 18:46:00,69,160,Alimento,3,229
38568,2024-01-27 18:47:00,35,12,Móvel,5,47
38569,2024-01-27 18:48:00,18,144,Móvel,4,162
38570,2024-01-27 18:49:00,100,107,Brinquedo,8,207
38571,2024-01-27 18:50:00,118,119,Alimento,2,237
38572,2024-01-27 18:51:00,16,26,Alimento,3,42
38573,2024-01-27 18:52:00,41,130,Brinquedo,7,171
38574,2024-01-27 18:53:00,10,94,Vestuário,2,104
38575,2024-01-27 18:54:00,99,73,Móvel,1,172
38576,2024-01-27 18:55:00,24,114,Brinquedo,3,138
38577,2024-01-27 18:56:00,111,134,Eletrônico,1,245
38578,2024-01-27 18:57:00,106,165,Alimento,1,271
38579,2024-01-27 18:58:00,103,170,Alimento,3,273
38580,2024-01-27 18:59:00,11,155,Móvel,5,166
38581,2024-01-27 19:00:00,117,134,Eletrônico,1,251
38582,2024-01-27 19:01:00,63,142,Alimento,9,205
38583,2024-01-27 19:02:00,85,154,Móvel,9,239
38584,2024-01-27 19:03:00,83,37,Móvel,4,120
38585,2024-01-27 19:04:00,21,76,Brinquedo,4,97
38586,2024-01-27 19:05:00,52,77,Móvel,4,129
38587,2024-01-27 19:06:00,100,66,Brinquedo,5,166
38588,2024-01-27 19:07:00,64,152,Eletrônico,6,216
38589,2024-01-27 19:08:00,41,101,Móvel,1,142
38590,2024-01-27 19:09:00,105,165,Móvel,7,270
38591,2024-01-27 19:10:00,56,147,Vestuário,9,203
38592,2024-01-27 19:11:00,97,124,Vestuário,6,221
38593,2024-01-27 19:12:00,52,144,Vestuário,5,196
38594,2024-01-27 19:13:00,80,96,Eletrônico,2,176
38595,2024-01-27 19:14:00,21,165,Vestuário,7,186
38596,2024-01-27 19:15:00,43,70,Brinquedo,9,113
38597,2024-01-27 19:16:00,34,160,Brinquedo,4,194
38598,2024-01-27 19:17:00,103,140,Eletrônico,3,243
38599,2024-01-27 19:18:00,78,122,Vestuário,8,200
38600,2024-01-27 19:19:00,79,52,Alimento,4,131
38601,2024-01-27 19:20:00,95,81,Alimento,8,176
38602,2024-01-27 19:21:00,33,104,Brinquedo,1,137
38603,2024-01-27 19:22:00,95,161,Móvel,7,256
38604,2024-01-27 19:23:00,36,164,Alimento,3,200
38605,2024-01-27 19:24:00,114,147,Brinquedo,9,261
38606,2024-01-27 19:25:00,101,96,Brinquedo,9,197
38607,2024-01-27 19:26:00,100,95,Brinquedo,3,195
38608,2024-01-27 19:27:00,95,75,Alimento,4,170
38609,2024-01-27 19:28:00,67,118,Vestuário,7,185
38610,2024-01-27 19:29:00,46,29,Brinquedo,4,75
38611,2024-01-27 19:30:00,61,25,Alimento,6,86
38612,2024-01-27 19:31:00,26,140,Alimento,2,166
38613,2024-01-27 19:32:00,48,120,Brinquedo,8,168
38614,2024-01-27 19:33:00,61,58,Vestuário,5,119
38615,2024-01-27 19:34:00,37,151,Vestuário,5,188
38616,2024-01-27 19:35:00,27,179,Alimento,2,206
38617,2024-01-27 19:36:00,27,146,Eletrônico,9,173
38618,2024-01-27 19:37:00,42,52,Brinquedo,9,94
38619,2024-01-27 19:38:00,61,104,Vestuário,9,165
38620,2024-01-27 19:39:00,42,100,Alimento,3,142
38621,2024-01-27 19:40:00,19,70,Móvel,9,89
38622,2024-01-27 19:41:00,80,172,Vestuário,8,252
38623,2024-01-27 19:42:00,71,21,Alimento,5,92
38624,2024-01-27 19:43:00,103,48,Eletrônico,7,151
38625,2024-01-27 19:44:00,28,35,Vestuário,1,63
38626,2024-01-27 19:45:00,64,63,Vestuário,8,127
38627,2024-01-27 19:46:00,76,55,Eletrônico,7,131
38628,2024-01-27 19:47:00,69,130,Vestuário,6,199
38629,2024-01-27 19:48:00,75,153,Vestuário,8,228
38630,2024-01-27 19:49:00,68,56,Eletrônico,4,124
38631,2024-01-27 19:50:00,91,113,Brinquedo,2,204
38632,2024-01-27 19:51:00,13,20,Brinquedo,4,33
38633,2024-01-27 19:52:00,108,40,Eletrônico,7,148
38634,2024-01-27 19:53:00,116,11,Brinquedo,6,127
38635,2024-01-27 19:54:00,72,66,Vestuário,1,138
38636,2024-01-27 19:55:00,11,108,Brinquedo,8,119
38637,2024-01-27 19:56:00,94,102,Alimento,9,196
38638,2024-01-27 19:57:00,90,25,Alimento,4,115
38639,2024-01-27 19:58:00,33,63,Vestuário,1,96
38640,2024-01-27 19:59:00,60,127,Móvel,6,187
38641,2024-01-27 20:00:00,61,23,Alimento,3,84
38642,2024-01-27 20:01:00,103,83,Alimento,9,186
38643,2024-01-27 20:02:00,92,127,Brinquedo,3,219
38644,2024-01-27 20:03:00,95,69,Eletrônico,1,164
38645,2024-01-27 20:04:00,53,73,Alimento,3,126
38646,2024-01-27 20:05:00,71,170,Brinquedo,3,241
38647,2024-01-27 20:06:00,72,42,Móvel,4,114
38648,2024-01-27 20:07:00,113,34,Vestuário,1,147
38649,2024-01-27 20:08:00,60,26,Brinquedo,6,86
38650,2024-01-27 20:09:00,117,139,Móvel,4,256
38651,2024-01-27 20:10:00,108,63,Eletrônico,3,171
38652,2024-01-27 20:11:00,60,108,Brinquedo,1,168
38653,2024-01-27 20:12:00,10,86,Brinquedo,3,96
38654,2024-01-27 20:13:00,57,143,Eletrônico,6,200
38655,2024-01-27 20:14:00,67,54,Eletrônico,3,121
38656,2024-01-27 20:15:00,105,123,Brinquedo,3,228
38657,2024-01-27 20:16:00,40,148,Eletrônico,7,188
38658,2024-01-27 20:17:00,31,45,Alimento,4,76
38659,2024-01-27 20:18:00,107,100,Eletrônico,9,207
38660,2024-01-27 20:19:00,72,57,Móvel,5,129
38661,2024-01-27 20:20:00,113,64,Móvel,7,177
38662,2024-01-27 20:21:00,14,101,Móvel,7,115
38663,2024-01-27 20:22:00,115,50,Vestuário,8,165
38664,2024-01-27 20:23:00,70,49,Alimento,9,119
38665,2024-01-27 20:24:00,116,87,Alimento,7,203
38666,2024-01-27 20:25:00,118,92,Alimento,6,210
38667,2024-01-27 20:26:00,62,99,Alimento,3,161
38668,2024-01-27 20:27:00,73,75,Eletrônico,7,148
38669,2024-01-27 20:28:00,82,138,Móvel,6,220
38670,2024-01-27 20:29:00,103,93,Brinquedo,2,196
38671,2024-01-27 20:30:00,76,48,Móvel,1,124
38672,2024-01-27 20:31:00,32,136,Brinquedo,8,168
38673,2024-01-27 20:32:00,67,130,Móvel,9,197
38674,2024-01-27 20:33:00,29,106,Eletrônico,7,135
38675,2024-01-27 20:34:00,65,154,Alimento,6,219
38676,2024-01-27 20:35:00,12,29,Eletrônico,2,41
38677,2024-01-27 20:36:00,67,107,Brinquedo,6,174
38678,2024-01-27 20:37:00,110,137,Alimento,2,247
38679,2024-01-27 20:38:00,42,49,Móvel,7,91
38680,2024-01-27 20:39:00,17,24,Eletrônico,8,41
38681,2024-01-27 20:40:00,28,164,Vestuário,1,192
38682,2024-01-27 20:41:00,48,142,Alimento,7,190
38683,2024-01-27 20:42:00,100,152,Vestuário,5,252
38684,2024-01-27 20:43:00,110,87,Móvel,9,197
38685,2024-01-27 20:44:00,88,107,Eletrônico,6,195
38686,2024-01-27 20:45:00,64,174,Móvel,1,238
38687,2024-01-27 20:46:00,104,56,Móvel,6,160
38688,2024-01-27 20:47:00,62,125,Vestuário,1,187
38689,2024-01-27 20:48:00,73,45,Alimento,1,118
38690,2024-01-27 20:49:00,55,15,Móvel,3,70
38691,2024-01-27 20:50:00,44,154,Móvel,2,198
38692,2024-01-27 20:51:00,39,49,Eletrônico,9,88
38693,2024-01-27 20:52:00,88,57,Brinquedo,2,145
38694,2024-01-27 20:53:00,116,114,Móvel,2,230
38695,2024-01-27 20:54:00,113,112,Brinquedo,1,225
38696,2024-01-27 20:55:00,35,78,Vestuário,9,113
38697,2024-01-27 20:56:00,96,97,Brinquedo,7,193
38698,2024-01-27 20:57:00,106,176,Alimento,8,282
38699,2024-01-27 20:58:00,87,129,Móvel,3,216
38700,2024-01-27 20:59:00,40,100,Alimento,9,140
38701,2024-01-27 21:00:00,96,163,Alimento,6,259
38702,2024-01-27 21:01:00,112,60,Eletrônico,3,172
38703,2024-01-27 21:02:00,25,103,Eletrônico,5,128
38704,2024-01-27 21:03:00,59,146,Alimento,5,205
38705,2024-01-27 21:04:00,71,25,Brinquedo,6,96
38706,2024-01-27 21:05:00,107,154,Alimento,3,261
38707,2024-01-27 21:06:00,27,84,Móvel,3,111
38708,2024-01-27 21:07:00,28,83,Eletrônico,8,111
38709,2024-01-27 21:08:00,52,34,Alimento,9,86
38710,2024-01-27 21:09:00,91,48,Brinquedo,1,139
38711,2024-01-27 21:10:00,97,173,Vestuário,8,270
38712,2024-01-27 21:11:00,41,134,Eletrônico,1,175
38713,2024-01-27 21:12:00,35,146,Brinquedo,9,181
38714,2024-01-27 21:13:00,91,145,Brinquedo,3,236
38715,2024-01-27 21:14:00,106,155,Vestuário,9,261
38716,2024-01-27 21:15:00,29,153,Móvel,8,182
38717,2024-01-27 21:16:00,42,72,Vestuário,5,114
38718,2024-01-27 21:17:00,109,32,Brinquedo,1,141
38719,2024-01-27 21:18:00,115,166,Vestuário,2,281
38720,2024-01-27 21:19:00,32,163,Brinquedo,5,195
38721,2024-01-27 21:20:00,73,128,Móvel,1,201
38722,2024-01-27 21:21:00,106,72,Vestuário,8,178
38723,2024-01-27 21:22:00,46,111,Alimento,2,157
38724,2024-01-27 21:23:00,12,147,Brinquedo,3,159
38725,2024-01-27 21:24:00,59,175,Vestuário,4,234
38726,2024-01-27 21:25:00,12,59,Móvel,1,71
38727,2024-01-27 21:26:00,21,57,Brinquedo,8,78
38728,2024-01-27 21:27:00,37,47,Vestuário,1,84
38729,2024-01-27 21:28:00,64,14,Vestuário,9,78
38730,2024-01-27 21:29:00,50,147,Móvel,6,197
38731,2024-01-27 21:30:00,81,176,Eletrônico,4,257
38732,2024-01-27 21:31:00,97,73,Brinquedo,2,170
38733,2024-01-27 21:32:00,91,158,Vestuário,3,249
38734,2024-01-27 21:33:00,76,77,Vestuário,1,153
38735,2024-01-27 21:34:00,42,23,Alimento,7,65
38736,2024-01-27 21:35:00,57,131,Eletrônico,2,188
38737,2024-01-27 21:36:00,49,124,Vestuário,3,173
38738,2024-01-27 21:37:00,36,25,Móvel,2,61
38739,2024-01-27 21:38:00,37,155,Alimento,1,192
38740,2024-01-27 21:39:00,34,116,Eletrônico,1,150
38741,2024-01-27 21:40:00,43,166,Vestuário,1,209
38742,2024-01-27 21:41:00,79,78,Móvel,2,157
38743,2024-01-27 21:42:00,82,153,Móvel,7,235
38744,2024-01-27 21:43:00,63,163,Brinquedo,4,226
38745,2024-01-27 21:44:00,85,43,Alimento,9,128
38746,2024-01-27 21:45:00,81,40,Vestuário,4,121
38747,2024-01-27 21:46:00,52,43,Móvel,3,95
38748,2024-01-27 21:47:00,88,170,Vestuário,1,258
38749,2024-01-27 21:48:00,117,64,Eletrônico,7,181
38750,2024-01-27 21:49:00,18,159,Eletrônico,2,177
38751,2024-01-27 21:50:00,57,87,Móvel,9,144
38752,2024-01-27 21:51:00,52,115,Alimento,4,167
38753,2024-01-27 21:52:00,29,25,Vestuário,3,54
38754,2024-01-27 21:53:00,113,100,Alimento,9,213
38755,2024-01-27 21:54:00,117,15,Brinquedo,3,132
38756,2024-01-27 21:55:00,54,168,Móvel,8,222
38757,2024-01-27 21:56:00,114,142,Móvel,4,256
38758,2024-01-27 21:57:00,70,163,Brinquedo,6,233
38759,2024-01-27 21:58:00,86,38,Móvel,8,124
38760,2024-01-27 21:59:00,66,19,Vestuário,2,85
38761,2024-01-27 22:00:00,36,155,Móvel,4,191
38762,2024-01-27 22:01:00,13,33,Vestuário,1,46
38763,2024-01-27 22:02:00,90,136,Vestuário,4,226
38764,2024-01-27 22:03:00,72,38,Eletrônico,6,110
38765,2024-01-27 22:04:00,16,10,Brinquedo,1,26
38766,2024-01-27 22:05:00,36,24,Vestuário,4,60
38767,2024-01-27 22:06:00,95,159,Alimento,2,254
38768,2024-01-27 22:07:00,92,15,Móvel,9,107
38769,2024-01-27 22:08:00,90,112,Brinquedo,7,202
38770,2024-01-27 22:09:00,72,171,Móvel,5,243
38771,2024-01-27 22:10:00,74,131,Alimento,6,205
38772,2024-01-27 22:11:00,72,20,Móvel,6,92
38773,2024-01-27 22:12:00,25,119,Eletrônico,6,144
38774,2024-01-27 22:13:00,71,110,Vestuário,4,181
38775,2024-01-27 22:14:00,61,24,Vestuário,6,85
38776,2024-01-27 22:15:00,111,104,Eletrônico,2,215
38777,2024-01-27 22:16:00,87,100,Alimento,6,187
38778,2024-01-27 22:17:00,34,21,Eletrônico,3,55
38779,2024-01-27 22:18:00,45,26,Móvel,4,71
38780,2024-01-27 22:19:00,83,142,Eletrônico,8,225
38781,2024-01-27 22:20:00,31,18,Vestuário,6,49
38782,2024-01-27 22:21:00,18,98,Brinquedo,9,116
38783,2024-01-27 22:22:00,70,38,Eletrônico,9,108
38784,2024-01-27 22:23:00,41,136,Vestuário,2,177
38785,2024-01-27 22:24:00,12,105,Alimento,3,117
38786,2024-01-27 22:25:00,21,45,Eletrônico,6,66
38787,2024-01-27 22:26:00,41,128,Eletrônico,7,169
38788,2024-01-27 22:27:00,36,94,Eletrônico,4,130
38789,2024-01-27 22:28:00,28,89,Vestuário,9,117
38790,2024-01-27 22:29:00,29,159,Vestuário,1,188
38791,2024-01-27 22:30:00,57,13,Vestuário,2,70
38792,2024-01-27 22:31:00,22,115,Alimento,7,137
38793,2024-01-27 22:32:00,90,94,Eletrônico,7,184
38794,2024-01-27 22:33:00,96,72,Brinquedo,1,168
38795,2024-01-27 22:34:00,113,32,Alimento,7,145
38796,2024-01-27 22:35:00,22,168,Brinquedo,8,190
38797,2024-01-27 22:36:00,98,122,Eletrônico,8,220
38798,2024-01-27 22:37:00,64,173,Brinquedo,8,237
38799,2024-01-27 22:38:00,43,153,Brinquedo,3,196
38800,2024-01-27 22:39:00,89,159,Vestuário,6,248
38801,2024-01-27 22:40:00,29,156,Vestuário,2,185
38802,2024-01-27 22:41:00,76,131,Vestuário,9,207
38803,2024-01-27 22:42:00,30,29,Vestuário,7,59
38804,2024-01-27 22:43:00,67,55,Vestuário,3,122
38805,2024-01-27 22:44:00,110,158,Eletrônico,4,268
38806,2024-01-27 22:45:00,91,179,Vestuário,1,270
38807,2024-01-27 22:46:00,74,31,Eletrônico,1,105
38808,2024-01-27 22:47:00,59,87,Brinquedo,6,146
38809,2024-01-27 22:48:00,50,144,Alimento,2,194
38810,2024-01-27 22:49:00,109,106,Alimento,8,215
38811,2024-01-27 22:50:00,51,52,Móvel,4,103
38812,2024-01-27 22:51:00,47,30,Eletrônico,3,77
38813,2024-01-27 22:52:00,38,149,Alimento,3,187
38814,2024-01-27 22:53:00,94,74,Vestuário,1,168
38815,2024-01-27 22:54:00,105,164,Vestuário,6,269
38816,2024-01-27 22:55:00,21,72,Alimento,2,93
38817,2024-01-27 22:56:00,111,58,Móvel,1,169
38818,2024-01-27 22:57:00,76,63,Alimento,5,139
38819,2024-01-27 22:58:00,116,55,Eletrônico,1,171
38820,2024-01-27 22:59:00,14,176,Eletrônico,3,190
38821,2024-01-27 23:00:00,12,38,Vestuário,6,50
38822,2024-01-27 23:01:00,98,156,Móvel,6,254
38823,2024-01-27 23:02:00,115,63,Alimento,4,178
38824,2024-01-27 23:03:00,59,88,Vestuário,9,147
38825,2024-01-27 23:04:00,56,97,Brinquedo,8,153
38826,2024-01-27 23:05:00,49,173,Eletrônico,4,222
38827,2024-01-27 23:06:00,50,53,Móvel,7,103
38828,2024-01-27 23:07:00,15,71,Eletrônico,7,86
38829,2024-01-27 23:08:00,41,18,Brinquedo,2,59
38830,2024-01-27 23:09:00,37,171,Móvel,5,208
38831,2024-01-27 23:10:00,10,178,Alimento,4,188
38832,2024-01-27 23:11:00,86,161,Vestuário,8,247
38833,2024-01-27 23:12:00,22,54,Eletrônico,1,76
38834,2024-01-27 23:13:00,41,172,Brinquedo,7,213
38835,2024-01-27 23:14:00,11,163,Alimento,7,174
38836,2024-01-27 23:15:00,82,49,Eletrônico,2,131
38837,2024-01-27 23:16:00,79,29,Vestuário,9,108
38838,2024-01-27 23:17:00,69,90,Alimento,4,159
38839,2024-01-27 23:18:00,59,158,Alimento,5,217
38840,2024-01-27 23:19:00,26,13,Vestuário,9,39
38841,2024-01-27 23:20:00,56,40,Alimento,4,96
38842,2024-01-27 23:21:00,11,63,Alimento,5,74
38843,2024-01-27 23:22:00,103,149,Móvel,7,252
38844,2024-01-27 23:23:00,99,44,Eletrônico,5,143
38845,2024-01-27 23:24:00,18,11,Alimento,4,29
38846,2024-01-27 23:25:00,29,143,Alimento,4,172
38847,2024-01-27 23:26:00,28,48,Eletrônico,1,76
38848,2024-01-27 23:27:00,29,61,Vestuário,8,90
38849,2024-01-27 23:28:00,111,30,Brinquedo,3,141
38850,2024-01-27 23:29:00,20,78,Brinquedo,4,98
38851,2024-01-27 23:30:00,115,161,Móvel,4,276
38852,2024-01-27 23:31:00,95,110,Brinquedo,4,205
38853,2024-01-27 23:32:00,12,61,Vestuário,2,73
38854,2024-01-27 23:33:00,18,151,Vestuário,7,169
38855,2024-01-27 23:34:00,40,96,Brinquedo,4,136
38856,2024-01-27 23:35:00,40,162,Vestuário,4,202
38857,2024-01-27 23:36:00,67,133,Brinquedo,2,200
38858,2024-01-27 23:37:00,30,81,Alimento,1,111
38859,2024-01-27 23:38:00,35,13,Alimento,4,48
38860,2024-01-27 23:39:00,117,85,Brinquedo,3,202
38861,2024-01-27 23:40:00,97,149,Brinquedo,6,246
38862,2024-01-27 23:41:00,19,158,Eletrônico,7,177
38863,2024-01-27 23:42:00,75,51,Brinquedo,4,126
38864,2024-01-27 23:43:00,112,159,Vestuário,5,271
38865,2024-01-27 23:44:00,39,92,Vestuário,5,131
38866,2024-01-27 23:45:00,78,87,Vestuário,9,165
38867,2024-01-27 23:46:00,83,115,Alimento,9,198
38868,2024-01-27 23:47:00,112,72,Brinquedo,1,184
38869,2024-01-27 23:48:00,33,75,Eletrônico,8,108
38870,2024-01-27 23:49:00,55,121,Brinquedo,6,176
38871,2024-01-27 23:50:00,77,80,Alimento,7,157
38872,2024-01-27 23:51:00,106,162,Eletrônico,9,268
38873,2024-01-27 23:52:00,35,48,Alimento,4,83
38874,2024-01-27 23:53:00,11,143,Vestuário,8,154
38875,2024-01-27 23:54:00,26,81,Móvel,5,107
38876,2024-01-27 23:55:00,49,12,Móvel,2,61
38877,2024-01-27 23:56:00,43,40,Eletrônico,4,83
38878,2024-01-27 23:57:00,102,77,Alimento,7,179
38879,2024-01-27 23:58:00,29,118,Alimento,9,147
38880,2024-01-27 23:59:00,85,157,Vestuário,7,242
38881,2024-01-28 00:00:00,100,115,Móvel,7,215
38882,2024-01-28 00:01:00,30,70,Vestuário,4,100
38883,2024-01-28 00:02:00,35,157,Eletrônico,2,192
38884,2024-01-28 00:03:00,38,170,Móvel,7,208
38885,2024-01-28 00:04:00,105,26,Eletrônico,1,131
38886,2024-01-28 00:05:00,72,29,Alimento,3,101
38887,2024-01-28 00:06:00,99,67,Eletrônico,2,166
38888,2024-01-28 00:07:00,24,119,Brinquedo,9,143
38889,2024-01-28 00:08:00,36,133,Eletrônico,8,169
38890,2024-01-28 00:09:00,41,50,Alimento,5,91
38891,2024-01-28 00:10:00,42,24,Eletrônico,6,66
38892,2024-01-28 00:11:00,115,104,Alimento,6,219
38893,2024-01-28 00:12:00,57,31,Vestuário,2,88
38894,2024-01-28 00:13:00,103,169,Eletrônico,4,272
38895,2024-01-28 00:14:00,38,73,Alimento,2,111
38896,2024-01-28 00:15:00,36,98,Móvel,1,134
38897,2024-01-28 00:16:00,21,48,Alimento,7,69
38898,2024-01-28 00:17:00,14,138,Eletrônico,4,152
38899,2024-01-28 00:18:00,56,21,Brinquedo,4,77
38900,2024-01-28 00:19:00,106,110,Vestuário,7,216
38901,2024-01-28 00:20:00,36,12,Móvel,8,48
38902,2024-01-28 00:21:00,106,134,Vestuário,6,240
38903,2024-01-28 00:22:00,27,176,Brinquedo,2,203
38904,2024-01-28 00:23:00,77,154,Brinquedo,5,231
38905,2024-01-28 00:24:00,118,41,Móvel,7,159
38906,2024-01-28 00:25:00,24,56,Brinquedo,9,80
38907,2024-01-28 00:26:00,25,147,Móvel,1,172
38908,2024-01-28 00:27:00,112,33,Alimento,7,145
38909,2024-01-28 00:28:00,54,31,Brinquedo,2,85
38910,2024-01-28 00:29:00,92,94,Alimento,8,186
38911,2024-01-28 00:30:00,47,18,Brinquedo,8,65
38912,2024-01-28 00:31:00,34,88,Alimento,9,122
38913,2024-01-28 00:32:00,81,70,Vestuário,8,151
38914,2024-01-28 00:33:00,82,76,Alimento,1,158
38915,2024-01-28 00:34:00,103,40,Vestuário,2,143
38916,2024-01-28 00:35:00,110,176,Vestuário,4,286
38917,2024-01-28 00:36:00,57,64,Eletrônico,9,121
38918,2024-01-28 00:37:00,18,113,Eletrônico,9,131
38919,2024-01-28 00:38:00,81,114,Alimento,7,195
38920,2024-01-28 00:39:00,115,152,Eletrônico,6,267
38921,2024-01-28 00:40:00,14,174,Brinquedo,3,188
38922,2024-01-28 00:41:00,15,37,Eletrônico,6,52
38923,2024-01-28 00:42:00,11,177,Alimento,7,188
38924,2024-01-28 00:43:00,34,119,Vestuário,4,153
38925,2024-01-28 00:44:00,118,23,Vestuário,6,141
38926,2024-01-28 00:45:00,25,168,Alimento,7,193
38927,2024-01-28 00:46:00,114,131,Vestuário,6,245
38928,2024-01-28 00:47:00,68,85,Eletrônico,1,153
38929,2024-01-28 00:48:00,86,23,Eletrônico,8,109
38930,2024-01-28 00:49:00,52,149,Brinquedo,6,201
38931,2024-01-28 00:50:00,43,24,Alimento,6,67
38932,2024-01-28 00:51:00,113,51,Brinquedo,2,164
38933,2024-01-28 00:52:00,45,130,Eletrônico,7,175
38934,2024-01-28 00:53:00,39,82,Móvel,1,121
38935,2024-01-28 00:54:00,54,24,Eletrônico,8,78
38936,2024-01-28 00:55:00,84,10,Vestuário,8,94
38937,2024-01-28 00:56:00,11,167,Móvel,5,178
38938,2024-01-28 00:57:00,106,122,Móvel,4,228
38939,2024-01-28 00:58:00,15,168,Vestuário,1,183
38940,2024-01-28 00:59:00,98,89,Vestuário,6,187
38941,2024-01-28 01:00:00,10,86,Vestuário,8,96
38942,2024-01-28 01:01:00,26,10,Eletrônico,1,36
38943,2024-01-28 01:02:00,57,55,Alimento,1,112
38944,2024-01-28 01:03:00,116,142,Vestuário,6,258
38945,2024-01-28 01:04:00,19,153,Eletrônico,2,172
38946,2024-01-28 01:05:00,103,174,Vestuário,5,277
38947,2024-01-28 01:06:00,119,79,Móvel,1,198
38948,2024-01-28 01:07:00,113,120,Eletrônico,2,233
38949,2024-01-28 01:08:00,48,26,Brinquedo,5,74
38950,2024-01-28 01:09:00,88,53,Alimento,6,141
38951,2024-01-28 01:10:00,48,166,Móvel,1,214
38952,2024-01-28 01:11:00,77,84,Móvel,3,161
38953,2024-01-28 01:12:00,15,27,Móvel,6,42
38954,2024-01-28 01:13:00,36,43,Móvel,9,79
38955,2024-01-28 01:14:00,61,45,Brinquedo,2,106
38956,2024-01-28 01:15:00,66,28,Brinquedo,3,94
38957,2024-01-28 01:16:00,72,92,Móvel,8,164
38958,2024-01-28 01:17:00,116,132,Móvel,4,248
38959,2024-01-28 01:18:00,24,38,Alimento,1,62
38960,2024-01-28 01:19:00,58,21,Móvel,1,79
38961,2024-01-28 01:20:00,56,133,Eletrônico,6,189
38962,2024-01-28 01:21:00,89,105,Brinquedo,3,194
38963,2024-01-28 01:22:00,11,114,Vestuário,2,125
38964,2024-01-28 01:23:00,62,174,Brinquedo,7,236
38965,2024-01-28 01:24:00,50,97,Móvel,1,147
38966,2024-01-28 01:25:00,63,160,Eletrônico,1,223
38967,2024-01-28 01:26:00,106,143,Alimento,2,249
38968,2024-01-28 01:27:00,91,32,Brinquedo,4,123
38969,2024-01-28 01:28:00,74,115,Alimento,7,189
38970,2024-01-28 01:29:00,49,101,Brinquedo,9,150
38971,2024-01-28 01:30:00,80,57,Brinquedo,7,137
38972,2024-01-28 01:31:00,25,155,Brinquedo,4,180
38973,2024-01-28 01:32:00,67,153,Vestuário,6,220
38974,2024-01-28 01:33:00,81,146,Eletrônico,2,227
38975,2024-01-28 01:34:00,36,163,Móvel,2,199
38976,2024-01-28 01:35:00,47,47,Alimento,5,94
38977,2024-01-28 01:36:00,112,12,Brinquedo,5,124
38978,2024-01-28 01:37:00,38,35,Móvel,1,73
38979,2024-01-28 01:38:00,107,28,Alimento,3,135
38980,2024-01-28 01:39:00,43,28,Alimento,9,71
38981,2024-01-28 01:40:00,58,134,Vestuário,7,192
38982,2024-01-28 01:41:00,116,150,Vestuário,1,266
38983,2024-01-28 01:42:00,118,85,Alimento,4,203
38984,2024-01-28 01:43:00,115,154,Vestuário,2,269
38985,2024-01-28 01:44:00,20,155,Vestuário,9,175
38986,2024-01-28 01:45:00,17,135,Alimento,6,152
38987,2024-01-28 01:46:00,103,54,Móvel,4,157
38988,2024-01-28 01:47:00,100,153,Alimento,3,253
38989,2024-01-28 01:48:00,35,111,Eletrônico,7,146
38990,2024-01-28 01:49:00,26,151,Vestuário,5,177
38991,2024-01-28 01:50:00,30,17,Vestuário,6,47
38992,2024-01-28 01:51:00,81,167,Vestuário,8,248
38993,2024-01-28 01:52:00,74,53,Brinquedo,3,127
38994,2024-01-28 01:53:00,63,35,Brinquedo,2,98
38995,2024-01-28 01:54:00,89,14,Brinquedo,6,103
38996,2024-01-28 01:55:00,66,35,Alimento,1,101
38997,2024-01-28 01:56:00,15,153,Móvel,4,168
38998,2024-01-28 01:57:00,107,147,Brinquedo,5,254
38999,2024-01-28 01:58:00,21,26,Alimento,4,47
39000,2024-01-28 01:59:00,17,78,Eletrônico,9,95
39001,2024-01-28 02:00:00,26,150,Brinquedo,8,176
39002,2024-01-28 02:01:00,83,132,Vestuário,5,215
39003,2024-01-28 02:02:00,52,115,Brinquedo,9,167
39004,2024-01-28 02:03:00,73,72,Alimento,6,145
39005,2024-01-28 02:04:00,42,94,Móvel,2,136
39006,2024-01-28 02:05:00,24,32,Alimento,5,56
39007,2024-01-28 02:06:00,109,120,Eletrônico,3,229
39008,2024-01-28 02:07:00,103,104,Vestuário,7,207
39009,2024-01-28 02:08:00,46,96,Móvel,9,142
39010,2024-01-28 02:09:00,95,10,Alimento,9,105
39011,2024-01-28 02:10:00,93,125,Eletrônico,2,218
39012,2024-01-28 02:11:00,25,44,Móvel,6,69
39013,2024-01-28 02:12:00,92,99,Vestuário,1,191
39014,2024-01-28 02:13:00,26,71,Vestuário,6,97
39015,2024-01-28 02:14:00,29,120,Eletrônico,9,149
39016,2024-01-28 02:15:00,39,109,Vestuário,2,148
39017,2024-01-28 02:16:00,108,52,Eletrônico,3,160
39018,2024-01-28 02:17:00,20,98,Brinquedo,1,118
39019,2024-01-28 02:18:00,58,72,Móvel,8,130
39020,2024-01-28 02:19:00,69,114,Eletrônico,3,183
39021,2024-01-28 02:20:00,78,63,Móvel,8,141
39022,2024-01-28 02:21:00,117,158,Alimento,1,275
39023,2024-01-28 02:22:00,100,160,Alimento,6,260
39024,2024-01-28 02:23:00,90,85,Móvel,1,175
39025,2024-01-28 02:24:00,117,157,Eletrônico,7,274
39026,2024-01-28 02:25:00,20,21,Brinquedo,5,41
39027,2024-01-28 02:26:00,57,16,Eletrônico,8,73
39028,2024-01-28 02:27:00,94,114,Vestuário,8,208
39029,2024-01-28 02:28:00,41,13,Eletrônico,7,54
39030,2024-01-28 02:29:00,119,86,Alimento,4,205
39031,2024-01-28 02:30:00,96,82,Alimento,5,178
39032,2024-01-28 02:31:00,40,10,Eletrônico,8,50
39033,2024-01-28 02:32:00,97,28,Móvel,4,125
39034,2024-01-28 02:33:00,90,36,Brinquedo,6,126
39035,2024-01-28 02:34:00,44,147,Alimento,7,191
39036,2024-01-28 02:35:00,23,130,Alimento,8,153
39037,2024-01-28 02:36:00,101,62,Brinquedo,2,163
39038,2024-01-28 02:37:00,63,125,Eletrônico,6,188
39039,2024-01-28 02:38:00,14,145,Brinquedo,4,159
39040,2024-01-28 02:39:00,82,70,Vestuário,8,152
39041,2024-01-28 02:40:00,49,99,Móvel,8,148
39042,2024-01-28 02:41:00,15,36,Eletrônico,1,51
39043,2024-01-28 02:42:00,78,170,Móvel,6,248
39044,2024-01-28 02:43:00,103,134,Vestuário,5,237
39045,2024-01-28 02:44:00,29,159,Brinquedo,8,188
39046,2024-01-28 02:45:00,67,179,Alimento,6,246
39047,2024-01-28 02:46:00,55,171,Móvel,7,226
39048,2024-01-28 02:47:00,67,114,Brinquedo,1,181
39049,2024-01-28 02:48:00,98,128,Vestuário,8,226
39050,2024-01-28 02:49:00,101,147,Móvel,7,248
39051,2024-01-28 02:50:00,99,56,Brinquedo,9,155
39052,2024-01-28 02:51:00,45,79,Vestuário,1,124
39053,2024-01-28 02:52:00,116,171,Móvel,4,287
39054,2024-01-28 02:53:00,11,98,Móvel,6,109
39055,2024-01-28 02:54:00,52,24,Brinquedo,1,76
39056,2024-01-28 02:55:00,19,111,Eletrônico,9,130
39057,2024-01-28 02:56:00,50,167,Móvel,5,217
39058,2024-01-28 02:57:00,61,79,Alimento,5,140
39059,2024-01-28 02:58:00,87,161,Eletrônico,6,248
39060,2024-01-28 02:59:00,10,13,Vestuário,6,23
39061,2024-01-28 03:00:00,115,62,Vestuário,6,177
39062,2024-01-28 03:01:00,24,121,Móvel,4,145
39063,2024-01-28 03:02:00,18,31,Vestuário,7,49
39064,2024-01-28 03:03:00,102,30,Eletrônico,5,132
39065,2024-01-28 03:04:00,26,111,Vestuário,1,137
39066,2024-01-28 03:05:00,64,76,Vestuário,3,140
39067,2024-01-28 03:06:00,55,71,Móvel,6,126
39068,2024-01-28 03:07:00,93,46,Vestuário,8,139
39069,2024-01-28 03:08:00,92,117,Móvel,9,209
39070,2024-01-28 03:09:00,41,17,Vestuário,1,58
39071,2024-01-28 03:10:00,34,165,Alimento,4,199
39072,2024-01-28 03:11:00,15,84,Eletrônico,1,99
39073,2024-01-28 03:12:00,106,84,Eletrônico,8,190
39074,2024-01-28 03:13:00,69,78,Eletrônico,5,147
39075,2024-01-28 03:14:00,24,23,Vestuário,7,47
39076,2024-01-28 03:15:00,83,110,Vestuário,2,193
39077,2024-01-28 03:16:00,93,102,Eletrônico,2,195
39078,2024-01-28 03:17:00,20,168,Alimento,5,188
39079,2024-01-28 03:18:00,98,129,Alimento,2,227
39080,2024-01-28 03:19:00,116,23,Móvel,1,139
39081,2024-01-28 03:20:00,111,150,Alimento,3,261
39082,2024-01-28 03:21:00,11,82,Alimento,8,93
39083,2024-01-28 03:22:00,114,60,Alimento,6,174
39084,2024-01-28 03:23:00,100,18,Brinquedo,4,118
39085,2024-01-28 03:24:00,77,165,Eletrônico,7,242
39086,2024-01-28 03:25:00,64,23,Brinquedo,4,87
39087,2024-01-28 03:26:00,90,10,Brinquedo,5,100
39088,2024-01-28 03:27:00,12,93,Vestuário,4,105
39089,2024-01-28 03:28:00,40,165,Eletrônico,6,205
39090,2024-01-28 03:29:00,115,46,Alimento,7,161
39091,2024-01-28 03:30:00,51,25,Vestuário,6,76
39092,2024-01-28 03:31:00,100,108,Vestuário,9,208
39093,2024-01-28 03:32:00,82,25,Eletrônico,9,107
39094,2024-01-28 03:33:00,109,92,Vestuário,7,201
39095,2024-01-28 03:34:00,58,130,Alimento,7,188
39096,2024-01-28 03:35:00,48,37,Vestuário,4,85
39097,2024-01-28 03:36:00,19,72,Móvel,1,91
39098,2024-01-28 03:37:00,93,88,Brinquedo,1,181
39099,2024-01-28 03:38:00,85,102,Alimento,9,187
39100,2024-01-28 03:39:00,86,138,Alimento,5,224
39101,2024-01-28 03:40:00,55,129,Móvel,9,184
39102,2024-01-28 03:41:00,13,59,Brinquedo,3,72
39103,2024-01-28 03:42:00,21,31,Alimento,2,52
39104,2024-01-28 03:43:00,51,84,Eletrônico,1,135
39105,2024-01-28 03:44:00,41,45,Eletrônico,9,86
39106,2024-01-28 03:45:00,82,107,Eletrônico,6,189
39107,2024-01-28 03:46:00,107,52,Vestuário,2,159
39108,2024-01-28 03:47:00,20,84,Móvel,6,104
39109,2024-01-28 03:48:00,65,40,Alimento,4,105
39110,2024-01-28 03:49:00,13,27,Móvel,8,40
39111,2024-01-28 03:50:00,115,23,Brinquedo,2,138
39112,2024-01-28 03:51:00,40,10,Eletrônico,9,50
39113,2024-01-28 03:52:00,38,133,Eletrônico,5,171
39114,2024-01-28 03:53:00,115,63,Eletrônico,3,178
39115,2024-01-28 03:54:00,100,128,Alimento,5,228
39116,2024-01-28 03:55:00,23,54,Móvel,2,77
39117,2024-01-28 03:56:00,48,150,Brinquedo,4,198
39118,2024-01-28 03:57:00,34,34,Eletrônico,9,68
39119,2024-01-28 03:58:00,83,162,Móvel,9,245
39120,2024-01-28 03:59:00,24,36,Vestuário,9,60
39121,2024-01-28 04:00:00,101,95,Brinquedo,9,196
39122,2024-01-28 04:01:00,107,159,Vestuário,8,266
39123,2024-01-28 04:02:00,72,49,Brinquedo,5,121
39124,2024-01-28 04:03:00,114,75,Alimento,3,189
39125,2024-01-28 04:04:00,76,84,Móvel,4,160
39126,2024-01-28 04:05:00,51,64,Brinquedo,2,115
39127,2024-01-28 04:06:00,72,140,Brinquedo,4,212
39128,2024-01-28 04:07:00,36,165,Eletrônico,9,201
39129,2024-01-28 04:08:00,16,154,Brinquedo,3,170
39130,2024-01-28 04:09:00,101,42,Móvel,9,143
39131,2024-01-28 04:10:00,49,98,Móvel,9,147
39132,2024-01-28 04:11:00,103,131,Alimento,4,234
39133,2024-01-28 04:12:00,116,135,Móvel,7,251
39134,2024-01-28 04:13:00,14,118,Vestuário,6,132
39135,2024-01-28 04:14:00,72,130,Vestuário,8,202
39136,2024-01-28 04:15:00,15,53,Alimento,1,68
39137,2024-01-28 04:16:00,39,95,Eletrônico,8,134
39138,2024-01-28 04:17:00,16,161,Brinquedo,8,177
39139,2024-01-28 04:18:00,89,72,Brinquedo,5,161
39140,2024-01-28 04:19:00,90,52,Móvel,2,142
39141,2024-01-28 04:20:00,18,23,Vestuário,1,41
39142,2024-01-28 04:21:00,94,39,Móvel,1,133
39143,2024-01-28 04:22:00,54,31,Brinquedo,9,85
39144,2024-01-28 04:23:00,117,104,Vestuário,8,221
39145,2024-01-28 04:24:00,90,150,Vestuário,5,240
39146,2024-01-28 04:25:00,49,93,Brinquedo,1,142
39147,2024-01-28 04:26:00,35,128,Brinquedo,9,163
39148,2024-01-28 04:27:00,41,61,Alimento,8,102
39149,2024-01-28 04:28:00,13,17,Brinquedo,5,30
39150,2024-01-28 04:29:00,53,178,Alimento,6,231
39151,2024-01-28 04:30:00,68,146,Móvel,9,214
39152,2024-01-28 04:31:00,61,98,Eletrônico,1,159
39153,2024-01-28 04:32:00,75,144,Alimento,8,219
39154,2024-01-28 04:33:00,73,77,Alimento,3,150
39155,2024-01-28 04:34:00,44,105,Vestuário,9,149
39156,2024-01-28 04:35:00,27,34,Móvel,8,61
39157,2024-01-28 04:36:00,50,85,Brinquedo,7,135
39158,2024-01-28 04:37:00,29,163,Eletrônico,4,192
39159,2024-01-28 04:38:00,65,94,Brinquedo,7,159
39160,2024-01-28 04:39:00,87,32,Brinquedo,8,119
39161,2024-01-28 04:40:00,50,171,Eletrônico,5,221
39162,2024-01-28 04:41:00,42,84,Eletrônico,3,126
39163,2024-01-28 04:42:00,64,31,Eletrônico,7,95
39164,2024-01-28 04:43:00,48,140,Brinquedo,8,188
39165,2024-01-28 04:44:00,73,69,Vestuário,4,142
39166,2024-01-28 04:45:00,15,136,Eletrônico,6,151
39167,2024-01-28 04:46:00,62,37,Eletrônico,2,99
39168,2024-01-28 04:47:00,69,59,Vestuário,3,128
39169,2024-01-28 04:48:00,117,134,Vestuário,7,251
39170,2024-01-28 04:49:00,32,109,Vestuário,1,141
39171,2024-01-28 04:50:00,23,61,Vestuário,4,84
39172,2024-01-28 04:51:00,92,95,Alimento,7,187
39173,2024-01-28 04:52:00,56,29,Vestuário,7,85
39174,2024-01-28 04:53:00,50,81,Alimento,4,131
39175,2024-01-28 04:54:00,51,67,Vestuário,5,118
39176,2024-01-28 04:55:00,119,134,Móvel,8,253
39177,2024-01-28 04:56:00,100,32,Brinquedo,6,132
39178,2024-01-28 04:57:00,115,32,Eletrônico,9,147
39179,2024-01-28 04:58:00,104,84,Eletrônico,2,188
39180,2024-01-28 04:59:00,87,158,Brinquedo,8,245
39181,2024-01-28 05:00:00,56,75,Móvel,7,131
39182,2024-01-28 05:01:00,34,139,Móvel,6,173
39183,2024-01-28 05:02:00,104,116,Móvel,5,220
39184,2024-01-28 05:03:00,18,136,Vestuário,6,154
39185,2024-01-28 05:04:00,88,129,Vestuário,5,217
39186,2024-01-28 05:05:00,75,150,Vestuário,9,225
39187,2024-01-28 05:06:00,24,49,Alimento,5,73
39188,2024-01-28 05:07:00,89,107,Móvel,4,196
39189,2024-01-28 05:08:00,93,172,Vestuário,1,265
39190,2024-01-28 05:09:00,40,61,Eletrônico,5,101
39191,2024-01-28 05:10:00,57,149,Eletrônico,6,206
39192,2024-01-28 05:11:00,101,99,Eletrônico,6,200
39193,2024-01-28 05:12:00,36,60,Brinquedo,3,96
39194,2024-01-28 05:13:00,22,15,Móvel,1,37
39195,2024-01-28 05:14:00,66,90,Vestuário,3,156
39196,2024-01-28 05:15:00,17,154,Brinquedo,7,171
39197,2024-01-28 05:16:00,113,148,Eletrônico,2,261
39198,2024-01-28 05:17:00,41,167,Brinquedo,8,208
39199,2024-01-28 05:18:00,72,14,Brinquedo,6,86
39200,2024-01-28 05:19:00,17,30,Alimento,1,47
39201,2024-01-28 05:20:00,23,128,Vestuário,4,151
39202,2024-01-28 05:21:00,56,104,Vestuário,6,160
39203,2024-01-28 05:22:00,112,120,Vestuário,9,232
39204,2024-01-28 05:23:00,14,94,Móvel,9,108
39205,2024-01-28 05:24:00,54,142,Alimento,9,196
39206,2024-01-28 05:25:00,98,92,Móvel,1,190
39207,2024-01-28 05:26:00,101,94,Móvel,3,195
39208,2024-01-28 05:27:00,23,139,Vestuário,4,162
39209,2024-01-28 05:28:00,68,80,Vestuário,2,148
39210,2024-01-28 05:29:00,51,94,Brinquedo,9,145
39211,2024-01-28 05:30:00,97,160,Brinquedo,4,257
39212,2024-01-28 05:31:00,96,136,Vestuário,6,232
39213,2024-01-28 05:32:00,88,144,Brinquedo,7,232
39214,2024-01-28 05:33:00,65,49,Vestuário,2,114
39215,2024-01-28 05:34:00,48,38,Vestuário,8,86
39216,2024-01-28 05:35:00,119,178,Móvel,1,297
39217,2024-01-28 05:36:00,70,177,Alimento,9,247
39218,2024-01-28 05:37:00,112,112,Brinquedo,5,224
39219,2024-01-28 05:38:00,74,18,Brinquedo,9,92
39220,2024-01-28 05:39:00,66,170,Vestuário,2,236
39221,2024-01-28 05:40:00,11,141,Eletrônico,4,152
39222,2024-01-28 05:41:00,25,39,Vestuário,2,64
39223,2024-01-28 05:42:00,20,166,Móvel,3,186
39224,2024-01-28 05:43:00,97,158,Vestuário,4,255
39225,2024-01-28 05:44:00,57,115,Brinquedo,8,172
39226,2024-01-28 05:45:00,60,155,Vestuário,2,215
39227,2024-01-28 05:46:00,90,125,Eletrônico,9,215
39228,2024-01-28 05:47:00,53,13,Brinquedo,7,66
39229,2024-01-28 05:48:00,72,80,Alimento,7,152
39230,2024-01-28 05:49:00,31,67,Móvel,1,98
39231,2024-01-28 05:50:00,79,110,Móvel,9,189
39232,2024-01-28 05:51:00,14,81,Eletrônico,1,95
39233,2024-01-28 05:52:00,48,165,Eletrônico,9,213
39234,2024-01-28 05:53:00,86,75,Eletrônico,2,161
39235,2024-01-28 05:54:00,112,169,Alimento,7,281
39236,2024-01-28 05:55:00,110,109,Vestuário,2,219
39237,2024-01-28 05:56:00,61,136,Alimento,6,197
39238,2024-01-28 05:57:00,49,115,Alimento,5,164
39239,2024-01-28 05:58:00,113,51,Vestuário,7,164
39240,2024-01-28 05:59:00,44,157,Móvel,5,201
39241,2024-01-28 06:00:00,36,71,Alimento,1,107
39242,2024-01-28 06:01:00,107,70,Móvel,7,177
39243,2024-01-28 06:02:00,51,24,Brinquedo,2,75
39244,2024-01-28 06:03:00,67,78,Brinquedo,9,145
39245,2024-01-28 06:04:00,86,128,Brinquedo,7,214
39246,2024-01-28 06:05:00,16,150,Vestuário,5,166
39247,2024-01-28 06:06:00,43,141,Vestuário,3,184
39248,2024-01-28 06:07:00,50,105,Brinquedo,9,155
39249,2024-01-28 06:08:00,107,25,Móvel,5,132
39250,2024-01-28 06:09:00,93,116,Vestuário,1,209
39251,2024-01-28 06:10:00,82,72,Brinquedo,3,154
39252,2024-01-28 06:11:00,58,45,Brinquedo,8,103
39253,2024-01-28 06:12:00,51,31,Brinquedo,9,82
39254,2024-01-28 06:13:00,62,86,Eletrônico,1,148
39255,2024-01-28 06:14:00,72,165,Móvel,9,237
39256,2024-01-28 06:15:00,70,103,Eletrônico,8,173
39257,2024-01-28 06:16:00,79,158,Alimento,5,237
39258,2024-01-28 06:17:00,26,116,Alimento,6,142
39259,2024-01-28 06:18:00,60,169,Vestuário,6,229
39260,2024-01-28 06:19:00,48,70,Móvel,4,118
39261,2024-01-28 06:20:00,92,44,Brinquedo,6,136
39262,2024-01-28 06:21:00,40,70,Vestuário,9,110
39263,2024-01-28 06:22:00,15,135,Alimento,7,150
39264,2024-01-28 06:23:00,101,67,Alimento,3,168
39265,2024-01-28 06:24:00,36,107,Brinquedo,8,143
39266,2024-01-28 06:25:00,83,163,Alimento,4,246
39267,2024-01-28 06:26:00,108,169,Vestuário,7,277
39268,2024-01-28 06:27:00,95,66,Vestuário,3,161
39269,2024-01-28 06:28:00,34,84,Eletrônico,7,118
39270,2024-01-28 06:29:00,29,13,Vestuário,1,42
39271,2024-01-28 06:30:00,53,76,Brinquedo,9,129
39272,2024-01-28 06:31:00,31,162,Eletrônico,7,193
39273,2024-01-28 06:32:00,89,77,Alimento,6,166
39274,2024-01-28 06:33:00,85,47,Alimento,9,132
39275,2024-01-28 06:34:00,81,175,Vestuário,9,256
39276,2024-01-28 06:35:00,97,124,Alimento,1,221
39277,2024-01-28 06:36:00,41,58,Móvel,5,99
39278,2024-01-28 06:37:00,118,178,Vestuário,1,296
39279,2024-01-28 06:38:00,42,114,Alimento,3,156
39280,2024-01-28 06:39:00,109,30,Eletrônico,8,139
39281,2024-01-28 06:40:00,20,94,Alimento,1,114
39282,2024-01-28 06:41:00,73,86,Brinquedo,9,159
39283,2024-01-28 06:42:00,78,44,Brinquedo,5,122
39284,2024-01-28 06:43:00,58,21,Vestuário,8,79
39285,2024-01-28 06:44:00,69,13,Vestuário,1,82
39286,2024-01-28 06:45:00,77,33,Móvel,7,110
39287,2024-01-28 06:46:00,62,118,Alimento,6,180
39288,2024-01-28 06:47:00,74,33,Vestuário,8,107
39289,2024-01-28 06:48:00,23,153,Brinquedo,2,176
39290,2024-01-28 06:49:00,116,118,Eletrônico,5,234
39291,2024-01-28 06:50:00,37,179,Eletrônico,2,216
39292,2024-01-28 06:51:00,44,42,Vestuário,7,86
39293,2024-01-28 06:52:00,28,149,Eletrônico,8,177
39294,2024-01-28 06:53:00,53,162,Vestuário,5,215
39295,2024-01-28 06:54:00,47,115,Alimento,2,162
39296,2024-01-28 06:55:00,34,126,Alimento,5,160
39297,2024-01-28 06:56:00,61,72,Alimento,5,133
39298,2024-01-28 06:57:00,114,150,Vestuário,9,264
39299,2024-01-28 06:58:00,20,111,Brinquedo,4,131
39300,2024-01-28 06:59:00,87,160,Móvel,5,247
39301,2024-01-28 07:00:00,40,161,Eletrônico,8,201
39302,2024-01-28 07:01:00,117,20,Móvel,1,137
39303,2024-01-28 07:02:00,44,107,Vestuário,7,151
39304,2024-01-28 07:03:00,91,72,Brinquedo,3,163
39305,2024-01-28 07:04:00,115,71,Eletrônico,7,186
39306,2024-01-28 07:05:00,10,45,Móvel,7,55
39307,2024-01-28 07:06:00,21,92,Alimento,6,113
39308,2024-01-28 07:07:00,93,132,Brinquedo,9,225
39309,2024-01-28 07:08:00,19,61,Móvel,9,80
39310,2024-01-28 07:09:00,24,137,Eletrônico,8,161
39311,2024-01-28 07:10:00,112,173,Brinquedo,2,285
39312,2024-01-28 07:11:00,83,59,Eletrônico,5,142
39313,2024-01-28 07:12:00,55,164,Eletrônico,1,219
39314,2024-01-28 07:13:00,88,145,Móvel,1,233
39315,2024-01-28 07:14:00,81,137,Vestuário,4,218
39316,2024-01-28 07:15:00,47,124,Alimento,9,171
39317,2024-01-28 07:16:00,81,148,Alimento,4,229
39318,2024-01-28 07:17:00,41,83,Brinquedo,5,124
39319,2024-01-28 07:18:00,108,63,Alimento,7,171
39320,2024-01-28 07:19:00,42,85,Móvel,4,127
39321,2024-01-28 07:20:00,83,38,Alimento,4,121
39322,2024-01-28 07:21:00,96,78,Vestuário,7,174
39323,2024-01-28 07:22:00,45,22,Vestuário,7,67
39324,2024-01-28 07:23:00,52,99,Alimento,9,151
39325,2024-01-28 07:24:00,42,69,Brinquedo,7,111
39326,2024-01-28 07:25:00,107,149,Alimento,8,256
39327,2024-01-28 07:26:00,29,127,Vestuário,3,156
39328,2024-01-28 07:27:00,76,135,Alimento,1,211
39329,2024-01-28 07:28:00,13,133,Alimento,9,146
39330,2024-01-28 07:29:00,75,93,Vestuário,8,168
39331,2024-01-28 07:30:00,92,104,Móvel,4,196
39332,2024-01-28 07:31:00,48,175,Alimento,2,223
39333,2024-01-28 07:32:00,94,24,Brinquedo,1,118
39334,2024-01-28 07:33:00,111,64,Brinquedo,6,175
39335,2024-01-28 07:34:00,10,76,Vestuário,4,86
39336,2024-01-28 07:35:00,80,64,Alimento,3,144
39337,2024-01-28 07:36:00,43,122,Brinquedo,7,165
39338,2024-01-28 07:37:00,25,111,Alimento,6,136
39339,2024-01-28 07:38:00,37,18,Alimento,1,55
39340,2024-01-28 07:39:00,74,15,Vestuário,4,89
39341,2024-01-28 07:40:00,114,32,Eletrônico,2,146
39342,2024-01-28 07:41:00,104,131,Eletrônico,5,235
39343,2024-01-28 07:42:00,69,62,Alimento,1,131
39344,2024-01-28 07:43:00,77,178,Brinquedo,9,255
39345,2024-01-28 07:44:00,96,165,Alimento,3,261
39346,2024-01-28 07:45:00,20,19,Móvel,4,39
39347,2024-01-28 07:46:00,18,153,Vestuário,2,171
39348,2024-01-28 07:47:00,100,110,Eletrônico,9,210
39349,2024-01-28 07:48:00,96,46,Vestuário,5,142
39350,2024-01-28 07:49:00,117,157,Brinquedo,7,274
39351,2024-01-28 07:50:00,70,65,Alimento,2,135
39352,2024-01-28 07:51:00,58,75,Móvel,9,133
39353,2024-01-28 07:52:00,16,167,Brinquedo,8,183
39354,2024-01-28 07:53:00,33,161,Vestuário,4,194
39355,2024-01-28 07:54:00,89,119,Alimento,2,208
39356,2024-01-28 07:55:00,78,108,Alimento,7,186
39357,2024-01-28 07:56:00,42,69,Vestuário,6,111
39358,2024-01-28 07:57:00,102,61,Brinquedo,3,163
39359,2024-01-28 07:58:00,67,158,Brinquedo,8,225
39360,2024-01-28 07:59:00,77,140,Brinquedo,8,217
39361,2024-01-28 08:00:00,62,48,Vestuário,9,110
39362,2024-01-28 08:01:00,80,145,Eletrônico,4,225
39363,2024-01-28 08:02:00,69,164,Vestuário,8,233
39364,2024-01-28 08:03:00,80,141,Móvel,8,221
39365,2024-01-28 08:04:00,57,68,Alimento,5,125
39366,2024-01-28 08:05:00,67,102,Eletrônico,8,169
39367,2024-01-28 08:06:00,65,136,Eletrônico,7,201
39368,2024-01-28 08:07:00,107,78,Alimento,3,185
39369,2024-01-28 08:08:00,96,25,Brinquedo,2,121
39370,2024-01-28 08:09:00,85,118,Eletrônico,3,203
39371,2024-01-28 08:10:00,87,171,Móvel,2,258
39372,2024-01-28 08:11:00,89,104,Brinquedo,2,193
39373,2024-01-28 08:12:00,30,85,Vestuário,2,115
39374,2024-01-28 08:13:00,50,103,Eletrônico,3,153
39375,2024-01-28 08:14:00,15,162,Eletrônico,4,177
39376,2024-01-28 08:15:00,24,165,Alimento,6,189
39377,2024-01-28 08:16:00,80,35,Alimento,2,115
39378,2024-01-28 08:17:00,23,118,Brinquedo,1,141
39379,2024-01-28 08:18:00,99,160,Eletrônico,5,259
39380,2024-01-28 08:19:00,59,28,Vestuário,5,87
39381,2024-01-28 08:20:00,108,11,Eletrônico,5,119
39382,2024-01-28 08:21:00,96,58,Vestuário,9,154
39383,2024-01-28 08:22:00,57,139,Eletrônico,7,196
39384,2024-01-28 08:23:00,115,71,Eletrônico,6,186
39385,2024-01-28 08:24:00,102,48,Brinquedo,1,150
39386,2024-01-28 08:25:00,99,80,Brinquedo,8,179
39387,2024-01-28 08:26:00,19,76,Eletrônico,3,95
39388,2024-01-28 08:27:00,94,75,Móvel,1,169
39389,2024-01-28 08:28:00,24,53,Eletrônico,6,77
39390,2024-01-28 08:29:00,44,45,Alimento,7,89
39391,2024-01-28 08:30:00,46,92,Eletrônico,2,138
39392,2024-01-28 08:31:00,27,142,Móvel,7,169
39393,2024-01-28 08:32:00,84,104,Alimento,2,188
39394,2024-01-28 08:33:00,20,134,Brinquedo,6,154
39395,2024-01-28 08:34:00,31,97,Móvel,5,128
39396,2024-01-28 08:35:00,86,54,Alimento,7,140
39397,2024-01-28 08:36:00,118,90,Brinquedo,5,208
39398,2024-01-28 08:37:00,117,104,Móvel,3,221
39399,2024-01-28 08:38:00,87,70,Vestuário,8,157
39400,2024-01-28 08:39:00,56,121,Brinquedo,6,177
39401,2024-01-28 08:40:00,97,16,Móvel,4,113
39402,2024-01-28 08:41:00,46,174,Brinquedo,4,220
39403,2024-01-28 08:42:00,54,68,Alimento,2,122
39404,2024-01-28 08:43:00,107,175,Eletrônico,9,282
39405,2024-01-28 08:44:00,54,114,Eletrônico,1,168
39406,2024-01-28 08:45:00,25,131,Brinquedo,7,156
39407,2024-01-28 08:46:00,46,171,Alimento,8,217
39408,2024-01-28 08:47:00,84,162,Eletrônico,1,246
39409,2024-01-28 08:48:00,35,83,Alimento,8,118
39410,2024-01-28 08:49:00,115,177,Alimento,2,292
39411,2024-01-28 08:50:00,49,24,Eletrônico,3,73
39412,2024-01-28 08:51:00,47,140,Eletrônico,8,187
39413,2024-01-28 08:52:00,111,81,Eletrônico,3,192
39414,2024-01-28 08:53:00,71,160,Móvel,3,231
39415,2024-01-28 08:54:00,77,28,Eletrônico,4,105
39416,2024-01-28 08:55:00,67,161,Eletrônico,3,228
39417,2024-01-28 08:56:00,21,20,Vestuário,1,41
39418,2024-01-28 08:57:00,118,111,Alimento,5,229
39419,2024-01-28 08:58:00,115,61,Vestuário,4,176
39420,2024-01-28 08:59:00,83,51,Brinquedo,1,134
39421,2024-01-28 09:00:00,88,109,Vestuário,3,197
39422,2024-01-28 09:01:00,29,97,Vestuário,4,126
39423,2024-01-28 09:02:00,109,21,Móvel,2,130
39424,2024-01-28 09:03:00,18,13,Móvel,9,31
39425,2024-01-28 09:04:00,99,32,Brinquedo,2,131
39426,2024-01-28 09:05:00,69,99,Eletrônico,5,168
39427,2024-01-28 09:06:00,96,165,Brinquedo,6,261
39428,2024-01-28 09:07:00,87,89,Vestuário,2,176
39429,2024-01-28 09:08:00,86,102,Móvel,5,188
39430,2024-01-28 09:09:00,43,155,Brinquedo,7,198
39431,2024-01-28 09:10:00,102,159,Alimento,4,261
39432,2024-01-28 09:11:00,104,79,Vestuário,2,183
39433,2024-01-28 09:12:00,73,176,Vestuário,5,249
39434,2024-01-28 09:13:00,21,31,Vestuário,1,52
39435,2024-01-28 09:14:00,25,101,Eletrônico,7,126
39436,2024-01-28 09:15:00,116,53,Móvel,7,169
39437,2024-01-28 09:16:00,20,92,Vestuário,3,112
39438,2024-01-28 09:17:00,101,50,Brinquedo,1,151
39439,2024-01-28 09:18:00,56,73,Brinquedo,1,129
39440,2024-01-28 09:19:00,37,26,Móvel,2,63
39441,2024-01-28 09:20:00,33,12,Móvel,3,45
39442,2024-01-28 09:21:00,12,159,Vestuário,6,171
39443,2024-01-28 09:22:00,98,46,Móvel,3,144
39444,2024-01-28 09:23:00,41,26,Brinquedo,5,67
39445,2024-01-28 09:24:00,112,169,Brinquedo,3,281
39446,2024-01-28 09:25:00,116,46,Brinquedo,4,162
39447,2024-01-28 09:26:00,33,28,Vestuário,3,61
39448,2024-01-28 09:27:00,102,105,Brinquedo,1,207
39449,2024-01-28 09:28:00,49,125,Móvel,2,174
39450,2024-01-28 09:29:00,30,175,Brinquedo,3,205
39451,2024-01-28 09:30:00,72,49,Móvel,3,121
39452,2024-01-28 09:31:00,105,115,Brinquedo,7,220
39453,2024-01-28 09:32:00,119,52,Móvel,6,171
39454,2024-01-28 09:33:00,14,134,Eletrônico,9,148
39455,2024-01-28 09:34:00,76,97,Alimento,5,173
39456,2024-01-28 09:35:00,10,130,Móvel,2,140
39457,2024-01-28 09:36:00,51,166,Alimento,2,217
39458,2024-01-28 09:37:00,16,118,Vestuário,4,134
39459,2024-01-28 09:38:00,66,93,Móvel,7,159
39460,2024-01-28 09:39:00,51,92,Brinquedo,6,143
39461,2024-01-28 09:40:00,25,151,Eletrônico,5,176
39462,2024-01-28 09:41:00,58,140,Eletrônico,3,198
39463,2024-01-28 09:42:00,23,64,Brinquedo,7,87
39464,2024-01-28 09:43:00,15,177,Vestuário,4,192
39465,2024-01-28 09:44:00,51,93,Vestuário,2,144
39466,2024-01-28 09:45:00,50,118,Brinquedo,7,168
39467,2024-01-28 09:46:00,72,72,Eletrônico,9,144
39468,2024-01-28 09:47:00,79,137,Vestuário,2,216
39469,2024-01-28 09:48:00,52,95,Brinquedo,8,147
39470,2024-01-28 09:49:00,57,179,Eletrônico,6,236
39471,2024-01-28 09:50:00,104,153,Brinquedo,4,257
39472,2024-01-28 09:51:00,80,156,Móvel,5,236
39473,2024-01-28 09:52:00,114,137,Vestuário,8,251
39474,2024-01-28 09:53:00,32,94,Alimento,7,126
39475,2024-01-28 09:54:00,105,168,Móvel,6,273
39476,2024-01-28 09:55:00,88,75,Brinquedo,8,163
39477,2024-01-28 09:56:00,119,13,Vestuário,6,132
39478,2024-01-28 09:57:00,73,50,Móvel,6,123
39479,2024-01-28 09:58:00,91,147,Vestuário,8,238
39480,2024-01-28 09:59:00,47,99,Eletrônico,6,146
39481,2024-01-28 10:00:00,54,54,Vestuário,5,108
39482,2024-01-28 10:01:00,43,27,Eletrônico,5,70
39483,2024-01-28 10:02:00,20,39,Brinquedo,2,59
39484,2024-01-28 10:03:00,82,164,Brinquedo,5,246
39485,2024-01-28 10:04:00,27,22,Móvel,2,49
39486,2024-01-28 10:05:00,119,32,Vestuário,4,151
39487,2024-01-28 10:06:00,40,113,Vestuário,2,153
39488,2024-01-28 10:07:00,72,137,Alimento,2,209
39489,2024-01-28 10:08:00,37,109,Brinquedo,1,146
39490,2024-01-28 10:09:00,45,157,Brinquedo,7,202
39491,2024-01-28 10:10:00,91,151,Alimento,6,242
39492,2024-01-28 10:11:00,15,168,Eletrônico,6,183
39493,2024-01-28 10:12:00,66,18,Vestuário,1,84
39494,2024-01-28 10:13:00,27,16,Brinquedo,9,43
39495,2024-01-28 10:14:00,15,50,Brinquedo,5,65
39496,2024-01-28 10:15:00,105,100,Eletrônico,9,205
39497,2024-01-28 10:16:00,97,37,Alimento,8,134
39498,2024-01-28 10:17:00,78,123,Vestuário,1,201
39499,2024-01-28 10:18:00,49,46,Alimento,1,95
39500,2024-01-28 10:19:00,97,21,Brinquedo,8,118
39501,2024-01-28 10:20:00,101,149,Móvel,9,250
39502,2024-01-28 10:21:00,35,29,Móvel,7,64
39503,2024-01-28 10:22:00,66,24,Eletrônico,4,90
39504,2024-01-28 10:23:00,41,105,Móvel,5,146
39505,2024-01-28 10:24:00,85,146,Móvel,1,231
39506,2024-01-28 10:25:00,116,132,Vestuário,4,248
39507,2024-01-28 10:26:00,16,17,Vestuário,2,33
39508,2024-01-28 10:27:00,68,153,Vestuário,6,221
39509,2024-01-28 10:28:00,64,132,Alimento,9,196
39510,2024-01-28 10:29:00,111,66,Móvel,1,177
39511,2024-01-28 10:30:00,102,162,Brinquedo,2,264
39512,2024-01-28 10:31:00,101,57,Móvel,5,158
39513,2024-01-28 10:32:00,72,145,Móvel,2,217
39514,2024-01-28 10:33:00,28,97,Vestuário,9,125
39515,2024-01-28 10:34:00,15,168,Alimento,9,183
39516,2024-01-28 10:35:00,73,175,Móvel,3,248
39517,2024-01-28 10:36:00,35,148,Alimento,9,183
39518,2024-01-28 10:37:00,70,159,Alimento,8,229
39519,2024-01-28 10:38:00,44,86,Móvel,2,130
39520,2024-01-28 10:39:00,26,21,Brinquedo,3,47
39521,2024-01-28 10:40:00,83,136,Brinquedo,3,219
39522,2024-01-28 10:41:00,118,90,Móvel,6,208
39523,2024-01-28 10:42:00,61,98,Alimento,6,159
39524,2024-01-28 10:43:00,41,134,Brinquedo,6,175
39525,2024-01-28 10:44:00,92,92,Móvel,8,184
39526,2024-01-28 10:45:00,70,172,Alimento,1,242
39527,2024-01-28 10:46:00,70,19,Alimento,4,89
39528,2024-01-28 10:47:00,51,14,Vestuário,9,65
39529,2024-01-28 10:48:00,17,81,Móvel,9,98
39530,2024-01-28 10:49:00,101,84,Móvel,6,185
39531,2024-01-28 10:50:00,46,99,Alimento,9,145
39532,2024-01-28 10:51:00,26,125,Brinquedo,5,151
39533,2024-01-28 10:52:00,80,90,Móvel,7,170
39534,2024-01-28 10:53:00,79,50,Vestuário,5,129
39535,2024-01-28 10:54:00,17,167,Brinquedo,8,184
39536,2024-01-28 10:55:00,88,139,Vestuário,2,227
39537,2024-01-28 10:56:00,86,45,Vestuário,9,131
39538,2024-01-28 10:57:00,17,51,Eletrônico,1,68
39539,2024-01-28 10:58:00,103,60,Eletrônico,3,163
39540,2024-01-28 10:59:00,71,108,Brinquedo,1,179
39541,2024-01-28 11:00:00,73,170,Brinquedo,7,243
39542,2024-01-28 11:01:00,91,119,Brinquedo,5,210
39543,2024-01-28 11:02:00,38,32,Eletrônico,3,70
39544,2024-01-28 11:03:00,106,77,Móvel,3,183
39545,2024-01-28 11:04:00,13,90,Vestuário,8,103
39546,2024-01-28 11:05:00,69,123,Vestuário,4,192
39547,2024-01-28 11:06:00,16,98,Brinquedo,7,114
39548,2024-01-28 11:07:00,32,44,Alimento,6,76
39549,2024-01-28 11:08:00,56,170,Eletrônico,9,226
39550,2024-01-28 11:09:00,34,173,Eletrônico,8,207
39551,2024-01-28 11:10:00,115,129,Vestuário,2,244
39552,2024-01-28 11:11:00,63,175,Brinquedo,6,238
39553,2024-01-28 11:12:00,60,158,Brinquedo,3,218
39554,2024-01-28 11:13:00,45,118,Móvel,8,163
39555,2024-01-28 11:14:00,66,153,Alimento,2,219
39556,2024-01-28 11:15:00,83,173,Vestuário,7,256
39557,2024-01-28 11:16:00,111,151,Eletrônico,5,262
39558,2024-01-28 11:17:00,80,152,Vestuário,7,232
39559,2024-01-28 11:18:00,109,119,Eletrônico,4,228
39560,2024-01-28 11:19:00,96,34,Móvel,6,130
39561,2024-01-28 11:20:00,27,71,Alimento,6,98
39562,2024-01-28 11:21:00,69,87,Móvel,6,156
39563,2024-01-28 11:22:00,24,65,Vestuário,3,89
39564,2024-01-28 11:23:00,54,39,Eletrônico,1,93
39565,2024-01-28 11:24:00,95,171,Vestuário,4,266
39566,2024-01-28 11:25:00,13,174,Móvel,1,187
39567,2024-01-28 11:26:00,80,108,Eletrônico,9,188
39568,2024-01-28 11:27:00,110,33,Vestuário,3,143
39569,2024-01-28 11:28:00,45,72,Brinquedo,5,117
39570,2024-01-28 11:29:00,64,87,Eletrônico,1,151
39571,2024-01-28 11:30:00,78,120,Eletrônico,4,198
39572,2024-01-28 11:31:00,60,10,Móvel,6,70
39573,2024-01-28 11:32:00,56,56,Eletrônico,9,112
39574,2024-01-28 11:33:00,74,141,Eletrônico,9,215
39575,2024-01-28 11:34:00,74,87,Vestuário,5,161
39576,2024-01-28 11:35:00,115,27,Alimento,6,142
39577,2024-01-28 11:36:00,34,167,Vestuário,9,201
39578,2024-01-28 11:37:00,22,84,Móvel,3,106
39579,2024-01-28 11:38:00,20,137,Eletrônico,1,157
39580,2024-01-28 11:39:00,11,115,Móvel,8,126
39581,2024-01-28 11:40:00,33,160,Móvel,8,193
39582,2024-01-28 11:41:00,116,131,Vestuário,6,247
39583,2024-01-28 11:42:00,99,177,Eletrônico,9,276
39584,2024-01-28 11:43:00,68,120,Eletrônico,6,188
39585,2024-01-28 11:44:00,53,82,Brinquedo,7,135
39586,2024-01-28 11:45:00,70,15,Brinquedo,2,85
39587,2024-01-28 11:46:00,29,53,Brinquedo,9,82
39588,2024-01-28 11:47:00,36,127,Móvel,1,163
39589,2024-01-28 11:48:00,101,15,Alimento,5,116
39590,2024-01-28 11:49:00,43,22,Brinquedo,8,65
39591,2024-01-28 11:50:00,68,47,Brinquedo,5,115
39592,2024-01-28 11:51:00,87,46,Brinquedo,2,133
39593,2024-01-28 11:52:00,95,137,Móvel,2,232
39594,2024-01-28 11:53:00,80,21,Vestuário,3,101
39595,2024-01-28 11:54:00,50,82,Brinquedo,6,132
39596,2024-01-28 11:55:00,58,145,Eletrônico,8,203
39597,2024-01-28 11:56:00,90,131,Brinquedo,6,221
39598,2024-01-28 11:57:00,79,158,Brinquedo,2,237
39599,2024-01-28 11:58:00,60,156,Móvel,7,216
39600,2024-01-28 11:59:00,11,119,Móvel,6,130
39601,2024-01-28 12:00:00,56,99,Eletrônico,1,155
39602,2024-01-28 12:01:00,36,12,Móvel,8,48
39603,2024-01-28 12:02:00,119,32,Vestuário,7,151
39604,2024-01-28 12:03:00,99,142,Alimento,6,241
39605,2024-01-28 12:04:00,68,106,Brinquedo,2,174
39606,2024-01-28 12:05:00,46,87,Móvel,6,133
39607,2024-01-28 12:06:00,72,151,Eletrônico,2,223
39608,2024-01-28 12:07:00,21,148,Alimento,4,169
39609,2024-01-28 12:08:00,22,173,Brinquedo,5,195
39610,2024-01-28 12:09:00,85,100,Brinquedo,6,185
39611,2024-01-28 12:10:00,20,153,Móvel,8,173
39612,2024-01-28 12:11:00,36,69,Eletrônico,8,105
39613,2024-01-28 12:12:00,70,31,Eletrônico,1,101
39614,2024-01-28 12:13:00,49,164,Brinquedo,7,213
39615,2024-01-28 12:14:00,88,161,Eletrônico,4,249
39616,2024-01-28 12:15:00,21,31,Vestuário,3,52
39617,2024-01-28 12:16:00,24,140,Alimento,3,164
39618,2024-01-28 12:17:00,60,145,Eletrônico,3,205
39619,2024-01-28 12:18:00,42,93,Móvel,4,135
39620,2024-01-28 12:19:00,97,116,Brinquedo,8,213
39621,2024-01-28 12:20:00,98,87,Eletrônico,6,185
39622,2024-01-28 12:21:00,87,128,Móvel,6,215
39623,2024-01-28 12:22:00,29,122,Alimento,7,151
39624,2024-01-28 12:23:00,14,130,Eletrônico,8,144
39625,2024-01-28 12:24:00,23,27,Alimento,3,50
39626,2024-01-28 12:25:00,44,86,Móvel,5,130
39627,2024-01-28 12:26:00,31,138,Vestuário,3,169
39628,2024-01-28 12:27:00,85,13,Móvel,8,98
39629,2024-01-28 12:28:00,26,54,Eletrônico,5,80
39630,2024-01-28 12:29:00,119,43,Eletrônico,3,162
39631,2024-01-28 12:30:00,32,16,Vestuário,1,48
39632,2024-01-28 12:31:00,38,81,Brinquedo,3,119
39633,2024-01-28 12:32:00,32,118,Brinquedo,4,150
39634,2024-01-28 12:33:00,56,79,Alimento,2,135
39635,2024-01-28 12:34:00,20,48,Vestuário,8,68
39636,2024-01-28 12:35:00,119,63,Brinquedo,8,182
39637,2024-01-28 12:36:00,21,120,Móvel,5,141
39638,2024-01-28 12:37:00,119,65,Brinquedo,8,184
39639,2024-01-28 12:38:00,15,19,Alimento,7,34
39640,2024-01-28 12:39:00,81,135,Alimento,7,216
39641,2024-01-28 12:40:00,92,67,Alimento,5,159
39642,2024-01-28 12:41:00,71,100,Brinquedo,6,171
39643,2024-01-28 12:42:00,18,170,Vestuário,6,188
39644,2024-01-28 12:43:00,23,42,Alimento,1,65
39645,2024-01-28 12:44:00,93,114,Vestuário,5,207
39646,2024-01-28 12:45:00,42,69,Alimento,4,111
39647,2024-01-28 12:46:00,73,162,Vestuário,4,235
39648,2024-01-28 12:47:00,107,153,Eletrônico,9,260
39649,2024-01-28 12:48:00,73,158,Eletrônico,7,231
39650,2024-01-28 12:49:00,118,85,Alimento,1,203
39651,2024-01-28 12:50:00,64,50,Móvel,8,114
39652,2024-01-28 12:51:00,49,91,Móvel,1,140
39653,2024-01-28 12:52:00,65,50,Eletrônico,6,115
39654,2024-01-28 12:53:00,45,167,Vestuário,7,212
39655,2024-01-28 12:54:00,10,11,Alimento,1,21
39656,2024-01-28 12:55:00,102,63,Eletrônico,1,165
39657,2024-01-28 12:56:00,68,24,Vestuário,7,92
39658,2024-01-28 12:57:00,63,161,Alimento,3,224
39659,2024-01-28 12:58:00,94,56,Vestuário,9,150
39660,2024-01-28 12:59:00,72,175,Brinquedo,7,247
39661,2024-01-28 13:00:00,62,113,Brinquedo,5,175
39662,2024-01-28 13:01:00,48,37,Alimento,7,85
39663,2024-01-28 13:02:00,117,107,Vestuário,7,224
39664,2024-01-28 13:03:00,90,177,Alimento,6,267
39665,2024-01-28 13:04:00,59,44,Vestuário,3,103
39666,2024-01-28 13:05:00,62,134,Móvel,2,196
39667,2024-01-28 13:06:00,115,23,Móvel,3,138
39668,2024-01-28 13:07:00,100,111,Eletrônico,3,211
39669,2024-01-28 13:08:00,38,14,Vestuário,7,52
39670,2024-01-28 13:09:00,95,52,Brinquedo,9,147
39671,2024-01-28 13:10:00,60,10,Eletrônico,7,70
39672,2024-01-28 13:11:00,84,141,Alimento,8,225
39673,2024-01-28 13:12:00,71,57,Vestuário,1,128
39674,2024-01-28 13:13:00,45,96,Alimento,9,141
39675,2024-01-28 13:14:00,24,13,Alimento,3,37
39676,2024-01-28 13:15:00,52,162,Móvel,9,214
39677,2024-01-28 13:16:00,15,75,Móvel,2,90
39678,2024-01-28 13:17:00,64,44,Eletrônico,3,108
39679,2024-01-28 13:18:00,108,178,Vestuário,8,286
39680,2024-01-28 13:19:00,96,90,Brinquedo,6,186
39681,2024-01-28 13:20:00,59,147,Vestuário,2,206
39682,2024-01-28 13:21:00,93,55,Brinquedo,1,148
39683,2024-01-28 13:22:00,45,40,Alimento,2,85
39684,2024-01-28 13:23:00,29,51,Alimento,3,80
39685,2024-01-28 13:24:00,59,60,Móvel,6,119
39686,2024-01-28 13:25:00,42,10,Móvel,7,52
39687,2024-01-28 13:26:00,89,170,Alimento,9,259
39688,2024-01-28 13:27:00,25,16,Móvel,9,41
39689,2024-01-28 13:28:00,42,116,Alimento,8,158
39690,2024-01-28 13:29:00,116,128,Móvel,3,244
39691,2024-01-28 13:30:00,38,92,Alimento,6,130
39692,2024-01-28 13:31:00,80,62,Eletrônico,3,142
39693,2024-01-28 13:32:00,65,20,Vestuário,8,85
39694,2024-01-28 13:33:00,112,34,Eletrônico,5,146
39695,2024-01-28 13:34:00,23,73,Vestuário,7,96
39696,2024-01-28 13:35:00,53,77,Eletrônico,4,130
39697,2024-01-28 13:36:00,61,11,Alimento,5,72
39698,2024-01-28 13:37:00,89,79,Brinquedo,6,168
39699,2024-01-28 13:38:00,13,103,Brinquedo,5,116
39700,2024-01-28 13:39:00,13,165,Vestuário,8,178
39701,2024-01-28 13:40:00,98,87,Vestuário,2,185
39702,2024-01-28 13:41:00,32,21,Brinquedo,5,53
39703,2024-01-28 13:42:00,33,110,Brinquedo,1,143
39704,2024-01-28 13:43:00,104,63,Vestuário,1,167
39705,2024-01-28 13:44:00,12,39,Móvel,8,51
39706,2024-01-28 13:45:00,22,109,Alimento,3,131
39707,2024-01-28 13:46:00,20,41,Vestuário,2,61
39708,2024-01-28 13:47:00,66,52,Alimento,1,118
39709,2024-01-28 13:48:00,67,59,Móvel,7,126
39710,2024-01-28 13:49:00,48,111,Móvel,9,159
39711,2024-01-28 13:50:00,44,118,Eletrônico,2,162
39712,2024-01-28 13:51:00,77,59,Brinquedo,2,136
39713,2024-01-28 13:52:00,84,91,Vestuário,3,175
39714,2024-01-28 13:53:00,108,171,Vestuário,6,279
39715,2024-01-28 13:54:00,113,32,Eletrônico,4,145
39716,2024-01-28 13:55:00,94,30,Eletrônico,7,124
39717,2024-01-28 13:56:00,100,16,Brinquedo,8,116
39718,2024-01-28 13:57:00,52,75,Vestuário,8,127
39719,2024-01-28 13:58:00,24,63,Móvel,9,87
39720,2024-01-28 13:59:00,58,103,Alimento,2,161
39721,2024-01-28 14:00:00,48,163,Alimento,2,211
39722,2024-01-28 14:01:00,94,123,Vestuário,4,217
39723,2024-01-28 14:02:00,29,157,Alimento,1,186
39724,2024-01-28 14:03:00,37,86,Eletrônico,7,123
39725,2024-01-28 14:04:00,19,77,Brinquedo,9,96
39726,2024-01-28 14:05:00,25,97,Móvel,4,122
39727,2024-01-28 14:06:00,116,133,Móvel,4,249
39728,2024-01-28 14:07:00,118,119,Eletrônico,5,237
39729,2024-01-28 14:08:00,38,151,Brinquedo,6,189
39730,2024-01-28 14:09:00,119,67,Móvel,1,186
39731,2024-01-28 14:10:00,11,82,Móvel,2,93
39732,2024-01-28 14:11:00,100,166,Móvel,1,266
39733,2024-01-28 14:12:00,82,177,Alimento,9,259
39734,2024-01-28 14:13:00,27,119,Móvel,7,146
39735,2024-01-28 14:14:00,74,12,Alimento,2,86
39736,2024-01-28 14:15:00,46,120,Móvel,3,166
39737,2024-01-28 14:16:00,23,135,Eletrônico,6,158
39738,2024-01-28 14:17:00,55,51,Eletrônico,4,106
39739,2024-01-28 14:18:00,53,17,Vestuário,5,70
39740,2024-01-28 14:19:00,62,144,Vestuário,8,206
39741,2024-01-28 14:20:00,57,22,Eletrônico,2,79
39742,2024-01-28 14:21:00,59,90,Eletrônico,3,149
39743,2024-01-28 14:22:00,113,51,Eletrônico,7,164
39744,2024-01-28 14:23:00,90,84,Móvel,4,174
39745,2024-01-28 14:24:00,80,30,Eletrônico,8,110
39746,2024-01-28 14:25:00,55,64,Eletrônico,8,119
39747,2024-01-28 14:26:00,115,13,Brinquedo,6,128
39748,2024-01-28 14:27:00,66,49,Alimento,8,115
39749,2024-01-28 14:28:00,98,95,Eletrônico,3,193
39750,2024-01-28 14:29:00,95,178,Vestuário,4,273
39751,2024-01-28 14:30:00,32,147,Móvel,9,179
39752,2024-01-28 14:31:00,78,164,Brinquedo,6,242
39753,2024-01-28 14:32:00,76,152,Vestuário,5,228
39754,2024-01-28 14:33:00,33,122,Brinquedo,4,155
39755,2024-01-28 14:34:00,112,156,Eletrônico,8,268
39756,2024-01-28 14:35:00,72,24,Eletrônico,8,96
39757,2024-01-28 14:36:00,22,176,Alimento,6,198
39758,2024-01-28 14:37:00,28,117,Alimento,1,145
39759,2024-01-28 14:38:00,60,62,Móvel,3,122
39760,2024-01-28 14:39:00,115,175,Brinquedo,8,290
39761,2024-01-28 14:40:00,21,170,Móvel,3,191
39762,2024-01-28 14:41:00,33,51,Vestuário,4,84
39763,2024-01-28 14:42:00,51,157,Brinquedo,3,208
39764,2024-01-28 14:43:00,119,118,Brinquedo,3,237
39765,2024-01-28 14:44:00,95,78,Vestuário,8,173
39766,2024-01-28 14:45:00,94,147,Brinquedo,2,241
39767,2024-01-28 14:46:00,118,35,Alimento,8,153
39768,2024-01-28 14:47:00,92,83,Brinquedo,2,175
39769,2024-01-28 14:48:00,58,19,Brinquedo,8,77
39770,2024-01-28 14:49:00,92,71,Alimento,1,163
39771,2024-01-28 14:50:00,97,99,Móvel,9,196
39772,2024-01-28 14:51:00,38,153,Eletrônico,1,191
39773,2024-01-28 14:52:00,42,109,Vestuário,1,151
39774,2024-01-28 14:53:00,15,59,Eletrônico,9,74
39775,2024-01-28 14:54:00,97,26,Vestuário,2,123
39776,2024-01-28 14:55:00,51,82,Eletrônico,9,133
39777,2024-01-28 14:56:00,62,71,Móvel,5,133
39778,2024-01-28 14:57:00,105,71,Eletrônico,1,176
39779,2024-01-28 14:58:00,69,171,Eletrônico,6,240
39780,2024-01-28 14:59:00,76,70,Vestuário,6,146
39781,2024-01-28 15:00:00,89,116,Móvel,3,205
39782,2024-01-28 15:01:00,113,125,Alimento,1,238
39783,2024-01-28 15:02:00,38,97,Alimento,9,135
39784,2024-01-28 15:03:00,108,116,Eletrônico,7,224
39785,2024-01-28 15:04:00,89,12,Móvel,5,101
39786,2024-01-28 15:05:00,31,174,Eletrônico,1,205
39787,2024-01-28 15:06:00,35,54,Alimento,5,89
39788,2024-01-28 15:07:00,51,39,Móvel,5,90
39789,2024-01-28 15:08:00,116,118,Móvel,1,234
39790,2024-01-28 15:09:00,93,56,Móvel,5,149
39791,2024-01-28 15:10:00,67,116,Móvel,1,183
39792,2024-01-28 15:11:00,97,106,Vestuário,7,203
39793,2024-01-28 15:12:00,76,102,Eletrônico,4,178
39794,2024-01-28 15:13:00,34,171,Móvel,2,205
39795,2024-01-28 15:14:00,35,164,Alimento,4,199
39796,2024-01-28 15:15:00,101,146,Alimento,8,247
39797,2024-01-28 15:16:00,63,50,Vestuário,1,113
39798,2024-01-28 15:17:00,119,45,Móvel,9,164
39799,2024-01-28 15:18:00,77,145,Alimento,2,222
39800,2024-01-28 15:19:00,36,125,Móvel,3,161
39801,2024-01-28 15:20:00,58,17,Brinquedo,1,75
39802,2024-01-28 15:21:00,102,175,Móvel,9,277
39803,2024-01-28 15:22:00,45,85,Alimento,6,130
39804,2024-01-28 15:23:00,101,142,Vestuário,8,243
39805,2024-01-28 15:24:00,21,159,Eletrônico,2,180
39806,2024-01-28 15:25:00,56,32,Eletrônico,1,88
39807,2024-01-28 15:26:00,100,24,Brinquedo,5,124
39808,2024-01-28 15:27:00,26,94,Alimento,5,120
39809,2024-01-28 15:28:00,114,99,Alimento,6,213
39810,2024-01-28 15:29:00,101,157,Móvel,1,258
39811,2024-01-28 15:30:00,35,123,Eletrônico,4,158
39812,2024-01-28 15:31:00,43,35,Móvel,9,78
39813,2024-01-28 15:32:00,71,56,Vestuário,4,127
39814,2024-01-28 15:33:00,111,177,Móvel,6,288
39815,2024-01-28 15:34:00,15,172,Vestuário,9,187
39816,2024-01-28 15:35:00,49,95,Brinquedo,8,144
39817,2024-01-28 15:36:00,54,41,Eletrônico,6,95
39818,2024-01-28 15:37:00,20,41,Vestuário,7,61
39819,2024-01-28 15:38:00,79,87,Alimento,1,166
39820,2024-01-28 15:39:00,21,79,Eletrônico,2,100
39821,2024-01-28 15:40:00,38,31,Alimento,1,69
39822,2024-01-28 15:41:00,87,144,Vestuário,1,231
39823,2024-01-28 15:42:00,48,12,Móvel,7,60
39824,2024-01-28 15:43:00,32,49,Móvel,3,81
39825,2024-01-28 15:44:00,15,97,Móvel,3,112
39826,2024-01-28 15:45:00,40,49,Eletrônico,5,89
39827,2024-01-28 15:46:00,26,155,Brinquedo,7,181
39828,2024-01-28 15:47:00,67,143,Vestuário,9,210
39829,2024-01-28 15:48:00,85,122,Alimento,5,207
39830,2024-01-28 15:49:00,29,54,Alimento,3,83
39831,2024-01-28 15:50:00,26,162,Móvel,3,188
39832,2024-01-28 15:51:00,33,138,Vestuário,8,171
39833,2024-01-28 15:52:00,36,115,Móvel,8,151
39834,2024-01-28 15:53:00,55,136,Vestuário,9,191
39835,2024-01-28 15:54:00,15,179,Brinquedo,7,194
39836,2024-01-28 15:55:00,37,138,Eletrônico,6,175
39837,2024-01-28 15:56:00,37,54,Alimento,5,91
39838,2024-01-28 15:57:00,100,13,Alimento,4,113
39839,2024-01-28 15:58:00,93,59,Alimento,8,152
39840,2024-01-28 15:59:00,82,63,Vestuário,4,145
39841,2024-01-28 16:00:00,12,96,Vestuário,3,108
39842,2024-01-28 16:01:00,29,128,Móvel,9,157
39843,2024-01-28 16:02:00,30,29,Vestuário,2,59
39844,2024-01-28 16:03:00,84,105,Alimento,1,189
39845,2024-01-28 16:04:00,40,32,Eletrônico,2,72
39846,2024-01-28 16:05:00,50,68,Móvel,4,118
39847,2024-01-28 16:06:00,89,147,Brinquedo,1,236
39848,2024-01-28 16:07:00,10,72,Móvel,7,82
39849,2024-01-28 16:08:00,57,17,Vestuário,6,74
39850,2024-01-28 16:09:00,92,19,Alimento,9,111
39851,2024-01-28 16:10:00,76,114,Brinquedo,9,190
39852,2024-01-28 16:11:00,41,158,Alimento,5,199
39853,2024-01-28 16:12:00,23,138,Brinquedo,7,161
39854,2024-01-28 16:13:00,111,91,Móvel,7,202
39855,2024-01-28 16:14:00,75,165,Vestuário,2,240
39856,2024-01-28 16:15:00,99,63,Eletrônico,5,162
39857,2024-01-28 16:16:00,49,124,Eletrônico,1,173
39858,2024-01-28 16:17:00,31,97,Vestuário,9,128
39859,2024-01-28 16:18:00,108,41,Alimento,6,149
39860,2024-01-28 16:19:00,104,80,Brinquedo,9,184
39861,2024-01-28 16:20:00,66,91,Móvel,5,157
39862,2024-01-28 16:21:00,71,138,Vestuário,5,209
39863,2024-01-28 16:22:00,75,15,Brinquedo,5,90
39864,2024-01-28 16:23:00,55,96,Eletrônico,3,151
39865,2024-01-28 16:24:00,105,62,Vestuário,7,167
39866,2024-01-28 16:25:00,109,150,Vestuário,7,259
39867,2024-01-28 16:26:00,73,94,Alimento,1,167
39868,2024-01-28 16:27:00,20,36,Eletrônico,5,56
39869,2024-01-28 16:28:00,90,111,Alimento,7,201
39870,2024-01-28 16:29:00,28,179,Alimento,8,207
39871,2024-01-28 16:30:00,49,127,Móvel,2,176
39872,2024-01-28 16:31:00,99,137,Móvel,4,236
39873,2024-01-28 16:32:00,72,80,Eletrônico,1,152
39874,2024-01-28 16:33:00,24,175,Eletrônico,6,199
39875,2024-01-28 16:34:00,109,71,Brinquedo,6,180
39876,2024-01-28 16:35:00,43,108,Alimento,8,151
39877,2024-01-28 16:36:00,103,86,Eletrônico,5,189
39878,2024-01-28 16:37:00,70,133,Móvel,5,203
39879,2024-01-28 16:38:00,107,157,Eletrônico,2,264
39880,2024-01-28 16:39:00,103,138,Vestuário,2,241
39881,2024-01-28 16:40:00,38,93,Móvel,3,131
39882,2024-01-28 16:41:00,15,55,Eletrônico,9,70
39883,2024-01-28 16:42:00,12,117,Alimento,9,129
39884,2024-01-28 16:43:00,65,68,Móvel,9,133
39885,2024-01-28 16:44:00,99,112,Brinquedo,5,211
39886,2024-01-28 16:45:00,20,17,Eletrônico,7,37
39887,2024-01-28 16:46:00,93,116,Móvel,7,209
39888,2024-01-28 16:47:00,65,138,Alimento,3,203
39889,2024-01-28 16:48:00,119,72,Vestuário,9,191
39890,2024-01-28 16:49:00,66,12,Vestuário,2,78
39891,2024-01-28 16:50:00,90,134,Vestuário,2,224
39892,2024-01-28 16:51:00,82,21,Vestuário,3,103
39893,2024-01-28 16:52:00,59,133,Alimento,9,192
39894,2024-01-28 16:53:00,47,49,Móvel,9,96
39895,2024-01-28 16:54:00,95,79,Vestuário,2,174
39896,2024-01-28 16:55:00,105,165,Vestuário,6,270
39897,2024-01-28 16:56:00,53,156,Alimento,2,209
39898,2024-01-28 16:57:00,55,19,Vestuário,2,74
39899,2024-01-28 16:58:00,99,31,Eletrônico,9,130
39900,2024-01-28 16:59:00,18,108,Vestuário,2,126
39901,2024-01-28 17:00:00,102,168,Brinquedo,9,270
39902,2024-01-28 17:01:00,44,134,Eletrônico,1,178
39903,2024-01-28 17:02:00,88,98,Vestuário,3,186
39904,2024-01-28 17:03:00,24,37,Móvel,8,61
39905,2024-01-28 17:04:00,102,101,Móvel,2,203
39906,2024-01-28 17:05:00,65,102,Brinquedo,7,167
39907,2024-01-28 17:06:00,10,159,Alimento,5,169
39908,2024-01-28 17:07:00,52,158,Móvel,8,210
39909,2024-01-28 17:08:00,107,20,Eletrônico,3,127
39910,2024-01-28 17:09:00,72,140,Móvel,7,212
39911,2024-01-28 17:10:00,102,70,Alimento,1,172
39912,2024-01-28 17:11:00,44,137,Vestuário,4,181
39913,2024-01-28 17:12:00,99,102,Móvel,9,201
39914,2024-01-28 17:13:00,66,102,Vestuário,8,168
39915,2024-01-28 17:14:00,16,130,Vestuário,3,146
39916,2024-01-28 17:15:00,14,47,Eletrônico,6,61
39917,2024-01-28 17:16:00,113,101,Eletrônico,6,214
39918,2024-01-28 17:17:00,81,121,Eletrônico,5,202
39919,2024-01-28 17:18:00,114,52,Brinquedo,1,166
39920,2024-01-28 17:19:00,50,102,Vestuário,4,152
39921,2024-01-28 17:20:00,43,76,Brinquedo,7,119
39922,2024-01-28 17:21:00,100,79,Brinquedo,2,179
39923,2024-01-28 17:22:00,25,165,Vestuário,9,190
39924,2024-01-28 17:23:00,41,124,Vestuário,7,165
39925,2024-01-28 17:24:00,36,137,Vestuário,4,173
39926,2024-01-28 17:25:00,19,72,Eletrônico,8,91
39927,2024-01-28 17:26:00,35,162,Eletrônico,6,197
39928,2024-01-28 17:27:00,28,151,Vestuário,3,179
39929,2024-01-28 17:28:00,67,168,Brinquedo,1,235
39930,2024-01-28 17:29:00,33,40,Vestuário,6,73
39931,2024-01-28 17:30:00,19,67,Móvel,4,86
39932,2024-01-28 17:31:00,66,98,Vestuário,6,164
39933,2024-01-28 17:32:00,99,32,Brinquedo,1,131
39934,2024-01-28 17:33:00,68,146,Alimento,9,214
39935,2024-01-28 17:34:00,78,89,Eletrônico,3,167
39936,2024-01-28 17:35:00,97,74,Brinquedo,6,171
39937,2024-01-28 17:36:00,90,144,Vestuário,3,234
39938,2024-01-28 17:37:00,39,159,Alimento,6,198
39939,2024-01-28 17:38:00,57,100,Alimento,2,157
39940,2024-01-28 17:39:00,75,155,Móvel,3,230
39941,2024-01-28 17:40:00,63,56,Brinquedo,5,119
39942,2024-01-28 17:41:00,117,26,Eletrônico,8,143
39943,2024-01-28 17:42:00,23,99,Vestuário,1,122
39944,2024-01-28 17:43:00,19,165,Vestuário,4,184
39945,2024-01-28 17:44:00,26,18,Móvel,9,44
39946,2024-01-28 17:45:00,48,107,Móvel,8,155
39947,2024-01-28 17:46:00,30,117,Vestuário,5,147
39948,2024-01-28 17:47:00,13,38,Eletrônico,3,51
39949,2024-01-28 17:48:00,11,67,Brinquedo,4,78
39950,2024-01-28 17:49:00,93,162,Alimento,7,255
39951,2024-01-28 17:50:00,18,83,Vestuário,1,101
39952,2024-01-28 17:51:00,111,37,Brinquedo,9,148
39953,2024-01-28 17:52:00,24,85,Eletrônico,8,109
39954,2024-01-28 17:53:00,87,122,Móvel,6,209
39955,2024-01-28 17:54:00,77,67,Eletrônico,7,144
39956,2024-01-28 17:55:00,115,146,Móvel,1,261
39957,2024-01-28 17:56:00,67,143,Eletrônico,9,210
39958,2024-01-28 17:57:00,84,165,Móvel,9,249
39959,2024-01-28 17:58:00,96,175,Vestuário,8,271
39960,2024-01-28 17:59:00,38,79,Alimento,9,117
39961,2024-01-28 18:00:00,47,173,Eletrônico,8,220
39962,2024-01-28 18:01:00,55,170,Móvel,7,225
39963,2024-01-28 18:02:00,45,179,Vestuário,3,224
39964,2024-01-28 18:03:00,32,19,Móvel,6,51
39965,2024-01-28 18:04:00,111,171,Alimento,1,282
39966,2024-01-28 18:05:00,64,166,Eletrônico,4,230
39967,2024-01-28 18:06:00,64,166,Vestuário,4,230
39968,2024-01-28 18:07:00,109,100,Alimento,4,209
39969,2024-01-28 18:08:00,93,10,Brinquedo,1,103
39970,2024-01-28 18:09:00,58,107,Móvel,5,165
39971,2024-01-28 18:10:00,27,133,Móvel,3,160
39972,2024-01-28 18:11:00,31,39,Eletrônico,4,70
39973,2024-01-28 18:12:00,51,80,Alimento,4,131
39974,2024-01-28 18:13:00,47,162,Alimento,1,209
39975,2024-01-28 18:14:00,58,44,Eletrônico,4,102
39976,2024-01-28 18:15:00,103,167,Brinquedo,6,270
39977,2024-01-28 18:16:00,11,101,Brinquedo,9,112
39978,2024-01-28 18:17:00,79,12,Móvel,8,91
39979,2024-01-28 18:18:00,39,114,Móvel,5,153
39980,2024-01-28 18:19:00,17,18,Eletrônico,6,35
39981,2024-01-28 18:20:00,116,165,Móvel,2,281
39982,2024-01-28 18:21:00,96,11,Alimento,4,107
39983,2024-01-28 18:22:00,106,14,Móvel,2,120
39984,2024-01-28 18:23:00,101,114,Eletrônico,4,215
39985,2024-01-28 18:24:00,33,54,Alimento,8,87
39986,2024-01-28 18:25:00,61,11,Eletrônico,2,72
39987,2024-01-28 18:26:00,46,40,Eletrônico,2,86
39988,2024-01-28 18:27:00,104,83,Alimento,5,187
39989,2024-01-28 18:28:00,53,69,Eletrônico,7,122
39990,2024-01-28 18:29:00,37,123,Eletrônico,6,160
39991,2024-01-28 18:30:00,59,113,Eletrônico,1,172
39992,2024-01-28 18:31:00,50,113,Alimento,3,163
39993,2024-01-28 18:32:00,20,97,Alimento,9,117
39994,2024-01-28 18:33:00,24,152,Alimento,9,176
39995,2024-01-28 18:34:00,68,12,Eletrônico,6,80
39996,2024-01-28 18:35:00,74,165,Eletrônico,8,239
39997,2024-01-28 18:36:00,67,80,Eletrônico,3,147
39998,2024-01-28 18:37:00,28,91,Brinquedo,9,119
39999,2024-01-28 18:38:00,37,50,Vestuário,6,87
40000,2024-01-28 18:39:00,29,91,Móvel,5,120
40001,2024-01-28 18:40:00,112,84,Brinquedo,2,196
40002,2024-01-28 18:41:00,48,41,Alimento,9,89
40003,2024-01-28 18:42:00,81,63,Eletrônico,4,144
40004,2024-01-28 18:43:00,43,127,Alimento,2,170
40005,2024-01-28 18:44:00,96,169,Vestuário,2,265
40006,2024-01-28 18:45:00,44,103,Brinquedo,7,147
40007,2024-01-28 18:46:00,55,72,Brinquedo,1,127
40008,2024-01-28 18:47:00,78,59,Alimento,5,137
40009,2024-01-28 18:48:00,50,68,Brinquedo,8,118
40010,2024-01-28 18:49:00,39,141,Brinquedo,4,180
40011,2024-01-28 18:50:00,100,128,Eletrônico,1,228
40012,2024-01-28 18:51:00,10,158,Móvel,8,168
40013,2024-01-28 18:52:00,90,150,Brinquedo,4,240
40014,2024-01-28 18:53:00,45,80,Móvel,6,125
40015,2024-01-28 18:54:00,75,90,Vestuário,8,165
40016,2024-01-28 18:55:00,35,23,Alimento,4,58
40017,2024-01-28 18:56:00,40,33,Móvel,1,73
40018,2024-01-28 18:57:00,26,95,Móvel,9,121
40019,2024-01-28 18:58:00,99,57,Alimento,4,156
40020,2024-01-28 18:59:00,34,32,Eletrônico,9,66
40021,2024-01-28 19:00:00,102,67,Alimento,8,169
40022,2024-01-28 19:01:00,38,47,Vestuário,9,85
40023,2024-01-28 19:02:00,106,100,Vestuário,9,206
40024,2024-01-28 19:03:00,103,130,Vestuário,8,233
40025,2024-01-28 19:04:00,86,173,Brinquedo,3,259
40026,2024-01-28 19:05:00,108,18,Brinquedo,2,126
40027,2024-01-28 19:06:00,19,144,Alimento,9,163
40028,2024-01-28 19:07:00,63,137,Móvel,5,200
40029,2024-01-28 19:08:00,113,131,Brinquedo,2,244
40030,2024-01-28 19:09:00,63,73,Brinquedo,2,136
40031,2024-01-28 19:10:00,92,46,Eletrônico,4,138
40032,2024-01-28 19:11:00,73,158,Vestuário,8,231
40033,2024-01-28 19:12:00,65,92,Vestuário,7,157
40034,2024-01-28 19:13:00,91,100,Brinquedo,7,191
40035,2024-01-28 19:14:00,18,175,Vestuário,6,193
40036,2024-01-28 19:15:00,45,22,Alimento,1,67
40037,2024-01-28 19:16:00,16,80,Eletrônico,4,96
40038,2024-01-28 19:17:00,35,149,Alimento,1,184
40039,2024-01-28 19:18:00,85,161,Eletrônico,9,246
40040,2024-01-28 19:19:00,56,13,Móvel,3,69
40041,2024-01-28 19:20:00,112,103,Alimento,9,215
40042,2024-01-28 19:21:00,37,135,Móvel,7,172
40043,2024-01-28 19:22:00,26,22,Vestuário,9,48
40044,2024-01-28 19:23:00,111,62,Eletrônico,1,173
40045,2024-01-28 19:24:00,69,19,Móvel,3,88
40046,2024-01-28 19:25:00,41,41,Alimento,4,82
40047,2024-01-28 19:26:00,99,33,Vestuário,7,132
40048,2024-01-28 19:27:00,114,176,Alimento,3,290
40049,2024-01-28 19:28:00,99,107,Vestuário,7,206
40050,2024-01-28 19:29:00,79,145,Eletrônico,7,224
40051,2024-01-28 19:30:00,27,54,Alimento,7,81
40052,2024-01-28 19:31:00,105,145,Vestuário,4,250
40053,2024-01-28 19:32:00,108,56,Brinquedo,5,164
40054,2024-01-28 19:33:00,76,134,Vestuário,5,210
40055,2024-01-28 19:34:00,81,101,Vestuário,1,182
40056,2024-01-28 19:35:00,38,140,Vestuário,4,178
40057,2024-01-28 19:36:00,77,138,Eletrônico,9,215
40058,2024-01-28 19:37:00,66,158,Móvel,2,224
40059,2024-01-28 19:38:00,110,164,Brinquedo,3,274
40060,2024-01-28 19:39:00,53,107,Alimento,8,160
40061,2024-01-28 19:40:00,90,80,Brinquedo,5,170
40062,2024-01-28 19:41:00,32,85,Alimento,5,117
40063,2024-01-28 19:42:00,12,55,Alimento,5,67
40064,2024-01-28 19:43:00,44,159,Vestuário,5,203
40065,2024-01-28 19:44:00,50,113,Brinquedo,6,163
40066,2024-01-28 19:45:00,103,10,Brinquedo,1,113
40067,2024-01-28 19:46:00,77,56,Alimento,3,133
40068,2024-01-28 19:47:00,12,76,Móvel,9,88
40069,2024-01-28 19:48:00,105,78,Móvel,8,183
40070,2024-01-28 19:49:00,28,107,Brinquedo,6,135
40071,2024-01-28 19:50:00,17,141,Alimento,6,158
40072,2024-01-28 19:51:00,11,128,Brinquedo,6,139
40073,2024-01-28 19:52:00,18,145,Alimento,9,163
40074,2024-01-28 19:53:00,19,116,Móvel,8,135
40075,2024-01-28 19:54:00,79,99,Brinquedo,8,178
40076,2024-01-28 19:55:00,110,41,Brinquedo,3,151
40077,2024-01-28 19:56:00,17,116,Eletrônico,4,133
40078,2024-01-28 19:57:00,29,176,Alimento,7,205
40079,2024-01-28 19:58:00,14,144,Vestuário,5,158
40080,2024-01-28 19:59:00,42,141,Alimento,7,183
40081,2024-01-28 20:00:00,33,153,Eletrônico,8,186
40082,2024-01-28 20:01:00,98,95,Eletrônico,6,193
40083,2024-01-28 20:02:00,91,121,Brinquedo,5,212
40084,2024-01-28 20:03:00,109,145,Móvel,6,254
40085,2024-01-28 20:04:00,74,103,Móvel,4,177
40086,2024-01-28 20:05:00,35,122,Brinquedo,7,157
40087,2024-01-28 20:06:00,20,164,Alimento,5,184
40088,2024-01-28 20:07:00,15,131,Alimento,1,146
40089,2024-01-28 20:08:00,90,151,Brinquedo,1,241
40090,2024-01-28 20:09:00,13,117,Eletrônico,5,130
40091,2024-01-28 20:10:00,67,84,Eletrônico,3,151
40092,2024-01-28 20:11:00,35,105,Vestuário,8,140
40093,2024-01-28 20:12:00,117,150,Vestuário,2,267
40094,2024-01-28 20:13:00,61,103,Móvel,9,164
40095,2024-01-28 20:14:00,20,130,Eletrônico,8,150
40096,2024-01-28 20:15:00,18,99,Eletrônico,4,117
40097,2024-01-28 20:16:00,45,55,Brinquedo,7,100
40098,2024-01-28 20:17:00,77,54,Vestuário,9,131
40099,2024-01-28 20:18:00,59,143,Móvel,3,202
40100,2024-01-28 20:19:00,22,53,Brinquedo,8,75
40101,2024-01-28 20:20:00,58,154,Alimento,5,212
40102,2024-01-28 20:21:00,20,37,Móvel,7,57
40103,2024-01-28 20:22:00,89,129,Alimento,7,218
40104,2024-01-28 20:23:00,25,97,Eletrônico,2,122
40105,2024-01-28 20:24:00,64,155,Alimento,7,219
40106,2024-01-28 20:25:00,106,51,Eletrônico,8,157
40107,2024-01-28 20:26:00,87,78,Eletrônico,9,165
40108,2024-01-28 20:27:00,83,135,Brinquedo,2,218
40109,2024-01-28 20:28:00,75,165,Brinquedo,2,240
40110,2024-01-28 20:29:00,87,52,Alimento,7,139
40111,2024-01-28 20:30:00,107,83,Móvel,9,190
40112,2024-01-28 20:31:00,18,161,Brinquedo,4,179
40113,2024-01-28 20:32:00,112,40,Vestuário,9,152
40114,2024-01-28 20:33:00,69,40,Móvel,7,109
40115,2024-01-28 20:34:00,18,32,Móvel,1,50
40116,2024-01-28 20:35:00,40,13,Vestuário,6,53
40117,2024-01-28 20:36:00,110,146,Vestuário,3,256
40118,2024-01-28 20:37:00,94,97,Alimento,2,191
40119,2024-01-28 20:38:00,55,46,Alimento,5,101
40120,2024-01-28 20:39:00,25,40,Eletrônico,5,65
40121,2024-01-28 20:40:00,39,173,Alimento,8,212
40122,2024-01-28 20:41:00,71,44,Eletrônico,5,115
40123,2024-01-28 20:42:00,61,148,Eletrônico,6,209
40124,2024-01-28 20:43:00,15,52,Móvel,4,67
40125,2024-01-28 20:44:00,99,65,Eletrônico,9,164
40126,2024-01-28 20:45:00,46,71,Alimento,9,117
40127,2024-01-28 20:46:00,116,119,Alimento,6,235
40128,2024-01-28 20:47:00,117,62,Vestuário,3,179
40129,2024-01-28 20:48:00,51,90,Vestuário,5,141
40130,2024-01-28 20:49:00,32,114,Eletrônico,1,146
40131,2024-01-28 20:50:00,13,48,Vestuário,4,61
40132,2024-01-28 20:51:00,16,47,Brinquedo,7,63
40133,2024-01-28 20:52:00,21,111,Vestuário,7,132
40134,2024-01-28 20:53:00,105,62,Móvel,6,167
40135,2024-01-28 20:54:00,85,160,Brinquedo,6,245
40136,2024-01-28 20:55:00,109,97,Brinquedo,5,206
40137,2024-01-28 20:56:00,45,160,Eletrônico,3,205
40138,2024-01-28 20:57:00,73,29,Brinquedo,1,102
40139,2024-01-28 20:58:00,44,141,Vestuário,1,185
40140,2024-01-28 20:59:00,81,100,Vestuário,4,181
40141,2024-01-28 21:00:00,77,77,Eletrônico,5,154
40142,2024-01-28 21:01:00,43,116,Vestuário,1,159
40143,2024-01-28 21:02:00,64,73,Vestuário,4,137
40144,2024-01-28 21:03:00,39,154,Vestuário,6,193
40145,2024-01-28 21:04:00,67,141,Vestuário,1,208
40146,2024-01-28 21:05:00,111,91,Móvel,3,202
40147,2024-01-28 21:06:00,116,163,Eletrônico,2,279
40148,2024-01-28 21:07:00,43,18,Alimento,9,61
40149,2024-01-28 21:08:00,38,118,Alimento,2,156
40150,2024-01-28 21:09:00,19,59,Móvel,8,78
40151,2024-01-28 21:10:00,80,144,Móvel,1,224
40152,2024-01-28 21:11:00,45,42,Alimento,7,87
40153,2024-01-28 21:12:00,57,98,Brinquedo,6,155
40154,2024-01-28 21:13:00,57,32,Vestuário,1,89
40155,2024-01-28 21:14:00,91,56,Eletrônico,4,147
40156,2024-01-28 21:15:00,23,63,Vestuário,3,86
40157,2024-01-28 21:16:00,113,103,Vestuário,7,216
40158,2024-01-28 21:17:00,12,113,Brinquedo,8,125
40159,2024-01-28 21:18:00,99,43,Eletrônico,2,142
40160,2024-01-28 21:19:00,28,153,Brinquedo,1,181
40161,2024-01-28 21:20:00,46,95,Brinquedo,4,141
40162,2024-01-28 21:21:00,13,171,Brinquedo,9,184
40163,2024-01-28 21:22:00,64,73,Eletrônico,8,137
40164,2024-01-28 21:23:00,81,76,Brinquedo,7,157
40165,2024-01-28 21:24:00,30,52,Eletrônico,1,82
40166,2024-01-28 21:25:00,52,80,Alimento,8,132
40167,2024-01-28 21:26:00,91,151,Brinquedo,8,242
40168,2024-01-28 21:27:00,107,27,Vestuário,2,134
40169,2024-01-28 21:28:00,22,117,Vestuário,8,139
40170,2024-01-28 21:29:00,42,122,Vestuário,5,164
40171,2024-01-28 21:30:00,42,41,Brinquedo,8,83
40172,2024-01-28 21:31:00,16,20,Eletrônico,1,36
40173,2024-01-28 21:32:00,16,163,Vestuário,7,179
40174,2024-01-28 21:33:00,82,142,Eletrônico,9,224
40175,2024-01-28 21:34:00,66,134,Vestuário,9,200
40176,2024-01-28 21:35:00,117,163,Móvel,2,280
40177,2024-01-28 21:36:00,67,29,Eletrônico,8,96
40178,2024-01-28 21:37:00,32,91,Eletrônico,5,123
40179,2024-01-28 21:38:00,45,12,Brinquedo,6,57
40180,2024-01-28 21:39:00,15,153,Brinquedo,5,168
40181,2024-01-28 21:40:00,108,87,Alimento,5,195
40182,2024-01-28 21:41:00,22,114,Brinquedo,7,136
40183,2024-01-28 21:42:00,81,133,Eletrônico,2,214
40184,2024-01-28 21:43:00,117,120,Vestuário,5,237
40185,2024-01-28 21:44:00,104,78,Brinquedo,8,182
40186,2024-01-28 21:45:00,10,70,Alimento,4,80
40187,2024-01-28 21:46:00,10,41,Eletrônico,6,51
40188,2024-01-28 21:47:00,32,104,Brinquedo,5,136
40189,2024-01-28 21:48:00,15,25,Móvel,1,40
40190,2024-01-28 21:49:00,83,117,Eletrônico,7,200
40191,2024-01-28 21:50:00,49,179,Móvel,4,228
40192,2024-01-28 21:51:00,116,130,Alimento,5,246
40193,2024-01-28 21:52:00,37,41,Vestuário,4,78
40194,2024-01-28 21:53:00,96,132,Alimento,4,228
40195,2024-01-28 21:54:00,96,15,Eletrônico,2,111
40196,2024-01-28 21:55:00,56,35,Vestuário,3,91
40197,2024-01-28 21:56:00,37,81,Alimento,7,118
40198,2024-01-28 21:57:00,32,154,Brinquedo,1,186
40199,2024-01-28 21:58:00,93,111,Alimento,5,204
40200,2024-01-28 21:59:00,65,131,Brinquedo,4,196
40201,2024-01-28 22:00:00,46,104,Móvel,2,150
40202,2024-01-28 22:01:00,47,74,Vestuário,3,121
40203,2024-01-28 22:02:00,68,20,Eletrônico,2,88
40204,2024-01-28 22:03:00,61,105,Móvel,9,166
40205,2024-01-28 22:04:00,89,111,Vestuário,2,200
40206,2024-01-28 22:05:00,109,96,Brinquedo,6,205
40207,2024-01-28 22:06:00,31,153,Brinquedo,2,184
40208,2024-01-28 22:07:00,20,156,Móvel,5,176
40209,2024-01-28 22:08:00,21,99,Brinquedo,2,120
40210,2024-01-28 22:09:00,55,92,Vestuário,3,147
40211,2024-01-28 22:10:00,95,175,Eletrônico,5,270
40212,2024-01-28 22:11:00,76,110,Brinquedo,3,186
40213,2024-01-28 22:12:00,63,60,Móvel,8,123
40214,2024-01-28 22:13:00,60,167,Vestuário,4,227
40215,2024-01-28 22:14:00,43,18,Móvel,6,61
40216,2024-01-28 22:15:00,115,91,Brinquedo,4,206
40217,2024-01-28 22:16:00,119,70,Eletrônico,4,189
40218,2024-01-28 22:17:00,116,62,Móvel,2,178
40219,2024-01-28 22:18:00,44,165,Eletrônico,4,209
40220,2024-01-28 22:19:00,117,16,Brinquedo,5,133
40221,2024-01-28 22:20:00,79,34,Vestuário,7,113
40222,2024-01-28 22:21:00,94,59,Vestuário,7,153
40223,2024-01-28 22:22:00,59,124,Vestuário,4,183
40224,2024-01-28 22:23:00,88,174,Eletrônico,8,262
40225,2024-01-28 22:24:00,12,116,Vestuário,3,128
40226,2024-01-28 22:25:00,74,116,Móvel,5,190
40227,2024-01-28 22:26:00,69,21,Eletrônico,5,90
40228,2024-01-28 22:27:00,37,112,Brinquedo,7,149
40229,2024-01-28 22:28:00,54,150,Eletrônico,4,204
40230,2024-01-28 22:29:00,28,113,Vestuário,5,141
40231,2024-01-28 22:30:00,92,61,Brinquedo,2,153
40232,2024-01-28 22:31:00,89,107,Brinquedo,6,196
40233,2024-01-28 22:32:00,24,15,Brinquedo,6,39
40234,2024-01-28 22:33:00,100,173,Móvel,2,273
40235,2024-01-28 22:34:00,37,131,Brinquedo,6,168
40236,2024-01-28 22:35:00,92,43,Móvel,5,135
40237,2024-01-28 22:36:00,48,78,Brinquedo,9,126
40238,2024-01-28 22:37:00,94,106,Brinquedo,2,200
40239,2024-01-28 22:38:00,100,70,Brinquedo,6,170
40240,2024-01-28 22:39:00,15,137,Alimento,9,152
40241,2024-01-28 22:40:00,71,13,Móvel,4,84
40242,2024-01-28 22:41:00,98,132,Vestuário,6,230
40243,2024-01-28 22:42:00,25,117,Vestuário,3,142
40244,2024-01-28 22:43:00,100,93,Vestuário,2,193
40245,2024-01-28 22:44:00,64,33,Eletrônico,7,97
40246,2024-01-28 22:45:00,66,77,Brinquedo,2,143
40247,2024-01-28 22:46:00,98,93,Alimento,2,191
40248,2024-01-28 22:47:00,94,33,Alimento,3,127
40249,2024-01-28 22:48:00,38,47,Brinquedo,3,85
40250,2024-01-28 22:49:00,13,39,Vestuário,1,52
40251,2024-01-28 22:50:00,87,136,Eletrônico,5,223
40252,2024-01-28 22:51:00,98,35,Brinquedo,9,133
40253,2024-01-28 22:52:00,78,177,Vestuário,7,255
40254,2024-01-28 22:53:00,80,35,Móvel,9,115
40255,2024-01-28 22:54:00,47,64,Eletrônico,1,111
40256,2024-01-28 22:55:00,15,111,Brinquedo,8,126
40257,2024-01-28 22:56:00,101,126,Eletrônico,8,227
40258,2024-01-28 22:57:00,86,66,Eletrônico,2,152
40259,2024-01-28 22:58:00,99,91,Alimento,6,190
40260,2024-01-28 22:59:00,118,128,Móvel,8,246
40261,2024-01-28 23:00:00,40,152,Brinquedo,6,192
40262,2024-01-28 23:01:00,49,61,Vestuário,1,110
40263,2024-01-28 23:02:00,39,31,Vestuário,6,70
40264,2024-01-28 23:03:00,86,10,Vestuário,2,96
40265,2024-01-28 23:04:00,85,21,Eletrônico,8,106
40266,2024-01-28 23:05:00,89,97,Vestuário,8,186
40267,2024-01-28 23:06:00,61,78,Eletrônico,9,139
40268,2024-01-28 23:07:00,99,83,Eletrônico,5,182
40269,2024-01-28 23:08:00,110,26,Vestuário,1,136
40270,2024-01-28 23:09:00,76,156,Brinquedo,8,232
40271,2024-01-28 23:10:00,82,161,Eletrônico,4,243
40272,2024-01-28 23:11:00,57,150,Eletrônico,4,207
40273,2024-01-28 23:12:00,118,65,Brinquedo,2,183
40274,2024-01-28 23:13:00,89,69,Brinquedo,6,158
40275,2024-01-28 23:14:00,21,150,Brinquedo,1,171
40276,2024-01-28 23:15:00,101,99,Móvel,6,200
40277,2024-01-28 23:16:00,88,51,Brinquedo,6,139
40278,2024-01-28 23:17:00,101,46,Móvel,5,147
40279,2024-01-28 23:18:00,117,69,Vestuário,9,186
40280,2024-01-28 23:19:00,43,70,Eletrônico,9,113
40281,2024-01-28 23:20:00,30,30,Vestuário,7,60
40282,2024-01-28 23:21:00,72,46,Brinquedo,6,118
40283,2024-01-28 23:22:00,15,77,Móvel,1,92
40284,2024-01-28 23:23:00,113,93,Brinquedo,3,206
40285,2024-01-28 23:24:00,90,120,Móvel,6,210
40286,2024-01-28 23:25:00,66,21,Alimento,8,87
40287,2024-01-28 23:26:00,44,78,Eletrônico,2,122
40288,2024-01-28 23:27:00,75,27,Móvel,9,102
40289,2024-01-28 23:28:00,14,146,Brinquedo,7,160
40290,2024-01-28 23:29:00,28,10,Brinquedo,6,38
40291,2024-01-28 23:30:00,80,38,Móvel,8,118
40292,2024-01-28 23:31:00,91,147,Eletrônico,8,238
40293,2024-01-28 23:32:00,97,142,Eletrônico,5,239
40294,2024-01-28 23:33:00,88,36,Eletrônico,6,124
40295,2024-01-28 23:34:00,67,146,Vestuário,5,213
40296,2024-01-28 23:35:00,16,149,Brinquedo,9,165
40297,2024-01-28 23:36:00,101,27,Móvel,6,128
40298,2024-01-28 23:37:00,56,49,Alimento,5,105
40299,2024-01-28 23:38:00,25,155,Eletrônico,8,180
40300,2024-01-28 23:39:00,57,19,Móvel,7,76
40301,2024-01-28 23:40:00,32,147,Vestuário,1,179
40302,2024-01-28 23:41:00,36,50,Brinquedo,1,86
40303,2024-01-28 23:42:00,38,95,Vestuário,3,133
40304,2024-01-28 23:43:00,70,66,Vestuário,6,136
40305,2024-01-28 23:44:00,58,50,Brinquedo,4,108
40306,2024-01-28 23:45:00,95,96,Vestuário,9,191
40307,2024-01-28 23:46:00,72,140,Alimento,7,212
40308,2024-01-28 23:47:00,67,77,Alimento,3,144
40309,2024-01-28 23:48:00,79,139,Eletrônico,4,218
40310,2024-01-28 23:49:00,70,93,Móvel,8,163
40311,2024-01-28 23:50:00,20,120,Eletrônico,7,140
40312,2024-01-28 23:51:00,62,150,Alimento,8,212
40313,2024-01-28 23:52:00,90,46,Brinquedo,7,136
40314,2024-01-28 23:53:00,71,67,Eletrônico,5,138
40315,2024-01-28 23:54:00,78,134,Vestuário,2,212
40316,2024-01-28 23:55:00,45,66,Brinquedo,7,111
40317,2024-01-28 23:56:00,68,20,Móvel,2,88
40318,2024-01-28 23:57:00,35,166,Eletrônico,7,201
40319,2024-01-28 23:58:00,33,10,Alimento,7,43
40320,2024-01-28 23:59:00,59,101,Vestuário,4,160
40321,2024-01-29 00:00:00,104,87,Alimento,9,191
40322,2024-01-29 00:01:00,67,118,Vestuário,1,185
40323,2024-01-29 00:02:00,103,73,Alimento,3,176
40324,2024-01-29 00:03:00,53,71,Alimento,6,124
40325,2024-01-29 00:04:00,80,104,Móvel,5,184
40326,2024-01-29 00:05:00,68,82,Alimento,3,150
40327,2024-01-29 00:06:00,21,114,Móvel,5,135
40328,2024-01-29 00:07:00,14,162,Vestuário,1,176
40329,2024-01-29 00:08:00,11,106,Eletrônico,8,117
40330,2024-01-29 00:09:00,38,77,Vestuário,8,115
40331,2024-01-29 00:10:00,62,106,Alimento,2,168
40332,2024-01-29 00:11:00,25,84,Móvel,8,109
40333,2024-01-29 00:12:00,89,121,Eletrônico,3,210
40334,2024-01-29 00:13:00,88,59,Brinquedo,1,147
40335,2024-01-29 00:14:00,96,147,Brinquedo,2,243
40336,2024-01-29 00:15:00,36,155,Vestuário,5,191
40337,2024-01-29 00:16:00,29,176,Móvel,4,205
40338,2024-01-29 00:17:00,102,66,Móvel,7,168
40339,2024-01-29 00:18:00,107,40,Vestuário,4,147
40340,2024-01-29 00:19:00,75,152,Brinquedo,6,227
40341,2024-01-29 00:20:00,89,91,Vestuário,7,180
40342,2024-01-29 00:21:00,80,112,Eletrônico,5,192
40343,2024-01-29 00:22:00,35,51,Brinquedo,7,86
40344,2024-01-29 00:23:00,45,54,Brinquedo,1,99
40345,2024-01-29 00:24:00,77,108,Vestuário,8,185
40346,2024-01-29 00:25:00,62,140,Eletrônico,4,202
40347,2024-01-29 00:26:00,100,175,Vestuário,7,275
40348,2024-01-29 00:27:00,32,159,Vestuário,8,191
40349,2024-01-29 00:28:00,25,18,Móvel,1,43
40350,2024-01-29 00:29:00,77,141,Móvel,7,218
40351,2024-01-29 00:30:00,84,49,Brinquedo,8,133
40352,2024-01-29 00:31:00,68,171,Alimento,2,239
40353,2024-01-29 00:32:00,37,177,Vestuário,6,214
40354,2024-01-29 00:33:00,37,105,Eletrônico,4,142
40355,2024-01-29 00:34:00,63,142,Brinquedo,1,205
40356,2024-01-29 00:35:00,10,76,Móvel,7,86
40357,2024-01-29 00:36:00,71,16,Vestuário,7,87
40358,2024-01-29 00:37:00,100,39,Brinquedo,9,139
40359,2024-01-29 00:38:00,82,150,Alimento,5,232
40360,2024-01-29 00:39:00,44,172,Brinquedo,2,216
40361,2024-01-29 00:40:00,59,120,Eletrônico,5,179
40362,2024-01-29 00:41:00,57,54,Alimento,6,111
40363,2024-01-29 00:42:00,109,88,Vestuário,5,197
40364,2024-01-29 00:43:00,25,51,Vestuário,4,76
40365,2024-01-29 00:44:00,69,175,Vestuário,6,244
40366,2024-01-29 00:45:00,116,155,Brinquedo,9,271
40367,2024-01-29 00:46:00,104,75,Brinquedo,5,179
40368,2024-01-29 00:47:00,67,93,Brinquedo,2,160
40369,2024-01-29 00:48:00,105,59,Vestuário,1,164
40370,2024-01-29 00:49:00,65,153,Móvel,3,218
40371,2024-01-29 00:50:00,110,40,Eletrônico,3,150
40372,2024-01-29 00:51:00,94,99,Móvel,5,193
40373,2024-01-29 00:52:00,20,59,Vestuário,8,79
40374,2024-01-29 00:53:00,79,82,Alimento,2,161
40375,2024-01-29 00:54:00,26,10,Eletrônico,1,36
40376,2024-01-29 00:55:00,73,127,Móvel,1,200
40377,2024-01-29 00:56:00,108,63,Móvel,9,171
40378,2024-01-29 00:57:00,80,99,Brinquedo,4,179
40379,2024-01-29 00:58:00,96,16,Eletrônico,8,112
40380,2024-01-29 00:59:00,21,103,Móvel,6,124
40381,2024-01-29 01:00:00,20,111,Móvel,4,131
40382,2024-01-29 01:01:00,119,173,Eletrônico,7,292
40383,2024-01-29 01:02:00,100,105,Móvel,9,205
40384,2024-01-29 01:03:00,66,115,Eletrônico,9,181
40385,2024-01-29 01:04:00,76,61,Alimento,1,137
40386,2024-01-29 01:05:00,88,90,Eletrônico,3,178
40387,2024-01-29 01:06:00,103,70,Brinquedo,6,173
40388,2024-01-29 01:07:00,80,48,Eletrônico,8,128
40389,2024-01-29 01:08:00,108,108,Alimento,7,216
40390,2024-01-29 01:09:00,62,72,Móvel,5,134
40391,2024-01-29 01:10:00,42,101,Eletrônico,6,143
40392,2024-01-29 01:11:00,73,126,Brinquedo,2,199
40393,2024-01-29 01:12:00,94,136,Alimento,8,230
40394,2024-01-29 01:13:00,10,95,Alimento,5,105
40395,2024-01-29 01:14:00,77,25,Alimento,2,102
40396,2024-01-29 01:15:00,50,124,Brinquedo,6,174
40397,2024-01-29 01:16:00,75,86,Brinquedo,4,161
40398,2024-01-29 01:17:00,108,64,Brinquedo,2,172
40399,2024-01-29 01:18:00,47,134,Brinquedo,1,181
40400,2024-01-29 01:19:00,34,147,Alimento,3,181
40401,2024-01-29 01:20:00,25,35,Eletrônico,7,60
40402,2024-01-29 01:21:00,48,29,Alimento,3,77
40403,2024-01-29 01:22:00,82,125,Alimento,7,207
40404,2024-01-29 01:23:00,75,32,Vestuário,5,107
40405,2024-01-29 01:24:00,78,151,Eletrônico,2,229
40406,2024-01-29 01:25:00,89,165,Brinquedo,3,254
40407,2024-01-29 01:26:00,41,84,Alimento,5,125
40408,2024-01-29 01:27:00,100,132,Alimento,7,232
40409,2024-01-29 01:28:00,17,83,Eletrônico,8,100
40410,2024-01-29 01:29:00,108,115,Vestuário,6,223
40411,2024-01-29 01:30:00,71,92,Brinquedo,5,163
40412,2024-01-29 01:31:00,72,132,Móvel,4,204
40413,2024-01-29 01:32:00,40,32,Eletrônico,1,72
40414,2024-01-29 01:33:00,100,63,Vestuário,6,163
40415,2024-01-29 01:34:00,43,27,Brinquedo,1,70
40416,2024-01-29 01:35:00,115,171,Vestuário,7,286
40417,2024-01-29 01:36:00,99,44,Vestuário,8,143
40418,2024-01-29 01:37:00,104,26,Eletrônico,9,130
40419,2024-01-29 01:38:00,112,133,Eletrônico,6,245
40420,2024-01-29 01:39:00,59,132,Brinquedo,4,191
40421,2024-01-29 01:40:00,14,60,Alimento,3,74
40422,2024-01-29 01:41:00,80,13,Móvel,4,93
40423,2024-01-29 01:42:00,102,60,Eletrônico,5,162
40424,2024-01-29 01:43:00,80,158,Eletrônico,7,238
40425,2024-01-29 01:44:00,66,87,Brinquedo,1,153
40426,2024-01-29 01:45:00,105,173,Brinquedo,9,278
40427,2024-01-29 01:46:00,41,43,Eletrônico,9,84
40428,2024-01-29 01:47:00,48,42,Brinquedo,2,90
40429,2024-01-29 01:48:00,80,162,Eletrônico,6,242
40430,2024-01-29 01:49:00,56,36,Móvel,1,92
40431,2024-01-29 01:50:00,63,10,Vestuário,1,73
40432,2024-01-29 01:51:00,77,11,Eletrônico,2,88
40433,2024-01-29 01:52:00,90,64,Alimento,3,154
40434,2024-01-29 01:53:00,39,25,Vestuário,6,64
40435,2024-01-29 01:54:00,55,18,Vestuário,4,73
40436,2024-01-29 01:55:00,47,175,Móvel,9,222
40437,2024-01-29 01:56:00,58,91,Alimento,4,149
40438,2024-01-29 01:57:00,93,55,Alimento,3,148
40439,2024-01-29 01:58:00,91,126,Móvel,9,217
40440,2024-01-29 01:59:00,41,119,Brinquedo,7,160
40441,2024-01-29 02:00:00,93,96,Eletrônico,4,189
40442,2024-01-29 02:01:00,15,173,Alimento,2,188
40443,2024-01-29 02:02:00,13,80,Alimento,9,93
40444,2024-01-29 02:03:00,59,46,Eletrônico,8,105
40445,2024-01-29 02:04:00,73,164,Vestuário,9,237
40446,2024-01-29 02:05:00,90,41,Eletrônico,1,131
40447,2024-01-29 02:06:00,68,24,Vestuário,3,92
40448,2024-01-29 02:07:00,15,134,Vestuário,8,149
40449,2024-01-29 02:08:00,115,26,Eletrônico,7,141
40450,2024-01-29 02:09:00,52,34,Vestuário,7,86
40451,2024-01-29 02:10:00,78,41,Eletrônico,4,119
40452,2024-01-29 02:11:00,25,101,Alimento,6,126
40453,2024-01-29 02:12:00,119,131,Eletrônico,9,250
40454,2024-01-29 02:13:00,65,73,Brinquedo,9,138
40455,2024-01-29 02:14:00,53,27,Alimento,7,80
40456,2024-01-29 02:15:00,29,96,Alimento,7,125
40457,2024-01-29 02:16:00,103,177,Vestuário,6,280
40458,2024-01-29 02:17:00,20,46,Eletrônico,8,66
40459,2024-01-29 02:18:00,22,12,Brinquedo,3,34
40460,2024-01-29 02:19:00,38,110,Alimento,7,148
40461,2024-01-29 02:20:00,118,133,Eletrônico,6,251
40462,2024-01-29 02:21:00,85,178,Móvel,9,263
40463,2024-01-29 02:22:00,50,99,Móvel,2,149
40464,2024-01-29 02:23:00,118,118,Vestuário,7,236
40465,2024-01-29 02:24:00,63,16,Móvel,4,79
40466,2024-01-29 02:25:00,99,139,Móvel,4,238
40467,2024-01-29 02:26:00,21,179,Eletrônico,1,200
40468,2024-01-29 02:27:00,67,137,Vestuário,2,204
40469,2024-01-29 02:28:00,95,135,Brinquedo,3,230
40470,2024-01-29 02:29:00,70,146,Vestuário,3,216
40471,2024-01-29 02:30:00,39,22,Móvel,1,61
40472,2024-01-29 02:31:00,71,179,Eletrônico,9,250
40473,2024-01-29 02:32:00,108,49,Vestuário,8,157
40474,2024-01-29 02:33:00,64,92,Alimento,5,156
40475,2024-01-29 02:34:00,60,92,Eletrônico,8,152
40476,2024-01-29 02:35:00,62,172,Móvel,8,234
40477,2024-01-29 02:36:00,76,74,Vestuário,3,150
40478,2024-01-29 02:37:00,83,11,Vestuário,1,94
40479,2024-01-29 02:38:00,93,132,Vestuário,7,225
40480,2024-01-29 02:39:00,100,135,Móvel,6,235
40481,2024-01-29 02:40:00,65,132,Móvel,2,197
40482,2024-01-29 02:41:00,96,85,Alimento,3,181
40483,2024-01-29 02:42:00,89,40,Vestuário,4,129
40484,2024-01-29 02:43:00,66,124,Móvel,9,190
40485,2024-01-29 02:44:00,79,87,Alimento,6,166
40486,2024-01-29 02:45:00,85,42,Eletrônico,6,127
40487,2024-01-29 02:46:00,77,129,Alimento,7,206
40488,2024-01-29 02:47:00,42,103,Alimento,8,145
40489,2024-01-29 02:48:00,50,159,Vestuário,2,209
40490,2024-01-29 02:49:00,29,19,Eletrônico,6,48
40491,2024-01-29 02:50:00,91,34,Brinquedo,5,125
40492,2024-01-29 02:51:00,68,36,Alimento,1,104
40493,2024-01-29 02:52:00,54,152,Vestuário,2,206
40494,2024-01-29 02:53:00,55,165,Vestuário,8,220
40495,2024-01-29 02:54:00,29,46,Brinquedo,5,75
40496,2024-01-29 02:55:00,97,60,Vestuário,2,157
40497,2024-01-29 02:56:00,80,53,Vestuário,4,133
40498,2024-01-29 02:57:00,61,12,Móvel,3,73
40499,2024-01-29 02:58:00,89,81,Vestuário,7,170
40500,2024-01-29 02:59:00,105,120,Brinquedo,1,225
40501,2024-01-29 03:00:00,40,30,Brinquedo,7,70
40502,2024-01-29 03:01:00,44,143,Brinquedo,8,187
40503,2024-01-29 03:02:00,67,102,Alimento,2,169
40504,2024-01-29 03:03:00,19,99,Brinquedo,1,118
40505,2024-01-29 03:04:00,108,56,Eletrônico,8,164
40506,2024-01-29 03:05:00,78,126,Alimento,1,204
40507,2024-01-29 03:06:00,52,145,Eletrônico,6,197
40508,2024-01-29 03:07:00,115,110,Móvel,1,225
40509,2024-01-29 03:08:00,57,47,Móvel,4,104
40510,2024-01-29 03:09:00,73,25,Brinquedo,3,98
40511,2024-01-29 03:10:00,91,109,Brinquedo,8,200
40512,2024-01-29 03:11:00,116,166,Móvel,6,282
40513,2024-01-29 03:12:00,94,74,Brinquedo,9,168
40514,2024-01-29 03:13:00,112,113,Móvel,3,225
40515,2024-01-29 03:14:00,85,97,Eletrônico,4,182
40516,2024-01-29 03:15:00,19,114,Vestuário,2,133
40517,2024-01-29 03:16:00,96,127,Móvel,6,223
40518,2024-01-29 03:17:00,76,12,Brinquedo,5,88
40519,2024-01-29 03:18:00,78,57,Eletrônico,5,135
40520,2024-01-29 03:19:00,56,39,Alimento,5,95
40521,2024-01-29 03:20:00,14,48,Móvel,9,62
40522,2024-01-29 03:21:00,85,150,Eletrônico,3,235
40523,2024-01-29 03:22:00,62,101,Brinquedo,7,163
40524,2024-01-29 03:23:00,59,42,Brinquedo,7,101
40525,2024-01-29 03:24:00,64,118,Brinquedo,2,182
40526,2024-01-29 03:25:00,28,76,Vestuário,7,104
40527,2024-01-29 03:26:00,42,144,Móvel,5,186
40528,2024-01-29 03:27:00,64,20,Eletrônico,4,84
40529,2024-01-29 03:28:00,90,45,Brinquedo,6,135
40530,2024-01-29 03:29:00,105,11,Alimento,8,116
40531,2024-01-29 03:30:00,26,115,Alimento,2,141
40532,2024-01-29 03:31:00,21,168,Móvel,7,189
40533,2024-01-29 03:32:00,23,129,Brinquedo,8,152
40534,2024-01-29 03:33:00,109,10,Alimento,5,119
40535,2024-01-29 03:34:00,31,101,Vestuário,5,132
40536,2024-01-29 03:35:00,36,130,Móvel,7,166
40537,2024-01-29 03:36:00,95,88,Móvel,2,183
40538,2024-01-29 03:37:00,99,110,Móvel,1,209
40539,2024-01-29 03:38:00,107,73,Vestuário,9,180
40540,2024-01-29 03:39:00,34,132,Vestuário,8,166
40541,2024-01-29 03:40:00,119,164,Móvel,3,283
40542,2024-01-29 03:41:00,62,28,Vestuário,5,90
40543,2024-01-29 03:42:00,74,79,Eletrônico,7,153
40544,2024-01-29 03:43:00,12,126,Eletrônico,2,138
40545,2024-01-29 03:44:00,22,156,Eletrônico,9,178
40546,2024-01-29 03:45:00,88,79,Móvel,1,167
40547,2024-01-29 03:46:00,42,48,Móvel,5,90
40548,2024-01-29 03:47:00,18,57,Móvel,9,75
40549,2024-01-29 03:48:00,13,137,Alimento,3,150
40550,2024-01-29 03:49:00,30,125,Vestuário,3,155
40551,2024-01-29 03:50:00,16,67,Vestuário,5,83
40552,2024-01-29 03:51:00,75,16,Brinquedo,5,91
40553,2024-01-29 03:52:00,29,51,Brinquedo,4,80
40554,2024-01-29 03:53:00,113,60,Eletrônico,3,173
40555,2024-01-29 03:54:00,18,49,Alimento,2,67
40556,2024-01-29 03:55:00,55,162,Móvel,8,217
40557,2024-01-29 03:56:00,19,171,Móvel,5,190
40558,2024-01-29 03:57:00,78,160,Eletrônico,3,238
40559,2024-01-29 03:58:00,53,165,Vestuário,6,218
40560,2024-01-29 03:59:00,24,113,Brinquedo,6,137
40561,2024-01-29 04:00:00,105,109,Alimento,2,214
40562,2024-01-29 04:01:00,115,106,Alimento,4,221
40563,2024-01-29 04:02:00,72,97,Vestuário,3,169
40564,2024-01-29 04:03:00,111,73,Vestuário,3,184
40565,2024-01-29 04:04:00,104,159,Alimento,6,263
40566,2024-01-29 04:05:00,91,56,Brinquedo,6,147
40567,2024-01-29 04:06:00,92,138,Eletrônico,4,230
40568,2024-01-29 04:07:00,113,61,Vestuário,3,174
40569,2024-01-29 04:08:00,45,154,Brinquedo,9,199
40570,2024-01-29 04:09:00,39,11,Brinquedo,5,50
40571,2024-01-29 04:10:00,74,164,Eletrônico,1,238
40572,2024-01-29 04:11:00,65,64,Alimento,8,129
40573,2024-01-29 04:12:00,118,159,Vestuário,6,277
40574,2024-01-29 04:13:00,84,152,Eletrônico,8,236
40575,2024-01-29 04:14:00,76,170,Brinquedo,9,246
40576,2024-01-29 04:15:00,110,79,Eletrônico,4,189
40577,2024-01-29 04:16:00,94,90,Alimento,9,184
40578,2024-01-29 04:17:00,102,169,Móvel,6,271
40579,2024-01-29 04:18:00,109,143,Vestuário,8,252
40580,2024-01-29 04:19:00,66,71,Brinquedo,2,137
40581,2024-01-29 04:20:00,117,177,Móvel,6,294
40582,2024-01-29 04:21:00,55,150,Brinquedo,3,205
40583,2024-01-29 04:22:00,101,94,Eletrônico,4,195
40584,2024-01-29 04:23:00,12,58,Vestuário,9,70
40585,2024-01-29 04:24:00,117,18,Brinquedo,5,135
40586,2024-01-29 04:25:00,26,127,Eletrônico,8,153
40587,2024-01-29 04:26:00,50,154,Móvel,9,204
40588,2024-01-29 04:27:00,29,72,Eletrônico,2,101
40589,2024-01-29 04:28:00,56,53,Eletrônico,9,109
40590,2024-01-29 04:29:00,80,125,Eletrônico,6,205
40591,2024-01-29 04:30:00,59,91,Vestuário,9,150
40592,2024-01-29 04:31:00,61,38,Brinquedo,8,99
40593,2024-01-29 04:32:00,41,112,Eletrônico,9,153
40594,2024-01-29 04:33:00,91,92,Móvel,6,183
40595,2024-01-29 04:34:00,58,123,Móvel,3,181
40596,2024-01-29 04:35:00,37,80,Eletrônico,6,117
40597,2024-01-29 04:36:00,114,28,Brinquedo,3,142
40598,2024-01-29 04:37:00,77,133,Alimento,3,210
40599,2024-01-29 04:38:00,76,93,Eletrônico,5,169
40600,2024-01-29 04:39:00,93,17,Eletrônico,7,110
40601,2024-01-29 04:40:00,15,39,Eletrônico,6,54
40602,2024-01-29 04:41:00,41,92,Móvel,3,133
40603,2024-01-29 04:42:00,27,58,Alimento,5,85
40604,2024-01-29 04:43:00,18,117,Alimento,4,135
40605,2024-01-29 04:44:00,44,168,Móvel,9,212
40606,2024-01-29 04:45:00,73,132,Vestuário,6,205
40607,2024-01-29 04:46:00,34,19,Eletrônico,4,53
40608,2024-01-29 04:47:00,18,146,Vestuário,9,164
40609,2024-01-29 04:48:00,113,81,Móvel,5,194
40610,2024-01-29 04:49:00,70,70,Brinquedo,2,140
40611,2024-01-29 04:50:00,113,159,Eletrônico,3,272
40612,2024-01-29 04:51:00,13,116,Eletrônico,8,129
40613,2024-01-29 04:52:00,74,39,Brinquedo,5,113
40614,2024-01-29 04:53:00,81,68,Brinquedo,1,149
40615,2024-01-29 04:54:00,19,77,Móvel,9,96
40616,2024-01-29 04:55:00,45,106,Móvel,4,151
40617,2024-01-29 04:56:00,35,29,Brinquedo,9,64
40618,2024-01-29 04:57:00,93,87,Eletrônico,4,180
40619,2024-01-29 04:58:00,24,43,Móvel,1,67
40620,2024-01-29 04:59:00,67,68,Brinquedo,4,135
40621,2024-01-29 05:00:00,107,152,Vestuário,2,259
40622,2024-01-29 05:01:00,76,68,Móvel,2,144
40623,2024-01-29 05:02:00,84,131,Brinquedo,1,215
40624,2024-01-29 05:03:00,103,147,Alimento,5,250
40625,2024-01-29 05:04:00,68,168,Brinquedo,5,236
40626,2024-01-29 05:05:00,76,170,Móvel,2,246
40627,2024-01-29 05:06:00,34,64,Alimento,5,98
40628,2024-01-29 05:07:00,111,60,Brinquedo,4,171
40629,2024-01-29 05:08:00,25,93,Brinquedo,4,118
40630,2024-01-29 05:09:00,42,20,Alimento,1,62
40631,2024-01-29 05:10:00,26,77,Eletrônico,5,103
40632,2024-01-29 05:11:00,100,165,Eletrônico,5,265
40633,2024-01-29 05:12:00,87,36,Alimento,7,123
40634,2024-01-29 05:13:00,117,134,Eletrônico,4,251
40635,2024-01-29 05:14:00,79,137,Vestuário,6,216
40636,2024-01-29 05:15:00,27,132,Brinquedo,3,159
40637,2024-01-29 05:16:00,107,115,Móvel,2,222
40638,2024-01-29 05:17:00,18,106,Móvel,5,124
40639,2024-01-29 05:18:00,56,53,Brinquedo,5,109
40640,2024-01-29 05:19:00,103,106,Vestuário,6,209
40641,2024-01-29 05:20:00,74,134,Móvel,4,208
40642,2024-01-29 05:21:00,21,24,Eletrônico,8,45
40643,2024-01-29 05:22:00,66,144,Vestuário,6,210
40644,2024-01-29 05:23:00,96,157,Móvel,9,253
40645,2024-01-29 05:24:00,106,137,Móvel,8,243
40646,2024-01-29 05:25:00,46,109,Alimento,7,155
40647,2024-01-29 05:26:00,81,40,Vestuário,8,121
40648,2024-01-29 05:27:00,109,72,Vestuário,4,181
40649,2024-01-29 05:28:00,43,24,Vestuário,6,67
40650,2024-01-29 05:29:00,37,145,Vestuário,7,182
40651,2024-01-29 05:30:00,29,54,Vestuário,7,83
40652,2024-01-29 05:31:00,35,167,Vestuário,6,202
40653,2024-01-29 05:32:00,37,44,Brinquedo,8,81
40654,2024-01-29 05:33:00,119,173,Vestuário,3,292
40655,2024-01-29 05:34:00,76,173,Alimento,3,249
40656,2024-01-29 05:35:00,74,48,Vestuário,3,122
40657,2024-01-29 05:36:00,81,31,Alimento,2,112
40658,2024-01-29 05:37:00,35,144,Móvel,4,179
40659,2024-01-29 05:38:00,67,29,Eletrônico,3,96
40660,2024-01-29 05:39:00,80,85,Alimento,7,165
40661,2024-01-29 05:40:00,67,128,Vestuário,7,195
40662,2024-01-29 05:41:00,106,157,Eletrônico,2,263
40663,2024-01-29 05:42:00,112,59,Alimento,7,171
40664,2024-01-29 05:43:00,60,177,Móvel,9,237
40665,2024-01-29 05:44:00,60,168,Alimento,4,228
40666,2024-01-29 05:45:00,62,155,Vestuário,6,217
40667,2024-01-29 05:46:00,70,57,Eletrônico,8,127
40668,2024-01-29 05:47:00,100,52,Brinquedo,3,152
40669,2024-01-29 05:48:00,71,34,Móvel,6,105
40670,2024-01-29 05:49:00,92,53,Eletrônico,1,145
40671,2024-01-29 05:50:00,15,57,Vestuário,4,72
40672,2024-01-29 05:51:00,41,65,Vestuário,5,106
40673,2024-01-29 05:52:00,45,127,Alimento,6,172
40674,2024-01-29 05:53:00,78,38,Eletrônico,7,116
40675,2024-01-29 05:54:00,114,56,Alimento,7,170
40676,2024-01-29 05:55:00,42,162,Eletrônico,5,204
40677,2024-01-29 05:56:00,70,61,Eletrônico,2,131
40678,2024-01-29 05:57:00,42,174,Vestuário,3,216
40679,2024-01-29 05:58:00,77,25,Móvel,9,102
40680,2024-01-29 05:59:00,64,112,Eletrônico,8,176
40681,2024-01-29 06:00:00,29,93,Vestuário,8,122
40682,2024-01-29 06:01:00,74,87,Vestuário,2,161
40683,2024-01-29 06:02:00,21,141,Móvel,2,162
40684,2024-01-29 06:03:00,67,35,Alimento,6,102
40685,2024-01-29 06:04:00,82,100,Alimento,6,182
40686,2024-01-29 06:05:00,110,69,Alimento,7,179
40687,2024-01-29 06:06:00,24,154,Alimento,7,178
40688,2024-01-29 06:07:00,48,16,Eletrônico,1,64
40689,2024-01-29 06:08:00,17,124,Brinquedo,6,141
40690,2024-01-29 06:09:00,48,115,Brinquedo,4,163
40691,2024-01-29 06:10:00,54,27,Alimento,1,81
40692,2024-01-29 06:11:00,33,103,Brinquedo,7,136
40693,2024-01-29 06:12:00,118,145,Eletrônico,6,263
40694,2024-01-29 06:13:00,47,64,Brinquedo,4,111
40695,2024-01-29 06:14:00,40,66,Alimento,8,106
40696,2024-01-29 06:15:00,112,80,Brinquedo,8,192
40697,2024-01-29 06:16:00,45,168,Eletrônico,1,213
40698,2024-01-29 06:17:00,44,76,Brinquedo,2,120
40699,2024-01-29 06:18:00,54,142,Eletrônico,4,196
40700,2024-01-29 06:19:00,85,24,Brinquedo,3,109
40701,2024-01-29 06:20:00,39,67,Alimento,1,106
40702,2024-01-29 06:21:00,28,88,Eletrônico,9,116
40703,2024-01-29 06:22:00,20,32,Alimento,7,52
40704,2024-01-29 06:23:00,92,32,Vestuário,5,124
40705,2024-01-29 06:24:00,97,21,Vestuário,2,118
40706,2024-01-29 06:25:00,10,60,Brinquedo,7,70
40707,2024-01-29 06:26:00,74,65,Eletrônico,7,139
40708,2024-01-29 06:27:00,118,80,Eletrônico,1,198
40709,2024-01-29 06:28:00,51,68,Móvel,9,119
40710,2024-01-29 06:29:00,45,166,Brinquedo,7,211
40711,2024-01-29 06:30:00,78,45,Móvel,7,123
40712,2024-01-29 06:31:00,22,76,Eletrônico,2,98
40713,2024-01-29 06:32:00,51,169,Alimento,1,220
40714,2024-01-29 06:33:00,83,43,Brinquedo,4,126
40715,2024-01-29 06:34:00,41,105,Brinquedo,4,146
40716,2024-01-29 06:35:00,40,38,Eletrônico,2,78
40717,2024-01-29 06:36:00,25,70,Móvel,9,95
40718,2024-01-29 06:37:00,29,18,Eletrônico,2,47
40719,2024-01-29 06:38:00,21,166,Móvel,8,187
40720,2024-01-29 06:39:00,75,108,Móvel,2,183
40721,2024-01-29 06:40:00,13,137,Brinquedo,6,150
40722,2024-01-29 06:41:00,32,99,Brinquedo,6,131
40723,2024-01-29 06:42:00,64,112,Eletrônico,1,176
40724,2024-01-29 06:43:00,75,114,Brinquedo,3,189
40725,2024-01-29 06:44:00,57,52,Eletrônico,1,109
40726,2024-01-29 06:45:00,118,146,Móvel,2,264
40727,2024-01-29 06:46:00,15,98,Móvel,7,113
40728,2024-01-29 06:47:00,24,91,Móvel,8,115
40729,2024-01-29 06:48:00,24,11,Vestuário,3,35
40730,2024-01-29 06:49:00,94,46,Eletrônico,6,140
40731,2024-01-29 06:50:00,27,151,Vestuário,5,178
40732,2024-01-29 06:51:00,101,19,Eletrônico,9,120
40733,2024-01-29 06:52:00,119,137,Alimento,2,256
40734,2024-01-29 06:53:00,77,114,Móvel,5,191
40735,2024-01-29 06:54:00,30,63,Móvel,7,93
40736,2024-01-29 06:55:00,14,151,Alimento,7,165
40737,2024-01-29 06:56:00,16,112,Brinquedo,6,128
40738,2024-01-29 06:57:00,108,129,Brinquedo,7,237
40739,2024-01-29 06:58:00,11,112,Vestuário,2,123
40740,2024-01-29 06:59:00,46,83,Alimento,9,129
40741,2024-01-29 07:00:00,21,26,Vestuário,1,47
40742,2024-01-29 07:01:00,57,52,Eletrônico,2,109
40743,2024-01-29 07:02:00,12,166,Alimento,2,178
40744,2024-01-29 07:03:00,33,34,Brinquedo,5,67
40745,2024-01-29 07:04:00,53,84,Alimento,6,137
40746,2024-01-29 07:05:00,48,115,Alimento,6,163
40747,2024-01-29 07:06:00,108,144,Móvel,6,252
40748,2024-01-29 07:07:00,46,30,Vestuário,9,76
40749,2024-01-29 07:08:00,54,165,Eletrônico,5,219
40750,2024-01-29 07:09:00,60,119,Brinquedo,3,179
40751,2024-01-29 07:10:00,110,123,Alimento,3,233
40752,2024-01-29 07:11:00,11,40,Vestuário,9,51
40753,2024-01-29 07:12:00,21,150,Alimento,9,171
40754,2024-01-29 07:13:00,59,118,Móvel,9,177
40755,2024-01-29 07:14:00,50,140,Vestuário,1,190
40756,2024-01-29 07:15:00,103,177,Vestuário,7,280
40757,2024-01-29 07:16:00,117,33,Alimento,7,150
40758,2024-01-29 07:17:00,118,136,Móvel,9,254
40759,2024-01-29 07:18:00,40,166,Eletrônico,6,206
40760,2024-01-29 07:19:00,86,37,Móvel,7,123
40761,2024-01-29 07:20:00,22,172,Vestuário,6,194
40762,2024-01-29 07:21:00,29,71,Brinquedo,6,100
40763,2024-01-29 07:22:00,91,123,Alimento,8,214
40764,2024-01-29 07:23:00,77,26,Eletrônico,5,103
40765,2024-01-29 07:24:00,58,79,Vestuário,1,137
40766,2024-01-29 07:25:00,99,151,Móvel,4,250
40767,2024-01-29 07:26:00,63,50,Brinquedo,6,113
40768,2024-01-29 07:27:00,40,173,Vestuário,3,213
40769,2024-01-29 07:28:00,103,117,Eletrônico,7,220
40770,2024-01-29 07:29:00,21,83,Eletrônico,6,104
40771,2024-01-29 07:30:00,25,139,Alimento,7,164
40772,2024-01-29 07:31:00,87,122,Alimento,8,209
40773,2024-01-29 07:32:00,41,66,Brinquedo,1,107
40774,2024-01-29 07:33:00,66,25,Vestuário,2,91
40775,2024-01-29 07:34:00,88,119,Móvel,7,207
40776,2024-01-29 07:35:00,30,99,Móvel,8,129
40777,2024-01-29 07:36:00,38,37,Brinquedo,7,75
40778,2024-01-29 07:37:00,94,53,Eletrônico,5,147
40779,2024-01-29 07:38:00,104,15,Vestuário,7,119
40780,2024-01-29 07:39:00,115,100,Brinquedo,5,215
40781,2024-01-29 07:40:00,47,80,Alimento,9,127
40782,2024-01-29 07:41:00,61,154,Eletrônico,7,215
40783,2024-01-29 07:42:00,63,102,Eletrônico,2,165
40784,2024-01-29 07:43:00,78,16,Alimento,4,94
40785,2024-01-29 07:44:00,82,88,Alimento,8,170
40786,2024-01-29 07:45:00,53,141,Móvel,6,194
40787,2024-01-29 07:46:00,76,78,Vestuário,3,154
40788,2024-01-29 07:47:00,108,19,Móvel,1,127
40789,2024-01-29 07:48:00,66,126,Vestuário,4,192
40790,2024-01-29 07:49:00,42,151,Eletrônico,5,193
40791,2024-01-29 07:50:00,20,161,Eletrônico,9,181
40792,2024-01-29 07:51:00,38,16,Móvel,2,54
40793,2024-01-29 07:52:00,78,91,Eletrônico,4,169
40794,2024-01-29 07:53:00,76,40,Alimento,9,116
40795,2024-01-29 07:54:00,33,24,Alimento,4,57
40796,2024-01-29 07:55:00,60,65,Eletrônico,8,125
40797,2024-01-29 07:56:00,77,158,Eletrônico,3,235
40798,2024-01-29 07:57:00,90,75,Alimento,2,165
40799,2024-01-29 07:58:00,96,63,Vestuário,7,159
40800,2024-01-29 07:59:00,56,147,Vestuário,3,203
40801,2024-01-29 08:00:00,98,153,Alimento,8,251
40802,2024-01-29 08:01:00,113,80,Eletrônico,9,193
40803,2024-01-29 08:02:00,12,82,Brinquedo,7,94
40804,2024-01-29 08:03:00,20,98,Vestuário,7,118
40805,2024-01-29 08:04:00,119,172,Móvel,4,291
40806,2024-01-29 08:05:00,66,96,Móvel,7,162
40807,2024-01-29 08:06:00,54,73,Alimento,8,127
40808,2024-01-29 08:07:00,56,89,Móvel,4,145
40809,2024-01-29 08:08:00,15,178,Vestuário,2,193
40810,2024-01-29 08:09:00,85,138,Eletrônico,4,223
40811,2024-01-29 08:10:00,79,133,Alimento,4,212
40812,2024-01-29 08:11:00,45,75,Móvel,9,120
40813,2024-01-29 08:12:00,63,61,Brinquedo,5,124
40814,2024-01-29 08:13:00,50,120,Móvel,2,170
40815,2024-01-29 08:14:00,114,168,Alimento,6,282
40816,2024-01-29 08:15:00,19,24,Brinquedo,3,43
40817,2024-01-29 08:16:00,18,113,Vestuário,7,131
40818,2024-01-29 08:17:00,86,108,Eletrônico,9,194
40819,2024-01-29 08:18:00,24,81,Alimento,5,105
40820,2024-01-29 08:19:00,26,84,Alimento,2,110
40821,2024-01-29 08:20:00,42,150,Móvel,1,192
40822,2024-01-29 08:21:00,26,35,Vestuário,5,61
40823,2024-01-29 08:22:00,71,115,Vestuário,2,186
40824,2024-01-29 08:23:00,102,62,Móvel,5,164
40825,2024-01-29 08:24:00,66,167,Vestuário,4,233
40826,2024-01-29 08:25:00,52,137,Alimento,9,189
40827,2024-01-29 08:26:00,25,38,Móvel,6,63
40828,2024-01-29 08:27:00,45,95,Vestuário,5,140
40829,2024-01-29 08:28:00,45,21,Móvel,4,66
40830,2024-01-29 08:29:00,95,148,Vestuário,5,243
40831,2024-01-29 08:30:00,44,159,Vestuário,3,203
40832,2024-01-29 08:31:00,26,172,Alimento,8,198
40833,2024-01-29 08:32:00,111,41,Eletrônico,3,152
40834,2024-01-29 08:33:00,30,120,Brinquedo,4,150
40835,2024-01-29 08:34:00,47,104,Brinquedo,5,151
40836,2024-01-29 08:35:00,67,138,Brinquedo,1,205
40837,2024-01-29 08:36:00,30,25,Alimento,8,55
40838,2024-01-29 08:37:00,48,47,Alimento,7,95
40839,2024-01-29 08:38:00,83,19,Brinquedo,1,102
40840,2024-01-29 08:39:00,57,153,Alimento,2,210
40841,2024-01-29 08:40:00,115,15,Alimento,6,130
40842,2024-01-29 08:41:00,33,43,Alimento,8,76
40843,2024-01-29 08:42:00,13,76,Móvel,5,89
40844,2024-01-29 08:43:00,62,173,Vestuário,1,235
40845,2024-01-29 08:44:00,83,74,Brinquedo,3,157
40846,2024-01-29 08:45:00,69,160,Brinquedo,7,229
40847,2024-01-29 08:46:00,117,152,Brinquedo,1,269
40848,2024-01-29 08:47:00,37,28,Vestuário,1,65
40849,2024-01-29 08:48:00,40,71,Brinquedo,9,111
40850,2024-01-29 08:49:00,10,84,Alimento,9,94
40851,2024-01-29 08:50:00,52,145,Móvel,9,197
40852,2024-01-29 08:51:00,59,97,Alimento,1,156
40853,2024-01-29 08:52:00,96,110,Móvel,1,206
40854,2024-01-29 08:53:00,79,156,Eletrônico,3,235
40855,2024-01-29 08:54:00,81,57,Móvel,9,138
40856,2024-01-29 08:55:00,65,68,Eletrônico,2,133
40857,2024-01-29 08:56:00,35,37,Eletrônico,4,72
40858,2024-01-29 08:57:00,97,104,Vestuário,4,201
40859,2024-01-29 08:58:00,117,85,Eletrônico,5,202
40860,2024-01-29 08:59:00,54,58,Eletrônico,6,112
40861,2024-01-29 09:00:00,36,131,Brinquedo,1,167
40862,2024-01-29 09:01:00,66,161,Alimento,8,227
40863,2024-01-29 09:02:00,44,129,Brinquedo,6,173
40864,2024-01-29 09:03:00,46,163,Brinquedo,2,209
40865,2024-01-29 09:04:00,32,93,Móvel,4,125
40866,2024-01-29 09:05:00,54,93,Brinquedo,3,147
40867,2024-01-29 09:06:00,27,48,Alimento,8,75
40868,2024-01-29 09:07:00,33,40,Vestuário,9,73
40869,2024-01-29 09:08:00,70,164,Vestuário,9,234
40870,2024-01-29 09:09:00,85,97,Alimento,9,182
40871,2024-01-29 09:10:00,74,128,Vestuário,9,202
40872,2024-01-29 09:11:00,67,164,Eletrônico,4,231
40873,2024-01-29 09:12:00,59,46,Eletrônico,2,105
40874,2024-01-29 09:13:00,117,107,Eletrônico,8,224
40875,2024-01-29 09:14:00,51,173,Vestuário,3,224
40876,2024-01-29 09:15:00,80,174,Eletrônico,9,254
40877,2024-01-29 09:16:00,87,151,Eletrônico,3,238
40878,2024-01-29 09:17:00,17,70,Brinquedo,5,87
40879,2024-01-29 09:18:00,99,159,Brinquedo,4,258
40880,2024-01-29 09:19:00,114,108,Móvel,3,222
40881,2024-01-29 09:20:00,79,97,Móvel,2,176
40882,2024-01-29 09:21:00,77,128,Eletrônico,6,205
40883,2024-01-29 09:22:00,100,176,Brinquedo,7,276
40884,2024-01-29 09:23:00,11,179,Móvel,8,190
40885,2024-01-29 09:24:00,24,151,Brinquedo,9,175
40886,2024-01-29 09:25:00,35,111,Vestuário,6,146
40887,2024-01-29 09:26:00,97,129,Móvel,5,226
40888,2024-01-29 09:27:00,39,25,Eletrônico,8,64
40889,2024-01-29 09:28:00,10,82,Alimento,7,92
40890,2024-01-29 09:29:00,57,76,Alimento,8,133
40891,2024-01-29 09:30:00,12,178,Vestuário,1,190
40892,2024-01-29 09:31:00,103,28,Móvel,7,131
40893,2024-01-29 09:32:00,103,98,Alimento,9,201
40894,2024-01-29 09:33:00,16,96,Alimento,1,112
40895,2024-01-29 09:34:00,99,152,Vestuário,6,251
40896,2024-01-29 09:35:00,97,91,Móvel,6,188
40897,2024-01-29 09:36:00,13,37,Alimento,1,50
40898,2024-01-29 09:37:00,16,40,Alimento,6,56
40899,2024-01-29 09:38:00,114,16,Eletrônico,6,130
40900,2024-01-29 09:39:00,36,122,Alimento,1,158
40901,2024-01-29 09:40:00,50,97,Brinquedo,3,147
40902,2024-01-29 09:41:00,32,113,Brinquedo,7,145
40903,2024-01-29 09:42:00,119,177,Eletrônico,9,296
40904,2024-01-29 09:43:00,23,172,Vestuário,3,195
40905,2024-01-29 09:44:00,112,89,Vestuário,9,201
40906,2024-01-29 09:45:00,84,135,Eletrônico,4,219
40907,2024-01-29 09:46:00,48,95,Eletrônico,6,143
40908,2024-01-29 09:47:00,82,169,Eletrônico,3,251
40909,2024-01-29 09:48:00,108,152,Vestuário,5,260
40910,2024-01-29 09:49:00,111,172,Alimento,9,283
40911,2024-01-29 09:50:00,50,19,Vestuário,1,69
40912,2024-01-29 09:51:00,113,161,Móvel,8,274
40913,2024-01-29 09:52:00,100,74,Brinquedo,3,174
40914,2024-01-29 09:53:00,99,156,Brinquedo,6,255
40915,2024-01-29 09:54:00,40,58,Móvel,8,98
40916,2024-01-29 09:55:00,62,162,Vestuário,4,224
40917,2024-01-29 09:56:00,119,58,Móvel,5,177
40918,2024-01-29 09:57:00,16,32,Brinquedo,7,48
40919,2024-01-29 09:58:00,53,133,Vestuário,7,186
40920,2024-01-29 09:59:00,71,51,Alimento,7,122
40921,2024-01-29 10:00:00,14,147,Eletrônico,9,161
40922,2024-01-29 10:01:00,67,155,Móvel,2,222
40923,2024-01-29 10:02:00,89,113,Móvel,4,202
40924,2024-01-29 10:03:00,67,78,Eletrônico,4,145
40925,2024-01-29 10:04:00,12,153,Brinquedo,8,165
40926,2024-01-29 10:05:00,64,84,Móvel,8,148
40927,2024-01-29 10:06:00,34,21,Brinquedo,7,55
40928,2024-01-29 10:07:00,85,145,Alimento,2,230
40929,2024-01-29 10:08:00,10,110,Brinquedo,7,120
40930,2024-01-29 10:09:00,83,34,Brinquedo,5,117
40931,2024-01-29 10:10:00,62,51,Eletrônico,5,113
40932,2024-01-29 10:11:00,114,170,Brinquedo,4,284
40933,2024-01-29 10:12:00,58,36,Brinquedo,3,94
40934,2024-01-29 10:13:00,29,155,Vestuário,7,184
40935,2024-01-29 10:14:00,102,87,Eletrônico,8,189
40936,2024-01-29 10:15:00,115,117,Móvel,6,232
40937,2024-01-29 10:16:00,17,159,Eletrônico,7,176
40938,2024-01-29 10:17:00,84,150,Alimento,9,234
40939,2024-01-29 10:18:00,53,157,Móvel,5,210
40940,2024-01-29 10:19:00,54,170,Móvel,9,224
40941,2024-01-29 10:20:00,79,148,Móvel,7,227
40942,2024-01-29 10:21:00,18,125,Vestuário,9,143
40943,2024-01-29 10:22:00,25,26,Alimento,3,51
40944,2024-01-29 10:23:00,18,175,Alimento,3,193
40945,2024-01-29 10:24:00,87,97,Eletrônico,4,184
40946,2024-01-29 10:25:00,104,78,Móvel,1,182
40947,2024-01-29 10:26:00,47,69,Móvel,4,116
40948,2024-01-29 10:27:00,15,92,Eletrônico,3,107
40949,2024-01-29 10:28:00,104,35,Eletrônico,3,139
40950,2024-01-29 10:29:00,87,62,Alimento,9,149
40951,2024-01-29 10:30:00,90,131,Brinquedo,3,221
40952,2024-01-29 10:31:00,110,83,Alimento,9,193
40953,2024-01-29 10:32:00,79,82,Vestuário,6,161
40954,2024-01-29 10:33:00,10,152,Móvel,8,162
40955,2024-01-29 10:34:00,58,18,Móvel,3,76
40956,2024-01-29 10:35:00,88,131,Brinquedo,7,219
40957,2024-01-29 10:36:00,15,137,Móvel,2,152
40958,2024-01-29 10:37:00,20,42,Vestuário,5,62
40959,2024-01-29 10:38:00,106,174,Eletrônico,6,280
40960,2024-01-29 10:39:00,113,46,Móvel,1,159
40961,2024-01-29 10:40:00,16,45,Móvel,6,61
40962,2024-01-29 10:41:00,41,38,Eletrônico,8,79
40963,2024-01-29 10:42:00,31,76,Alimento,5,107
40964,2024-01-29 10:43:00,34,167,Vestuário,9,201
40965,2024-01-29 10:44:00,86,108,Móvel,7,194
40966,2024-01-29 10:45:00,50,120,Brinquedo,9,170
40967,2024-01-29 10:46:00,71,94,Alimento,4,165
40968,2024-01-29 10:47:00,43,164,Alimento,2,207
40969,2024-01-29 10:48:00,50,20,Vestuário,2,70
40970,2024-01-29 10:49:00,47,85,Vestuário,9,132
40971,2024-01-29 10:50:00,16,117,Móvel,6,133
40972,2024-01-29 10:51:00,31,40,Alimento,7,71
40973,2024-01-29 10:52:00,16,107,Móvel,1,123
40974,2024-01-29 10:53:00,84,61,Brinquedo,8,145
40975,2024-01-29 10:54:00,27,30,Alimento,6,57
40976,2024-01-29 10:55:00,19,52,Eletrônico,7,71
40977,2024-01-29 10:56:00,74,53,Eletrônico,8,127
40978,2024-01-29 10:57:00,43,45,Vestuário,4,88
40979,2024-01-29 10:58:00,71,120,Móvel,1,191
40980,2024-01-29 10:59:00,99,76,Eletrônico,6,175
40981,2024-01-29 11:00:00,107,168,Eletrônico,2,275
40982,2024-01-29 11:01:00,70,33,Móvel,2,103
40983,2024-01-29 11:02:00,114,77,Móvel,7,191
40984,2024-01-29 11:03:00,93,53,Eletrônico,1,146
40985,2024-01-29 11:04:00,113,13,Vestuário,7,126
40986,2024-01-29 11:05:00,35,25,Brinquedo,1,60
40987,2024-01-29 11:06:00,88,81,Eletrônico,8,169
40988,2024-01-29 11:07:00,39,86,Vestuário,5,125
40989,2024-01-29 11:08:00,92,82,Brinquedo,7,174
40990,2024-01-29 11:09:00,112,103,Vestuário,7,215
40991,2024-01-29 11:10:00,54,20,Vestuário,1,74
40992,2024-01-29 11:11:00,24,109,Vestuário,7,133
40993,2024-01-29 11:12:00,100,32,Brinquedo,1,132
40994,2024-01-29 11:13:00,102,148,Móvel,3,250
40995,2024-01-29 11:14:00,59,161,Alimento,3,220
40996,2024-01-29 11:15:00,15,140,Eletrônico,2,155
40997,2024-01-29 11:16:00,67,42,Vestuário,5,109
40998,2024-01-29 11:17:00,70,144,Alimento,3,214
40999,2024-01-29 11:18:00,82,129,Alimento,5,211
41000,2024-01-29 11:19:00,64,153,Eletrônico,6,217
41001,2024-01-29 11:20:00,42,114,Alimento,5,156
41002,2024-01-29 11:21:00,115,30,Vestuário,6,145
41003,2024-01-29 11:22:00,76,96,Alimento,1,172
41004,2024-01-29 11:23:00,70,68,Eletrônico,3,138
41005,2024-01-29 11:24:00,21,16,Alimento,3,37
41006,2024-01-29 11:25:00,75,61,Móvel,1,136
41007,2024-01-29 11:26:00,42,43,Eletrônico,9,85
41008,2024-01-29 11:27:00,40,18,Eletrônico,2,58
41009,2024-01-29 11:28:00,102,145,Alimento,7,247
41010,2024-01-29 11:29:00,45,161,Alimento,5,206
41011,2024-01-29 11:30:00,18,38,Brinquedo,7,56
41012,2024-01-29 11:31:00,56,27,Alimento,6,83
41013,2024-01-29 11:32:00,86,163,Móvel,8,249
41014,2024-01-29 11:33:00,55,164,Brinquedo,2,219
41015,2024-01-29 11:34:00,89,152,Alimento,8,241
41016,2024-01-29 11:35:00,31,24,Eletrônico,4,55
41017,2024-01-29 11:36:00,53,107,Vestuário,3,160
41018,2024-01-29 11:37:00,61,76,Eletrônico,3,137
41019,2024-01-29 11:38:00,55,124,Vestuário,7,179
41020,2024-01-29 11:39:00,71,68,Móvel,8,139
41021,2024-01-29 11:40:00,68,14,Móvel,1,82
41022,2024-01-29 11:41:00,115,177,Eletrônico,2,292
41023,2024-01-29 11:42:00,87,163,Eletrônico,3,250
41024,2024-01-29 11:43:00,91,85,Brinquedo,6,176
41025,2024-01-29 11:44:00,74,93,Eletrônico,1,167
41026,2024-01-29 11:45:00,92,119,Eletrônico,2,211
41027,2024-01-29 11:46:00,110,27,Vestuário,4,137
41028,2024-01-29 11:47:00,59,117,Brinquedo,4,176
41029,2024-01-29 11:48:00,29,113,Móvel,3,142
41030,2024-01-29 11:49:00,61,43,Vestuário,3,104
41031,2024-01-29 11:50:00,29,144,Brinquedo,6,173
41032,2024-01-29 11:51:00,23,85,Móvel,5,108
41033,2024-01-29 11:52:00,92,64,Vestuário,1,156
41034,2024-01-29 11:53:00,93,154,Vestuário,6,247
41035,2024-01-29 11:54:00,106,142,Eletrônico,4,248
41036,2024-01-29 11:55:00,34,80,Brinquedo,6,114
41037,2024-01-29 11:56:00,10,61,Vestuário,4,71
41038,2024-01-29 11:57:00,16,178,Alimento,5,194
41039,2024-01-29 11:58:00,52,58,Alimento,4,110
41040,2024-01-29 11:59:00,109,62,Vestuário,2,171
41041,2024-01-29 12:00:00,44,137,Vestuário,7,181
41042,2024-01-29 12:01:00,59,62,Brinquedo,9,121
41043,2024-01-29 12:02:00,102,173,Brinquedo,4,275
41044,2024-01-29 12:03:00,63,88,Móvel,6,151
41045,2024-01-29 12:04:00,69,67,Alimento,4,136
41046,2024-01-29 12:05:00,64,36,Vestuário,3,100
41047,2024-01-29 12:06:00,96,143,Vestuário,8,239
41048,2024-01-29 12:07:00,95,165,Vestuário,9,260
41049,2024-01-29 12:08:00,105,137,Vestuário,5,242
41050,2024-01-29 12:09:00,47,54,Eletrônico,5,101
41051,2024-01-29 12:10:00,91,159,Alimento,8,250
41052,2024-01-29 12:11:00,57,33,Alimento,1,90
41053,2024-01-29 12:12:00,56,158,Alimento,4,214
41054,2024-01-29 12:13:00,115,139,Vestuário,9,254
41055,2024-01-29 12:14:00,67,145,Alimento,1,212
41056,2024-01-29 12:15:00,17,135,Vestuário,7,152
41057,2024-01-29 12:16:00,61,28,Brinquedo,1,89
41058,2024-01-29 12:17:00,98,74,Brinquedo,9,172
41059,2024-01-29 12:18:00,16,53,Vestuário,9,69
41060,2024-01-29 12:19:00,29,125,Alimento,7,154
41061,2024-01-29 12:20:00,12,99,Eletrônico,4,111
41062,2024-01-29 12:21:00,46,154,Vestuário,2,200
41063,2024-01-29 12:22:00,96,63,Eletrônico,9,159
41064,2024-01-29 12:23:00,84,95,Brinquedo,2,179
41065,2024-01-29 12:24:00,50,14,Móvel,6,64
41066,2024-01-29 12:25:00,75,160,Brinquedo,8,235
41067,2024-01-29 12:26:00,28,108,Eletrônico,1,136
41068,2024-01-29 12:27:00,109,93,Eletrônico,6,202
41069,2024-01-29 12:28:00,75,63,Brinquedo,5,138
41070,2024-01-29 12:29:00,69,110,Eletrônico,9,179
41071,2024-01-29 12:30:00,17,71,Brinquedo,5,88
41072,2024-01-29 12:31:00,58,65,Eletrônico,7,123
41073,2024-01-29 12:32:00,116,101,Eletrônico,4,217
41074,2024-01-29 12:33:00,84,161,Vestuário,5,245
41075,2024-01-29 12:34:00,32,18,Brinquedo,3,50
41076,2024-01-29 12:35:00,21,65,Vestuário,6,86
41077,2024-01-29 12:36:00,58,112,Eletrônico,1,170
41078,2024-01-29 12:37:00,28,102,Brinquedo,2,130
41079,2024-01-29 12:38:00,99,82,Vestuário,7,181
41080,2024-01-29 12:39:00,117,122,Alimento,5,239
41081,2024-01-29 12:40:00,77,65,Alimento,3,142
41082,2024-01-29 12:41:00,108,82,Eletrônico,4,190
41083,2024-01-29 12:42:00,82,21,Brinquedo,7,103
41084,2024-01-29 12:43:00,64,10,Eletrônico,5,74
41085,2024-01-29 12:44:00,103,52,Alimento,2,155
41086,2024-01-29 12:45:00,65,56,Brinquedo,9,121
41087,2024-01-29 12:46:00,63,171,Alimento,7,234
41088,2024-01-29 12:47:00,61,133,Alimento,8,194
41089,2024-01-29 12:48:00,101,91,Vestuário,9,192
41090,2024-01-29 12:49:00,59,122,Móvel,6,181
41091,2024-01-29 12:50:00,70,18,Móvel,6,88
41092,2024-01-29 12:51:00,114,99,Eletrônico,8,213
41093,2024-01-29 12:52:00,54,89,Brinquedo,2,143
41094,2024-01-29 12:53:00,15,96,Vestuário,2,111
41095,2024-01-29 12:54:00,78,17,Vestuário,8,95
41096,2024-01-29 12:55:00,101,136,Móvel,9,237
41097,2024-01-29 12:56:00,97,80,Alimento,3,177
41098,2024-01-29 12:57:00,24,71,Móvel,8,95
41099,2024-01-29 12:58:00,77,155,Móvel,5,232
41100,2024-01-29 12:59:00,62,171,Móvel,7,233
41101,2024-01-29 13:00:00,44,163,Brinquedo,4,207
41102,2024-01-29 13:01:00,104,178,Móvel,3,282
41103,2024-01-29 13:02:00,42,156,Vestuário,1,198
41104,2024-01-29 13:03:00,31,95,Vestuário,6,126
41105,2024-01-29 13:04:00,11,73,Alimento,2,84
41106,2024-01-29 13:05:00,93,129,Eletrônico,4,222
41107,2024-01-29 13:06:00,76,155,Alimento,5,231
41108,2024-01-29 13:07:00,19,74,Vestuário,9,93
41109,2024-01-29 13:08:00,66,30,Alimento,2,96
41110,2024-01-29 13:09:00,42,155,Móvel,8,197
41111,2024-01-29 13:10:00,46,169,Vestuário,2,215
41112,2024-01-29 13:11:00,48,125,Alimento,4,173
41113,2024-01-29 13:12:00,20,11,Alimento,8,31
41114,2024-01-29 13:13:00,36,79,Vestuário,4,115
41115,2024-01-29 13:14:00,21,126,Alimento,5,147
41116,2024-01-29 13:15:00,66,30,Brinquedo,8,96
41117,2024-01-29 13:16:00,73,127,Brinquedo,7,200
41118,2024-01-29 13:17:00,13,136,Eletrônico,5,149
41119,2024-01-29 13:18:00,17,35,Móvel,4,52
41120,2024-01-29 13:19:00,30,71,Móvel,5,101
41121,2024-01-29 13:20:00,79,35,Móvel,8,114
41122,2024-01-29 13:21:00,19,45,Móvel,2,64
41123,2024-01-29 13:22:00,52,35,Eletrônico,7,87
41124,2024-01-29 13:23:00,20,63,Eletrônico,4,83
41125,2024-01-29 13:24:00,84,127,Móvel,1,211
41126,2024-01-29 13:25:00,15,62,Móvel,1,77
41127,2024-01-29 13:26:00,107,45,Vestuário,1,152
41128,2024-01-29 13:27:00,85,15,Vestuário,3,100
41129,2024-01-29 13:28:00,108,153,Brinquedo,5,261
41130,2024-01-29 13:29:00,80,91,Vestuário,3,171
41131,2024-01-29 13:30:00,97,116,Vestuário,6,213
41132,2024-01-29 13:31:00,80,31,Eletrônico,6,111
41133,2024-01-29 13:32:00,53,158,Móvel,5,211
41134,2024-01-29 13:33:00,65,116,Vestuário,9,181
41135,2024-01-29 13:34:00,28,34,Eletrônico,9,62
41136,2024-01-29 13:35:00,66,36,Eletrônico,9,102
41137,2024-01-29 13:36:00,92,160,Alimento,6,252
41138,2024-01-29 13:37:00,119,162,Móvel,6,281
41139,2024-01-29 13:38:00,88,143,Brinquedo,7,231
41140,2024-01-29 13:39:00,35,62,Alimento,7,97
41141,2024-01-29 13:40:00,105,176,Vestuário,2,281
41142,2024-01-29 13:41:00,47,41,Vestuário,3,88
41143,2024-01-29 13:42:00,111,134,Vestuário,8,245
41144,2024-01-29 13:43:00,46,137,Alimento,6,183
41145,2024-01-29 13:44:00,89,12,Eletrônico,3,101
41146,2024-01-29 13:45:00,92,152,Eletrônico,3,244
41147,2024-01-29 13:46:00,55,62,Móvel,3,117
41148,2024-01-29 13:47:00,21,165,Brinquedo,3,186
41149,2024-01-29 13:48:00,43,164,Vestuário,6,207
41150,2024-01-29 13:49:00,55,14,Eletrônico,8,69
41151,2024-01-29 13:50:00,86,58,Vestuário,8,144
41152,2024-01-29 13:51:00,119,139,Móvel,9,258
41153,2024-01-29 13:52:00,45,105,Brinquedo,2,150
41154,2024-01-29 13:53:00,63,159,Móvel,5,222
41155,2024-01-29 13:54:00,14,142,Eletrônico,7,156
41156,2024-01-29 13:55:00,106,162,Móvel,6,268
41157,2024-01-29 13:56:00,109,178,Alimento,3,287
41158,2024-01-29 13:57:00,54,46,Eletrônico,4,100
41159,2024-01-29 13:58:00,60,75,Móvel,9,135
41160,2024-01-29 13:59:00,44,120,Alimento,8,164
41161,2024-01-29 14:00:00,114,42,Móvel,6,156
41162,2024-01-29 14:01:00,10,143,Alimento,9,153
41163,2024-01-29 14:02:00,24,57,Alimento,2,81
41164,2024-01-29 14:03:00,45,103,Brinquedo,4,148
41165,2024-01-29 14:04:00,102,154,Móvel,4,256
41166,2024-01-29 14:05:00,15,114,Brinquedo,4,129
41167,2024-01-29 14:06:00,96,93,Brinquedo,1,189
41168,2024-01-29 14:07:00,16,107,Eletrônico,5,123
41169,2024-01-29 14:08:00,15,87,Alimento,5,102
41170,2024-01-29 14:09:00,17,148,Alimento,3,165
41171,2024-01-29 14:10:00,83,86,Vestuário,6,169
41172,2024-01-29 14:11:00,81,170,Eletrônico,3,251
41173,2024-01-29 14:12:00,59,55,Móvel,6,114
41174,2024-01-29 14:13:00,48,176,Eletrônico,2,224
41175,2024-01-29 14:14:00,20,16,Vestuário,8,36
41176,2024-01-29 14:15:00,56,36,Vestuário,8,92
41177,2024-01-29 14:16:00,61,57,Brinquedo,4,118
41178,2024-01-29 14:17:00,85,158,Eletrônico,4,243
41179,2024-01-29 14:18:00,86,93,Alimento,8,179
41180,2024-01-29 14:19:00,109,175,Brinquedo,6,284
41181,2024-01-29 14:20:00,43,156,Móvel,9,199
41182,2024-01-29 14:21:00,57,118,Móvel,5,175
41183,2024-01-29 14:22:00,26,82,Móvel,5,108
41184,2024-01-29 14:23:00,25,157,Alimento,6,182
41185,2024-01-29 14:24:00,113,141,Vestuário,2,254
41186,2024-01-29 14:25:00,56,32,Eletrônico,3,88
41187,2024-01-29 14:26:00,98,15,Alimento,7,113
41188,2024-01-29 14:27:00,53,46,Vestuário,4,99
41189,2024-01-29 14:28:00,104,35,Brinquedo,5,139
41190,2024-01-29 14:29:00,34,70,Móvel,1,104
41191,2024-01-29 14:30:00,55,108,Eletrônico,7,163
41192,2024-01-29 14:31:00,81,43,Brinquedo,1,124
41193,2024-01-29 14:32:00,56,113,Alimento,8,169
41194,2024-01-29 14:33:00,34,43,Brinquedo,2,77
41195,2024-01-29 14:34:00,76,86,Eletrônico,3,162
41196,2024-01-29 14:35:00,67,16,Móvel,2,83
41197,2024-01-29 14:36:00,71,90,Alimento,4,161
41198,2024-01-29 14:37:00,74,123,Vestuário,3,197
41199,2024-01-29 14:38:00,37,166,Móvel,5,203
41200,2024-01-29 14:39:00,112,22,Eletrônico,1,134
41201,2024-01-29 14:40:00,14,44,Eletrônico,1,58
41202,2024-01-29 14:41:00,79,123,Eletrônico,6,202
41203,2024-01-29 14:42:00,75,26,Móvel,7,101
41204,2024-01-29 14:43:00,81,131,Vestuário,1,212
41205,2024-01-29 14:44:00,57,174,Brinquedo,7,231
41206,2024-01-29 14:45:00,119,170,Móvel,6,289
41207,2024-01-29 14:46:00,113,178,Móvel,3,291
41208,2024-01-29 14:47:00,59,25,Móvel,3,84
41209,2024-01-29 14:48:00,37,158,Vestuário,6,195
41210,2024-01-29 14:49:00,112,123,Móvel,1,235
41211,2024-01-29 14:50:00,24,15,Alimento,8,39
41212,2024-01-29 14:51:00,93,112,Alimento,4,205
41213,2024-01-29 14:52:00,106,69,Móvel,6,175
41214,2024-01-29 14:53:00,54,84,Brinquedo,8,138
41215,2024-01-29 14:54:00,79,30,Vestuário,4,109
41216,2024-01-29 14:55:00,54,110,Móvel,1,164
41217,2024-01-29 14:56:00,26,100,Eletrônico,5,126
41218,2024-01-29 14:57:00,11,125,Brinquedo,5,136
41219,2024-01-29 14:58:00,96,172,Vestuário,3,268
41220,2024-01-29 14:59:00,30,71,Móvel,9,101
41221,2024-01-29 15:00:00,46,177,Alimento,2,223
41222,2024-01-29 15:01:00,10,62,Vestuário,3,72
41223,2024-01-29 15:02:00,60,10,Eletrônico,6,70
41224,2024-01-29 15:03:00,12,29,Eletrônico,2,41
41225,2024-01-29 15:04:00,16,153,Vestuário,6,169
41226,2024-01-29 15:05:00,117,174,Móvel,7,291
41227,2024-01-29 15:06:00,57,20,Vestuário,7,77
41228,2024-01-29 15:07:00,63,159,Eletrônico,1,222
41229,2024-01-29 15:08:00,109,148,Brinquedo,7,257
41230,2024-01-29 15:09:00,44,141,Vestuário,3,185
41231,2024-01-29 15:10:00,38,114,Móvel,9,152
41232,2024-01-29 15:11:00,61,88,Brinquedo,6,149
41233,2024-01-29 15:12:00,110,46,Brinquedo,1,156
41234,2024-01-29 15:13:00,11,77,Brinquedo,9,88
41235,2024-01-29 15:14:00,34,33,Móvel,1,67
41236,2024-01-29 15:15:00,45,54,Alimento,3,99
41237,2024-01-29 15:16:00,97,33,Alimento,2,130
41238,2024-01-29 15:17:00,119,119,Móvel,3,238
41239,2024-01-29 15:18:00,104,13,Alimento,4,117
41240,2024-01-29 15:19:00,42,25,Eletrônico,4,67
41241,2024-01-29 15:20:00,23,61,Alimento,3,84
41242,2024-01-29 15:21:00,44,77,Móvel,8,121
41243,2024-01-29 15:22:00,14,18,Vestuário,1,32
41244,2024-01-29 15:23:00,28,166,Brinquedo,5,194
41245,2024-01-29 15:24:00,21,81,Móvel,9,102
41246,2024-01-29 15:25:00,45,40,Eletrônico,4,85
41247,2024-01-29 15:26:00,89,43,Móvel,5,132
41248,2024-01-29 15:27:00,40,32,Móvel,9,72
41249,2024-01-29 15:28:00,100,14,Brinquedo,5,114
41250,2024-01-29 15:29:00,43,167,Eletrônico,8,210
41251,2024-01-29 15:30:00,56,79,Brinquedo,2,135
41252,2024-01-29 15:31:00,89,56,Alimento,7,145
41253,2024-01-29 15:32:00,82,52,Móvel,8,134
41254,2024-01-29 15:33:00,27,86,Móvel,5,113
41255,2024-01-29 15:34:00,27,147,Brinquedo,7,174
41256,2024-01-29 15:35:00,14,106,Eletrônico,7,120
41257,2024-01-29 15:36:00,62,62,Móvel,3,124
41258,2024-01-29 15:37:00,54,84,Alimento,4,138
41259,2024-01-29 15:38:00,17,157,Alimento,5,174
41260,2024-01-29 15:39:00,98,146,Brinquedo,4,244
41261,2024-01-29 15:40:00,81,114,Vestuário,9,195
41262,2024-01-29 15:41:00,57,78,Brinquedo,2,135
41263,2024-01-29 15:42:00,23,150,Brinquedo,2,173
41264,2024-01-29 15:43:00,91,123,Alimento,3,214
41265,2024-01-29 15:44:00,67,66,Eletrônico,7,133
41266,2024-01-29 15:45:00,112,82,Vestuário,5,194
41267,2024-01-29 15:46:00,70,159,Alimento,2,229
41268,2024-01-29 15:47:00,13,142,Móvel,7,155
41269,2024-01-29 15:48:00,74,148,Eletrônico,6,222
41270,2024-01-29 15:49:00,117,74,Vestuário,2,191
41271,2024-01-29 15:50:00,107,47,Brinquedo,2,154
41272,2024-01-29 15:51:00,104,128,Brinquedo,2,232
41273,2024-01-29 15:52:00,107,18,Móvel,9,125
41274,2024-01-29 15:53:00,11,49,Brinquedo,9,60
41275,2024-01-29 15:54:00,76,120,Vestuário,8,196
41276,2024-01-29 15:55:00,45,65,Eletrônico,9,110
41277,2024-01-29 15:56:00,59,119,Móvel,4,178
41278,2024-01-29 15:57:00,113,77,Móvel,9,190
41279,2024-01-29 15:58:00,28,148,Vestuário,9,176
41280,2024-01-29 15:59:00,72,82,Móvel,1,154
41281,2024-01-29 16:00:00,84,79,Alimento,8,163
41282,2024-01-29 16:01:00,34,42,Eletrônico,7,76
41283,2024-01-29 16:02:00,13,127,Brinquedo,1,140
41284,2024-01-29 16:03:00,24,107,Eletrônico,8,131
41285,2024-01-29 16:04:00,34,28,Móvel,4,62
41286,2024-01-29 16:05:00,26,36,Vestuário,1,62
41287,2024-01-29 16:06:00,90,112,Alimento,4,202
41288,2024-01-29 16:07:00,22,52,Brinquedo,1,74
41289,2024-01-29 16:08:00,105,166,Móvel,8,271
41290,2024-01-29 16:09:00,84,38,Eletrônico,8,122
41291,2024-01-29 16:10:00,23,98,Brinquedo,7,121
41292,2024-01-29 16:11:00,20,179,Móvel,6,199
41293,2024-01-29 16:12:00,13,101,Brinquedo,3,114
41294,2024-01-29 16:13:00,56,168,Alimento,1,224
41295,2024-01-29 16:14:00,79,33,Móvel,9,112
41296,2024-01-29 16:15:00,98,80,Móvel,3,178
41297,2024-01-29 16:16:00,74,163,Móvel,8,237
41298,2024-01-29 16:17:00,46,143,Eletrônico,4,189
41299,2024-01-29 16:18:00,73,63,Alimento,5,136
41300,2024-01-29 16:19:00,76,170,Brinquedo,9,246
41301,2024-01-29 16:20:00,36,47,Brinquedo,5,83
41302,2024-01-29 16:21:00,45,50,Brinquedo,1,95
41303,2024-01-29 16:22:00,44,68,Móvel,2,112
41304,2024-01-29 16:23:00,81,23,Eletrônico,6,104
41305,2024-01-29 16:24:00,18,116,Vestuário,5,134
41306,2024-01-29 16:25:00,115,162,Vestuário,7,277
41307,2024-01-29 16:26:00,39,174,Eletrônico,1,213
41308,2024-01-29 16:27:00,10,27,Vestuário,3,37
41309,2024-01-29 16:28:00,37,144,Alimento,1,181
41310,2024-01-29 16:29:00,16,155,Eletrônico,5,171
41311,2024-01-29 16:30:00,44,32,Eletrônico,8,76
41312,2024-01-29 16:31:00,38,44,Eletrônico,2,82
41313,2024-01-29 16:32:00,76,93,Alimento,2,169
41314,2024-01-29 16:33:00,25,155,Alimento,3,180
41315,2024-01-29 16:34:00,93,54,Vestuário,5,147
41316,2024-01-29 16:35:00,55,10,Eletrônico,9,65
41317,2024-01-29 16:36:00,97,46,Eletrônico,5,143
41318,2024-01-29 16:37:00,31,146,Brinquedo,8,177
41319,2024-01-29 16:38:00,59,17,Eletrônico,2,76
41320,2024-01-29 16:39:00,47,27,Eletrônico,9,74
41321,2024-01-29 16:40:00,53,16,Brinquedo,4,69
41322,2024-01-29 16:41:00,98,41,Alimento,7,139
41323,2024-01-29 16:42:00,47,57,Vestuário,3,104
41324,2024-01-29 16:43:00,97,37,Brinquedo,7,134
41325,2024-01-29 16:44:00,115,13,Brinquedo,2,128
41326,2024-01-29 16:45:00,49,52,Vestuário,3,101
41327,2024-01-29 16:46:00,105,174,Vestuário,5,279
41328,2024-01-29 16:47:00,15,36,Brinquedo,3,51
41329,2024-01-29 16:48:00,25,100,Brinquedo,6,125
41330,2024-01-29 16:49:00,20,156,Móvel,2,176
41331,2024-01-29 16:50:00,104,16,Brinquedo,2,120
41332,2024-01-29 16:51:00,44,83,Vestuário,7,127
41333,2024-01-29 16:52:00,90,135,Alimento,9,225
41334,2024-01-29 16:53:00,78,161,Móvel,1,239
41335,2024-01-29 16:54:00,17,172,Vestuário,9,189
41336,2024-01-29 16:55:00,100,26,Móvel,6,126
41337,2024-01-29 16:56:00,51,24,Eletrônico,8,75
41338,2024-01-29 16:57:00,103,67,Eletrônico,6,170
41339,2024-01-29 16:58:00,14,110,Brinquedo,7,124
41340,2024-01-29 16:59:00,20,143,Móvel,5,163
41341,2024-01-29 17:00:00,51,12,Alimento,4,63
41342,2024-01-29 17:01:00,108,160,Eletrônico,2,268
41343,2024-01-29 17:02:00,26,155,Móvel,9,181
41344,2024-01-29 17:03:00,97,144,Brinquedo,9,241
41345,2024-01-29 17:04:00,83,170,Vestuário,2,253
41346,2024-01-29 17:05:00,59,65,Eletrônico,1,124
41347,2024-01-29 17:06:00,79,82,Móvel,8,161
41348,2024-01-29 17:07:00,22,157,Móvel,9,179
41349,2024-01-29 17:08:00,50,178,Vestuário,9,228
41350,2024-01-29 17:09:00,101,153,Eletrônico,6,254
41351,2024-01-29 17:10:00,117,123,Móvel,2,240
41352,2024-01-29 17:11:00,84,154,Alimento,4,238
41353,2024-01-29 17:12:00,62,132,Móvel,8,194
41354,2024-01-29 17:13:00,38,64,Eletrônico,6,102
41355,2024-01-29 17:14:00,112,92,Móvel,1,204
41356,2024-01-29 17:15:00,102,159,Brinquedo,2,261
41357,2024-01-29 17:16:00,75,141,Alimento,1,216
41358,2024-01-29 17:17:00,49,27,Brinquedo,7,76
41359,2024-01-29 17:18:00,19,154,Móvel,6,173
41360,2024-01-29 17:19:00,50,95,Brinquedo,6,145
41361,2024-01-29 17:20:00,113,23,Brinquedo,8,136
41362,2024-01-29 17:21:00,69,124,Vestuário,5,193
41363,2024-01-29 17:22:00,62,179,Eletrônico,1,241
41364,2024-01-29 17:23:00,43,80,Móvel,7,123
41365,2024-01-29 17:24:00,13,177,Vestuário,3,190
41366,2024-01-29 17:25:00,73,151,Alimento,9,224
41367,2024-01-29 17:26:00,103,152,Eletrônico,3,255
41368,2024-01-29 17:27:00,87,44,Brinquedo,7,131
41369,2024-01-29 17:28:00,76,107,Brinquedo,3,183
41370,2024-01-29 17:29:00,105,167,Alimento,4,272
41371,2024-01-29 17:30:00,84,122,Alimento,6,206
41372,2024-01-29 17:31:00,32,147,Móvel,8,179
41373,2024-01-29 17:32:00,119,70,Eletrônico,3,189
41374,2024-01-29 17:33:00,100,106,Brinquedo,1,206
41375,2024-01-29 17:34:00,26,65,Brinquedo,2,91
41376,2024-01-29 17:35:00,111,173,Brinquedo,2,284
41377,2024-01-29 17:36:00,79,36,Alimento,5,115
41378,2024-01-29 17:37:00,36,63,Vestuário,5,99
41379,2024-01-29 17:38:00,83,86,Vestuário,5,169
41380,2024-01-29 17:39:00,20,54,Brinquedo,4,74
41381,2024-01-29 17:40:00,101,30,Móvel,2,131
41382,2024-01-29 17:41:00,100,158,Móvel,1,258
41383,2024-01-29 17:42:00,23,11,Alimento,3,34
41384,2024-01-29 17:43:00,81,135,Alimento,8,216
41385,2024-01-29 17:44:00,40,79,Eletrônico,4,119
41386,2024-01-29 17:45:00,17,70,Vestuário,9,87
41387,2024-01-29 17:46:00,87,119,Brinquedo,9,206
41388,2024-01-29 17:47:00,63,33,Vestuário,5,96
41389,2024-01-29 17:48:00,91,90,Brinquedo,1,181
41390,2024-01-29 17:49:00,85,80,Móvel,5,165
41391,2024-01-29 17:50:00,36,120,Vestuário,3,156
41392,2024-01-29 17:51:00,43,78,Brinquedo,6,121
41393,2024-01-29 17:52:00,41,150,Vestuário,4,191
41394,2024-01-29 17:53:00,46,163,Vestuário,5,209
41395,2024-01-29 17:54:00,35,158,Eletrônico,4,193
41396,2024-01-29 17:55:00,84,49,Móvel,3,133
41397,2024-01-29 17:56:00,35,85,Vestuário,7,120
41398,2024-01-29 17:57:00,81,169,Eletrônico,6,250
41399,2024-01-29 17:58:00,57,49,Alimento,2,106
41400,2024-01-29 17:59:00,72,102,Eletrônico,1,174
41401,2024-01-29 18:00:00,92,75,Móvel,9,167
41402,2024-01-29 18:01:00,116,135,Brinquedo,6,251
41403,2024-01-29 18:02:00,13,153,Vestuário,3,166
41404,2024-01-29 18:03:00,40,82,Vestuário,9,122
41405,2024-01-29 18:04:00,78,48,Brinquedo,6,126
41406,2024-01-29 18:05:00,29,103,Vestuário,2,132
41407,2024-01-29 18:06:00,74,27,Brinquedo,8,101
41408,2024-01-29 18:07:00,32,119,Móvel,1,151
41409,2024-01-29 18:08:00,42,109,Móvel,9,151
41410,2024-01-29 18:09:00,45,164,Eletrônico,8,209
41411,2024-01-29 18:10:00,30,144,Vestuário,1,174
41412,2024-01-29 18:11:00,105,160,Eletrônico,7,265
41413,2024-01-29 18:12:00,82,86,Brinquedo,3,168
41414,2024-01-29 18:13:00,71,167,Vestuário,3,238
41415,2024-01-29 18:14:00,69,124,Vestuário,7,193
41416,2024-01-29 18:15:00,40,120,Brinquedo,8,160
41417,2024-01-29 18:16:00,116,136,Eletrônico,1,252
41418,2024-01-29 18:17:00,70,18,Móvel,4,88
41419,2024-01-29 18:18:00,13,42,Vestuário,5,55
41420,2024-01-29 18:19:00,17,54,Alimento,2,71
41421,2024-01-29 18:20:00,84,94,Alimento,8,178
41422,2024-01-29 18:21:00,102,91,Eletrônico,9,193
41423,2024-01-29 18:22:00,65,126,Eletrônico,3,191
41424,2024-01-29 18:23:00,52,59,Móvel,5,111
41425,2024-01-29 18:24:00,49,22,Eletrônico,4,71
41426,2024-01-29 18:25:00,117,140,Eletrônico,6,257
41427,2024-01-29 18:26:00,18,89,Alimento,2,107
41428,2024-01-29 18:27:00,64,100,Alimento,2,164
41429,2024-01-29 18:28:00,92,139,Brinquedo,2,231
41430,2024-01-29 18:29:00,36,64,Vestuário,9,100
41431,2024-01-29 18:30:00,117,144,Móvel,9,261
41432,2024-01-29 18:31:00,65,108,Eletrônico,5,173
41433,2024-01-29 18:32:00,106,142,Vestuário,1,248
41434,2024-01-29 18:33:00,59,76,Brinquedo,2,135
41435,2024-01-29 18:34:00,26,30,Móvel,7,56
41436,2024-01-29 18:35:00,73,104,Vestuário,3,177
41437,2024-01-29 18:36:00,38,80,Vestuário,4,118
41438,2024-01-29 18:37:00,18,142,Alimento,5,160
41439,2024-01-29 18:38:00,89,63,Alimento,2,152
41440,2024-01-29 18:39:00,36,87,Eletrônico,6,123
41441,2024-01-29 18:40:00,115,21,Alimento,4,136
41442,2024-01-29 18:41:00,110,37,Eletrônico,7,147
41443,2024-01-29 18:42:00,111,32,Vestuário,4,143
41444,2024-01-29 18:43:00,52,179,Alimento,3,231
41445,2024-01-29 18:44:00,13,81,Brinquedo,3,94
41446,2024-01-29 18:45:00,110,120,Móvel,3,230
41447,2024-01-29 18:46:00,23,64,Vestuário,7,87
41448,2024-01-29 18:47:00,18,149,Brinquedo,4,167
41449,2024-01-29 18:48:00,118,177,Vestuário,3,295
41450,2024-01-29 18:49:00,51,98,Móvel,8,149
41451,2024-01-29 18:50:00,44,86,Vestuário,7,130
41452,2024-01-29 18:51:00,74,141,Vestuário,8,215
41453,2024-01-29 18:52:00,118,150,Vestuário,1,268
41454,2024-01-29 18:53:00,43,89,Móvel,6,132
41455,2024-01-29 18:54:00,67,105,Brinquedo,6,172
41456,2024-01-29 18:55:00,99,167,Móvel,7,266
41457,2024-01-29 18:56:00,98,20,Alimento,6,118
41458,2024-01-29 18:57:00,19,66,Eletrônico,7,85
41459,2024-01-29 18:58:00,115,67,Alimento,1,182
41460,2024-01-29 18:59:00,96,14,Brinquedo,8,110
41461,2024-01-29 19:00:00,19,149,Vestuário,9,168
41462,2024-01-29 19:01:00,103,75,Alimento,9,178
41463,2024-01-29 19:02:00,49,49,Brinquedo,8,98
41464,2024-01-29 19:03:00,52,73,Móvel,9,125
41465,2024-01-29 19:04:00,82,160,Eletrônico,3,242
41466,2024-01-29 19:05:00,79,58,Brinquedo,5,137
41467,2024-01-29 19:06:00,12,57,Alimento,3,69
41468,2024-01-29 19:07:00,110,165,Alimento,1,275
41469,2024-01-29 19:08:00,78,57,Brinquedo,4,135
41470,2024-01-29 19:09:00,116,150,Vestuário,9,266
41471,2024-01-29 19:10:00,78,149,Móvel,5,227
41472,2024-01-29 19:11:00,100,163,Móvel,1,263
41473,2024-01-29 19:12:00,64,152,Alimento,5,216
41474,2024-01-29 19:13:00,60,21,Brinquedo,7,81
41475,2024-01-29 19:14:00,16,49,Eletrônico,1,65
41476,2024-01-29 19:15:00,90,23,Eletrônico,4,113
41477,2024-01-29 19:16:00,67,118,Vestuário,3,185
41478,2024-01-29 19:17:00,91,160,Alimento,1,251
41479,2024-01-29 19:18:00,13,137,Móvel,4,150
41480,2024-01-29 19:19:00,39,161,Alimento,1,200
41481,2024-01-29 19:20:00,88,142,Eletrônico,9,230
41482,2024-01-29 19:21:00,118,129,Eletrônico,2,247
41483,2024-01-29 19:22:00,73,42,Vestuário,7,115
41484,2024-01-29 19:23:00,93,81,Vestuário,8,174
41485,2024-01-29 19:24:00,84,173,Brinquedo,8,257
41486,2024-01-29 19:25:00,86,55,Eletrônico,9,141
41487,2024-01-29 19:26:00,63,76,Móvel,6,139
41488,2024-01-29 19:27:00,38,113,Eletrônico,8,151
41489,2024-01-29 19:28:00,91,176,Alimento,2,267
41490,2024-01-29 19:29:00,115,106,Alimento,3,221
41491,2024-01-29 19:30:00,114,110,Vestuário,1,224
41492,2024-01-29 19:31:00,11,143,Alimento,8,154
41493,2024-01-29 19:32:00,114,129,Alimento,8,243
41494,2024-01-29 19:33:00,71,120,Brinquedo,7,191
41495,2024-01-29 19:34:00,89,108,Móvel,4,197
41496,2024-01-29 19:35:00,73,102,Vestuário,1,175
41497,2024-01-29 19:36:00,48,45,Alimento,5,93
41498,2024-01-29 19:37:00,66,154,Vestuário,7,220
41499,2024-01-29 19:38:00,62,22,Vestuário,1,84
41500,2024-01-29 19:39:00,14,175,Alimento,1,189
41501,2024-01-29 19:40:00,116,123,Alimento,7,239
41502,2024-01-29 19:41:00,45,127,Móvel,5,172
41503,2024-01-29 19:42:00,62,110,Vestuário,7,172
41504,2024-01-29 19:43:00,20,140,Alimento,8,160
41505,2024-01-29 19:44:00,18,127,Vestuário,5,145
41506,2024-01-29 19:45:00,105,130,Móvel,4,235
41507,2024-01-29 19:46:00,80,36,Brinquedo,6,116
41508,2024-01-29 19:47:00,72,26,Vestuário,9,98
41509,2024-01-29 19:48:00,82,18,Móvel,9,100
41510,2024-01-29 19:49:00,53,24,Brinquedo,8,77
41511,2024-01-29 19:50:00,113,133,Móvel,1,246
41512,2024-01-29 19:51:00,17,73,Vestuário,5,90
41513,2024-01-29 19:52:00,31,21,Vestuário,8,52
41514,2024-01-29 19:53:00,20,92,Vestuário,3,112
41515,2024-01-29 19:54:00,47,171,Vestuário,3,218
41516,2024-01-29 19:55:00,100,167,Brinquedo,4,267
41517,2024-01-29 19:56:00,98,37,Alimento,7,135
41518,2024-01-29 19:57:00,26,69,Alimento,2,95
41519,2024-01-29 19:58:00,66,90,Vestuário,8,156
41520,2024-01-29 19:59:00,101,54,Brinquedo,7,155
41521,2024-01-29 20:00:00,110,111,Brinquedo,9,221
41522,2024-01-29 20:01:00,54,151,Brinquedo,8,205
41523,2024-01-29 20:02:00,57,104,Eletrônico,6,161
41524,2024-01-29 20:03:00,54,107,Brinquedo,6,161
41525,2024-01-29 20:04:00,82,77,Eletrônico,5,159
41526,2024-01-29 20:05:00,11,130,Brinquedo,1,141
41527,2024-01-29 20:06:00,87,54,Brinquedo,7,141
41528,2024-01-29 20:07:00,36,13,Móvel,7,49
41529,2024-01-29 20:08:00,26,14,Móvel,4,40
41530,2024-01-29 20:09:00,116,98,Vestuário,1,214
41531,2024-01-29 20:10:00,109,54,Eletrônico,3,163
41532,2024-01-29 20:11:00,49,153,Eletrônico,8,202
41533,2024-01-29 20:12:00,54,77,Brinquedo,5,131
41534,2024-01-29 20:13:00,19,151,Móvel,1,170
41535,2024-01-29 20:14:00,64,44,Brinquedo,7,108
41536,2024-01-29 20:15:00,118,151,Alimento,6,269
41537,2024-01-29 20:16:00,17,88,Alimento,3,105
41538,2024-01-29 20:17:00,58,157,Alimento,5,215
41539,2024-01-29 20:18:00,62,112,Alimento,8,174
41540,2024-01-29 20:19:00,24,156,Vestuário,1,180
41541,2024-01-29 20:20:00,101,133,Vestuário,1,234
41542,2024-01-29 20:21:00,43,167,Brinquedo,6,210
41543,2024-01-29 20:22:00,29,74,Alimento,3,103
41544,2024-01-29 20:23:00,59,125,Alimento,7,184
41545,2024-01-29 20:24:00,83,94,Vestuário,5,177
41546,2024-01-29 20:25:00,15,117,Brinquedo,9,132
41547,2024-01-29 20:26:00,82,103,Eletrônico,6,185
41548,2024-01-29 20:27:00,71,150,Vestuário,5,221
41549,2024-01-29 20:28:00,27,117,Eletrônico,3,144
41550,2024-01-29 20:29:00,114,179,Vestuário,9,293
41551,2024-01-29 20:30:00,66,117,Alimento,4,183
41552,2024-01-29 20:31:00,72,155,Eletrônico,1,227
41553,2024-01-29 20:32:00,10,49,Móvel,7,59
41554,2024-01-29 20:33:00,44,101,Alimento,9,145
41555,2024-01-29 20:34:00,35,167,Brinquedo,2,202
41556,2024-01-29 20:35:00,107,118,Vestuário,1,225
41557,2024-01-29 20:36:00,95,58,Móvel,5,153
41558,2024-01-29 20:37:00,85,159,Móvel,3,244
41559,2024-01-29 20:38:00,23,96,Vestuário,3,119
41560,2024-01-29 20:39:00,78,103,Alimento,9,181
41561,2024-01-29 20:40:00,69,49,Brinquedo,8,118
41562,2024-01-29 20:41:00,36,33,Alimento,6,69
41563,2024-01-29 20:42:00,66,128,Eletrônico,1,194
41564,2024-01-29 20:43:00,31,91,Alimento,1,122
41565,2024-01-29 20:44:00,93,124,Brinquedo,8,217
41566,2024-01-29 20:45:00,98,89,Vestuário,5,187
41567,2024-01-29 20:46:00,20,155,Eletrônico,5,175
41568,2024-01-29 20:47:00,89,69,Eletrônico,7,158
41569,2024-01-29 20:48:00,87,125,Móvel,8,212
41570,2024-01-29 20:49:00,93,125,Eletrônico,9,218
41571,2024-01-29 20:50:00,66,71,Móvel,5,137
41572,2024-01-29 20:51:00,57,81,Móvel,1,138
41573,2024-01-29 20:52:00,71,101,Brinquedo,9,172
41574,2024-01-29 20:53:00,23,161,Móvel,7,184
41575,2024-01-29 20:54:00,85,22,Móvel,6,107
41576,2024-01-29 20:55:00,78,67,Alimento,1,145
41577,2024-01-29 20:56:00,118,73,Móvel,3,191
41578,2024-01-29 20:57:00,39,140,Brinquedo,5,179
41579,2024-01-29 20:58:00,81,114,Vestuário,9,195
41580,2024-01-29 20:59:00,107,62,Alimento,4,169
41581,2024-01-29 21:00:00,117,117,Eletrônico,3,234
41582,2024-01-29 21:01:00,14,142,Brinquedo,1,156
41583,2024-01-29 21:02:00,93,177,Vestuário,3,270
41584,2024-01-29 21:03:00,78,86,Móvel,7,164
41585,2024-01-29 21:04:00,17,92,Vestuário,1,109
41586,2024-01-29 21:05:00,45,129,Alimento,3,174
41587,2024-01-29 21:06:00,53,58,Vestuário,5,111
41588,2024-01-29 21:07:00,85,63,Eletrônico,3,148
41589,2024-01-29 21:08:00,85,74,Brinquedo,2,159
41590,2024-01-29 21:09:00,13,111,Eletrônico,4,124
41591,2024-01-29 21:10:00,23,150,Alimento,1,173
41592,2024-01-29 21:11:00,59,127,Móvel,3,186
41593,2024-01-29 21:12:00,38,170,Móvel,7,208
41594,2024-01-29 21:13:00,38,83,Eletrônico,1,121
41595,2024-01-29 21:14:00,28,105,Eletrônico,7,133
41596,2024-01-29 21:15:00,43,115,Móvel,4,158
41597,2024-01-29 21:16:00,72,18,Brinquedo,3,90
41598,2024-01-29 21:17:00,91,174,Móvel,8,265
41599,2024-01-29 21:18:00,38,33,Vestuário,2,71
41600,2024-01-29 21:19:00,44,39,Vestuário,7,83
41601,2024-01-29 21:20:00,110,73,Móvel,3,183
41602,2024-01-29 21:21:00,45,108,Alimento,1,153
41603,2024-01-29 21:22:00,38,89,Alimento,3,127
41604,2024-01-29 21:23:00,84,84,Vestuário,9,168
41605,2024-01-29 21:24:00,64,128,Móvel,4,192
41606,2024-01-29 21:25:00,24,97,Móvel,1,121
41607,2024-01-29 21:26:00,25,80,Móvel,4,105
41608,2024-01-29 21:27:00,94,106,Brinquedo,2,200
41609,2024-01-29 21:28:00,101,154,Alimento,4,255
41610,2024-01-29 21:29:00,21,172,Vestuário,9,193
41611,2024-01-29 21:30:00,72,147,Vestuário,4,219
41612,2024-01-29 21:31:00,106,113,Móvel,9,219
41613,2024-01-29 21:32:00,47,160,Alimento,8,207
41614,2024-01-29 21:33:00,33,47,Eletrônico,5,80
41615,2024-01-29 21:34:00,113,71,Móvel,6,184
41616,2024-01-29 21:35:00,93,62,Alimento,9,155
41617,2024-01-29 21:36:00,76,95,Brinquedo,8,171
41618,2024-01-29 21:37:00,86,50,Móvel,5,136
41619,2024-01-29 21:38:00,100,28,Vestuário,7,128
41620,2024-01-29 21:39:00,57,24,Vestuário,5,81
41621,2024-01-29 21:40:00,35,70,Vestuário,2,105
41622,2024-01-29 21:41:00,64,44,Brinquedo,6,108
41623,2024-01-29 21:42:00,67,117,Alimento,6,184
41624,2024-01-29 21:43:00,78,110,Eletrônico,7,188
41625,2024-01-29 21:44:00,81,42,Vestuário,4,123
41626,2024-01-29 21:45:00,97,86,Alimento,8,183
41627,2024-01-29 21:46:00,86,66,Eletrônico,1,152
41628,2024-01-29 21:47:00,51,13,Alimento,8,64
41629,2024-01-29 21:48:00,17,73,Alimento,3,90
41630,2024-01-29 21:49:00,73,44,Alimento,2,117
41631,2024-01-29 21:50:00,26,87,Eletrônico,6,113
41632,2024-01-29 21:51:00,52,16,Vestuário,1,68
41633,2024-01-29 21:52:00,47,26,Alimento,3,73
41634,2024-01-29 21:53:00,84,148,Vestuário,3,232
41635,2024-01-29 21:54:00,90,56,Alimento,7,146
41636,2024-01-29 21:55:00,55,81,Eletrônico,6,136
41637,2024-01-29 21:56:00,43,95,Brinquedo,5,138
41638,2024-01-29 21:57:00,38,83,Alimento,8,121
41639,2024-01-29 21:58:00,46,37,Móvel,1,83
41640,2024-01-29 21:59:00,109,117,Vestuário,9,226
41641,2024-01-29 22:00:00,61,53,Vestuário,5,114
41642,2024-01-29 22:01:00,55,141,Móvel,5,196
41643,2024-01-29 22:02:00,82,55,Eletrônico,2,137
41644,2024-01-29 22:03:00,46,140,Brinquedo,1,186
41645,2024-01-29 22:04:00,68,154,Alimento,7,222
41646,2024-01-29 22:05:00,103,33,Alimento,8,136
41647,2024-01-29 22:06:00,97,132,Móvel,3,229
41648,2024-01-29 22:07:00,22,141,Vestuário,4,163
41649,2024-01-29 22:08:00,50,102,Eletrônico,1,152
41650,2024-01-29 22:09:00,10,152,Eletrônico,2,162
41651,2024-01-29 22:10:00,40,24,Móvel,5,64
41652,2024-01-29 22:11:00,91,165,Vestuário,7,256
41653,2024-01-29 22:12:00,55,22,Móvel,1,77
41654,2024-01-29 22:13:00,116,75,Vestuário,8,191
41655,2024-01-29 22:14:00,109,92,Móvel,9,201
41656,2024-01-29 22:15:00,112,113,Alimento,5,225
41657,2024-01-29 22:16:00,36,89,Eletrônico,2,125
41658,2024-01-29 22:17:00,68,121,Brinquedo,1,189
41659,2024-01-29 22:18:00,111,57,Alimento,3,168
41660,2024-01-29 22:19:00,73,38,Eletrônico,3,111
41661,2024-01-29 22:20:00,40,99,Alimento,5,139
41662,2024-01-29 22:21:00,114,29,Brinquedo,1,143
41663,2024-01-29 22:22:00,67,47,Alimento,6,114
41664,2024-01-29 22:23:00,111,43,Alimento,1,154
41665,2024-01-29 22:24:00,38,85,Móvel,4,123
41666,2024-01-29 22:25:00,98,171,Brinquedo,8,269
41667,2024-01-29 22:26:00,19,150,Eletrônico,5,169
41668,2024-01-29 22:27:00,93,31,Alimento,6,124
41669,2024-01-29 22:28:00,14,61,Móvel,4,75
41670,2024-01-29 22:29:00,62,65,Móvel,2,127
41671,2024-01-29 22:30:00,86,108,Vestuário,6,194
41672,2024-01-29 22:31:00,20,36,Brinquedo,8,56
41673,2024-01-29 22:32:00,15,57,Brinquedo,2,72
41674,2024-01-29 22:33:00,80,155,Alimento,9,235
41675,2024-01-29 22:34:00,118,155,Brinquedo,3,273
41676,2024-01-29 22:35:00,89,121,Eletrônico,4,210
41677,2024-01-29 22:36:00,38,12,Eletrônico,9,50
41678,2024-01-29 22:37:00,51,117,Vestuário,2,168
41679,2024-01-29 22:38:00,34,137,Alimento,6,171
41680,2024-01-29 22:39:00,115,134,Vestuário,8,249
41681,2024-01-29 22:40:00,112,10,Brinquedo,1,122
41682,2024-01-29 22:41:00,103,144,Alimento,7,247
41683,2024-01-29 22:42:00,50,72,Alimento,6,122
41684,2024-01-29 22:43:00,83,146,Eletrônico,4,229
41685,2024-01-29 22:44:00,12,124,Eletrônico,4,136
41686,2024-01-29 22:45:00,88,115,Alimento,7,203
41687,2024-01-29 22:46:00,84,34,Brinquedo,6,118
41688,2024-01-29 22:47:00,56,66,Vestuário,7,122
41689,2024-01-29 22:48:00,99,73,Eletrônico,7,172
41690,2024-01-29 22:49:00,102,91,Brinquedo,8,193
41691,2024-01-29 22:50:00,110,105,Alimento,1,215
41692,2024-01-29 22:51:00,117,96,Móvel,8,213
41693,2024-01-29 22:52:00,51,130,Vestuário,2,181
41694,2024-01-29 22:53:00,58,112,Vestuário,1,170
41695,2024-01-29 22:54:00,34,147,Vestuário,9,181
41696,2024-01-29 22:55:00,54,60,Eletrônico,1,114
41697,2024-01-29 22:56:00,92,172,Alimento,1,264
41698,2024-01-29 22:57:00,70,55,Brinquedo,2,125
41699,2024-01-29 22:58:00,34,102,Alimento,6,136
41700,2024-01-29 22:59:00,75,47,Eletrônico,2,122
41701,2024-01-29 23:00:00,18,83,Alimento,6,101
41702,2024-01-29 23:01:00,105,20,Alimento,2,125
41703,2024-01-29 23:02:00,78,98,Brinquedo,7,176
41704,2024-01-29 23:03:00,83,171,Móvel,5,254
41705,2024-01-29 23:04:00,48,46,Móvel,7,94
41706,2024-01-29 23:05:00,106,140,Eletrônico,7,246
41707,2024-01-29 23:06:00,51,91,Móvel,5,142
41708,2024-01-29 23:07:00,62,87,Alimento,5,149
41709,2024-01-29 23:08:00,55,95,Brinquedo,8,150
41710,2024-01-29 23:09:00,41,113,Móvel,4,154
41711,2024-01-29 23:10:00,31,55,Vestuário,9,86
41712,2024-01-29 23:11:00,63,95,Alimento,1,158
41713,2024-01-29 23:12:00,109,79,Alimento,5,188
41714,2024-01-29 23:13:00,21,125,Brinquedo,6,146
41715,2024-01-29 23:14:00,43,161,Móvel,1,204
41716,2024-01-29 23:15:00,53,82,Móvel,6,135
41717,2024-01-29 23:16:00,66,71,Alimento,7,137
41718,2024-01-29 23:17:00,102,90,Alimento,1,192
41719,2024-01-29 23:18:00,42,33,Brinquedo,6,75
41720,2024-01-29 23:19:00,63,71,Vestuário,1,134
41721,2024-01-29 23:20:00,67,40,Móvel,8,107
41722,2024-01-29 23:21:00,73,163,Brinquedo,4,236
41723,2024-01-29 23:22:00,56,57,Vestuário,4,113
41724,2024-01-29 23:23:00,110,83,Eletrônico,9,193
41725,2024-01-29 23:24:00,98,114,Eletrônico,1,212
41726,2024-01-29 23:25:00,20,151,Móvel,2,171
41727,2024-01-29 23:26:00,84,169,Alimento,4,253
41728,2024-01-29 23:27:00,96,135,Eletrônico,3,231
41729,2024-01-29 23:28:00,58,122,Eletrônico,1,180
41730,2024-01-29 23:29:00,119,179,Eletrônico,7,298
41731,2024-01-29 23:30:00,16,69,Vestuário,2,85
41732,2024-01-29 23:31:00,73,30,Eletrônico,5,103
41733,2024-01-29 23:32:00,114,171,Móvel,7,285
41734,2024-01-29 23:33:00,42,13,Brinquedo,9,55
41735,2024-01-29 23:34:00,36,40,Brinquedo,4,76
41736,2024-01-29 23:35:00,43,178,Alimento,9,221
41737,2024-01-29 23:36:00,113,77,Móvel,7,190
41738,2024-01-29 23:37:00,112,75,Vestuário,4,187
41739,2024-01-29 23:38:00,71,136,Eletrônico,4,207
41740,2024-01-29 23:39:00,64,55,Vestuário,7,119
41741,2024-01-29 23:40:00,87,131,Eletrônico,2,218
41742,2024-01-29 23:41:00,103,158,Brinquedo,6,261
41743,2024-01-29 23:42:00,31,112,Eletrônico,9,143
41744,2024-01-29 23:43:00,51,97,Alimento,5,148
41745,2024-01-29 23:44:00,61,93,Alimento,3,154
41746,2024-01-29 23:45:00,44,81,Vestuário,2,125
41747,2024-01-29 23:46:00,92,84,Móvel,6,176
41748,2024-01-29 23:47:00,46,23,Móvel,9,69
41749,2024-01-29 23:48:00,23,163,Alimento,4,186
41750,2024-01-29 23:49:00,68,43,Brinquedo,1,111
41751,2024-01-29 23:50:00,20,69,Brinquedo,6,89
41752,2024-01-29 23:51:00,116,64,Móvel,1,180
41753,2024-01-29 23:52:00,24,158,Eletrônico,3,182
41754,2024-01-29 23:53:00,91,48,Vestuário,6,139
41755,2024-01-29 23:54:00,41,61,Brinquedo,9,102
41756,2024-01-29 23:55:00,61,18,Alimento,5,79
41757,2024-01-29 23:56:00,44,120,Vestuário,9,164
41758,2024-01-29 23:57:00,100,77,Vestuário,3,177
41759,2024-01-29 23:58:00,109,92,Móvel,8,201
41760,2024-01-29 23:59:00,13,56,Vestuário,5,69
41761,2024-01-30 00:00:00,66,27,Vestuário,6,93
41762,2024-01-30 00:01:00,89,146,Alimento,1,235
41763,2024-01-30 00:02:00,82,138,Móvel,9,220
41764,2024-01-30 00:03:00,53,38,Eletrônico,2,91
41765,2024-01-30 00:04:00,74,80,Alimento,9,154
41766,2024-01-30 00:05:00,108,148,Vestuário,7,256
41767,2024-01-30 00:06:00,58,166,Móvel,1,224
41768,2024-01-30 00:07:00,106,71,Alimento,9,177
41769,2024-01-30 00:08:00,60,67,Alimento,5,127
41770,2024-01-30 00:09:00,72,69,Brinquedo,1,141
41771,2024-01-30 00:10:00,98,157,Eletrônico,1,255
41772,2024-01-30 00:11:00,57,17,Vestuário,8,74
41773,2024-01-30 00:12:00,71,99,Brinquedo,3,170
41774,2024-01-30 00:13:00,18,105,Eletrônico,6,123
41775,2024-01-30 00:14:00,43,46,Brinquedo,4,89
41776,2024-01-30 00:15:00,80,164,Alimento,3,244
41777,2024-01-30 00:16:00,74,66,Alimento,1,140
41778,2024-01-30 00:17:00,78,38,Vestuário,6,116
41779,2024-01-30 00:18:00,103,38,Eletrônico,6,141
41780,2024-01-30 00:19:00,97,75,Eletrônico,2,172
41781,2024-01-30 00:20:00,18,14,Brinquedo,5,32
41782,2024-01-30 00:21:00,43,81,Brinquedo,2,124
41783,2024-01-30 00:22:00,73,67,Móvel,1,140
41784,2024-01-30 00:23:00,55,176,Alimento,6,231
41785,2024-01-30 00:24:00,114,131,Móvel,4,245
41786,2024-01-30 00:25:00,41,82,Brinquedo,2,123
41787,2024-01-30 00:26:00,25,127,Alimento,2,152
41788,2024-01-30 00:27:00,41,101,Móvel,4,142
41789,2024-01-30 00:28:00,76,157,Vestuário,4,233
41790,2024-01-30 00:29:00,35,173,Vestuário,9,208
41791,2024-01-30 00:30:00,103,25,Alimento,5,128
41792,2024-01-30 00:31:00,88,30,Brinquedo,7,118
41793,2024-01-30 00:32:00,30,95,Móvel,4,125
41794,2024-01-30 00:33:00,84,77,Vestuário,8,161
41795,2024-01-30 00:34:00,99,126,Eletrônico,5,225
41796,2024-01-30 00:35:00,82,29,Brinquedo,2,111
41797,2024-01-30 00:36:00,90,113,Brinquedo,5,203
41798,2024-01-30 00:37:00,29,46,Móvel,6,75
41799,2024-01-30 00:38:00,51,157,Alimento,3,208
41800,2024-01-30 00:39:00,59,85,Alimento,4,144
41801,2024-01-30 00:40:00,69,47,Alimento,3,116
41802,2024-01-30 00:41:00,66,27,Vestuário,2,93
41803,2024-01-30 00:42:00,103,24,Eletrônico,3,127
41804,2024-01-30 00:43:00,108,42,Brinquedo,7,150
41805,2024-01-30 00:44:00,27,12,Alimento,1,39
41806,2024-01-30 00:45:00,63,43,Vestuário,6,106
41807,2024-01-30 00:46:00,10,40,Brinquedo,9,50
41808,2024-01-30 00:47:00,61,146,Alimento,6,207
41809,2024-01-30 00:48:00,18,161,Brinquedo,4,179
41810,2024-01-30 00:49:00,10,30,Vestuário,6,40
41811,2024-01-30 00:50:00,21,131,Brinquedo,1,152
41812,2024-01-30 00:51:00,114,143,Móvel,2,257
41813,2024-01-30 00:52:00,39,42,Móvel,4,81
41814,2024-01-30 00:53:00,118,123,Vestuário,6,241
41815,2024-01-30 00:54:00,113,24,Eletrônico,1,137
41816,2024-01-30 00:55:00,52,131,Eletrônico,7,183
41817,2024-01-30 00:56:00,17,86,Vestuário,3,103
41818,2024-01-30 00:57:00,24,49,Móvel,3,73
41819,2024-01-30 00:58:00,92,163,Móvel,6,255
41820,2024-01-30 00:59:00,104,131,Alimento,9,235
41821,2024-01-30 01:00:00,26,67,Vestuário,1,93
41822,2024-01-30 01:01:00,57,59,Vestuário,8,116
41823,2024-01-30 01:02:00,84,176,Vestuário,5,260
41824,2024-01-30 01:03:00,76,157,Brinquedo,4,233
41825,2024-01-30 01:04:00,78,117,Brinquedo,8,195
41826,2024-01-30 01:05:00,47,151,Móvel,7,198
41827,2024-01-30 01:06:00,71,92,Eletrônico,2,163
41828,2024-01-30 01:07:00,96,49,Móvel,4,145
41829,2024-01-30 01:08:00,77,123,Eletrônico,9,200
41830,2024-01-30 01:09:00,63,146,Eletrônico,6,209
41831,2024-01-30 01:10:00,105,48,Alimento,5,153
41832,2024-01-30 01:11:00,95,169,Eletrônico,3,264
41833,2024-01-30 01:12:00,10,87,Móvel,4,97
41834,2024-01-30 01:13:00,89,128,Brinquedo,5,217
41835,2024-01-30 01:14:00,98,155,Alimento,4,253
41836,2024-01-30 01:15:00,26,62,Vestuário,4,88
41837,2024-01-30 01:16:00,70,119,Alimento,6,189
41838,2024-01-30 01:17:00,93,79,Vestuário,9,172
41839,2024-01-30 01:18:00,42,62,Brinquedo,2,104
41840,2024-01-30 01:19:00,63,152,Eletrônico,9,215
41841,2024-01-30 01:20:00,61,115,Móvel,2,176
41842,2024-01-30 01:21:00,67,10,Alimento,9,77
41843,2024-01-30 01:22:00,28,125,Vestuário,6,153
41844,2024-01-30 01:23:00,49,136,Eletrônico,7,185
41845,2024-01-30 01:24:00,26,104,Eletrônico,9,130
41846,2024-01-30 01:25:00,69,85,Móvel,7,154
41847,2024-01-30 01:26:00,64,39,Vestuário,2,103
41848,2024-01-30 01:27:00,40,172,Eletrônico,9,212
41849,2024-01-30 01:28:00,36,45,Vestuário,6,81
41850,2024-01-30 01:29:00,29,125,Eletrônico,8,154
41851,2024-01-30 01:30:00,47,169,Alimento,9,216
41852,2024-01-30 01:31:00,86,97,Brinquedo,8,183
41853,2024-01-30 01:32:00,85,90,Brinquedo,6,175
41854,2024-01-30 01:33:00,76,176,Brinquedo,2,252
41855,2024-01-30 01:34:00,99,93,Alimento,1,192
41856,2024-01-30 01:35:00,70,149,Vestuário,7,219
41857,2024-01-30 01:36:00,36,156,Eletrônico,9,192
41858,2024-01-30 01:37:00,11,94,Alimento,9,105
41859,2024-01-30 01:38:00,119,103,Móvel,4,222
41860,2024-01-30 01:39:00,61,159,Eletrônico,9,220
41861,2024-01-30 01:40:00,30,73,Brinquedo,7,103
41862,2024-01-30 01:41:00,83,33,Vestuário,4,116
41863,2024-01-30 01:42:00,113,87,Vestuário,5,200
41864,2024-01-30 01:43:00,98,55,Brinquedo,3,153
41865,2024-01-30 01:44:00,12,33,Vestuário,2,45
41866,2024-01-30 01:45:00,52,165,Móvel,5,217
41867,2024-01-30 01:46:00,54,97,Vestuário,5,151
41868,2024-01-30 01:47:00,105,128,Alimento,9,233
41869,2024-01-30 01:48:00,14,149,Alimento,3,163
41870,2024-01-30 01:49:00,20,168,Móvel,3,188
41871,2024-01-30 01:50:00,37,92,Eletrônico,9,129
41872,2024-01-30 01:51:00,56,148,Móvel,9,204
41873,2024-01-30 01:52:00,55,86,Vestuário,6,141
41874,2024-01-30 01:53:00,113,175,Eletrônico,4,288
41875,2024-01-30 01:54:00,18,89,Brinquedo,1,107
41876,2024-01-30 01:55:00,71,53,Alimento,4,124
41877,2024-01-30 01:56:00,102,119,Eletrônico,3,221
41878,2024-01-30 01:57:00,69,173,Vestuário,8,242
41879,2024-01-30 01:58:00,46,13,Vestuário,2,59
41880,2024-01-30 01:59:00,57,26,Eletrônico,9,83
41881,2024-01-30 02:00:00,34,74,Eletrônico,8,108
41882,2024-01-30 02:01:00,42,41,Eletrônico,4,83
41883,2024-01-30 02:02:00,47,11,Eletrônico,6,58
41884,2024-01-30 02:03:00,82,18,Móvel,6,100
41885,2024-01-30 02:04:00,33,64,Móvel,4,97
41886,2024-01-30 02:05:00,21,12,Alimento,5,33
41887,2024-01-30 02:06:00,82,129,Brinquedo,1,211
41888,2024-01-30 02:07:00,48,59,Alimento,4,107
41889,2024-01-30 02:08:00,70,62,Vestuário,3,132
41890,2024-01-30 02:09:00,41,128,Alimento,5,169
41891,2024-01-30 02:10:00,89,154,Brinquedo,3,243
41892,2024-01-30 02:11:00,14,178,Alimento,6,192
41893,2024-01-30 02:12:00,41,157,Brinquedo,5,198
41894,2024-01-30 02:13:00,19,107,Brinquedo,4,126
41895,2024-01-30 02:14:00,82,94,Eletrônico,8,176
41896,2024-01-30 02:15:00,41,139,Móvel,5,180
41897,2024-01-30 02:16:00,73,41,Eletrônico,3,114
41898,2024-01-30 02:17:00,15,83,Móvel,9,98
41899,2024-01-30 02:18:00,111,57,Móvel,1,168
41900,2024-01-30 02:19:00,86,83,Alimento,5,169
41901,2024-01-30 02:20:00,93,153,Eletrônico,9,246
41902,2024-01-30 02:21:00,92,77,Brinquedo,6,169
41903,2024-01-30 02:22:00,97,59,Móvel,9,156
41904,2024-01-30 02:23:00,101,86,Brinquedo,7,187
41905,2024-01-30 02:24:00,117,131,Móvel,9,248
41906,2024-01-30 02:25:00,54,153,Alimento,5,207
41907,2024-01-30 02:26:00,11,52,Eletrônico,9,63
41908,2024-01-30 02:27:00,93,170,Eletrônico,6,263
41909,2024-01-30 02:28:00,57,12,Alimento,8,69
41910,2024-01-30 02:29:00,62,151,Vestuário,9,213
41911,2024-01-30 02:30:00,31,161,Vestuário,6,192
41912,2024-01-30 02:31:00,61,25,Móvel,8,86
41913,2024-01-30 02:32:00,90,148,Eletrônico,5,238
41914,2024-01-30 02:33:00,61,115,Móvel,7,176
41915,2024-01-30 02:34:00,82,55,Móvel,3,137
41916,2024-01-30 02:35:00,42,85,Vestuário,6,127
41917,2024-01-30 02:36:00,70,64,Eletrônico,8,134
41918,2024-01-30 02:37:00,113,119,Móvel,1,232
41919,2024-01-30 02:38:00,24,144,Eletrônico,1,168
41920,2024-01-30 02:39:00,25,64,Eletrônico,5,89
41921,2024-01-30 02:40:00,80,55,Móvel,8,135
41922,2024-01-30 02:41:00,43,98,Eletrônico,8,141
41923,2024-01-30 02:42:00,95,11,Móvel,6,106
41924,2024-01-30 02:43:00,54,27,Eletrônico,3,81
41925,2024-01-30 02:44:00,33,122,Móvel,1,155
41926,2024-01-30 02:45:00,19,34,Vestuário,5,53
41927,2024-01-30 02:46:00,63,99,Móvel,1,162
41928,2024-01-30 02:47:00,70,99,Móvel,9,169
41929,2024-01-30 02:48:00,61,129,Eletrônico,3,190
41930,2024-01-30 02:49:00,39,111,Eletrônico,1,150
41931,2024-01-30 02:50:00,45,78,Brinquedo,9,123
41932,2024-01-30 02:51:00,10,13,Vestuário,2,23
41933,2024-01-30 02:52:00,38,61,Vestuário,5,99
41934,2024-01-30 02:53:00,108,72,Brinquedo,1,180
41935,2024-01-30 02:54:00,107,18,Vestuário,4,125
41936,2024-01-30 02:55:00,75,152,Vestuário,9,227
41937,2024-01-30 02:56:00,100,146,Vestuário,7,246
41938,2024-01-30 02:57:00,21,81,Móvel,1,102
41939,2024-01-30 02:58:00,45,93,Alimento,9,138
41940,2024-01-30 02:59:00,78,144,Alimento,7,222
41941,2024-01-30 03:00:00,105,92,Alimento,9,197
41942,2024-01-30 03:01:00,15,158,Móvel,1,173
41943,2024-01-30 03:02:00,107,37,Brinquedo,9,144
41944,2024-01-30 03:03:00,77,43,Alimento,6,120
41945,2024-01-30 03:04:00,113,15,Brinquedo,2,128
41946,2024-01-30 03:05:00,14,171,Alimento,7,185
41947,2024-01-30 03:06:00,39,11,Vestuário,5,50
41948,2024-01-30 03:07:00,42,149,Brinquedo,9,191
41949,2024-01-30 03:08:00,22,116,Vestuário,5,138
41950,2024-01-30 03:09:00,83,18,Brinquedo,9,101
41951,2024-01-30 03:10:00,78,86,Vestuário,6,164
41952,2024-01-30 03:11:00,93,52,Vestuário,3,145
41953,2024-01-30 03:12:00,96,131,Eletrônico,8,227
41954,2024-01-30 03:13:00,11,169,Brinquedo,3,180
41955,2024-01-30 03:14:00,86,40,Eletrônico,1,126
41956,2024-01-30 03:15:00,116,84,Brinquedo,1,200
41957,2024-01-30 03:16:00,90,135,Móvel,9,225
41958,2024-01-30 03:17:00,95,33,Móvel,7,128
41959,2024-01-30 03:18:00,20,131,Eletrônico,5,151
41960,2024-01-30 03:19:00,108,86,Vestuário,3,194
41961,2024-01-30 03:20:00,17,71,Alimento,9,88
41962,2024-01-30 03:21:00,111,97,Vestuário,4,208
41963,2024-01-30 03:22:00,75,67,Móvel,1,142
41964,2024-01-30 03:23:00,22,69,Vestuário,1,91
41965,2024-01-30 03:24:00,97,84,Brinquedo,6,181
41966,2024-01-30 03:25:00,96,97,Eletrônico,7,193
41967,2024-01-30 03:26:00,84,160,Móvel,3,244
41968,2024-01-30 03:27:00,82,73,Vestuário,2,155
41969,2024-01-30 03:28:00,89,44,Eletrônico,2,133
41970,2024-01-30 03:29:00,103,137,Vestuário,9,240
41971,2024-01-30 03:30:00,77,25,Eletrônico,1,102
41972,2024-01-30 03:31:00,72,171,Móvel,3,243
41973,2024-01-30 03:32:00,62,150,Vestuário,8,212
41974,2024-01-30 03:33:00,22,90,Alimento,2,112
41975,2024-01-30 03:34:00,93,166,Brinquedo,8,259
41976,2024-01-30 03:35:00,84,13,Móvel,9,97
41977,2024-01-30 03:36:00,118,80,Alimento,4,198
41978,2024-01-30 03:37:00,45,63,Vestuário,6,108
41979,2024-01-30 03:38:00,48,95,Vestuário,3,143
41980,2024-01-30 03:39:00,22,157,Móvel,5,179
41981,2024-01-30 03:40:00,27,100,Vestuário,8,127
41982,2024-01-30 03:41:00,13,70,Alimento,9,83
41983,2024-01-30 03:42:00,89,108,Alimento,2,197
41984,2024-01-30 03:43:00,30,179,Vestuário,6,209
41985,2024-01-30 03:44:00,75,65,Móvel,4,140
41986,2024-01-30 03:45:00,100,168,Alimento,7,268
41987,2024-01-30 03:46:00,103,141,Móvel,2,244
41988,2024-01-30 03:47:00,27,43,Vestuário,5,70
41989,2024-01-30 03:48:00,66,175,Alimento,3,241
41990,2024-01-30 03:49:00,47,46,Móvel,9,93
41991,2024-01-30 03:50:00,107,56,Brinquedo,6,163
41992,2024-01-30 03:51:00,75,32,Alimento,8,107
41993,2024-01-30 03:52:00,101,62,Brinquedo,6,163
41994,2024-01-30 03:53:00,83,179,Eletrônico,9,262
41995,2024-01-30 03:54:00,34,101,Eletrônico,9,135
41996,2024-01-30 03:55:00,32,157,Eletrônico,5,189
41997,2024-01-30 03:56:00,24,151,Vestuário,6,175
41998,2024-01-30 03:57:00,76,74,Eletrônico,9,150
41999,2024-01-30 03:58:00,66,71,Eletrônico,3,137
42000,2024-01-30 03:59:00,63,60,Móvel,8,123
42001,2024-01-30 04:00:00,77,40,Brinquedo,9,117
42002,2024-01-30 04:01:00,38,72,Alimento,8,110
42003,2024-01-30 04:02:00,13,22,Brinquedo,6,35
42004,2024-01-30 04:03:00,39,127,Brinquedo,1,166
42005,2024-01-30 04:04:00,41,117,Vestuário,4,158
42006,2024-01-30 04:05:00,14,165,Vestuário,2,179
42007,2024-01-30 04:06:00,98,176,Móvel,6,274
42008,2024-01-30 04:07:00,42,106,Brinquedo,6,148
42009,2024-01-30 04:08:00,91,33,Eletrônico,2,124
42010,2024-01-30 04:09:00,51,97,Alimento,4,148
42011,2024-01-30 04:10:00,63,104,Eletrônico,5,167
42012,2024-01-30 04:11:00,42,100,Vestuário,7,142
42013,2024-01-30 04:12:00,51,86,Brinquedo,3,137
42014,2024-01-30 04:13:00,69,30,Alimento,6,99
42015,2024-01-30 04:14:00,26,130,Móvel,8,156
42016,2024-01-30 04:15:00,19,172,Móvel,2,191
42017,2024-01-30 04:16:00,29,42,Alimento,9,71
42018,2024-01-30 04:17:00,25,75,Móvel,2,100
42019,2024-01-30 04:18:00,115,146,Móvel,1,261
42020,2024-01-30 04:19:00,72,24,Eletrônico,2,96
42021,2024-01-30 04:20:00,102,161,Móvel,7,263
42022,2024-01-30 04:21:00,93,167,Alimento,7,260
42023,2024-01-30 04:22:00,79,89,Eletrônico,7,168
42024,2024-01-30 04:23:00,109,82,Alimento,6,191
42025,2024-01-30 04:24:00,95,134,Brinquedo,8,229
42026,2024-01-30 04:25:00,64,138,Móvel,4,202
42027,2024-01-30 04:26:00,75,112,Móvel,7,187
42028,2024-01-30 04:27:00,44,147,Eletrônico,8,191
42029,2024-01-30 04:28:00,19,39,Vestuário,9,58
42030,2024-01-30 04:29:00,116,164,Eletrônico,4,280
42031,2024-01-30 04:30:00,87,96,Vestuário,2,183
42032,2024-01-30 04:31:00,20,51,Móvel,8,71
42033,2024-01-30 04:32:00,92,49,Eletrônico,2,141
42034,2024-01-30 04:33:00,88,129,Alimento,7,217
42035,2024-01-30 04:34:00,109,34,Móvel,4,143
42036,2024-01-30 04:35:00,64,153,Eletrônico,9,217
42037,2024-01-30 04:36:00,34,45,Vestuário,8,79
42038,2024-01-30 04:37:00,49,138,Eletrônico,9,187
42039,2024-01-30 04:38:00,39,105,Móvel,6,144
42040,2024-01-30 04:39:00,119,22,Vestuário,9,141
42041,2024-01-30 04:40:00,48,150,Vestuário,7,198
42042,2024-01-30 04:41:00,69,169,Vestuário,7,238
42043,2024-01-30 04:42:00,52,132,Eletrônico,2,184
42044,2024-01-30 04:43:00,18,37,Eletrônico,3,55
42045,2024-01-30 04:44:00,78,68,Alimento,7,146
42046,2024-01-30 04:45:00,70,129,Brinquedo,3,199
42047,2024-01-30 04:46:00,69,15,Móvel,9,84
42048,2024-01-30 04:47:00,80,36,Eletrônico,7,116
42049,2024-01-30 04:48:00,69,130,Alimento,1,199
42050,2024-01-30 04:49:00,47,115,Vestuário,3,162
42051,2024-01-30 04:50:00,55,68,Móvel,5,123
42052,2024-01-30 04:51:00,50,33,Vestuário,6,83
42053,2024-01-30 04:52:00,76,75,Brinquedo,4,151
42054,2024-01-30 04:53:00,96,145,Brinquedo,1,241
42055,2024-01-30 04:54:00,16,141,Móvel,9,157
42056,2024-01-30 04:55:00,31,64,Alimento,5,95
42057,2024-01-30 04:56:00,64,135,Vestuário,6,199
42058,2024-01-30 04:57:00,108,88,Alimento,4,196
42059,2024-01-30 04:58:00,78,81,Móvel,5,159
42060,2024-01-30 04:59:00,107,17,Alimento,4,124
42061,2024-01-30 05:00:00,84,106,Vestuário,3,190
42062,2024-01-30 05:01:00,21,29,Vestuário,7,50
42063,2024-01-30 05:02:00,10,68,Brinquedo,3,78
42064,2024-01-30 05:03:00,98,98,Eletrônico,5,196
42065,2024-01-30 05:04:00,44,173,Eletrônico,2,217
42066,2024-01-30 05:05:00,24,117,Eletrônico,8,141
42067,2024-01-30 05:06:00,58,51,Vestuário,4,109
42068,2024-01-30 05:07:00,91,176,Vestuário,7,267
42069,2024-01-30 05:08:00,57,145,Móvel,8,202
42070,2024-01-30 05:09:00,95,84,Móvel,1,179
42071,2024-01-30 05:10:00,72,44,Alimento,9,116
42072,2024-01-30 05:11:00,102,58,Brinquedo,4,160
42073,2024-01-30 05:12:00,80,173,Brinquedo,9,253
42074,2024-01-30 05:13:00,32,43,Móvel,5,75
42075,2024-01-30 05:14:00,64,153,Eletrônico,5,217
42076,2024-01-30 05:15:00,56,68,Vestuário,4,124
42077,2024-01-30 05:16:00,103,109,Brinquedo,4,212
42078,2024-01-30 05:17:00,37,49,Móvel,8,86
42079,2024-01-30 05:18:00,22,117,Alimento,7,139
42080,2024-01-30 05:19:00,50,158,Eletrônico,2,208
42081,2024-01-30 05:20:00,38,152,Móvel,4,190
42082,2024-01-30 05:21:00,59,96,Alimento,7,155
42083,2024-01-30 05:22:00,51,164,Brinquedo,6,215
42084,2024-01-30 05:23:00,87,37,Eletrônico,6,124
42085,2024-01-30 05:24:00,57,124,Móvel,4,181
42086,2024-01-30 05:25:00,89,68,Móvel,9,157
42087,2024-01-30 05:26:00,57,144,Alimento,9,201
42088,2024-01-30 05:27:00,94,151,Móvel,4,245
42089,2024-01-30 05:28:00,57,116,Móvel,7,173
42090,2024-01-30 05:29:00,20,95,Alimento,2,115
42091,2024-01-30 05:30:00,109,92,Eletrônico,9,201
42092,2024-01-30 05:31:00,96,20,Alimento,1,116
42093,2024-01-30 05:32:00,104,65,Eletrônico,9,169
42094,2024-01-30 05:33:00,96,134,Vestuário,3,230
42095,2024-01-30 05:34:00,89,145,Eletrônico,2,234
42096,2024-01-30 05:35:00,50,174,Móvel,2,224
42097,2024-01-30 05:36:00,53,55,Móvel,6,108
42098,2024-01-30 05:37:00,109,98,Eletrônico,3,207
42099,2024-01-30 05:38:00,68,103,Vestuário,2,171
42100,2024-01-30 05:39:00,16,166,Alimento,3,182
42101,2024-01-30 05:40:00,106,127,Móvel,9,233
42102,2024-01-30 05:41:00,59,140,Alimento,6,199
42103,2024-01-30 05:42:00,73,10,Alimento,2,83
42104,2024-01-30 05:43:00,10,29,Eletrônico,6,39
42105,2024-01-30 05:44:00,73,166,Alimento,9,239
42106,2024-01-30 05:45:00,12,71,Vestuário,5,83
42107,2024-01-30 05:46:00,33,105,Móvel,8,138
42108,2024-01-30 05:47:00,21,89,Eletrônico,6,110
42109,2024-01-30 05:48:00,19,145,Eletrônico,3,164
42110,2024-01-30 05:49:00,54,22,Móvel,4,76
42111,2024-01-30 05:50:00,102,62,Vestuário,5,164
42112,2024-01-30 05:51:00,27,149,Alimento,8,176
42113,2024-01-30 05:52:00,13,43,Vestuário,3,56
42114,2024-01-30 05:53:00,24,103,Alimento,6,127
42115,2024-01-30 05:54:00,21,70,Eletrônico,7,91
42116,2024-01-30 05:55:00,71,155,Móvel,9,226
42117,2024-01-30 05:56:00,54,130,Móvel,5,184
42118,2024-01-30 05:57:00,22,117,Eletrônico,4,139
42119,2024-01-30 05:58:00,87,91,Alimento,9,178
42120,2024-01-30 05:59:00,63,22,Vestuário,4,85
42121,2024-01-30 06:00:00,13,153,Brinquedo,7,166
42122,2024-01-30 06:01:00,52,115,Alimento,5,167
42123,2024-01-30 06:02:00,18,114,Alimento,7,132
42124,2024-01-30 06:03:00,16,89,Vestuário,7,105
42125,2024-01-30 06:04:00,78,109,Vestuário,5,187
42126,2024-01-30 06:05:00,95,174,Alimento,2,269
42127,2024-01-30 06:06:00,95,162,Móvel,5,257
42128,2024-01-30 06:07:00,119,105,Eletrônico,3,224
42129,2024-01-30 06:08:00,63,20,Móvel,2,83
42130,2024-01-30 06:09:00,13,39,Brinquedo,4,52
42131,2024-01-30 06:10:00,116,154,Alimento,3,270
42132,2024-01-30 06:11:00,78,108,Alimento,8,186
42133,2024-01-30 06:12:00,75,140,Eletrônico,6,215
42134,2024-01-30 06:13:00,12,66,Alimento,5,78
42135,2024-01-30 06:14:00,28,39,Brinquedo,3,67
42136,2024-01-30 06:15:00,31,178,Eletrônico,7,209
42137,2024-01-30 06:16:00,103,59,Brinquedo,8,162
42138,2024-01-30 06:17:00,66,92,Alimento,9,158
42139,2024-01-30 06:18:00,41,91,Brinquedo,2,132
42140,2024-01-30 06:19:00,49,135,Móvel,9,184
42141,2024-01-30 06:20:00,100,132,Móvel,2,232
42142,2024-01-30 06:21:00,106,30,Eletrônico,1,136
42143,2024-01-30 06:22:00,102,125,Móvel,1,227
42144,2024-01-30 06:23:00,85,154,Vestuário,4,239
42145,2024-01-30 06:24:00,58,97,Alimento,8,155
42146,2024-01-30 06:25:00,28,179,Eletrônico,1,207
42147,2024-01-30 06:26:00,66,93,Eletrônico,1,159
42148,2024-01-30 06:27:00,101,76,Eletrônico,9,177
42149,2024-01-30 06:28:00,70,179,Vestuário,3,249
42150,2024-01-30 06:29:00,92,33,Brinquedo,5,125
42151,2024-01-30 06:30:00,103,58,Eletrônico,7,161
42152,2024-01-30 06:31:00,106,63,Eletrônico,3,169
42153,2024-01-30 06:32:00,50,152,Alimento,2,202
42154,2024-01-30 06:33:00,75,104,Eletrônico,8,179
42155,2024-01-30 06:34:00,34,81,Alimento,9,115
42156,2024-01-30 06:35:00,68,162,Eletrônico,3,230
42157,2024-01-30 06:36:00,51,85,Eletrônico,2,136
42158,2024-01-30 06:37:00,117,160,Eletrônico,4,277
42159,2024-01-30 06:38:00,50,157,Brinquedo,2,207
42160,2024-01-30 06:39:00,47,27,Vestuário,3,74
42161,2024-01-30 06:40:00,44,170,Eletrônico,1,214
42162,2024-01-30 06:41:00,85,26,Móvel,3,111
42163,2024-01-30 06:42:00,105,113,Brinquedo,4,218
42164,2024-01-30 06:43:00,41,64,Vestuário,8,105
42165,2024-01-30 06:44:00,53,150,Alimento,2,203
42166,2024-01-30 06:45:00,75,58,Móvel,6,133
42167,2024-01-30 06:46:00,72,164,Alimento,5,236
42168,2024-01-30 06:47:00,67,132,Móvel,4,199
42169,2024-01-30 06:48:00,28,47,Alimento,2,75
42170,2024-01-30 06:49:00,94,41,Eletrônico,6,135
42171,2024-01-30 06:50:00,92,142,Vestuário,7,234
42172,2024-01-30 06:51:00,34,45,Alimento,4,79
42173,2024-01-30 06:52:00,119,151,Eletrônico,3,270
42174,2024-01-30 06:53:00,111,24,Vestuário,2,135
42175,2024-01-30 06:54:00,21,151,Eletrônico,6,172
42176,2024-01-30 06:55:00,35,40,Vestuário,8,75
42177,2024-01-30 06:56:00,104,33,Alimento,5,137
42178,2024-01-30 06:57:00,21,98,Eletrônico,3,119
42179,2024-01-30 06:58:00,82,90,Móvel,6,172
42180,2024-01-30 06:59:00,17,83,Alimento,5,100
42181,2024-01-30 07:00:00,75,100,Alimento,1,175
42182,2024-01-30 07:01:00,110,115,Brinquedo,2,225
42183,2024-01-30 07:02:00,73,105,Eletrônico,8,178
42184,2024-01-30 07:03:00,51,85,Móvel,7,136
42185,2024-01-30 07:04:00,42,118,Eletrônico,6,160
42186,2024-01-30 07:05:00,72,64,Móvel,1,136
42187,2024-01-30 07:06:00,62,62,Móvel,5,124
42188,2024-01-30 07:07:00,102,151,Alimento,4,253
42189,2024-01-30 07:08:00,10,30,Brinquedo,1,40
42190,2024-01-30 07:09:00,93,159,Brinquedo,7,252
42191,2024-01-30 07:10:00,80,104,Vestuário,9,184
42192,2024-01-30 07:11:00,95,145,Vestuário,2,240
42193,2024-01-30 07:12:00,68,160,Brinquedo,6,228
42194,2024-01-30 07:13:00,106,124,Vestuário,7,230
42195,2024-01-30 07:14:00,93,11,Brinquedo,6,104
42196,2024-01-30 07:15:00,95,10,Vestuário,5,105
42197,2024-01-30 07:16:00,29,44,Alimento,6,73
42198,2024-01-30 07:17:00,57,143,Brinquedo,1,200
42199,2024-01-30 07:18:00,95,44,Vestuário,6,139
42200,2024-01-30 07:19:00,105,135,Alimento,2,240
42201,2024-01-30 07:20:00,20,61,Móvel,6,81
42202,2024-01-30 07:21:00,45,137,Brinquedo,2,182
42203,2024-01-30 07:22:00,109,124,Vestuário,6,233
42204,2024-01-30 07:23:00,15,169,Vestuário,3,184
42205,2024-01-30 07:24:00,54,22,Brinquedo,2,76
42206,2024-01-30 07:25:00,101,99,Alimento,6,200
42207,2024-01-30 07:26:00,119,137,Eletrônico,2,256
42208,2024-01-30 07:27:00,99,57,Móvel,9,156
42209,2024-01-30 07:28:00,36,25,Vestuário,4,61
42210,2024-01-30 07:29:00,97,100,Móvel,3,197
42211,2024-01-30 07:30:00,96,12,Vestuário,7,108
42212,2024-01-30 07:31:00,42,60,Eletrônico,9,102
42213,2024-01-30 07:32:00,94,163,Vestuário,2,257
42214,2024-01-30 07:33:00,20,26,Brinquedo,7,46
42215,2024-01-30 07:34:00,77,124,Eletrônico,1,201
42216,2024-01-30 07:35:00,56,44,Móvel,4,100
42217,2024-01-30 07:36:00,83,61,Vestuário,5,144
42218,2024-01-30 07:37:00,19,56,Móvel,8,75
42219,2024-01-30 07:38:00,84,35,Alimento,1,119
42220,2024-01-30 07:39:00,22,55,Alimento,3,77
42221,2024-01-30 07:40:00,41,55,Brinquedo,3,96
42222,2024-01-30 07:41:00,11,172,Móvel,5,183
42223,2024-01-30 07:42:00,119,127,Brinquedo,4,246
42224,2024-01-30 07:43:00,73,90,Brinquedo,9,163
42225,2024-01-30 07:44:00,109,81,Alimento,7,190
42226,2024-01-30 07:45:00,89,71,Vestuário,6,160
42227,2024-01-30 07:46:00,42,16,Brinquedo,6,58
42228,2024-01-30 07:47:00,61,106,Vestuário,4,167
42229,2024-01-30 07:48:00,16,10,Vestuário,1,26
42230,2024-01-30 07:49:00,93,113,Alimento,6,206
42231,2024-01-30 07:50:00,115,151,Móvel,8,266
42232,2024-01-30 07:51:00,102,133,Alimento,5,235
42233,2024-01-30 07:52:00,78,141,Alimento,7,219
42234,2024-01-30 07:53:00,17,163,Vestuário,4,180
42235,2024-01-30 07:54:00,82,43,Vestuário,5,125
42236,2024-01-30 07:55:00,77,156,Brinquedo,2,233
42237,2024-01-30 07:56:00,40,97,Alimento,6,137
42238,2024-01-30 07:57:00,98,160,Eletrônico,7,258
42239,2024-01-30 07:58:00,85,36,Móvel,5,121
42240,2024-01-30 07:59:00,61,151,Móvel,6,212
42241,2024-01-30 08:00:00,44,26,Vestuário,9,70
42242,2024-01-30 08:01:00,67,158,Móvel,1,225
42243,2024-01-30 08:02:00,13,157,Brinquedo,5,170
42244,2024-01-30 08:03:00,32,87,Eletrônico,7,119
42245,2024-01-30 08:04:00,45,95,Alimento,1,140
42246,2024-01-30 08:05:00,32,35,Eletrônico,9,67
42247,2024-01-30 08:06:00,87,20,Eletrônico,9,107
42248,2024-01-30 08:07:00,39,129,Vestuário,2,168
42249,2024-01-30 08:08:00,49,41,Brinquedo,4,90
42250,2024-01-30 08:09:00,42,61,Brinquedo,8,103
42251,2024-01-30 08:10:00,113,171,Brinquedo,6,284
42252,2024-01-30 08:11:00,84,143,Alimento,2,227
42253,2024-01-30 08:12:00,111,91,Móvel,6,202
42254,2024-01-30 08:13:00,74,76,Alimento,6,150
42255,2024-01-30 08:14:00,58,125,Móvel,7,183
42256,2024-01-30 08:15:00,39,104,Vestuário,3,143
42257,2024-01-30 08:16:00,95,131,Brinquedo,4,226
42258,2024-01-30 08:17:00,89,67,Alimento,8,156
42259,2024-01-30 08:18:00,20,142,Alimento,3,162
42260,2024-01-30 08:19:00,68,139,Eletrônico,9,207
42261,2024-01-30 08:20:00,88,29,Eletrônico,9,117
42262,2024-01-30 08:21:00,89,130,Móvel,7,219
42263,2024-01-30 08:22:00,93,17,Móvel,9,110
42264,2024-01-30 08:23:00,10,17,Eletrônico,3,27
42265,2024-01-30 08:24:00,25,30,Brinquedo,6,55
42266,2024-01-30 08:25:00,82,83,Alimento,6,165
42267,2024-01-30 08:26:00,88,115,Vestuário,9,203
42268,2024-01-30 08:27:00,67,71,Vestuário,5,138
42269,2024-01-30 08:28:00,31,10,Vestuário,4,41
42270,2024-01-30 08:29:00,68,110,Móvel,3,178
42271,2024-01-30 08:30:00,98,143,Alimento,8,241
42272,2024-01-30 08:31:00,26,98,Eletrônico,8,124
42273,2024-01-30 08:32:00,65,41,Vestuário,2,106
42274,2024-01-30 08:33:00,11,140,Alimento,5,151
42275,2024-01-30 08:34:00,43,41,Brinquedo,5,84
42276,2024-01-30 08:35:00,36,38,Alimento,6,74
42277,2024-01-30 08:36:00,94,62,Vestuário,9,156
42278,2024-01-30 08:37:00,19,80,Brinquedo,7,99
42279,2024-01-30 08:38:00,11,99,Brinquedo,1,110
42280,2024-01-30 08:39:00,70,158,Vestuário,8,228
42281,2024-01-30 08:40:00,16,22,Vestuário,3,38
42282,2024-01-30 08:41:00,95,133,Móvel,4,228
42283,2024-01-30 08:42:00,51,141,Vestuário,9,192
42284,2024-01-30 08:43:00,87,69,Vestuário,8,156
42285,2024-01-30 08:44:00,51,142,Móvel,7,193
42286,2024-01-30 08:45:00,20,15,Móvel,3,35
42287,2024-01-30 08:46:00,86,72,Eletrônico,5,158
42288,2024-01-30 08:47:00,119,107,Brinquedo,8,226
42289,2024-01-30 08:48:00,41,60,Móvel,2,101
42290,2024-01-30 08:49:00,116,122,Móvel,6,238
42291,2024-01-30 08:50:00,45,147,Vestuário,7,192
42292,2024-01-30 08:51:00,102,61,Eletrônico,5,163
42293,2024-01-30 08:52:00,38,169,Eletrônico,2,207
42294,2024-01-30 08:53:00,119,105,Móvel,9,224
42295,2024-01-30 08:54:00,61,139,Alimento,1,200
42296,2024-01-30 08:55:00,28,91,Brinquedo,9,119
42297,2024-01-30 08:56:00,20,106,Eletrônico,3,126
42298,2024-01-30 08:57:00,10,108,Eletrônico,1,118
42299,2024-01-30 08:58:00,59,75,Móvel,7,134
42300,2024-01-30 08:59:00,99,46,Brinquedo,9,145
42301,2024-01-30 09:00:00,54,15,Móvel,1,69
42302,2024-01-30 09:01:00,118,170,Vestuário,9,288
42303,2024-01-30 09:02:00,61,119,Vestuário,4,180
42304,2024-01-30 09:03:00,26,178,Móvel,4,204
42305,2024-01-30 09:04:00,35,168,Móvel,4,203
42306,2024-01-30 09:05:00,13,29,Brinquedo,1,42
42307,2024-01-30 09:06:00,34,98,Eletrônico,3,132
42308,2024-01-30 09:07:00,101,154,Eletrônico,5,255
42309,2024-01-30 09:08:00,26,105,Alimento,8,131
42310,2024-01-30 09:09:00,70,160,Brinquedo,3,230
42311,2024-01-30 09:10:00,29,156,Brinquedo,1,185
42312,2024-01-30 09:11:00,46,96,Alimento,9,142
42313,2024-01-30 09:12:00,103,103,Eletrônico,1,206
42314,2024-01-30 09:13:00,38,83,Vestuário,6,121
42315,2024-01-30 09:14:00,92,93,Brinquedo,4,185
42316,2024-01-30 09:15:00,44,33,Eletrônico,3,77
42317,2024-01-30 09:16:00,62,102,Eletrônico,2,164
42318,2024-01-30 09:17:00,101,135,Móvel,2,236
42319,2024-01-30 09:18:00,72,70,Alimento,3,142
42320,2024-01-30 09:19:00,40,132,Brinquedo,6,172
42321,2024-01-30 09:20:00,69,162,Móvel,8,231
42322,2024-01-30 09:21:00,34,140,Brinquedo,7,174
42323,2024-01-30 09:22:00,34,22,Vestuário,6,56
42324,2024-01-30 09:23:00,64,150,Alimento,3,214
42325,2024-01-30 09:24:00,107,63,Móvel,5,170
42326,2024-01-30 09:25:00,60,170,Móvel,2,230
42327,2024-01-30 09:26:00,10,67,Móvel,7,77
42328,2024-01-30 09:27:00,92,56,Alimento,4,148
42329,2024-01-30 09:28:00,86,156,Brinquedo,2,242
42330,2024-01-30 09:29:00,46,74,Alimento,2,120
42331,2024-01-30 09:30:00,37,33,Eletrônico,9,70
42332,2024-01-30 09:31:00,55,118,Móvel,5,173
42333,2024-01-30 09:32:00,56,115,Eletrônico,7,171
42334,2024-01-30 09:33:00,44,42,Alimento,6,86
42335,2024-01-30 09:34:00,77,149,Móvel,7,226
42336,2024-01-30 09:35:00,111,33,Brinquedo,8,144
42337,2024-01-30 09:36:00,97,105,Vestuário,8,202
42338,2024-01-30 09:37:00,112,66,Alimento,3,178
42339,2024-01-30 09:38:00,119,97,Móvel,7,216
42340,2024-01-30 09:39:00,31,79,Alimento,2,110
42341,2024-01-30 09:40:00,58,65,Vestuário,2,123
42342,2024-01-30 09:41:00,23,75,Móvel,3,98
42343,2024-01-30 09:42:00,65,134,Alimento,8,199
42344,2024-01-30 09:43:00,39,24,Brinquedo,5,63
42345,2024-01-30 09:44:00,92,41,Eletrônico,5,133
42346,2024-01-30 09:45:00,94,118,Móvel,5,212
42347,2024-01-30 09:46:00,32,31,Vestuário,5,63
42348,2024-01-30 09:47:00,24,165,Móvel,1,189
42349,2024-01-30 09:48:00,21,99,Eletrônico,9,120
42350,2024-01-30 09:49:00,39,69,Eletrônico,3,108
42351,2024-01-30 09:50:00,50,17,Alimento,8,67
42352,2024-01-30 09:51:00,13,24,Vestuário,4,37
42353,2024-01-30 09:52:00,80,60,Eletrônico,6,140
42354,2024-01-30 09:53:00,96,14,Vestuário,1,110
42355,2024-01-30 09:54:00,85,79,Vestuário,2,164
42356,2024-01-30 09:55:00,15,172,Móvel,7,187
42357,2024-01-30 09:56:00,41,43,Vestuário,9,84
42358,2024-01-30 09:57:00,109,37,Eletrônico,2,146
42359,2024-01-30 09:58:00,73,40,Vestuário,8,113
42360,2024-01-30 09:59:00,48,109,Brinquedo,1,157
42361,2024-01-30 10:00:00,16,132,Alimento,9,148
42362,2024-01-30 10:01:00,15,86,Brinquedo,4,101
42363,2024-01-30 10:02:00,94,82,Brinquedo,9,176
42364,2024-01-30 10:03:00,103,107,Móvel,1,210
42365,2024-01-30 10:04:00,92,57,Brinquedo,2,149
42366,2024-01-30 10:05:00,68,13,Brinquedo,7,81
42367,2024-01-30 10:06:00,46,77,Eletrônico,5,123
42368,2024-01-30 10:07:00,82,165,Vestuário,8,247
42369,2024-01-30 10:08:00,99,94,Móvel,5,193
42370,2024-01-30 10:09:00,18,71,Móvel,7,89
42371,2024-01-30 10:10:00,27,91,Vestuário,9,118
42372,2024-01-30 10:11:00,43,48,Eletrônico,4,91
42373,2024-01-30 10:12:00,41,76,Móvel,8,117
42374,2024-01-30 10:13:00,100,85,Eletrônico,3,185
42375,2024-01-30 10:14:00,108,109,Brinquedo,1,217
42376,2024-01-30 10:15:00,107,171,Alimento,3,278
42377,2024-01-30 10:16:00,84,52,Brinquedo,3,136
42378,2024-01-30 10:17:00,47,93,Brinquedo,9,140
42379,2024-01-30 10:18:00,14,163,Alimento,5,177
42380,2024-01-30 10:19:00,80,170,Alimento,8,250
42381,2024-01-30 10:20:00,30,53,Brinquedo,1,83
42382,2024-01-30 10:21:00,79,75,Eletrônico,7,154
42383,2024-01-30 10:22:00,71,50,Alimento,9,121
42384,2024-01-30 10:23:00,16,72,Eletrônico,5,88
42385,2024-01-30 10:24:00,117,129,Alimento,9,246
42386,2024-01-30 10:25:00,36,125,Vestuário,2,161
42387,2024-01-30 10:26:00,53,89,Brinquedo,9,142
42388,2024-01-30 10:27:00,107,105,Alimento,8,212
42389,2024-01-30 10:28:00,42,40,Móvel,6,82
42390,2024-01-30 10:29:00,43,79,Móvel,1,122
42391,2024-01-30 10:30:00,78,14,Eletrônico,4,92
42392,2024-01-30 10:31:00,26,96,Eletrônico,9,122
42393,2024-01-30 10:32:00,75,133,Eletrônico,7,208
42394,2024-01-30 10:33:00,36,100,Vestuário,3,136
42395,2024-01-30 10:34:00,88,123,Eletrônico,1,211
42396,2024-01-30 10:35:00,106,116,Eletrônico,7,222
42397,2024-01-30 10:36:00,57,55,Alimento,9,112
42398,2024-01-30 10:37:00,65,112,Eletrônico,5,177
42399,2024-01-30 10:38:00,87,95,Vestuário,3,182
42400,2024-01-30 10:39:00,72,141,Eletrônico,9,213
42401,2024-01-30 10:40:00,84,135,Móvel,2,219
42402,2024-01-30 10:41:00,41,168,Brinquedo,9,209
42403,2024-01-30 10:42:00,35,148,Alimento,6,183
42404,2024-01-30 10:43:00,26,126,Vestuário,9,152
42405,2024-01-30 10:44:00,76,170,Vestuário,6,246
42406,2024-01-30 10:45:00,37,126,Brinquedo,6,163
42407,2024-01-30 10:46:00,100,105,Vestuário,5,205
42408,2024-01-30 10:47:00,42,127,Vestuário,1,169
42409,2024-01-30 10:48:00,89,90,Vestuário,4,179
42410,2024-01-30 10:49:00,33,159,Móvel,9,192
42411,2024-01-30 10:50:00,109,13,Brinquedo,9,122
42412,2024-01-30 10:51:00,92,36,Móvel,6,128
42413,2024-01-30 10:52:00,115,152,Móvel,6,267
42414,2024-01-30 10:53:00,115,114,Eletrônico,8,229
42415,2024-01-30 10:54:00,87,35,Eletrônico,8,122
42416,2024-01-30 10:55:00,32,144,Brinquedo,6,176
42417,2024-01-30 10:56:00,84,84,Brinquedo,8,168
42418,2024-01-30 10:57:00,16,111,Móvel,4,127
42419,2024-01-30 10:58:00,87,160,Móvel,5,247
42420,2024-01-30 10:59:00,118,36,Vestuário,7,154
42421,2024-01-30 11:00:00,96,141,Móvel,7,237
42422,2024-01-30 11:01:00,42,30,Vestuário,1,72
42423,2024-01-30 11:02:00,38,92,Móvel,7,130
42424,2024-01-30 11:03:00,24,69,Móvel,3,93
42425,2024-01-30 11:04:00,96,31,Alimento,9,127
42426,2024-01-30 11:05:00,14,38,Brinquedo,5,52
42427,2024-01-30 11:06:00,69,144,Brinquedo,7,213
42428,2024-01-30 11:07:00,118,69,Alimento,5,187
42429,2024-01-30 11:08:00,48,149,Eletrônico,5,197
42430,2024-01-30 11:09:00,97,159,Vestuário,4,256
42431,2024-01-30 11:10:00,92,92,Eletrônico,9,184
42432,2024-01-30 11:11:00,53,97,Móvel,3,150
42433,2024-01-30 11:12:00,61,177,Eletrônico,5,238
42434,2024-01-30 11:13:00,35,106,Alimento,8,141
42435,2024-01-30 11:14:00,103,160,Vestuário,4,263
42436,2024-01-30 11:15:00,76,84,Alimento,6,160
42437,2024-01-30 11:16:00,43,141,Brinquedo,3,184
42438,2024-01-30 11:17:00,94,69,Eletrônico,2,163
42439,2024-01-30 11:18:00,76,139,Eletrônico,7,215
42440,2024-01-30 11:19:00,44,71,Eletrônico,5,115
42441,2024-01-30 11:20:00,112,132,Alimento,1,244
42442,2024-01-30 11:21:00,93,26,Brinquedo,8,119
42443,2024-01-30 11:22:00,90,159,Móvel,4,249
42444,2024-01-30 11:23:00,91,85,Brinquedo,1,176
42445,2024-01-30 11:24:00,110,100,Móvel,9,210
42446,2024-01-30 11:25:00,59,121,Vestuário,2,180
42447,2024-01-30 11:26:00,62,111,Alimento,9,173
42448,2024-01-30 11:27:00,58,86,Eletrônico,3,144
42449,2024-01-30 11:28:00,54,99,Brinquedo,3,153
42450,2024-01-30 11:29:00,56,22,Eletrônico,1,78
42451,2024-01-30 11:30:00,26,20,Móvel,6,46
42452,2024-01-30 11:31:00,14,13,Brinquedo,4,27
42453,2024-01-30 11:32:00,118,68,Brinquedo,8,186
42454,2024-01-30 11:33:00,59,48,Eletrônico,2,107
42455,2024-01-30 11:34:00,67,11,Vestuário,4,78
42456,2024-01-30 11:35:00,30,51,Alimento,4,81
42457,2024-01-30 11:36:00,71,102,Eletrônico,6,173
42458,2024-01-30 11:37:00,72,116,Móvel,7,188
42459,2024-01-30 11:38:00,32,80,Eletrônico,4,112
42460,2024-01-30 11:39:00,19,52,Alimento,7,71
42461,2024-01-30 11:40:00,78,171,Alimento,4,249
42462,2024-01-30 11:41:00,93,83,Móvel,5,176
42463,2024-01-30 11:42:00,12,29,Eletrônico,3,41
42464,2024-01-30 11:43:00,14,79,Alimento,7,93
42465,2024-01-30 11:44:00,23,63,Brinquedo,7,86
42466,2024-01-30 11:45:00,15,48,Vestuário,1,63
42467,2024-01-30 11:46:00,94,151,Alimento,6,245
42468,2024-01-30 11:47:00,37,19,Brinquedo,4,56
42469,2024-01-30 11:48:00,32,170,Brinquedo,1,202
42470,2024-01-30 11:49:00,38,52,Eletrônico,3,90
42471,2024-01-30 11:50:00,35,116,Vestuário,9,151
42472,2024-01-30 11:51:00,79,132,Móvel,8,211
42473,2024-01-30 11:52:00,44,119,Móvel,9,163
42474,2024-01-30 11:53:00,114,74,Alimento,4,188
42475,2024-01-30 11:54:00,33,61,Brinquedo,3,94
42476,2024-01-30 11:55:00,65,168,Alimento,9,233
42477,2024-01-30 11:56:00,113,37,Móvel,1,150
42478,2024-01-30 11:57:00,116,161,Alimento,8,277
42479,2024-01-30 11:58:00,99,69,Alimento,3,168
42480,2024-01-30 11:59:00,100,167,Eletrônico,5,267
42481,2024-01-30 12:00:00,118,102,Eletrônico,8,220
42482,2024-01-30 12:01:00,80,107,Vestuário,1,187
42483,2024-01-30 12:02:00,26,51,Móvel,4,77
42484,2024-01-30 12:03:00,29,30,Brinquedo,8,59
42485,2024-01-30 12:04:00,114,158,Vestuário,9,272
42486,2024-01-30 12:05:00,28,155,Móvel,5,183
42487,2024-01-30 12:06:00,41,128,Eletrônico,6,169
42488,2024-01-30 12:07:00,78,170,Alimento,7,248
42489,2024-01-30 12:08:00,107,144,Alimento,8,251
42490,2024-01-30 12:09:00,41,11,Brinquedo,4,52
42491,2024-01-30 12:10:00,75,42,Alimento,3,117
42492,2024-01-30 12:11:00,16,80,Brinquedo,1,96
42493,2024-01-30 12:12:00,48,166,Brinquedo,7,214
42494,2024-01-30 12:13:00,67,145,Brinquedo,2,212
42495,2024-01-30 12:14:00,49,29,Eletrônico,8,78
42496,2024-01-30 12:15:00,75,46,Eletrônico,9,121
42497,2024-01-30 12:16:00,77,164,Brinquedo,5,241
42498,2024-01-30 12:17:00,93,171,Móvel,3,264
42499,2024-01-30 12:18:00,105,40,Brinquedo,8,145
42500,2024-01-30 12:19:00,66,108,Eletrônico,4,174
42501,2024-01-30 12:20:00,96,143,Móvel,1,239
42502,2024-01-30 12:21:00,70,108,Alimento,3,178
42503,2024-01-30 12:22:00,58,40,Alimento,5,98
42504,2024-01-30 12:23:00,96,42,Móvel,6,138
42505,2024-01-30 12:24:00,44,111,Vestuário,1,155
42506,2024-01-30 12:25:00,33,98,Eletrônico,9,131
42507,2024-01-30 12:26:00,102,121,Vestuário,4,223
42508,2024-01-30 12:27:00,45,109,Móvel,5,154
42509,2024-01-30 12:28:00,52,75,Brinquedo,2,127
42510,2024-01-30 12:29:00,103,19,Móvel,2,122
42511,2024-01-30 12:30:00,81,150,Brinquedo,7,231
42512,2024-01-30 12:31:00,25,170,Alimento,4,195
42513,2024-01-30 12:32:00,103,90,Alimento,8,193
42514,2024-01-30 12:33:00,47,78,Brinquedo,6,125
42515,2024-01-30 12:34:00,59,64,Alimento,2,123
42516,2024-01-30 12:35:00,78,33,Móvel,4,111
42517,2024-01-30 12:36:00,37,24,Vestuário,4,61
42518,2024-01-30 12:37:00,65,42,Alimento,5,107
42519,2024-01-30 12:38:00,105,37,Brinquedo,1,142
42520,2024-01-30 12:39:00,55,42,Móvel,4,97
42521,2024-01-30 12:40:00,85,31,Móvel,4,116
42522,2024-01-30 12:41:00,19,102,Eletrônico,2,121
42523,2024-01-30 12:42:00,54,130,Brinquedo,7,184
42524,2024-01-30 12:43:00,96,148,Brinquedo,1,244
42525,2024-01-30 12:44:00,11,81,Vestuário,7,92
42526,2024-01-30 12:45:00,26,88,Móvel,5,114
42527,2024-01-30 12:46:00,69,15,Móvel,7,84
42528,2024-01-30 12:47:00,10,163,Móvel,4,173
42529,2024-01-30 12:48:00,19,127,Vestuário,5,146
42530,2024-01-30 12:49:00,41,164,Alimento,5,205
42531,2024-01-30 12:50:00,96,37,Brinquedo,8,133
42532,2024-01-30 12:51:00,86,98,Alimento,4,184
42533,2024-01-30 12:52:00,74,84,Móvel,2,158
42534,2024-01-30 12:53:00,11,41,Alimento,6,52
42535,2024-01-30 12:54:00,107,89,Brinquedo,9,196
42536,2024-01-30 12:55:00,20,77,Vestuário,5,97
42537,2024-01-30 12:56:00,89,166,Brinquedo,5,255
42538,2024-01-30 12:57:00,113,151,Móvel,3,264
42539,2024-01-30 12:58:00,33,34,Alimento,8,67
42540,2024-01-30 12:59:00,95,25,Brinquedo,1,120
42541,2024-01-30 13:00:00,52,60,Móvel,3,112
42542,2024-01-30 13:01:00,89,113,Vestuário,7,202
42543,2024-01-30 13:02:00,57,164,Alimento,1,221
42544,2024-01-30 13:03:00,36,51,Móvel,1,87
42545,2024-01-30 13:04:00,94,170,Móvel,6,264
42546,2024-01-30 13:05:00,72,156,Vestuário,2,228
42547,2024-01-30 13:06:00,17,130,Alimento,2,147
42548,2024-01-30 13:07:00,19,104,Vestuário,9,123
42549,2024-01-30 13:08:00,65,143,Vestuário,8,208
42550,2024-01-30 13:09:00,66,46,Vestuário,3,112
42551,2024-01-30 13:10:00,28,69,Vestuário,3,97
42552,2024-01-30 13:11:00,96,104,Eletrônico,9,200
42553,2024-01-30 13:12:00,80,110,Brinquedo,5,190
42554,2024-01-30 13:13:00,106,63,Eletrônico,9,169
42555,2024-01-30 13:14:00,20,28,Móvel,4,48
42556,2024-01-30 13:15:00,55,177,Alimento,5,232
42557,2024-01-30 13:16:00,44,107,Eletrônico,3,151
42558,2024-01-30 13:17:00,58,10,Eletrônico,6,68
42559,2024-01-30 13:18:00,61,136,Eletrônico,6,197
42560,2024-01-30 13:19:00,30,122,Alimento,7,152
42561,2024-01-30 13:20:00,40,146,Brinquedo,6,186
42562,2024-01-30 13:21:00,85,87,Móvel,1,172
42563,2024-01-30 13:22:00,78,31,Alimento,3,109
42564,2024-01-30 13:23:00,12,89,Vestuário,4,101
42565,2024-01-30 13:24:00,117,27,Alimento,6,144
42566,2024-01-30 13:25:00,22,43,Alimento,3,65
42567,2024-01-30 13:26:00,119,27,Brinquedo,9,146
42568,2024-01-30 13:27:00,47,23,Alimento,8,70
42569,2024-01-30 13:28:00,83,12,Brinquedo,8,95
42570,2024-01-30 13:29:00,48,14,Vestuário,2,62
42571,2024-01-30 13:30:00,64,28,Móvel,5,92
42572,2024-01-30 13:31:00,81,114,Alimento,5,195
42573,2024-01-30 13:32:00,114,90,Brinquedo,8,204
42574,2024-01-30 13:33:00,100,75,Eletrônico,1,175
42575,2024-01-30 13:34:00,90,124,Alimento,8,214
42576,2024-01-30 13:35:00,13,90,Eletrônico,5,103
42577,2024-01-30 13:36:00,102,43,Vestuário,5,145
42578,2024-01-30 13:37:00,82,62,Alimento,4,144
42579,2024-01-30 13:38:00,32,158,Móvel,7,190
42580,2024-01-30 13:39:00,12,95,Vestuário,1,107
42581,2024-01-30 13:40:00,90,78,Vestuário,9,168
42582,2024-01-30 13:41:00,54,157,Alimento,6,211
42583,2024-01-30 13:42:00,115,155,Eletrônico,7,270
42584,2024-01-30 13:43:00,91,161,Brinquedo,2,252
42585,2024-01-30 13:44:00,105,44,Móvel,5,149
42586,2024-01-30 13:45:00,56,42,Brinquedo,6,98
42587,2024-01-30 13:46:00,108,43,Eletrônico,7,151
42588,2024-01-30 13:47:00,51,102,Móvel,6,153
42589,2024-01-30 13:48:00,46,62,Eletrônico,3,108
42590,2024-01-30 13:49:00,43,11,Eletrônico,3,54
42591,2024-01-30 13:50:00,48,100,Alimento,3,148
42592,2024-01-30 13:51:00,45,73,Vestuário,9,118
42593,2024-01-30 13:52:00,48,62,Brinquedo,6,110
42594,2024-01-30 13:53:00,10,151,Vestuário,4,161
42595,2024-01-30 13:54:00,48,93,Brinquedo,4,141
42596,2024-01-30 13:55:00,114,153,Móvel,5,267
42597,2024-01-30 13:56:00,34,166,Brinquedo,3,200
42598,2024-01-30 13:57:00,94,110,Eletrônico,9,204
42599,2024-01-30 13:58:00,44,151,Brinquedo,3,195
42600,2024-01-30 13:59:00,104,57,Eletrônico,8,161
42601,2024-01-30 14:00:00,103,130,Eletrônico,5,233
42602,2024-01-30 14:01:00,118,37,Vestuário,3,155
42603,2024-01-30 14:02:00,39,102,Móvel,6,141
42604,2024-01-30 14:03:00,98,164,Vestuário,6,262
42605,2024-01-30 14:04:00,76,88,Vestuário,3,164
42606,2024-01-30 14:05:00,118,134,Brinquedo,8,252
42607,2024-01-30 14:06:00,101,84,Alimento,3,185
42608,2024-01-30 14:07:00,25,82,Eletrônico,1,107
42609,2024-01-30 14:08:00,47,118,Alimento,4,165
42610,2024-01-30 14:09:00,102,157,Brinquedo,4,259
42611,2024-01-30 14:10:00,76,89,Vestuário,3,165
42612,2024-01-30 14:11:00,84,133,Móvel,1,217
42613,2024-01-30 14:12:00,72,11,Vestuário,5,83
42614,2024-01-30 14:13:00,80,155,Vestuário,4,235
42615,2024-01-30 14:14:00,27,53,Brinquedo,1,80
42616,2024-01-30 14:15:00,38,57,Eletrônico,5,95
42617,2024-01-30 14:16:00,31,123,Brinquedo,8,154
42618,2024-01-30 14:17:00,56,124,Brinquedo,6,180
42619,2024-01-30 14:18:00,16,172,Vestuário,5,188
42620,2024-01-30 14:19:00,77,117,Vestuário,4,194
42621,2024-01-30 14:20:00,34,78,Vestuário,2,112
42622,2024-01-30 14:21:00,79,108,Móvel,1,187
42623,2024-01-30 14:22:00,63,38,Eletrônico,8,101
42624,2024-01-30 14:23:00,93,69,Alimento,2,162
42625,2024-01-30 14:24:00,54,33,Móvel,5,87
42626,2024-01-30 14:25:00,47,32,Eletrônico,3,79
42627,2024-01-30 14:26:00,27,36,Eletrônico,2,63
42628,2024-01-30 14:27:00,111,171,Móvel,9,282
42629,2024-01-30 14:28:00,105,69,Eletrônico,2,174
42630,2024-01-30 14:29:00,27,86,Alimento,4,113
42631,2024-01-30 14:30:00,106,157,Vestuário,8,263
42632,2024-01-30 14:31:00,32,36,Alimento,4,68
42633,2024-01-30 14:32:00,47,28,Alimento,4,75
42634,2024-01-30 14:33:00,48,123,Vestuário,6,171
42635,2024-01-30 14:34:00,80,71,Vestuário,3,151
42636,2024-01-30 14:35:00,119,160,Eletrônico,9,279
42637,2024-01-30 14:36:00,81,26,Brinquedo,2,107
42638,2024-01-30 14:37:00,18,105,Alimento,9,123
42639,2024-01-30 14:38:00,57,112,Vestuário,8,169
42640,2024-01-30 14:39:00,101,75,Alimento,8,176
42641,2024-01-30 14:40:00,71,30,Brinquedo,4,101
42642,2024-01-30 14:41:00,23,74,Móvel,5,97
42643,2024-01-30 14:42:00,79,23,Brinquedo,8,102
42644,2024-01-30 14:43:00,35,33,Móvel,7,68
42645,2024-01-30 14:44:00,54,91,Eletrônico,9,145
42646,2024-01-30 14:45:00,80,147,Alimento,2,227
42647,2024-01-30 14:46:00,13,117,Alimento,3,130
42648,2024-01-30 14:47:00,54,57,Brinquedo,2,111
42649,2024-01-30 14:48:00,102,57,Brinquedo,6,159
42650,2024-01-30 14:49:00,112,133,Brinquedo,8,245
42651,2024-01-30 14:50:00,12,145,Vestuário,1,157
42652,2024-01-30 14:51:00,13,113,Vestuário,8,126
42653,2024-01-30 14:52:00,67,117,Eletrônico,8,184
42654,2024-01-30 14:53:00,48,141,Eletrônico,6,189
42655,2024-01-30 14:54:00,61,176,Alimento,4,237
42656,2024-01-30 14:55:00,56,105,Brinquedo,6,161
42657,2024-01-30 14:56:00,117,70,Vestuário,3,187
42658,2024-01-30 14:57:00,84,93,Eletrônico,5,177
42659,2024-01-30 14:58:00,10,171,Brinquedo,8,181
42660,2024-01-30 14:59:00,66,114,Móvel,6,180
42661,2024-01-30 15:00:00,64,46,Móvel,6,110
42662,2024-01-30 15:01:00,23,170,Brinquedo,9,193
42663,2024-01-30 15:02:00,38,100,Eletrônico,2,138
42664,2024-01-30 15:03:00,22,134,Alimento,9,156
42665,2024-01-30 15:04:00,116,179,Vestuário,7,295
42666,2024-01-30 15:05:00,62,173,Brinquedo,4,235
42667,2024-01-30 15:06:00,118,47,Brinquedo,3,165
42668,2024-01-30 15:07:00,55,87,Vestuário,1,142
42669,2024-01-30 15:08:00,110,70,Móvel,7,180
42670,2024-01-30 15:09:00,51,110,Brinquedo,1,161
42671,2024-01-30 15:10:00,83,42,Vestuário,4,125
42672,2024-01-30 15:11:00,113,60,Eletrônico,1,173
42673,2024-01-30 15:12:00,41,109,Brinquedo,8,150
42674,2024-01-30 15:13:00,109,119,Vestuário,3,228
42675,2024-01-30 15:14:00,30,99,Eletrônico,7,129
42676,2024-01-30 15:15:00,70,12,Alimento,2,82
42677,2024-01-30 15:16:00,60,86,Móvel,9,146
42678,2024-01-30 15:17:00,73,149,Vestuário,6,222
42679,2024-01-30 15:18:00,106,146,Brinquedo,5,252
42680,2024-01-30 15:19:00,28,101,Alimento,2,129
42681,2024-01-30 15:20:00,18,131,Brinquedo,5,149
42682,2024-01-30 15:21:00,31,151,Brinquedo,7,182
42683,2024-01-30 15:22:00,16,83,Vestuário,4,99
42684,2024-01-30 15:23:00,17,34,Eletrônico,4,51
42685,2024-01-30 15:24:00,72,156,Eletrônico,3,228
42686,2024-01-30 15:25:00,110,68,Alimento,9,178
42687,2024-01-30 15:26:00,30,51,Eletrônico,6,81
42688,2024-01-30 15:27:00,40,77,Eletrônico,8,117
42689,2024-01-30 15:28:00,89,88,Brinquedo,6,177
42690,2024-01-30 15:29:00,86,139,Eletrônico,7,225
42691,2024-01-30 15:30:00,83,150,Vestuário,1,233
42692,2024-01-30 15:31:00,30,155,Vestuário,3,185
42693,2024-01-30 15:32:00,49,14,Alimento,8,63
42694,2024-01-30 15:33:00,111,90,Móvel,9,201
42695,2024-01-30 15:34:00,57,81,Móvel,6,138
42696,2024-01-30 15:35:00,81,174,Eletrônico,8,255
42697,2024-01-30 15:36:00,55,74,Alimento,4,129
42698,2024-01-30 15:37:00,49,119,Alimento,7,168
42699,2024-01-30 15:38:00,15,77,Vestuário,5,92
42700,2024-01-30 15:39:00,16,137,Brinquedo,1,153
42701,2024-01-30 15:40:00,113,15,Móvel,1,128
42702,2024-01-30 15:41:00,48,146,Brinquedo,3,194
42703,2024-01-30 15:42:00,90,149,Móvel,5,239
42704,2024-01-30 15:43:00,50,18,Brinquedo,5,68
42705,2024-01-30 15:44:00,85,161,Eletrônico,8,246
42706,2024-01-30 15:45:00,92,25,Vestuário,6,117
42707,2024-01-30 15:46:00,13,37,Eletrônico,6,50
42708,2024-01-30 15:47:00,100,10,Vestuário,4,110
42709,2024-01-30 15:48:00,105,81,Brinquedo,1,186
42710,2024-01-30 15:49:00,110,126,Brinquedo,6,236
42711,2024-01-30 15:50:00,41,100,Vestuário,8,141
42712,2024-01-30 15:51:00,109,25,Eletrônico,8,134
42713,2024-01-30 15:52:00,28,18,Alimento,7,46
42714,2024-01-30 15:53:00,39,167,Vestuário,9,206
42715,2024-01-30 15:54:00,99,136,Eletrônico,8,235
42716,2024-01-30 15:55:00,52,86,Alimento,5,138
42717,2024-01-30 15:56:00,40,98,Eletrônico,2,138
42718,2024-01-30 15:57:00,19,12,Vestuário,3,31
42719,2024-01-30 15:58:00,25,169,Eletrônico,2,194
42720,2024-01-30 15:59:00,26,173,Brinquedo,8,199
42721,2024-01-30 16:00:00,95,123,Móvel,5,218
42722,2024-01-30 16:01:00,11,57,Vestuário,1,68
42723,2024-01-30 16:02:00,62,170,Alimento,5,232
42724,2024-01-30 16:03:00,44,151,Móvel,4,195
42725,2024-01-30 16:04:00,47,157,Vestuário,3,204
42726,2024-01-30 16:05:00,74,117,Brinquedo,3,191
42727,2024-01-30 16:06:00,45,111,Eletrônico,3,156
42728,2024-01-30 16:07:00,84,64,Móvel,2,148
42729,2024-01-30 16:08:00,39,34,Eletrônico,2,73
42730,2024-01-30 16:09:00,83,146,Vestuário,5,229
42731,2024-01-30 16:10:00,19,33,Alimento,2,52
42732,2024-01-30 16:11:00,90,156,Vestuário,6,246
42733,2024-01-30 16:12:00,83,91,Alimento,3,174
42734,2024-01-30 16:13:00,78,157,Brinquedo,6,235
42735,2024-01-30 16:14:00,105,45,Móvel,4,150
42736,2024-01-30 16:15:00,30,90,Brinquedo,8,120
42737,2024-01-30 16:16:00,117,143,Vestuário,7,260
42738,2024-01-30 16:17:00,116,88,Alimento,6,204
42739,2024-01-30 16:18:00,19,109,Alimento,1,128
42740,2024-01-30 16:19:00,75,56,Móvel,9,131
42741,2024-01-30 16:20:00,89,153,Vestuário,9,242
42742,2024-01-30 16:21:00,104,67,Eletrônico,3,171
42743,2024-01-30 16:22:00,118,165,Eletrônico,7,283
42744,2024-01-30 16:23:00,36,166,Vestuário,8,202
42745,2024-01-30 16:24:00,59,150,Vestuário,3,209
42746,2024-01-30 16:25:00,53,176,Alimento,5,229
42747,2024-01-30 16:26:00,28,118,Alimento,7,146
42748,2024-01-30 16:27:00,88,149,Vestuário,3,237
42749,2024-01-30 16:28:00,97,91,Brinquedo,4,188
42750,2024-01-30 16:29:00,43,13,Móvel,3,56
42751,2024-01-30 16:30:00,82,46,Móvel,9,128
42752,2024-01-30 16:31:00,63,56,Vestuário,6,119
42753,2024-01-30 16:32:00,101,154,Eletrônico,9,255
42754,2024-01-30 16:33:00,111,46,Alimento,8,157
42755,2024-01-30 16:34:00,89,34,Brinquedo,5,123
42756,2024-01-30 16:35:00,82,170,Vestuário,8,252
42757,2024-01-30 16:36:00,118,112,Móvel,3,230
42758,2024-01-30 16:37:00,35,22,Alimento,1,57
42759,2024-01-30 16:38:00,55,80,Brinquedo,9,135
42760,2024-01-30 16:39:00,91,15,Móvel,6,106
42761,2024-01-30 16:40:00,57,41,Vestuário,5,98
42762,2024-01-30 16:41:00,28,45,Vestuário,3,73
42763,2024-01-30 16:42:00,112,52,Eletrônico,1,164
42764,2024-01-30 16:43:00,23,37,Vestuário,6,60
42765,2024-01-30 16:44:00,43,63,Móvel,8,106
42766,2024-01-30 16:45:00,95,48,Alimento,6,143
42767,2024-01-30 16:46:00,34,56,Eletrônico,8,90
42768,2024-01-30 16:47:00,87,88,Brinquedo,3,175
42769,2024-01-30 16:48:00,64,64,Eletrônico,3,128
42770,2024-01-30 16:49:00,72,93,Alimento,2,165
42771,2024-01-30 16:50:00,117,141,Alimento,7,258
42772,2024-01-30 16:51:00,38,91,Alimento,6,129
42773,2024-01-30 16:52:00,69,102,Brinquedo,9,171
42774,2024-01-30 16:53:00,66,125,Brinquedo,1,191
42775,2024-01-30 16:54:00,34,151,Vestuário,8,185
42776,2024-01-30 16:55:00,54,164,Brinquedo,7,218
42777,2024-01-30 16:56:00,18,78,Vestuário,4,96
42778,2024-01-30 16:57:00,83,93,Brinquedo,7,176
42779,2024-01-30 16:58:00,33,93,Alimento,8,126
42780,2024-01-30 16:59:00,90,75,Brinquedo,1,165
42781,2024-01-30 17:00:00,16,96,Alimento,6,112
42782,2024-01-30 17:01:00,92,149,Vestuário,4,241
42783,2024-01-30 17:02:00,13,115,Vestuário,2,128
42784,2024-01-30 17:03:00,103,36,Alimento,5,139
42785,2024-01-30 17:04:00,84,44,Eletrônico,2,128
42786,2024-01-30 17:05:00,33,44,Brinquedo,4,77
42787,2024-01-30 17:06:00,69,77,Alimento,3,146
42788,2024-01-30 17:07:00,10,34,Eletrônico,8,44
42789,2024-01-30 17:08:00,12,84,Móvel,5,96
42790,2024-01-30 17:09:00,25,175,Eletrônico,3,200
42791,2024-01-30 17:10:00,33,164,Brinquedo,5,197
42792,2024-01-30 17:11:00,119,110,Eletrônico,7,229
42793,2024-01-30 17:12:00,73,83,Vestuário,7,156
42794,2024-01-30 17:13:00,28,126,Alimento,5,154
42795,2024-01-30 17:14:00,50,76,Brinquedo,3,126
42796,2024-01-30 17:15:00,71,164,Brinquedo,5,235
42797,2024-01-30 17:16:00,103,155,Brinquedo,8,258
42798,2024-01-30 17:17:00,34,103,Eletrônico,5,137
42799,2024-01-30 17:18:00,75,76,Alimento,8,151
42800,2024-01-30 17:19:00,95,146,Vestuário,7,241
42801,2024-01-30 17:20:00,71,114,Alimento,6,185
42802,2024-01-30 17:21:00,61,47,Brinquedo,5,108
42803,2024-01-30 17:22:00,27,143,Eletrônico,2,170
42804,2024-01-30 17:23:00,50,38,Eletrônico,4,88
42805,2024-01-30 17:24:00,49,51,Eletrônico,6,100
42806,2024-01-30 17:25:00,41,15,Vestuário,2,56
42807,2024-01-30 17:26:00,12,35,Eletrônico,8,47
42808,2024-01-30 17:27:00,40,73,Brinquedo,5,113
42809,2024-01-30 17:28:00,88,159,Alimento,1,247
42810,2024-01-30 17:29:00,87,163,Brinquedo,4,250
42811,2024-01-30 17:30:00,90,157,Brinquedo,2,247
42812,2024-01-30 17:31:00,72,79,Vestuário,9,151
42813,2024-01-30 17:32:00,99,85,Brinquedo,3,184
42814,2024-01-30 17:33:00,72,148,Eletrônico,1,220
42815,2024-01-30 17:34:00,110,169,Eletrônico,1,279
42816,2024-01-30 17:35:00,72,54,Alimento,9,126
42817,2024-01-30 17:36:00,112,13,Eletrônico,1,125
42818,2024-01-30 17:37:00,102,73,Alimento,4,175
42819,2024-01-30 17:38:00,73,141,Alimento,5,214
42820,2024-01-30 17:39:00,79,145,Vestuário,7,224
42821,2024-01-30 17:40:00,14,19,Brinquedo,5,33
42822,2024-01-30 17:41:00,25,179,Brinquedo,4,204
42823,2024-01-30 17:42:00,59,79,Vestuário,9,138
42824,2024-01-30 17:43:00,119,53,Brinquedo,7,172
42825,2024-01-30 17:44:00,58,17,Eletrônico,8,75
42826,2024-01-30 17:45:00,50,155,Móvel,1,205
42827,2024-01-30 17:46:00,99,87,Alimento,4,186
42828,2024-01-30 17:47:00,82,28,Brinquedo,2,110
42829,2024-01-30 17:48:00,41,149,Vestuário,4,190
42830,2024-01-30 17:49:00,92,16,Móvel,7,108
42831,2024-01-30 17:50:00,80,113,Brinquedo,8,193
42832,2024-01-30 17:51:00,93,178,Alimento,3,271
42833,2024-01-30 17:52:00,75,102,Móvel,7,177
42834,2024-01-30 17:53:00,114,75,Brinquedo,8,189
42835,2024-01-30 17:54:00,91,58,Móvel,3,149
42836,2024-01-30 17:55:00,37,47,Móvel,4,84
42837,2024-01-30 17:56:00,64,143,Vestuário,2,207
42838,2024-01-30 17:57:00,88,100,Brinquedo,7,188
42839,2024-01-30 17:58:00,90,151,Eletrônico,5,241
42840,2024-01-30 17:59:00,39,161,Vestuário,1,200
42841,2024-01-30 18:00:00,64,135,Eletrônico,9,199
42842,2024-01-30 18:01:00,26,58,Vestuário,4,84
42843,2024-01-30 18:02:00,41,133,Alimento,8,174
42844,2024-01-30 18:03:00,96,59,Brinquedo,5,155
42845,2024-01-30 18:04:00,109,106,Vestuário,1,215
42846,2024-01-30 18:05:00,29,44,Brinquedo,5,73
42847,2024-01-30 18:06:00,78,73,Eletrônico,9,151
42848,2024-01-30 18:07:00,93,170,Alimento,4,263
42849,2024-01-30 18:08:00,18,126,Brinquedo,8,144
42850,2024-01-30 18:09:00,111,18,Eletrônico,7,129
42851,2024-01-30 18:10:00,117,166,Vestuário,6,283
42852,2024-01-30 18:11:00,73,149,Eletrônico,9,222
42853,2024-01-30 18:12:00,19,35,Brinquedo,2,54
42854,2024-01-30 18:13:00,95,84,Alimento,8,179
42855,2024-01-30 18:14:00,91,125,Vestuário,1,216
42856,2024-01-30 18:15:00,87,151,Brinquedo,7,238
42857,2024-01-30 18:16:00,21,37,Vestuário,6,58
42858,2024-01-30 18:17:00,83,170,Eletrônico,2,253
42859,2024-01-30 18:18:00,99,125,Eletrônico,1,224
42860,2024-01-30 18:19:00,48,136,Móvel,9,184
42861,2024-01-30 18:20:00,23,173,Brinquedo,3,196
42862,2024-01-30 18:21:00,100,123,Vestuário,8,223
42863,2024-01-30 18:22:00,30,177,Alimento,5,207
42864,2024-01-30 18:23:00,19,47,Alimento,1,66
42865,2024-01-30 18:24:00,87,25,Eletrônico,2,112
42866,2024-01-30 18:25:00,115,130,Brinquedo,6,245
42867,2024-01-30 18:26:00,52,30,Brinquedo,6,82
42868,2024-01-30 18:27:00,22,125,Eletrônico,2,147
42869,2024-01-30 18:28:00,38,100,Vestuário,7,138
42870,2024-01-30 18:29:00,110,41,Vestuário,6,151
42871,2024-01-30 18:30:00,23,136,Brinquedo,4,159
42872,2024-01-30 18:31:00,25,10,Brinquedo,3,35
42873,2024-01-30 18:32:00,51,167,Móvel,9,218
42874,2024-01-30 18:33:00,32,101,Alimento,3,133
42875,2024-01-30 18:34:00,42,154,Vestuário,4,196
42876,2024-01-30 18:35:00,52,91,Móvel,4,143
42877,2024-01-30 18:36:00,85,70,Brinquedo,3,155
42878,2024-01-30 18:37:00,19,150,Vestuário,6,169
42879,2024-01-30 18:38:00,78,152,Eletrônico,3,230
42880,2024-01-30 18:39:00,49,134,Eletrônico,6,183
42881,2024-01-30 18:40:00,16,47,Vestuário,6,63
42882,2024-01-30 18:41:00,10,149,Vestuário,9,159
42883,2024-01-30 18:42:00,15,29,Vestuário,5,44
42884,2024-01-30 18:43:00,112,70,Vestuário,6,182
42885,2024-01-30 18:44:00,109,179,Alimento,2,288
42886,2024-01-30 18:45:00,101,12,Móvel,3,113
42887,2024-01-30 18:46:00,78,143,Brinquedo,8,221
42888,2024-01-30 18:47:00,86,113,Brinquedo,1,199
42889,2024-01-30 18:48:00,55,36,Alimento,5,91
42890,2024-01-30 18:49:00,102,38,Alimento,2,140
42891,2024-01-30 18:50:00,53,166,Vestuário,9,219
42892,2024-01-30 18:51:00,104,157,Brinquedo,4,261
42893,2024-01-30 18:52:00,56,104,Eletrônico,9,160
42894,2024-01-30 18:53:00,102,177,Eletrônico,4,279
42895,2024-01-30 18:54:00,44,14,Alimento,5,58
42896,2024-01-30 18:55:00,92,139,Brinquedo,9,231
42897,2024-01-30 18:56:00,87,98,Vestuário,1,185
42898,2024-01-30 18:57:00,13,41,Brinquedo,4,54
42899,2024-01-30 18:58:00,86,88,Vestuário,9,174
42900,2024-01-30 18:59:00,25,93,Alimento,5,118
42901,2024-01-30 19:00:00,32,106,Vestuário,8,138
42902,2024-01-30 19:01:00,89,129,Vestuário,9,218
42903,2024-01-30 19:02:00,56,65,Móvel,4,121
42904,2024-01-30 19:03:00,21,169,Móvel,4,190
42905,2024-01-30 19:04:00,104,165,Vestuário,4,269
42906,2024-01-30 19:05:00,49,135,Eletrônico,2,184
42907,2024-01-30 19:06:00,69,21,Brinquedo,9,90
42908,2024-01-30 19:07:00,92,47,Vestuário,6,139
42909,2024-01-30 19:08:00,52,118,Vestuário,5,170
42910,2024-01-30 19:09:00,39,25,Eletrônico,7,64
42911,2024-01-30 19:10:00,118,82,Móvel,6,200
42912,2024-01-30 19:11:00,79,134,Brinquedo,2,213
42913,2024-01-30 19:12:00,41,172,Brinquedo,7,213
42914,2024-01-30 19:13:00,102,133,Brinquedo,2,235
42915,2024-01-30 19:14:00,90,164,Brinquedo,5,254
42916,2024-01-30 19:15:00,33,118,Móvel,4,151
42917,2024-01-30 19:16:00,35,131,Eletrônico,3,166
42918,2024-01-30 19:17:00,46,95,Brinquedo,1,141
42919,2024-01-30 19:18:00,64,43,Alimento,8,107
42920,2024-01-30 19:19:00,62,31,Eletrônico,4,93
42921,2024-01-30 19:20:00,18,129,Vestuário,9,147
42922,2024-01-30 19:21:00,86,83,Alimento,1,169
42923,2024-01-30 19:22:00,26,142,Alimento,2,168
42924,2024-01-30 19:23:00,63,136,Brinquedo,6,199
42925,2024-01-30 19:24:00,95,169,Vestuário,2,264
42926,2024-01-30 19:25:00,113,127,Vestuário,5,240
42927,2024-01-30 19:26:00,74,122,Brinquedo,1,196
42928,2024-01-30 19:27:00,74,94,Brinquedo,6,168
42929,2024-01-30 19:28:00,93,95,Eletrônico,3,188
42930,2024-01-30 19:29:00,58,61,Móvel,6,119
42931,2024-01-30 19:30:00,50,179,Eletrônico,8,229
42932,2024-01-30 19:31:00,113,86,Vestuário,6,199
42933,2024-01-30 19:32:00,33,29,Alimento,2,62
42934,2024-01-30 19:33:00,115,23,Alimento,2,138
42935,2024-01-30 19:34:00,46,168,Vestuário,2,214
42936,2024-01-30 19:35:00,27,38,Brinquedo,1,65
42937,2024-01-30 19:36:00,68,18,Alimento,2,86
42938,2024-01-30 19:37:00,98,113,Móvel,5,211
42939,2024-01-30 19:38:00,91,155,Móvel,2,246
42940,2024-01-30 19:39:00,88,151,Eletrônico,7,239
42941,2024-01-30 19:40:00,53,90,Brinquedo,8,143
42942,2024-01-30 19:41:00,113,16,Eletrônico,5,129
42943,2024-01-30 19:42:00,56,94,Alimento,8,150
42944,2024-01-30 19:43:00,119,69,Eletrônico,6,188
42945,2024-01-30 19:44:00,93,66,Móvel,7,159
42946,2024-01-30 19:45:00,77,54,Alimento,8,131
42947,2024-01-30 19:46:00,81,133,Eletrônico,5,214
42948,2024-01-30 19:47:00,13,145,Brinquedo,4,158
42949,2024-01-30 19:48:00,43,78,Brinquedo,1,121
42950,2024-01-30 19:49:00,34,41,Brinquedo,7,75
42951,2024-01-30 19:50:00,17,31,Brinquedo,2,48
42952,2024-01-30 19:51:00,72,99,Alimento,8,171
42953,2024-01-30 19:52:00,70,136,Alimento,6,206
42954,2024-01-30 19:53:00,86,102,Brinquedo,6,188
42955,2024-01-30 19:54:00,52,107,Móvel,5,159
42956,2024-01-30 19:55:00,47,163,Alimento,2,210
42957,2024-01-30 19:56:00,113,70,Eletrônico,4,183
42958,2024-01-30 19:57:00,77,78,Eletrônico,8,155
42959,2024-01-30 19:58:00,48,153,Vestuário,5,201
42960,2024-01-30 19:59:00,22,145,Alimento,6,167
42961,2024-01-30 20:00:00,79,65,Móvel,6,144
42962,2024-01-30 20:01:00,41,158,Alimento,9,199
42963,2024-01-30 20:02:00,16,24,Alimento,6,40
42964,2024-01-30 20:03:00,31,138,Alimento,1,169
42965,2024-01-30 20:04:00,68,50,Brinquedo,6,118
42966,2024-01-30 20:05:00,40,96,Vestuário,3,136
42967,2024-01-30 20:06:00,65,155,Brinquedo,2,220
42968,2024-01-30 20:07:00,95,10,Vestuário,1,105
42969,2024-01-30 20:08:00,39,30,Móvel,6,69
42970,2024-01-30 20:09:00,82,166,Alimento,5,248
42971,2024-01-30 20:10:00,11,99,Vestuário,9,110
42972,2024-01-30 20:11:00,119,101,Vestuário,5,220
42973,2024-01-30 20:12:00,112,107,Vestuário,5,219
42974,2024-01-30 20:13:00,49,130,Móvel,5,179
42975,2024-01-30 20:14:00,49,47,Alimento,4,96
42976,2024-01-30 20:15:00,48,130,Alimento,1,178
42977,2024-01-30 20:16:00,20,37,Móvel,5,57
42978,2024-01-30 20:17:00,100,76,Vestuário,1,176
42979,2024-01-30 20:18:00,37,174,Móvel,3,211
42980,2024-01-30 20:19:00,33,108,Alimento,7,141
42981,2024-01-30 20:20:00,32,17,Eletrônico,5,49
42982,2024-01-30 20:21:00,114,102,Brinquedo,4,216
42983,2024-01-30 20:22:00,28,114,Alimento,8,142
42984,2024-01-30 20:23:00,42,93,Móvel,5,135
42985,2024-01-30 20:24:00,21,79,Eletrônico,5,100
42986,2024-01-30 20:25:00,96,121,Eletrônico,9,217
42987,2024-01-30 20:26:00,34,27,Eletrônico,9,61
42988,2024-01-30 20:27:00,75,176,Móvel,5,251
42989,2024-01-30 20:28:00,65,51,Eletrônico,3,116
42990,2024-01-30 20:29:00,56,45,Eletrônico,7,101
42991,2024-01-30 20:30:00,105,45,Eletrônico,8,150
42992,2024-01-30 20:31:00,20,100,Brinquedo,4,120
42993,2024-01-30 20:32:00,42,157,Eletrônico,9,199
42994,2024-01-30 20:33:00,52,140,Brinquedo,6,192
42995,2024-01-30 20:34:00,39,151,Brinquedo,2,190
42996,2024-01-30 20:35:00,114,88,Vestuário,3,202
42997,2024-01-30 20:36:00,51,41,Brinquedo,6,92
42998,2024-01-30 20:37:00,74,109,Alimento,1,183
42999,2024-01-30 20:38:00,92,26,Alimento,2,118
43000,2024-01-30 20:39:00,22,149,Móvel,4,171
43001,2024-01-30 20:40:00,53,91,Eletrônico,3,144
43002,2024-01-30 20:41:00,108,84,Eletrônico,4,192
43003,2024-01-30 20:42:00,117,88,Vestuário,4,205
43004,2024-01-30 20:43:00,38,169,Eletrônico,9,207
43005,2024-01-30 20:44:00,85,126,Vestuário,3,211
43006,2024-01-30 20:45:00,38,134,Vestuário,3,172
43007,2024-01-30 20:46:00,83,161,Vestuário,7,244
43008,2024-01-30 20:47:00,93,51,Vestuário,7,144
43009,2024-01-30 20:48:00,38,43,Brinquedo,6,81
43010,2024-01-30 20:49:00,37,46,Vestuário,6,83
43011,2024-01-30 20:50:00,84,106,Eletrônico,6,190
43012,2024-01-30 20:51:00,32,16,Brinquedo,7,48
43013,2024-01-30 20:52:00,32,84,Alimento,8,116
43014,2024-01-30 20:53:00,119,68,Brinquedo,3,187
43015,2024-01-30 20:54:00,105,76,Eletrônico,3,181
43016,2024-01-30 20:55:00,118,58,Alimento,3,176
43017,2024-01-30 20:56:00,65,146,Móvel,5,211
43018,2024-01-30 20:57:00,48,162,Móvel,9,210
43019,2024-01-30 20:58:00,34,65,Alimento,3,99
43020,2024-01-30 20:59:00,11,45,Alimento,7,56
43021,2024-01-30 21:00:00,88,159,Eletrônico,6,247
43022,2024-01-30 21:01:00,47,155,Móvel,6,202
43023,2024-01-30 21:02:00,100,18,Alimento,1,118
43024,2024-01-30 21:03:00,64,64,Móvel,4,128
43025,2024-01-30 21:04:00,45,74,Vestuário,4,119
43026,2024-01-30 21:05:00,14,108,Eletrônico,3,122
43027,2024-01-30 21:06:00,22,41,Vestuário,8,63
43028,2024-01-30 21:07:00,49,43,Móvel,4,92
43029,2024-01-30 21:08:00,89,82,Alimento,2,171
43030,2024-01-30 21:09:00,24,121,Alimento,4,145
43031,2024-01-30 21:10:00,27,98,Vestuário,5,125
43032,2024-01-30 21:11:00,12,61,Móvel,7,73
43033,2024-01-30 21:12:00,85,178,Móvel,7,263
43034,2024-01-30 21:13:00,110,41,Vestuário,8,151
43035,2024-01-30 21:14:00,37,168,Móvel,6,205
43036,2024-01-30 21:15:00,16,142,Móvel,7,158
43037,2024-01-30 21:16:00,51,163,Eletrônico,2,214
43038,2024-01-30 21:17:00,98,133,Brinquedo,5,231
43039,2024-01-30 21:18:00,60,103,Móvel,4,163
43040,2024-01-30 21:19:00,25,108,Móvel,6,133
43041,2024-01-30 21:20:00,79,83,Móvel,3,162
43042,2024-01-30 21:21:00,91,119,Eletrônico,8,210
43043,2024-01-30 21:22:00,86,112,Vestuário,9,198
43044,2024-01-30 21:23:00,18,127,Vestuário,1,145
43045,2024-01-30 21:24:00,51,67,Brinquedo,3,118
43046,2024-01-30 21:25:00,41,45,Vestuário,4,86
43047,2024-01-30 21:26:00,59,25,Eletrônico,5,84
43048,2024-01-30 21:27:00,38,127,Eletrônico,7,165
43049,2024-01-30 21:28:00,110,162,Vestuário,1,272
43050,2024-01-30 21:29:00,16,141,Vestuário,3,157
43051,2024-01-30 21:30:00,25,63,Móvel,7,88
43052,2024-01-30 21:31:00,56,141,Brinquedo,1,197
43053,2024-01-30 21:32:00,99,62,Eletrônico,8,161
43054,2024-01-30 21:33:00,60,22,Eletrônico,7,82
43055,2024-01-30 21:34:00,56,27,Alimento,4,83
43056,2024-01-30 21:35:00,35,157,Móvel,7,192
43057,2024-01-30 21:36:00,53,36,Eletrônico,9,89
43058,2024-01-30 21:37:00,99,41,Brinquedo,9,140
43059,2024-01-30 21:38:00,119,62,Eletrônico,2,181
43060,2024-01-30 21:39:00,103,176,Móvel,9,279
43061,2024-01-30 21:40:00,119,43,Móvel,7,162
43062,2024-01-30 21:41:00,51,85,Móvel,3,136
43063,2024-01-30 21:42:00,41,64,Vestuário,6,105
43064,2024-01-30 21:43:00,27,170,Eletrônico,7,197
43065,2024-01-30 21:44:00,84,70,Eletrônico,8,154
43066,2024-01-30 21:45:00,60,163,Vestuário,7,223
43067,2024-01-30 21:46:00,58,51,Vestuário,3,109
43068,2024-01-30 21:47:00,38,151,Brinquedo,8,189
43069,2024-01-30 21:48:00,102,90,Vestuário,6,192
43070,2024-01-30 21:49:00,71,178,Vestuário,6,249
43071,2024-01-30 21:50:00,70,27,Alimento,1,97
43072,2024-01-30 21:51:00,41,169,Brinquedo,5,210
43073,2024-01-30 21:52:00,86,94,Móvel,9,180
43074,2024-01-30 21:53:00,107,140,Alimento,8,247
43075,2024-01-30 21:54:00,54,25,Móvel,8,79
43076,2024-01-30 21:55:00,17,64,Móvel,6,81
43077,2024-01-30 21:56:00,97,67,Vestuário,4,164
43078,2024-01-30 21:57:00,102,75,Alimento,7,177
43079,2024-01-30 21:58:00,95,14,Brinquedo,2,109
43080,2024-01-30 21:59:00,37,61,Eletrônico,2,98
43081,2024-01-30 22:00:00,37,64,Eletrônico,1,101
43082,2024-01-30 22:01:00,107,62,Móvel,5,169
43083,2024-01-30 22:02:00,66,86,Vestuário,8,152
43084,2024-01-30 22:03:00,48,145,Móvel,4,193
43085,2024-01-30 22:04:00,64,125,Eletrônico,3,189
43086,2024-01-30 22:05:00,90,124,Eletrônico,9,214
43087,2024-01-30 22:06:00,50,22,Móvel,9,72
43088,2024-01-30 22:07:00,37,38,Eletrônico,4,75
43089,2024-01-30 22:08:00,102,46,Vestuário,8,148
43090,2024-01-30 22:09:00,89,96,Brinquedo,2,185
43091,2024-01-30 22:10:00,24,122,Vestuário,7,146
43092,2024-01-30 22:11:00,41,42,Alimento,1,83
43093,2024-01-30 22:12:00,112,43,Eletrônico,1,155
43094,2024-01-30 22:13:00,98,158,Eletrônico,7,256
43095,2024-01-30 22:14:00,50,132,Vestuário,1,182
43096,2024-01-30 22:15:00,21,28,Móvel,7,49
43097,2024-01-30 22:16:00,84,120,Vestuário,3,204
43098,2024-01-30 22:17:00,88,15,Brinquedo,2,103
43099,2024-01-30 22:18:00,97,76,Brinquedo,2,173
43100,2024-01-30 22:19:00,77,87,Móvel,4,164
43101,2024-01-30 22:20:00,46,177,Alimento,8,223
43102,2024-01-30 22:21:00,22,78,Brinquedo,3,100
43103,2024-01-30 22:22:00,44,122,Vestuário,5,166
43104,2024-01-30 22:23:00,66,32,Móvel,1,98
43105,2024-01-30 22:24:00,66,46,Eletrônico,6,112
43106,2024-01-30 22:25:00,63,167,Eletrônico,5,230
43107,2024-01-30 22:26:00,79,20,Alimento,9,99
43108,2024-01-30 22:27:00,15,84,Brinquedo,8,99
43109,2024-01-30 22:28:00,36,169,Brinquedo,5,205
43110,2024-01-30 22:29:00,32,123,Eletrônico,8,155
43111,2024-01-30 22:30:00,119,166,Eletrônico,5,285
43112,2024-01-30 22:31:00,22,130,Brinquedo,5,152
43113,2024-01-30 22:32:00,80,30,Alimento,1,110
43114,2024-01-30 22:33:00,61,13,Vestuário,1,74
43115,2024-01-30 22:34:00,113,81,Eletrônico,1,194
43116,2024-01-30 22:35:00,99,142,Móvel,6,241
43117,2024-01-30 22:36:00,67,18,Vestuário,6,85
43118,2024-01-30 22:37:00,66,65,Móvel,3,131
43119,2024-01-30 22:38:00,46,52,Eletrônico,9,98
43120,2024-01-30 22:39:00,84,39,Brinquedo,6,123
43121,2024-01-30 22:40:00,14,160,Eletrônico,3,174
43122,2024-01-30 22:41:00,102,29,Brinquedo,5,131
43123,2024-01-30 22:42:00,30,166,Alimento,9,196
43124,2024-01-30 22:43:00,108,52,Vestuário,2,160
43125,2024-01-30 22:44:00,89,36,Móvel,9,125
43126,2024-01-30 22:45:00,50,151,Eletrônico,1,201
43127,2024-01-30 22:46:00,39,84,Alimento,9,123
43128,2024-01-30 22:47:00,35,26,Eletrônico,7,61
43129,2024-01-30 22:48:00,59,96,Eletrônico,7,155
43130,2024-01-30 22:49:00,113,77,Móvel,2,190
43131,2024-01-30 22:50:00,67,160,Alimento,3,227
43132,2024-01-30 22:51:00,57,83,Alimento,4,140
43133,2024-01-30 22:52:00,70,102,Alimento,4,172
43134,2024-01-30 22:53:00,88,45,Vestuário,2,133
43135,2024-01-30 22:54:00,23,14,Alimento,7,37
43136,2024-01-30 22:55:00,41,96,Eletrônico,9,137
43137,2024-01-30 22:56:00,89,168,Eletrônico,9,257
43138,2024-01-30 22:57:00,58,170,Eletrônico,2,228
43139,2024-01-30 22:58:00,56,82,Brinquedo,7,138
43140,2024-01-30 22:59:00,107,59,Alimento,1,166
43141,2024-01-30 23:00:00,73,148,Vestuário,1,221
43142,2024-01-30 23:01:00,81,80,Brinquedo,4,161
43143,2024-01-30 23:02:00,40,35,Alimento,6,75
43144,2024-01-30 23:03:00,60,135,Brinquedo,6,195
43145,2024-01-30 23:04:00,33,178,Móvel,9,211
43146,2024-01-30 23:05:00,107,63,Móvel,1,170
43147,2024-01-30 23:06:00,112,59,Alimento,4,171
43148,2024-01-30 23:07:00,12,150,Móvel,2,162
43149,2024-01-30 23:08:00,14,29,Brinquedo,2,43
43150,2024-01-30 23:09:00,113,87,Eletrônico,1,200
43151,2024-01-30 23:10:00,100,170,Eletrônico,7,270
43152,2024-01-30 23:11:00,58,39,Vestuário,8,97
43153,2024-01-30 23:12:00,38,112,Móvel,9,150
43154,2024-01-30 23:13:00,68,100,Brinquedo,9,168
43155,2024-01-30 23:14:00,119,140,Alimento,9,259
43156,2024-01-30 23:15:00,43,144,Alimento,6,187
43157,2024-01-30 23:16:00,32,55,Alimento,1,87
43158,2024-01-30 23:17:00,105,45,Alimento,2,150
43159,2024-01-30 23:18:00,118,35,Móvel,8,153
43160,2024-01-30 23:19:00,38,15,Eletrônico,4,53
43161,2024-01-30 23:20:00,110,123,Alimento,4,233
43162,2024-01-30 23:21:00,39,20,Móvel,4,59
43163,2024-01-30 23:22:00,12,140,Alimento,4,152
43164,2024-01-30 23:23:00,19,121,Eletrônico,6,140
43165,2024-01-30 23:24:00,70,148,Alimento,8,218
43166,2024-01-30 23:25:00,28,161,Brinquedo,8,189
43167,2024-01-30 23:26:00,81,116,Móvel,9,197
43168,2024-01-30 23:27:00,44,129,Vestuário,1,173
43169,2024-01-30 23:28:00,59,111,Brinquedo,9,170
43170,2024-01-30 23:29:00,36,63,Móvel,7,99
43171,2024-01-30 23:30:00,33,117,Alimento,8,150
43172,2024-01-30 23:31:00,38,129,Vestuário,5,167
43173,2024-01-30 23:32:00,99,57,Vestuário,9,156
43174,2024-01-30 23:33:00,25,73,Brinquedo,9,98
43175,2024-01-30 23:34:00,31,82,Alimento,8,113
43176,2024-01-30 23:35:00,42,56,Eletrônico,6,98
43177,2024-01-30 23:36:00,82,33,Móvel,2,115
43178,2024-01-30 23:37:00,87,81,Vestuário,5,168
43179,2024-01-30 23:38:00,98,75,Alimento,8,173
43180,2024-01-30 23:39:00,50,22,Eletrônico,3,72
43181,2024-01-30 23:40:00,48,128,Eletrônico,8,176
43182,2024-01-30 23:41:00,22,115,Vestuário,1,137
43183,2024-01-30 23:42:00,92,43,Brinquedo,4,135
43184,2024-01-30 23:43:00,42,31,Alimento,4,73
43185,2024-01-30 23:44:00,14,51,Vestuário,1,65
43186,2024-01-30 23:45:00,74,157,Móvel,7,231
43187,2024-01-30 23:46:00,76,89,Vestuário,6,165
43188,2024-01-30 23:47:00,112,97,Brinquedo,6,209
43189,2024-01-30 23:48:00,54,62,Móvel,2,116
43190,2024-01-30 23:49:00,73,42,Vestuário,6,115
43191,2024-01-30 23:50:00,45,139,Móvel,5,184
43192,2024-01-30 23:51:00,32,60,Brinquedo,6,92
43193,2024-01-30 23:52:00,92,56,Móvel,7,148
43194,2024-01-30 23:53:00,14,96,Brinquedo,9,110
43195,2024-01-30 23:54:00,60,130,Móvel,7,190
43196,2024-01-30 23:55:00,113,95,Alimento,1,208
43197,2024-01-30 23:56:00,10,77,Móvel,8,87
43198,2024-01-30 23:57:00,30,69,Vestuário,7,99
43199,2024-01-30 23:58:00,37,19,Eletrônico,5,56
43200,2024-01-30 23:59:00,67,31,Eletrônico,9,98
43201,2024-01-31 00:00:00,90,41,Móvel,5,131
43202,2024-01-31 00:01:00,102,162,Vestuário,2,264
43203,2024-01-31 00:02:00,54,146,Vestuário,2,200
43204,2024-01-31 00:03:00,73,37,Eletrônico,6,110
43205,2024-01-31 00:04:00,25,114,Brinquedo,9,139
43206,2024-01-31 00:05:00,31,25,Eletrônico,8,56
43207,2024-01-31 00:06:00,65,50,Móvel,5,115
43208,2024-01-31 00:07:00,79,100,Vestuário,4,179
43209,2024-01-31 00:08:00,112,70,Alimento,7,182
43210,2024-01-31 00:09:00,63,24,Eletrônico,1,87
43211,2024-01-31 00:10:00,92,123,Móvel,6,215
43212,2024-01-31 00:11:00,89,157,Brinquedo,7,246
43213,2024-01-31 00:12:00,76,105,Alimento,1,181
43214,2024-01-31 00:13:00,54,130,Eletrônico,9,184
43215,2024-01-31 00:14:00,75,13,Vestuário,2,88
43216,2024-01-31 00:15:00,47,99,Alimento,9,146
43217,2024-01-31 00:16:00,34,61,Vestuário,4,95
43218,2024-01-31 00:17:00,88,43,Móvel,2,131
43219,2024-01-31 00:18:00,81,47,Brinquedo,6,128
43220,2024-01-31 00:19:00,119,85,Brinquedo,5,204
43221,2024-01-31 00:20:00,113,23,Vestuário,5,136
43222,2024-01-31 00:21:00,58,151,Brinquedo,9,209
43223,2024-01-31 00:22:00,92,83,Vestuário,7,175
43224,2024-01-31 00:23:00,51,74,Eletrônico,8,125
43225,2024-01-31 00:24:00,53,165,Brinquedo,3,218
43226,2024-01-31 00:25:00,96,128,Vestuário,4,224
43227,2024-01-31 00:26:00,93,105,Móvel,1,198
43228,2024-01-31 00:27:00,84,38,Móvel,3,122
43229,2024-01-31 00:28:00,78,113,Brinquedo,8,191
43230,2024-01-31 00:29:00,98,89,Alimento,7,187
43231,2024-01-31 00:30:00,16,106,Alimento,2,122
43232,2024-01-31 00:31:00,104,92,Brinquedo,5,196
43233,2024-01-31 00:32:00,69,48,Vestuário,3,117
43234,2024-01-31 00:33:00,64,43,Móvel,4,107
43235,2024-01-31 00:34:00,10,27,Brinquedo,6,37
43236,2024-01-31 00:35:00,16,102,Eletrônico,4,118
43237,2024-01-31 00:36:00,59,53,Vestuário,5,112
43238,2024-01-31 00:37:00,23,119,Vestuário,2,142
43239,2024-01-31 00:38:00,43,80,Vestuário,1,123
43240,2024-01-31 00:39:00,57,48,Móvel,4,105
43241,2024-01-31 00:40:00,18,124,Eletrônico,5,142
43242,2024-01-31 00:41:00,34,141,Eletrônico,3,175
43243,2024-01-31 00:42:00,41,79,Móvel,1,120
43244,2024-01-31 00:43:00,32,156,Alimento,3,188
43245,2024-01-31 00:44:00,64,33,Brinquedo,5,97
43246,2024-01-31 00:45:00,99,91,Brinquedo,4,190
43247,2024-01-31 00:46:00,43,18,Brinquedo,8,61
43248,2024-01-31 00:47:00,58,60,Eletrônico,6,118
43249,2024-01-31 00:48:00,39,37,Alimento,8,76
43250,2024-01-31 00:49:00,94,49,Móvel,3,143
43251,2024-01-31 00:50:00,59,37,Vestuário,1,96
43252,2024-01-31 00:51:00,87,128,Móvel,9,215
43253,2024-01-31 00:52:00,46,60,Eletrônico,9,106
43254,2024-01-31 00:53:00,77,117,Eletrônico,6,194
43255,2024-01-31 00:54:00,94,166,Móvel,2,260
43256,2024-01-31 00:55:00,20,150,Brinquedo,4,170
43257,2024-01-31 00:56:00,34,73,Brinquedo,8,107
43258,2024-01-31 00:57:00,37,177,Eletrônico,4,214
43259,2024-01-31 00:58:00,14,30,Eletrônico,3,44
43260,2024-01-31 00:59:00,49,107,Eletrônico,3,156
43261,2024-01-31 01:00:00,89,82,Alimento,6,171
43262,2024-01-31 01:01:00,102,165,Eletrônico,7,267
43263,2024-01-31 01:02:00,12,23,Alimento,4,35
43264,2024-01-31 01:03:00,92,159,Móvel,9,251
43265,2024-01-31 01:04:00,86,106,Vestuário,1,192
43266,2024-01-31 01:05:00,15,148,Alimento,1,163
43267,2024-01-31 01:06:00,13,118,Vestuário,5,131
43268,2024-01-31 01:07:00,88,83,Móvel,6,171
43269,2024-01-31 01:08:00,84,128,Eletrônico,5,212
43270,2024-01-31 01:09:00,74,25,Brinquedo,4,99
43271,2024-01-31 01:10:00,84,172,Vestuário,1,256
43272,2024-01-31 01:11:00,89,162,Brinquedo,3,251
43273,2024-01-31 01:12:00,44,159,Eletrônico,1,203
43274,2024-01-31 01:13:00,46,136,Brinquedo,4,182
43275,2024-01-31 01:14:00,90,172,Vestuário,2,262
43276,2024-01-31 01:15:00,111,77,Brinquedo,3,188
43277,2024-01-31 01:16:00,39,52,Alimento,4,91
43278,2024-01-31 01:17:00,19,161,Eletrônico,6,180
43279,2024-01-31 01:18:00,16,103,Brinquedo,8,119
43280,2024-01-31 01:19:00,82,118,Vestuário,1,200
43281,2024-01-31 01:20:00,90,14,Eletrônico,7,104
43282,2024-01-31 01:21:00,97,68,Vestuário,1,165
43283,2024-01-31 01:22:00,95,22,Vestuário,7,117
43284,2024-01-31 01:23:00,34,118,Vestuário,8,152
43285,2024-01-31 01:24:00,48,171,Brinquedo,1,219
43286,2024-01-31 01:25:00,14,83,Móvel,6,97
43287,2024-01-31 01:26:00,52,128,Vestuário,7,180
43288,2024-01-31 01:27:00,78,61,Móvel,4,139
43289,2024-01-31 01:28:00,89,157,Móvel,2,246
43290,2024-01-31 01:29:00,56,122,Eletrônico,8,178
43291,2024-01-31 01:30:00,68,143,Vestuário,1,211
43292,2024-01-31 01:31:00,112,164,Brinquedo,3,276
43293,2024-01-31 01:32:00,103,39,Alimento,4,142
43294,2024-01-31 01:33:00,97,14,Brinquedo,4,111
43295,2024-01-31 01:34:00,19,143,Brinquedo,5,162
43296,2024-01-31 01:35:00,27,97,Alimento,2,124
43297,2024-01-31 01:36:00,10,172,Móvel,2,182
43298,2024-01-31 01:37:00,71,150,Brinquedo,8,221
43299,2024-01-31 01:38:00,78,26,Eletrônico,3,104
43300,2024-01-31 01:39:00,87,18,Brinquedo,1,105
43301,2024-01-31 01:40:00,59,53,Alimento,7,112
43302,2024-01-31 01:41:00,66,98,Vestuário,3,164
43303,2024-01-31 01:42:00,22,80,Alimento,2,102
43304,2024-01-31 01:43:00,78,85,Móvel,3,163
43305,2024-01-31 01:44:00,70,146,Brinquedo,2,216
43306,2024-01-31 01:45:00,63,41,Brinquedo,7,104
43307,2024-01-31 01:46:00,62,49,Brinquedo,5,111
43308,2024-01-31 01:47:00,40,16,Vestuário,4,56
43309,2024-01-31 01:48:00,110,70,Móvel,4,180
43310,2024-01-31 01:49:00,94,39,Alimento,4,133
43311,2024-01-31 01:50:00,63,105,Eletrônico,5,168
43312,2024-01-31 01:51:00,57,101,Móvel,6,158
43313,2024-01-31 01:52:00,69,158,Brinquedo,1,227
43314,2024-01-31 01:53:00,94,46,Eletrônico,5,140
43315,2024-01-31 01:54:00,69,163,Móvel,3,232
43316,2024-01-31 01:55:00,116,169,Alimento,6,285
43317,2024-01-31 01:56:00,41,34,Vestuário,3,75
43318,2024-01-31 01:57:00,87,39,Vestuário,8,126
43319,2024-01-31 01:58:00,116,142,Eletrônico,9,258
43320,2024-01-31 01:59:00,54,44,Brinquedo,1,98
43321,2024-01-31 02:00:00,12,169,Brinquedo,9,181
43322,2024-01-31 02:01:00,108,19,Brinquedo,6,127
43323,2024-01-31 02:02:00,70,54,Brinquedo,7,124
43324,2024-01-31 02:03:00,11,123,Móvel,2,134
43325,2024-01-31 02:04:00,111,67,Alimento,8,178
43326,2024-01-31 02:05:00,34,20,Alimento,5,54
43327,2024-01-31 02:06:00,95,74,Brinquedo,1,169
43328,2024-01-31 02:07:00,115,101,Vestuário,6,216
43329,2024-01-31 02:08:00,113,11,Móvel,2,124
43330,2024-01-31 02:09:00,70,127,Vestuário,4,197
43331,2024-01-31 02:10:00,16,136,Móvel,5,152
43332,2024-01-31 02:11:00,43,32,Alimento,3,75
43333,2024-01-31 02:12:00,15,120,Eletrônico,6,135
43334,2024-01-31 02:13:00,89,123,Alimento,4,212
43335,2024-01-31 02:14:00,23,117,Brinquedo,5,140
43336,2024-01-31 02:15:00,25,163,Eletrônico,2,188
43337,2024-01-31 02:16:00,33,55,Alimento,5,88
43338,2024-01-31 02:17:00,21,106,Eletrônico,5,127
43339,2024-01-31 02:18:00,99,41,Brinquedo,2,140
43340,2024-01-31 02:19:00,36,144,Vestuário,5,180
43341,2024-01-31 02:20:00,53,150,Brinquedo,8,203
43342,2024-01-31 02:21:00,92,118,Vestuário,9,210
43343,2024-01-31 02:22:00,46,93,Brinquedo,5,139
43344,2024-01-31 02:23:00,95,164,Brinquedo,6,259
43345,2024-01-31 02:24:00,107,147,Eletrônico,5,254
43346,2024-01-31 02:25:00,52,139,Brinquedo,1,191
43347,2024-01-31 02:26:00,38,110,Eletrônico,7,148
43348,2024-01-31 02:27:00,15,78,Alimento,5,93
43349,2024-01-31 02:28:00,68,138,Móvel,7,206
43350,2024-01-31 02:29:00,75,158,Vestuário,5,233
43351,2024-01-31 02:30:00,29,52,Alimento,6,81
43352,2024-01-31 02:31:00,67,19,Alimento,1,86
43353,2024-01-31 02:32:00,34,79,Vestuário,6,113
43354,2024-01-31 02:33:00,70,65,Vestuário,7,135
43355,2024-01-31 02:34:00,22,164,Brinquedo,1,186
43356,2024-01-31 02:35:00,38,86,Eletrônico,6,124
43357,2024-01-31 02:36:00,94,52,Vestuário,2,146
43358,2024-01-31 02:37:00,107,110,Brinquedo,5,217
43359,2024-01-31 02:38:00,76,114,Vestuário,5,190
43360,2024-01-31 02:39:00,20,138,Vestuário,5,158
43361,2024-01-31 02:40:00,90,44,Alimento,2,134
43362,2024-01-31 02:41:00,37,14,Móvel,3,51
43363,2024-01-31 02:42:00,34,32,Alimento,6,66
43364,2024-01-31 02:43:00,62,178,Móvel,4,240
43365,2024-01-31 02:44:00,36,27,Móvel,2,63
43366,2024-01-31 02:45:00,22,110,Vestuário,1,132
43367,2024-01-31 02:46:00,99,158,Alimento,1,257
43368,2024-01-31 02:47:00,11,19,Brinquedo,1,30
43369,2024-01-31 02:48:00,18,72,Vestuário,5,90
43370,2024-01-31 02:49:00,41,127,Vestuário,1,168
43371,2024-01-31 02:50:00,38,150,Móvel,6,188
43372,2024-01-31 02:51:00,96,126,Móvel,7,222
43373,2024-01-31 02:52:00,97,36,Vestuário,1,133
43374,2024-01-31 02:53:00,11,176,Móvel,4,187
43375,2024-01-31 02:54:00,79,74,Alimento,1,153
43376,2024-01-31 02:55:00,43,112,Vestuário,8,155
43377,2024-01-31 02:56:00,58,57,Alimento,7,115
43378,2024-01-31 02:57:00,46,101,Eletrônico,3,147
43379,2024-01-31 02:58:00,83,100,Alimento,4,183
43380,2024-01-31 02:59:00,46,165,Brinquedo,8,211
43381,2024-01-31 03:00:00,43,154,Brinquedo,5,197
43382,2024-01-31 03:01:00,66,112,Eletrônico,5,178
43383,2024-01-31 03:02:00,39,158,Móvel,4,197
43384,2024-01-31 03:03:00,118,15,Alimento,5,133
43385,2024-01-31 03:04:00,49,41,Vestuário,4,90
43386,2024-01-31 03:05:00,38,159,Alimento,3,197
43387,2024-01-31 03:06:00,51,93,Alimento,4,144
43388,2024-01-31 03:07:00,104,51,Móvel,2,155
43389,2024-01-31 03:08:00,52,88,Brinquedo,9,140
43390,2024-01-31 03:09:00,31,61,Eletrônico,4,92
43391,2024-01-31 03:10:00,73,147,Vestuário,4,220
43392,2024-01-31 03:11:00,89,152,Alimento,8,241
43393,2024-01-31 03:12:00,29,137,Eletrônico,6,166
43394,2024-01-31 03:13:00,54,108,Vestuário,5,162
43395,2024-01-31 03:14:00,34,34,Alimento,8,68
43396,2024-01-31 03:15:00,14,31,Brinquedo,5,45
43397,2024-01-31 03:16:00,79,88,Eletrônico,6,167
43398,2024-01-31 03:17:00,44,168,Móvel,1,212
43399,2024-01-31 03:18:00,112,149,Eletrônico,8,261
43400,2024-01-31 03:19:00,99,170,Brinquedo,6,269
43401,2024-01-31 03:20:00,109,71,Brinquedo,5,180
43402,2024-01-31 03:21:00,59,104,Vestuário,9,163
43403,2024-01-31 03:22:00,96,60,Alimento,2,156
43404,2024-01-31 03:23:00,94,137,Eletrônico,6,231
43405,2024-01-31 03:24:00,72,92,Vestuário,6,164
43406,2024-01-31 03:25:00,57,130,Eletrônico,8,187
43407,2024-01-31 03:26:00,117,132,Eletrônico,8,249
43408,2024-01-31 03:27:00,91,148,Eletrônico,4,239
43409,2024-01-31 03:28:00,75,77,Brinquedo,2,152
43410,2024-01-31 03:29:00,25,143,Vestuário,4,168
43411,2024-01-31 03:30:00,93,135,Eletrônico,9,228
43412,2024-01-31 03:31:00,103,96,Móvel,7,199
43413,2024-01-31 03:32:00,67,88,Móvel,8,155
43414,2024-01-31 03:33:00,32,81,Móvel,2,113
43415,2024-01-31 03:34:00,69,136,Eletrônico,4,205
43416,2024-01-31 03:35:00,27,31,Brinquedo,5,58
43417,2024-01-31 03:36:00,100,106,Brinquedo,6,206
43418,2024-01-31 03:37:00,77,116,Eletrônico,4,193
43419,2024-01-31 03:38:00,13,36,Móvel,5,49
43420,2024-01-31 03:39:00,105,95,Eletrônico,4,200
43421,2024-01-31 03:40:00,75,109,Móvel,8,184
43422,2024-01-31 03:41:00,21,137,Vestuário,7,158
43423,2024-01-31 03:42:00,38,84,Vestuário,7,122
43424,2024-01-31 03:43:00,24,156,Brinquedo,4,180
43425,2024-01-31 03:44:00,94,121,Móvel,4,215
43426,2024-01-31 03:45:00,61,65,Brinquedo,3,126
43427,2024-01-31 03:46:00,67,73,Alimento,8,140
43428,2024-01-31 03:47:00,94,68,Brinquedo,8,162
43429,2024-01-31 03:48:00,79,168,Eletrônico,1,247
43430,2024-01-31 03:49:00,59,28,Vestuário,6,87
43431,2024-01-31 03:50:00,28,108,Brinquedo,3,136
43432,2024-01-31 03:51:00,60,18,Vestuário,2,78
43433,2024-01-31 03:52:00,77,132,Móvel,5,209
43434,2024-01-31 03:53:00,116,60,Eletrônico,2,176
43435,2024-01-31 03:54:00,40,170,Brinquedo,9,210
43436,2024-01-31 03:55:00,114,73,Eletrônico,1,187
43437,2024-01-31 03:56:00,39,104,Eletrônico,7,143
43438,2024-01-31 03:57:00,115,19,Vestuário,6,134
43439,2024-01-31 03:58:00,116,42,Alimento,4,158
43440,2024-01-31 03:59:00,74,79,Móvel,9,153
43441,2024-01-31 04:00:00,118,75,Brinquedo,2,193
43442,2024-01-31 04:01:00,36,154,Vestuário,8,190
43443,2024-01-31 04:02:00,27,70,Eletrônico,5,97
43444,2024-01-31 04:03:00,100,167,Eletrônico,6,267
43445,2024-01-31 04:04:00,31,164,Brinquedo,2,195
43446,2024-01-31 04:05:00,16,112,Vestuário,7,128
43447,2024-01-31 04:06:00,43,61,Móvel,2,104
43448,2024-01-31 04:07:00,77,106,Eletrônico,6,183
43449,2024-01-31 04:08:00,65,177,Alimento,9,242
43450,2024-01-31 04:09:00,108,129,Vestuário,4,237
43451,2024-01-31 04:10:00,43,101,Vestuário,1,144
43452,2024-01-31 04:11:00,40,58,Móvel,5,98
43453,2024-01-31 04:12:00,90,136,Eletrônico,3,226
43454,2024-01-31 04:13:00,15,22,Brinquedo,6,37
43455,2024-01-31 04:14:00,82,156,Alimento,1,238
43456,2024-01-31 04:15:00,63,24,Vestuário,6,87
43457,2024-01-31 04:16:00,34,168,Móvel,1,202
43458,2024-01-31 04:17:00,96,74,Alimento,7,170
43459,2024-01-31 04:18:00,109,120,Eletrônico,9,229
43460,2024-01-31 04:19:00,69,164,Vestuário,7,233
43461,2024-01-31 04:20:00,107,136,Vestuário,7,243
43462,2024-01-31 04:21:00,29,145,Vestuário,5,174
43463,2024-01-31 04:22:00,54,100,Eletrônico,3,154
43464,2024-01-31 04:23:00,11,76,Eletrônico,1,87
43465,2024-01-31 04:24:00,22,169,Vestuário,7,191
43466,2024-01-31 04:25:00,105,59,Brinquedo,6,164
43467,2024-01-31 04:26:00,118,24,Brinquedo,4,142
43468,2024-01-31 04:27:00,45,139,Vestuário,7,184
43469,2024-01-31 04:28:00,57,161,Alimento,4,218
43470,2024-01-31 04:29:00,107,117,Vestuário,8,224
43471,2024-01-31 04:30:00,44,20,Alimento,5,64
43472,2024-01-31 04:31:00,44,75,Alimento,1,119
43473,2024-01-31 04:32:00,81,149,Vestuário,2,230
43474,2024-01-31 04:33:00,114,121,Vestuário,5,235
43475,2024-01-31 04:34:00,93,94,Brinquedo,1,187
43476,2024-01-31 04:35:00,107,107,Brinquedo,8,214
43477,2024-01-31 04:36:00,103,38,Eletrônico,5,141
43478,2024-01-31 04:37:00,65,27,Vestuário,4,92
43479,2024-01-31 04:38:00,81,10,Brinquedo,8,91
43480,2024-01-31 04:39:00,113,156,Móvel,8,269
43481,2024-01-31 04:40:00,76,83,Vestuário,7,159
43482,2024-01-31 04:41:00,46,123,Eletrônico,1,169
43483,2024-01-31 04:42:00,70,36,Brinquedo,9,106
43484,2024-01-31 04:43:00,18,117,Alimento,8,135
43485,2024-01-31 04:44:00,34,110,Eletrônico,2,144
43486,2024-01-31 04:45:00,106,92,Móvel,3,198
43487,2024-01-31 04:46:00,40,27,Eletrônico,7,67
43488,2024-01-31 04:47:00,96,34,Brinquedo,3,130
43489,2024-01-31 04:48:00,56,99,Brinquedo,5,155
43490,2024-01-31 04:49:00,98,60,Vestuário,8,158
43491,2024-01-31 04:50:00,114,47,Móvel,9,161
43492,2024-01-31 04:51:00,82,132,Alimento,2,214
43493,2024-01-31 04:52:00,118,22,Vestuário,3,140
43494,2024-01-31 04:53:00,100,115,Móvel,8,215
43495,2024-01-31 04:54:00,69,104,Móvel,8,173
43496,2024-01-31 04:55:00,70,151,Alimento,8,221
43497,2024-01-31 04:56:00,17,70,Móvel,7,87
43498,2024-01-31 04:57:00,112,122,Eletrônico,9,234
43499,2024-01-31 04:58:00,36,27,Móvel,2,63
43500,2024-01-31 04:59:00,108,41,Móvel,1,149
43501,2024-01-31 05:00:00,12,41,Eletrônico,2,53
43502,2024-01-31 05:01:00,100,164,Eletrônico,8,264
43503,2024-01-31 05:02:00,80,70,Eletrônico,5,150
43504,2024-01-31 05:03:00,77,139,Móvel,5,216
43505,2024-01-31 05:04:00,32,147,Eletrônico,3,179
43506,2024-01-31 05:05:00,78,94,Vestuário,6,172
43507,2024-01-31 05:06:00,55,169,Eletrônico,4,224
43508,2024-01-31 05:07:00,13,53,Brinquedo,4,66
43509,2024-01-31 05:08:00,102,12,Eletrônico,6,114
43510,2024-01-31 05:09:00,90,76,Móvel,5,166
43511,2024-01-31 05:10:00,63,159,Eletrônico,1,222
43512,2024-01-31 05:11:00,117,116,Vestuário,9,233
43513,2024-01-31 05:12:00,89,169,Eletrônico,5,258
43514,2024-01-31 05:13:00,60,80,Eletrônico,1,140
43515,2024-01-31 05:14:00,22,101,Vestuário,2,123
43516,2024-01-31 05:15:00,117,41,Eletrônico,5,158
43517,2024-01-31 05:16:00,101,134,Móvel,9,235
43518,2024-01-31 05:17:00,26,39,Móvel,2,65
43519,2024-01-31 05:18:00,86,14,Alimento,2,100
43520,2024-01-31 05:19:00,81,116,Vestuário,4,197
43521,2024-01-31 05:20:00,83,86,Brinquedo,5,169
43522,2024-01-31 05:21:00,70,18,Móvel,4,88
43523,2024-01-31 05:22:00,91,106,Vestuário,3,197
43524,2024-01-31 05:23:00,109,126,Móvel,3,235
43525,2024-01-31 05:24:00,76,134,Vestuário,3,210
43526,2024-01-31 05:25:00,60,30,Eletrônico,3,90
43527,2024-01-31 05:26:00,81,152,Vestuário,8,233
43528,2024-01-31 05:27:00,69,84,Vestuário,9,153
43529,2024-01-31 05:28:00,108,33,Alimento,1,141
43530,2024-01-31 05:29:00,32,178,Brinquedo,6,210
43531,2024-01-31 05:30:00,77,130,Móvel,7,207
43532,2024-01-31 05:31:00,97,116,Brinquedo,8,213
43533,2024-01-31 05:32:00,29,129,Vestuário,7,158
43534,2024-01-31 05:33:00,33,22,Eletrônico,5,55
43535,2024-01-31 05:34:00,73,179,Alimento,3,252
43536,2024-01-31 05:35:00,80,57,Brinquedo,3,137
43537,2024-01-31 05:36:00,55,37,Vestuário,9,92
43538,2024-01-31 05:37:00,90,134,Brinquedo,8,224
43539,2024-01-31 05:38:00,41,69,Eletrônico,8,110
43540,2024-01-31 05:39:00,77,150,Brinquedo,2,227
43541,2024-01-31 05:40:00,96,174,Eletrônico,5,270
43542,2024-01-31 05:41:00,58,84,Brinquedo,7,142
43543,2024-01-31 05:42:00,117,159,Brinquedo,6,276
43544,2024-01-31 05:43:00,68,43,Brinquedo,4,111
43545,2024-01-31 05:44:00,110,133,Brinquedo,1,243
43546,2024-01-31 05:45:00,65,143,Alimento,8,208
43547,2024-01-31 05:46:00,38,111,Eletrônico,1,149
43548,2024-01-31 05:47:00,96,53,Vestuário,5,149
43549,2024-01-31 05:48:00,40,14,Vestuário,1,54
43550,2024-01-31 05:49:00,70,168,Brinquedo,7,238
43551,2024-01-31 05:50:00,42,30,Móvel,5,72
43552,2024-01-31 05:51:00,51,152,Móvel,8,203
43553,2024-01-31 05:52:00,113,125,Móvel,1,238
43554,2024-01-31 05:53:00,35,135,Vestuário,7,170
43555,2024-01-31 05:54:00,79,11,Vestuário,8,90
43556,2024-01-31 05:55:00,106,62,Eletrônico,7,168
43557,2024-01-31 05:56:00,79,166,Móvel,1,245
43558,2024-01-31 05:57:00,57,171,Brinquedo,9,228
43559,2024-01-31 05:58:00,114,106,Eletrônico,7,220
43560,2024-01-31 05:59:00,48,68,Eletrônico,5,116
43561,2024-01-31 06:00:00,85,109,Móvel,3,194
43562,2024-01-31 06:01:00,95,135,Brinquedo,2,230
43563,2024-01-31 06:02:00,53,130,Móvel,5,183
43564,2024-01-31 06:03:00,24,90,Eletrônico,1,114
43565,2024-01-31 06:04:00,22,90,Móvel,8,112
43566,2024-01-31 06:05:00,65,138,Vestuário,4,203
43567,2024-01-31 06:06:00,59,56,Alimento,2,115
43568,2024-01-31 06:07:00,24,77,Eletrônico,8,101
43569,2024-01-31 06:08:00,76,72,Móvel,1,148
43570,2024-01-31 06:09:00,80,106,Brinquedo,5,186
43571,2024-01-31 06:10:00,39,59,Eletrônico,9,98
43572,2024-01-31 06:11:00,30,134,Brinquedo,1,164
43573,2024-01-31 06:12:00,31,122,Vestuário,4,153
43574,2024-01-31 06:13:00,108,29,Brinquedo,6,137
43575,2024-01-31 06:14:00,112,26,Brinquedo,8,138
43576,2024-01-31 06:15:00,20,115,Vestuário,3,135
43577,2024-01-31 06:16:00,20,59,Alimento,6,79
43578,2024-01-31 06:17:00,98,97,Vestuário,8,195
43579,2024-01-31 06:18:00,88,19,Alimento,2,107
43580,2024-01-31 06:19:00,18,50,Móvel,3,68
43581,2024-01-31 06:20:00,63,164,Alimento,9,227
43582,2024-01-31 06:21:00,111,105,Alimento,3,216
43583,2024-01-31 06:22:00,81,145,Brinquedo,2,226
43584,2024-01-31 06:23:00,102,151,Alimento,5,253
43585,2024-01-31 06:24:00,110,50,Eletrônico,4,160
43586,2024-01-31 06:25:00,111,56,Vestuário,7,167
43587,2024-01-31 06:26:00,60,58,Vestuário,2,118
43588,2024-01-31 06:27:00,73,63,Alimento,5,136
43589,2024-01-31 06:28:00,92,148,Eletrônico,9,240
43590,2024-01-31 06:29:00,57,143,Brinquedo,5,200
43591,2024-01-31 06:30:00,48,38,Móvel,4,86
43592,2024-01-31 06:31:00,21,49,Móvel,8,70
43593,2024-01-31 06:32:00,65,73,Vestuário,4,138
43594,2024-01-31 06:33:00,72,121,Móvel,6,193
43595,2024-01-31 06:34:00,103,164,Eletrônico,7,267
43596,2024-01-31 06:35:00,89,44,Vestuário,8,133
43597,2024-01-31 06:36:00,117,139,Eletrônico,7,256
43598,2024-01-31 06:37:00,67,56,Móvel,4,123
43599,2024-01-31 06:38:00,70,174,Móvel,4,244
43600,2024-01-31 06:39:00,25,106,Alimento,3,131
43601,2024-01-31 06:40:00,88,143,Eletrônico,2,231
43602,2024-01-31 06:41:00,57,36,Brinquedo,3,93
43603,2024-01-31 06:42:00,29,39,Vestuário,6,68
43604,2024-01-31 06:43:00,73,155,Alimento,6,228
43605,2024-01-31 06:44:00,67,60,Vestuário,9,127
43606,2024-01-31 06:45:00,17,41,Móvel,4,58
43607,2024-01-31 06:46:00,64,143,Móvel,1,207
43608,2024-01-31 06:47:00,65,50,Alimento,5,115
43609,2024-01-31 06:48:00,48,72,Brinquedo,9,120
43610,2024-01-31 06:49:00,91,154,Alimento,1,245
43611,2024-01-31 06:50:00,49,92,Brinquedo,5,141
43612,2024-01-31 06:51:00,110,146,Alimento,6,256
43613,2024-01-31 06:52:00,46,143,Alimento,7,189
43614,2024-01-31 06:53:00,91,12,Vestuário,7,103
43615,2024-01-31 06:54:00,74,63,Alimento,9,137
43616,2024-01-31 06:55:00,84,142,Eletrônico,8,226
43617,2024-01-31 06:56:00,75,35,Alimento,4,110
43618,2024-01-31 06:57:00,90,120,Móvel,7,210
43619,2024-01-31 06:58:00,44,96,Brinquedo,9,140
43620,2024-01-31 06:59:00,61,18,Eletrônico,5,79
43621,2024-01-31 07:00:00,89,22,Eletrônico,4,111
43622,2024-01-31 07:01:00,102,160,Móvel,2,262
43623,2024-01-31 07:02:00,47,91,Alimento,3,138
43624,2024-01-31 07:03:00,24,166,Brinquedo,2,190
43625,2024-01-31 07:04:00,14,93,Alimento,8,107
43626,2024-01-31 07:05:00,87,33,Eletrônico,4,120
43627,2024-01-31 07:06:00,98,86,Móvel,8,184
43628,2024-01-31 07:07:00,74,48,Móvel,8,122
43629,2024-01-31 07:08:00,100,127,Eletrônico,3,227
43630,2024-01-31 07:09:00,25,125,Eletrônico,1,150
43631,2024-01-31 07:10:00,52,63,Vestuário,8,115
43632,2024-01-31 07:11:00,100,10,Alimento,7,110
43633,2024-01-31 07:12:00,46,165,Eletrônico,7,211
43634,2024-01-31 07:13:00,64,88,Eletrônico,2,152
43635,2024-01-31 07:14:00,90,147,Eletrônico,1,237
43636,2024-01-31 07:15:00,65,36,Vestuário,1,101
43637,2024-01-31 07:16:00,36,14,Brinquedo,8,50
43638,2024-01-31 07:17:00,116,54,Vestuário,6,170
43639,2024-01-31 07:18:00,15,83,Brinquedo,8,98
43640,2024-01-31 07:19:00,59,37,Móvel,6,96
43641,2024-01-31 07:20:00,51,145,Alimento,5,196
43642,2024-01-31 07:21:00,105,20,Eletrônico,1,125
43643,2024-01-31 07:22:00,77,60,Eletrônico,1,137
43644,2024-01-31 07:23:00,117,34,Móvel,1,151
43645,2024-01-31 07:24:00,89,146,Brinquedo,2,235
43646,2024-01-31 07:25:00,118,91,Vestuário,9,209
43647,2024-01-31 07:26:00,17,141,Alimento,3,158
43648,2024-01-31 07:27:00,91,153,Brinquedo,2,244
43649,2024-01-31 07:28:00,32,12,Alimento,2,44
43650,2024-01-31 07:29:00,77,10,Vestuário,8,87
43651,2024-01-31 07:30:00,86,142,Brinquedo,8,228
43652,2024-01-31 07:31:00,23,120,Brinquedo,2,143
43653,2024-01-31 07:32:00,45,164,Brinquedo,3,209
43654,2024-01-31 07:33:00,73,107,Eletrônico,8,180
43655,2024-01-31 07:34:00,37,158,Vestuário,2,195
43656,2024-01-31 07:35:00,45,84,Brinquedo,7,129
43657,2024-01-31 07:36:00,93,27,Alimento,8,120
43658,2024-01-31 07:37:00,97,138,Vestuário,8,235
43659,2024-01-31 07:38:00,14,105,Brinquedo,4,119
43660,2024-01-31 07:39:00,11,102,Móvel,8,113
43661,2024-01-31 07:40:00,96,149,Brinquedo,3,245
43662,2024-01-31 07:41:00,55,20,Eletrônico,1,75
43663,2024-01-31 07:42:00,33,15,Brinquedo,7,48
43664,2024-01-31 07:43:00,101,43,Eletrônico,2,144
43665,2024-01-31 07:44:00,76,62,Eletrônico,2,138
43666,2024-01-31 07:45:00,116,134,Eletrônico,2,250
43667,2024-01-31 07:46:00,35,165,Brinquedo,8,200
43668,2024-01-31 07:47:00,102,134,Vestuário,2,236
43669,2024-01-31 07:48:00,87,98,Móvel,9,185
43670,2024-01-31 07:49:00,87,31,Móvel,9,118
43671,2024-01-31 07:50:00,119,148,Alimento,3,267
43672,2024-01-31 07:51:00,101,124,Vestuário,4,225
43673,2024-01-31 07:52:00,112,43,Alimento,4,155
43674,2024-01-31 07:53:00,19,102,Eletrônico,9,121
43675,2024-01-31 07:54:00,76,95,Móvel,5,171
43676,2024-01-31 07:55:00,108,30,Alimento,6,138
43677,2024-01-31 07:56:00,86,67,Alimento,2,153
43678,2024-01-31 07:57:00,118,64,Brinquedo,6,182
43679,2024-01-31 07:58:00,114,111,Vestuário,2,225
43680,2024-01-31 07:59:00,69,120,Eletrônico,6,189
43681,2024-01-31 08:00:00,67,135,Alimento,8,202
43682,2024-01-31 08:01:00,64,149,Móvel,1,213
43683,2024-01-31 08:02:00,98,81,Vestuário,5,179
43684,2024-01-31 08:03:00,46,73,Eletrônico,2,119
43685,2024-01-31 08:04:00,118,166,Móvel,7,284
43686,2024-01-31 08:05:00,64,60,Eletrônico,7,124
43687,2024-01-31 08:06:00,51,33,Móvel,2,84
43688,2024-01-31 08:07:00,48,19,Alimento,5,67
43689,2024-01-31 08:08:00,33,164,Eletrônico,4,197
43690,2024-01-31 08:09:00,66,156,Alimento,6,222
43691,2024-01-31 08:10:00,106,40,Eletrônico,9,146
43692,2024-01-31 08:11:00,17,117,Eletrônico,8,134
43693,2024-01-31 08:12:00,34,150,Alimento,7,184
43694,2024-01-31 08:13:00,37,145,Eletrônico,3,182
43695,2024-01-31 08:14:00,26,151,Móvel,4,177
43696,2024-01-31 08:15:00,25,126,Brinquedo,1,151
43697,2024-01-31 08:16:00,103,11,Móvel,8,114
43698,2024-01-31 08:17:00,83,106,Brinquedo,7,189
43699,2024-01-31 08:18:00,56,111,Alimento,7,167
43700,2024-01-31 08:19:00,38,144,Brinquedo,7,182
43701,2024-01-31 08:20:00,33,73,Vestuário,8,106
43702,2024-01-31 08:21:00,19,126,Brinquedo,3,145
43703,2024-01-31 08:22:00,57,113,Vestuário,1,170
43704,2024-01-31 08:23:00,108,153,Móvel,9,261
43705,2024-01-31 08:24:00,91,93,Eletrônico,2,184
43706,2024-01-31 08:25:00,18,36,Eletrônico,4,54
43707,2024-01-31 08:26:00,88,108,Alimento,9,196
43708,2024-01-31 08:27:00,112,109,Brinquedo,5,221
43709,2024-01-31 08:28:00,99,84,Alimento,4,183
43710,2024-01-31 08:29:00,21,157,Alimento,2,178
43711,2024-01-31 08:30:00,37,50,Brinquedo,9,87
43712,2024-01-31 08:31:00,42,103,Vestuário,7,145
43713,2024-01-31 08:32:00,101,151,Brinquedo,7,252
43714,2024-01-31 08:33:00,93,54,Brinquedo,7,147
43715,2024-01-31 08:34:00,67,84,Eletrônico,3,151
43716,2024-01-31 08:35:00,100,79,Alimento,3,179
43717,2024-01-31 08:36:00,38,49,Móvel,7,87
43718,2024-01-31 08:37:00,26,175,Eletrônico,4,201
43719,2024-01-31 08:38:00,30,66,Móvel,3,96
43720,2024-01-31 08:39:00,79,36,Vestuário,1,115
43721,2024-01-31 08:40:00,69,137,Móvel,8,206
43722,2024-01-31 08:41:00,53,121,Alimento,1,174
43723,2024-01-31 08:42:00,67,160,Vestuário,5,227
43724,2024-01-31 08:43:00,114,104,Vestuário,7,218
43725,2024-01-31 08:44:00,115,152,Vestuário,9,267
43726,2024-01-31 08:45:00,48,21,Eletrônico,7,69
43727,2024-01-31 08:46:00,116,101,Alimento,3,217
43728,2024-01-31 08:47:00,37,94,Vestuário,3,131
43729,2024-01-31 08:48:00,50,23,Brinquedo,7,73
43730,2024-01-31 08:49:00,65,49,Eletrônico,9,114
43731,2024-01-31 08:50:00,59,93,Brinquedo,5,152
43732,2024-01-31 08:51:00,85,96,Alimento,4,181
43733,2024-01-31 08:52:00,19,131,Brinquedo,9,150
43734,2024-01-31 08:53:00,32,167,Móvel,1,199
43735,2024-01-31 08:54:00,17,61,Alimento,9,78
43736,2024-01-31 08:55:00,67,36,Vestuário,3,103
43737,2024-01-31 08:56:00,100,108,Brinquedo,8,208
43738,2024-01-31 08:57:00,86,103,Vestuário,8,189
43739,2024-01-31 08:58:00,95,70,Eletrônico,3,165
43740,2024-01-31 08:59:00,48,176,Eletrônico,8,224
43741,2024-01-31 09:00:00,90,38,Eletrônico,3,128
43742,2024-01-31 09:01:00,87,32,Brinquedo,9,119
43743,2024-01-31 09:02:00,83,55,Alimento,8,138
43744,2024-01-31 09:03:00,76,84,Alimento,3,160
43745,2024-01-31 09:04:00,70,135,Vestuário,7,205
43746,2024-01-31 09:05:00,10,50,Móvel,5,60
43747,2024-01-31 09:06:00,77,49,Vestuário,9,126
43748,2024-01-31 09:07:00,14,52,Alimento,4,66
43749,2024-01-31 09:08:00,10,160,Vestuário,2,170
43750,2024-01-31 09:09:00,82,133,Eletrônico,8,215
43751,2024-01-31 09:10:00,101,144,Móvel,3,245
43752,2024-01-31 09:11:00,26,151,Eletrônico,6,177
43753,2024-01-31 09:12:00,88,64,Alimento,5,152
43754,2024-01-31 09:13:00,29,35,Alimento,7,64
43755,2024-01-31 09:14:00,89,69,Alimento,8,158
43756,2024-01-31 09:15:00,71,105,Móvel,6,176
43757,2024-01-31 09:16:00,41,34,Brinquedo,1,75
43758,2024-01-31 09:17:00,76,176,Vestuário,7,252
43759,2024-01-31 09:18:00,84,169,Vestuário,6,253
43760,2024-01-31 09:19:00,71,140,Alimento,1,211
43761,2024-01-31 09:20:00,85,78,Vestuário,1,163
43762,2024-01-31 09:21:00,29,109,Vestuário,3,138
43763,2024-01-31 09:22:00,28,40,Alimento,3,68
43764,2024-01-31 09:23:00,30,60,Móvel,2,90
43765,2024-01-31 09:24:00,21,23,Móvel,6,44
43766,2024-01-31 09:25:00,74,168,Vestuário,2,242
43767,2024-01-31 09:26:00,101,36,Eletrônico,6,137
43768,2024-01-31 09:27:00,72,33,Eletrônico,6,105
43769,2024-01-31 09:28:00,66,88,Móvel,4,154
43770,2024-01-31 09:29:00,45,49,Vestuário,7,94
43771,2024-01-31 09:30:00,86,53,Móvel,5,139
43772,2024-01-31 09:31:00,102,165,Móvel,5,267
43773,2024-01-31 09:32:00,23,148,Móvel,9,171
43774,2024-01-31 09:33:00,58,57,Móvel,3,115
43775,2024-01-31 09:34:00,101,115,Brinquedo,9,216
43776,2024-01-31 09:35:00,36,169,Alimento,1,205
43777,2024-01-31 09:36:00,115,47,Eletrônico,3,162
43778,2024-01-31 09:37:00,17,155,Vestuário,6,172
43779,2024-01-31 09:38:00,112,33,Alimento,7,145
43780,2024-01-31 09:39:00,116,177,Móvel,2,293
43781,2024-01-31 09:40:00,63,122,Brinquedo,3,185
43782,2024-01-31 09:41:00,106,63,Vestuário,8,169
43783,2024-01-31 09:42:00,26,92,Móvel,5,118
43784,2024-01-31 09:43:00,106,124,Móvel,7,230
43785,2024-01-31 09:44:00,103,21,Brinquedo,1,124
43786,2024-01-31 09:45:00,16,138,Móvel,2,154
43787,2024-01-31 09:46:00,56,85,Vestuário,9,141
43788,2024-01-31 09:47:00,58,67,Vestuário,4,125
43789,2024-01-31 09:48:00,78,176,Alimento,4,254
43790,2024-01-31 09:49:00,51,160,Móvel,9,211
43791,2024-01-31 09:50:00,16,67,Eletrônico,7,83
43792,2024-01-31 09:51:00,13,84,Vestuário,5,97
43793,2024-01-31 09:52:00,115,14,Móvel,4,129
43794,2024-01-31 09:53:00,46,136,Alimento,3,182
43795,2024-01-31 09:54:00,88,85,Móvel,5,173
43796,2024-01-31 09:55:00,55,177,Vestuário,5,232
43797,2024-01-31 09:56:00,21,12,Vestuário,4,33
43798,2024-01-31 09:57:00,32,11,Alimento,1,43
43799,2024-01-31 09:58:00,106,169,Brinquedo,2,275
43800,2024-01-31 09:59:00,93,153,Eletrônico,7,246
43801,2024-01-31 10:00:00,92,123,Vestuário,8,215
43802,2024-01-31 10:01:00,101,21,Alimento,5,122
43803,2024-01-31 10:02:00,115,136,Vestuário,5,251
43804,2024-01-31 10:03:00,55,132,Alimento,9,187
43805,2024-01-31 10:04:00,50,15,Vestuário,8,65
43806,2024-01-31 10:05:00,83,60,Alimento,2,143
43807,2024-01-31 10:06:00,91,140,Móvel,5,231
43808,2024-01-31 10:07:00,56,14,Móvel,9,70
43809,2024-01-31 10:08:00,43,138,Móvel,2,181
43810,2024-01-31 10:09:00,18,129,Móvel,4,147
43811,2024-01-31 10:10:00,76,13,Vestuário,8,89
43812,2024-01-31 10:11:00,61,96,Alimento,6,157
43813,2024-01-31 10:12:00,61,142,Alimento,1,203
43814,2024-01-31 10:13:00,107,34,Alimento,4,141
43815,2024-01-31 10:14:00,80,121,Vestuário,5,201
43816,2024-01-31 10:15:00,41,17,Brinquedo,5,58
43817,2024-01-31 10:16:00,19,153,Brinquedo,4,172
43818,2024-01-31 10:17:00,57,75,Brinquedo,7,132
43819,2024-01-31 10:18:00,26,31,Vestuário,2,57
43820,2024-01-31 10:19:00,18,11,Alimento,7,29
43821,2024-01-31 10:20:00,50,24,Brinquedo,4,74
43822,2024-01-31 10:21:00,93,36,Alimento,5,129
43823,2024-01-31 10:22:00,50,88,Brinquedo,9,138
43824,2024-01-31 10:23:00,92,178,Alimento,8,270
43825,2024-01-31 10:24:00,60,63,Alimento,2,123
43826,2024-01-31 10:25:00,67,60,Eletrônico,9,127
43827,2024-01-31 10:26:00,39,61,Brinquedo,5,100
43828,2024-01-31 10:27:00,20,83,Eletrônico,2,103
43829,2024-01-31 10:28:00,42,29,Eletrônico,1,71
43830,2024-01-31 10:29:00,45,86,Móvel,4,131
43831,2024-01-31 10:30:00,87,19,Eletrônico,1,106
43832,2024-01-31 10:31:00,40,48,Vestuário,1,88
43833,2024-01-31 10:32:00,107,51,Alimento,1,158
43834,2024-01-31 10:33:00,18,140,Brinquedo,4,158
43835,2024-01-31 10:34:00,78,97,Brinquedo,3,175
43836,2024-01-31 10:35:00,14,65,Vestuário,4,79
43837,2024-01-31 10:36:00,99,129,Vestuário,7,228
43838,2024-01-31 10:37:00,106,103,Eletrônico,8,209
43839,2024-01-31 10:38:00,108,104,Móvel,9,212
43840,2024-01-31 10:39:00,101,89,Vestuário,5,190
43841,2024-01-31 10:40:00,89,86,Vestuário,6,175
43842,2024-01-31 10:41:00,37,140,Eletrônico,2,177
43843,2024-01-31 10:42:00,48,63,Brinquedo,7,111
43844,2024-01-31 10:43:00,62,102,Eletrônico,4,164
43845,2024-01-31 10:44:00,85,78,Brinquedo,4,163
43846,2024-01-31 10:45:00,42,107,Móvel,6,149
43847,2024-01-31 10:46:00,118,88,Eletrônico,4,206
43848,2024-01-31 10:47:00,106,160,Eletrônico,5,266
43849,2024-01-31 10:48:00,25,138,Vestuário,4,163
43850,2024-01-31 10:49:00,14,75,Alimento,2,89
43851,2024-01-31 10:50:00,104,99,Alimento,2,203
43852,2024-01-31 10:51:00,90,69,Eletrônico,4,159
43853,2024-01-31 10:52:00,27,35,Alimento,3,62
43854,2024-01-31 10:53:00,116,173,Alimento,4,289
43855,2024-01-31 10:54:00,102,15,Brinquedo,8,117
43856,2024-01-31 10:55:00,68,58,Alimento,8,126
43857,2024-01-31 10:56:00,82,80,Móvel,8,162
43858,2024-01-31 10:57:00,103,119,Móvel,4,222
43859,2024-01-31 10:58:00,51,104,Alimento,7,155
43860,2024-01-31 10:59:00,56,121,Vestuário,5,177
43861,2024-01-31 11:00:00,70,15,Brinquedo,5,85
43862,2024-01-31 11:01:00,81,28,Alimento,1,109
43863,2024-01-31 11:02:00,50,10,Brinquedo,5,60
43864,2024-01-31 11:03:00,84,134,Móvel,4,218
43865,2024-01-31 11:04:00,64,43,Móvel,3,107
43866,2024-01-31 11:05:00,84,57,Eletrônico,6,141
43867,2024-01-31 11:06:00,71,16,Eletrônico,3,87
43868,2024-01-31 11:07:00,113,51,Móvel,3,164
43869,2024-01-31 11:08:00,116,67,Eletrônico,9,183
43870,2024-01-31 11:09:00,51,136,Brinquedo,5,187
43871,2024-01-31 11:10:00,37,30,Vestuário,2,67
43872,2024-01-31 11:11:00,36,160,Vestuário,5,196
43873,2024-01-31 11:12:00,27,74,Alimento,5,101
43874,2024-01-31 11:13:00,78,35,Alimento,1,113
43875,2024-01-31 11:14:00,85,29,Móvel,8,114
43876,2024-01-31 11:15:00,10,163,Vestuário,4,173
43877,2024-01-31 11:16:00,73,60,Alimento,6,133
43878,2024-01-31 11:17:00,116,66,Brinquedo,7,182
43879,2024-01-31 11:18:00,55,140,Móvel,2,195
43880,2024-01-31 11:19:00,92,87,Vestuário,5,179
43881,2024-01-31 11:20:00,92,32,Móvel,8,124
43882,2024-01-31 11:21:00,112,94,Móvel,2,206
43883,2024-01-31 11:22:00,83,52,Eletrônico,1,135
43884,2024-01-31 11:23:00,17,133,Brinquedo,1,150
43885,2024-01-31 11:24:00,90,116,Vestuário,6,206
43886,2024-01-31 11:25:00,95,13,Eletrônico,1,108
43887,2024-01-31 11:26:00,66,89,Eletrônico,1,155
43888,2024-01-31 11:27:00,88,109,Eletrônico,5,197
43889,2024-01-31 11:28:00,71,126,Alimento,6,197
43890,2024-01-31 11:29:00,60,95,Eletrônico,8,155
43891,2024-01-31 11:30:00,99,38,Alimento,5,137
43892,2024-01-31 11:31:00,112,162,Vestuário,5,274
43893,2024-01-31 11:32:00,64,161,Brinquedo,9,225
43894,2024-01-31 11:33:00,113,75,Brinquedo,6,188
43895,2024-01-31 11:34:00,36,117,Brinquedo,3,153
43896,2024-01-31 11:35:00,75,166,Brinquedo,3,241
43897,2024-01-31 11:36:00,112,107,Móvel,5,219
43898,2024-01-31 11:37:00,99,27,Alimento,2,126
43899,2024-01-31 11:38:00,101,83,Brinquedo,9,184
43900,2024-01-31 11:39:00,98,11,Brinquedo,8,109
43901,2024-01-31 11:40:00,17,144,Móvel,9,161
43902,2024-01-31 11:41:00,11,168,Vestuário,2,179
43903,2024-01-31 11:42:00,74,86,Alimento,3,160
43904,2024-01-31 11:43:00,30,47,Brinquedo,8,77
43905,2024-01-31 11:44:00,61,59,Móvel,5,120
43906,2024-01-31 11:45:00,22,101,Eletrônico,8,123
43907,2024-01-31 11:46:00,81,39,Alimento,4,120
43908,2024-01-31 11:47:00,95,42,Brinquedo,6,137
43909,2024-01-31 11:48:00,50,101,Eletrônico,8,151
43910,2024-01-31 11:49:00,106,155,Móvel,3,261
43911,2024-01-31 11:50:00,76,35,Eletrônico,4,111
43912,2024-01-31 11:51:00,31,68,Vestuário,2,99
43913,2024-01-31 11:52:00,31,42,Alimento,8,73
43914,2024-01-31 11:53:00,83,11,Vestuário,2,94
43915,2024-01-31 11:54:00,20,161,Eletrônico,8,181
43916,2024-01-31 11:55:00,32,99,Vestuário,4,131
43917,2024-01-31 11:56:00,67,108,Brinquedo,3,175
43918,2024-01-31 11:57:00,59,68,Vestuário,3,127
43919,2024-01-31 11:58:00,56,54,Móvel,9,110
43920,2024-01-31 11:59:00,109,178,Móvel,6,287
43921,2024-01-31 12:00:00,92,62,Vestuário,7,154
43922,2024-01-31 12:01:00,39,158,Alimento,6,197
43923,2024-01-31 12:02:00,18,47,Móvel,4,65
43924,2024-01-31 12:03:00,19,65,Alimento,5,84
43925,2024-01-31 12:04:00,67,153,Brinquedo,8,220
43926,2024-01-31 12:05:00,96,152,Brinquedo,7,248
43927,2024-01-31 12:06:00,49,60,Alimento,6,109
43928,2024-01-31 12:07:00,76,172,Brinquedo,6,248
43929,2024-01-31 12:08:00,115,64,Vestuário,6,179
43930,2024-01-31 12:09:00,88,42,Alimento,2,130
43931,2024-01-31 12:10:00,49,118,Vestuário,3,167
43932,2024-01-31 12:11:00,110,63,Brinquedo,1,173
43933,2024-01-31 12:12:00,30,173,Eletrônico,1,203
43934,2024-01-31 12:13:00,51,175,Vestuário,4,226
43935,2024-01-31 12:14:00,13,127,Alimento,2,140
43936,2024-01-31 12:15:00,97,86,Móvel,1,183
43937,2024-01-31 12:16:00,67,62,Vestuário,8,129
43938,2024-01-31 12:17:00,103,115,Alimento,8,218
43939,2024-01-31 12:18:00,22,152,Vestuário,5,174
43940,2024-01-31 12:19:00,108,119,Eletrônico,8,227
43941,2024-01-31 12:20:00,55,77,Eletrônico,2,132
43942,2024-01-31 12:21:00,56,162,Eletrônico,2,218
43943,2024-01-31 12:22:00,32,86,Alimento,1,118
43944,2024-01-31 12:23:00,101,129,Alimento,3,230
43945,2024-01-31 12:24:00,85,24,Eletrônico,3,109
43946,2024-01-31 12:25:00,63,67,Alimento,2,130
43947,2024-01-31 12:26:00,23,176,Eletrônico,4,199
43948,2024-01-31 12:27:00,53,70,Móvel,6,123
43949,2024-01-31 12:28:00,27,49,Vestuário,6,76
43950,2024-01-31 12:29:00,92,14,Alimento,6,106
43951,2024-01-31 12:30:00,72,67,Brinquedo,4,139
43952,2024-01-31 12:31:00,93,89,Brinquedo,1,182
43953,2024-01-31 12:32:00,21,110,Vestuário,5,131
43954,2024-01-31 12:33:00,88,157,Alimento,4,245
43955,2024-01-31 12:34:00,20,87,Móvel,8,107
43956,2024-01-31 12:35:00,93,54,Brinquedo,1,147
43957,2024-01-31 12:36:00,57,116,Brinquedo,2,173
43958,2024-01-31 12:37:00,10,22,Eletrônico,9,32
43959,2024-01-31 12:38:00,62,127,Vestuário,6,189
43960,2024-01-31 12:39:00,21,127,Móvel,4,148
43961,2024-01-31 12:40:00,37,75,Eletrônico,1,112
43962,2024-01-31 12:41:00,99,89,Móvel,2,188
43963,2024-01-31 12:42:00,104,86,Eletrônico,7,190
43964,2024-01-31 12:43:00,12,45,Eletrônico,9,57
43965,2024-01-31 12:44:00,12,17,Vestuário,4,29
43966,2024-01-31 12:45:00,28,154,Vestuário,8,182
43967,2024-01-31 12:46:00,33,28,Brinquedo,9,61
43968,2024-01-31 12:47:00,27,69,Vestuário,6,96
43969,2024-01-31 12:48:00,62,51,Vestuário,7,113
43970,2024-01-31 12:49:00,16,155,Móvel,1,171
43971,2024-01-31 12:50:00,48,89,Vestuário,8,137
43972,2024-01-31 12:51:00,28,107,Brinquedo,3,135
43973,2024-01-31 12:52:00,12,107,Brinquedo,5,119
43974,2024-01-31 12:53:00,86,152,Alimento,6,238
43975,2024-01-31 12:54:00,25,165,Vestuário,8,190
43976,2024-01-31 12:55:00,79,168,Brinquedo,5,247
43977,2024-01-31 12:56:00,34,174,Brinquedo,3,208
43978,2024-01-31 12:57:00,107,93,Brinquedo,9,200
43979,2024-01-31 12:58:00,67,67,Eletrônico,9,134
43980,2024-01-31 12:59:00,111,160,Vestuário,6,271
43981,2024-01-31 13:00:00,103,173,Eletrônico,1,276
43982,2024-01-31 13:01:00,84,142,Alimento,4,226
43983,2024-01-31 13:02:00,71,40,Móvel,9,111
43984,2024-01-31 13:03:00,29,13,Brinquedo,4,42
43985,2024-01-31 13:04:00,15,118,Móvel,7,133
43986,2024-01-31 13:05:00,28,105,Alimento,3,133
43987,2024-01-31 13:06:00,22,64,Eletrônico,6,86
43988,2024-01-31 13:07:00,106,38,Vestuário,3,144
43989,2024-01-31 13:08:00,42,112,Eletrônico,6,154
43990,2024-01-31 13:09:00,92,136,Eletrônico,7,228
43991,2024-01-31 13:10:00,55,55,Eletrônico,4,110
43992,2024-01-31 13:11:00,52,65,Móvel,9,117
43993,2024-01-31 13:12:00,81,136,Alimento,4,217
43994,2024-01-31 13:13:00,80,158,Brinquedo,9,238
43995,2024-01-31 13:14:00,55,35,Alimento,1,90
43996,2024-01-31 13:15:00,82,99,Móvel,2,181
43997,2024-01-31 13:16:00,28,134,Brinquedo,4,162
43998,2024-01-31 13:17:00,95,101,Eletrônico,5,196
43999,2024-01-31 13:18:00,84,90,Vestuário,7,174
44000,2024-01-31 13:19:00,116,157,Eletrônico,1,273
44001,2024-01-31 13:20:00,39,86,Móvel,4,125
44002,2024-01-31 13:21:00,51,118,Eletrônico,3,169
44003,2024-01-31 13:22:00,102,82,Brinquedo,1,184
44004,2024-01-31 13:23:00,66,114,Móvel,2,180
44005,2024-01-31 13:24:00,66,114,Brinquedo,1,180
44006,2024-01-31 13:25:00,106,176,Eletrônico,1,282
44007,2024-01-31 13:26:00,47,55,Eletrônico,2,102
44008,2024-01-31 13:27:00,102,158,Vestuário,3,260
44009,2024-01-31 13:28:00,36,146,Brinquedo,2,182
44010,2024-01-31 13:29:00,109,100,Eletrônico,1,209
44011,2024-01-31 13:30:00,67,106,Eletrônico,2,173
44012,2024-01-31 13:31:00,36,84,Alimento,1,120
44013,2024-01-31 13:32:00,90,63,Eletrônico,6,153
44014,2024-01-31 13:33:00,24,94,Brinquedo,2,118
44015,2024-01-31 13:34:00,89,119,Brinquedo,7,208
44016,2024-01-31 13:35:00,100,82,Brinquedo,8,182
44017,2024-01-31 13:36:00,42,164,Eletrônico,9,206
44018,2024-01-31 13:37:00,53,123,Móvel,8,176
44019,2024-01-31 13:38:00,75,115,Móvel,1,190
44020,2024-01-31 13:39:00,15,156,Móvel,3,171
44021,2024-01-31 13:40:00,88,119,Alimento,6,207
44022,2024-01-31 13:41:00,76,115,Vestuário,8,191
44023,2024-01-31 13:42:00,38,128,Eletrônico,6,166
44024,2024-01-31 13:43:00,62,35,Vestuário,8,97
44025,2024-01-31 13:44:00,100,160,Alimento,5,260
44026,2024-01-31 13:45:00,81,171,Eletrônico,4,252
44027,2024-01-31 13:46:00,50,20,Vestuário,5,70
44028,2024-01-31 13:47:00,15,86,Alimento,7,101
44029,2024-01-31 13:48:00,28,94,Vestuário,5,122
44030,2024-01-31 13:49:00,111,69,Móvel,8,180
44031,2024-01-31 13:50:00,93,95,Eletrônico,2,188
44032,2024-01-31 13:51:00,99,38,Eletrônico,1,137
44033,2024-01-31 13:52:00,114,30,Móvel,2,144
44034,2024-01-31 13:53:00,112,121,Eletrônico,7,233
44035,2024-01-31 13:54:00,102,17,Alimento,6,119
44036,2024-01-31 13:55:00,28,75,Móvel,5,103
44037,2024-01-31 13:56:00,39,116,Brinquedo,6,155
44038,2024-01-31 13:57:00,92,83,Vestuário,5,175
44039,2024-01-31 13:58:00,19,90,Vestuário,2,109
44040,2024-01-31 13:59:00,101,136,Vestuário,5,237
44041,2024-01-31 14:00:00,48,21,Móvel,2,69
44042,2024-01-31 14:01:00,34,137,Alimento,6,171
44043,2024-01-31 14:02:00,41,74,Móvel,3,115
44044,2024-01-31 14:03:00,97,163,Vestuário,7,260
44045,2024-01-31 14:04:00,85,137,Alimento,6,222
44046,2024-01-31 14:05:00,12,167,Móvel,2,179
44047,2024-01-31 14:06:00,44,99,Brinquedo,5,143
44048,2024-01-31 14:07:00,96,162,Brinquedo,1,258
44049,2024-01-31 14:08:00,77,75,Brinquedo,2,152
44050,2024-01-31 14:09:00,79,35,Móvel,4,114
44051,2024-01-31 14:10:00,70,77,Brinquedo,6,147
44052,2024-01-31 14:11:00,94,147,Brinquedo,8,241
44053,2024-01-31 14:12:00,36,144,Móvel,7,180
44054,2024-01-31 14:13:00,38,134,Alimento,7,172
44055,2024-01-31 14:14:00,18,143,Eletrônico,8,161
44056,2024-01-31 14:15:00,90,108,Brinquedo,6,198
44057,2024-01-31 14:16:00,71,115,Vestuário,3,186
44058,2024-01-31 14:17:00,51,81,Eletrônico,4,132
44059,2024-01-31 14:18:00,92,130,Vestuário,6,222
44060,2024-01-31 14:19:00,29,80,Vestuário,1,109
44061,2024-01-31 14:20:00,67,15,Móvel,9,82
44062,2024-01-31 14:21:00,106,15,Móvel,7,121
44063,2024-01-31 14:22:00,48,80,Eletrônico,5,128
44064,2024-01-31 14:23:00,87,19,Vestuário,4,106
44065,2024-01-31 14:24:00,113,74,Brinquedo,1,187
44066,2024-01-31 14:25:00,96,105,Alimento,3,201
44067,2024-01-31 14:26:00,88,123,Vestuário,6,211
44068,2024-01-31 14:27:00,90,22,Móvel,1,112
44069,2024-01-31 14:28:00,100,121,Eletrônico,6,221
44070,2024-01-31 14:29:00,104,60,Eletrônico,9,164
44071,2024-01-31 14:30:00,68,134,Eletrônico,4,202
44072,2024-01-31 14:31:00,40,60,Eletrônico,5,100
44073,2024-01-31 14:32:00,51,43,Vestuário,5,94
44074,2024-01-31 14:33:00,85,80,Móvel,7,165
44075,2024-01-31 14:34:00,100,140,Brinquedo,1,240
44076,2024-01-31 14:35:00,72,145,Eletrônico,1,217
44077,2024-01-31 14:36:00,104,24,Vestuário,8,128
44078,2024-01-31 14:37:00,114,14,Brinquedo,9,128
44079,2024-01-31 14:38:00,37,153,Brinquedo,8,190
44080,2024-01-31 14:39:00,54,51,Vestuário,2,105
44081,2024-01-31 14:40:00,24,81,Vestuário,9,105
44082,2024-01-31 14:41:00,35,43,Eletrônico,1,78
44083,2024-01-31 14:42:00,74,176,Alimento,2,250
44084,2024-01-31 14:43:00,12,75,Vestuário,9,87
44085,2024-01-31 14:44:00,62,36,Vestuário,7,98
44086,2024-01-31 14:45:00,77,39,Brinquedo,1,116
44087,2024-01-31 14:46:00,84,54,Móvel,2,138
44088,2024-01-31 14:47:00,62,15,Móvel,6,77
44089,2024-01-31 14:48:00,42,28,Brinquedo,5,70
44090,2024-01-31 14:49:00,107,124,Móvel,3,231
44091,2024-01-31 14:50:00,51,169,Alimento,3,220
44092,2024-01-31 14:51:00,18,165,Eletrônico,3,183
44093,2024-01-31 14:52:00,114,103,Vestuário,1,217
44094,2024-01-31 14:53:00,68,77,Brinquedo,5,145
44095,2024-01-31 14:54:00,111,16,Móvel,1,127
44096,2024-01-31 14:55:00,58,119,Alimento,7,177
44097,2024-01-31 14:56:00,93,84,Eletrônico,2,177
44098,2024-01-31 14:57:00,23,123,Eletrônico,6,146
44099,2024-01-31 14:58:00,26,162,Móvel,8,188
44100,2024-01-31 14:59:00,18,69,Alimento,3,87
44101,2024-01-31 15:00:00,59,21,Alimento,8,80
44102,2024-01-31 15:01:00,24,95,Brinquedo,3,119
44103,2024-01-31 15:02:00,11,156,Alimento,3,167
44104,2024-01-31 15:03:00,45,60,Vestuário,1,105
44105,2024-01-31 15:04:00,106,132,Vestuário,8,238
44106,2024-01-31 15:05:00,106,115,Vestuário,8,221
44107,2024-01-31 15:06:00,110,107,Eletrônico,6,217
44108,2024-01-31 15:07:00,89,53,Alimento,7,142
44109,2024-01-31 15:08:00,79,29,Móvel,1,108
44110,2024-01-31 15:09:00,100,177,Eletrônico,2,277
44111,2024-01-31 15:10:00,43,60,Eletrônico,6,103
44112,2024-01-31 15:11:00,48,73,Vestuário,7,121
44113,2024-01-31 15:12:00,82,90,Eletrônico,4,172
44114,2024-01-31 15:13:00,107,55,Vestuário,8,162
44115,2024-01-31 15:14:00,89,42,Móvel,7,131
44116,2024-01-31 15:15:00,47,110,Vestuário,3,157
44117,2024-01-31 15:16:00,63,89,Móvel,9,152
44118,2024-01-31 15:17:00,38,51,Móvel,1,89
44119,2024-01-31 15:18:00,107,139,Brinquedo,6,246
44120,2024-01-31 15:19:00,26,80,Eletrônico,7,106
44121,2024-01-31 15:20:00,89,117,Vestuário,2,206
44122,2024-01-31 15:21:00,18,102,Vestuário,4,120
44123,2024-01-31 15:22:00,30,107,Eletrônico,7,137
44124,2024-01-31 15:23:00,27,159,Móvel,7,186
44125,2024-01-31 15:24:00,30,60,Brinquedo,5,90
44126,2024-01-31 15:25:00,17,24,Móvel,7,41
44127,2024-01-31 15:26:00,11,62,Vestuário,1,73
44128,2024-01-31 15:27:00,100,16,Brinquedo,5,116
44129,2024-01-31 15:28:00,99,108,Alimento,6,207
44130,2024-01-31 15:29:00,103,33,Brinquedo,5,136
44131,2024-01-31 15:30:00,91,104,Alimento,3,195
44132,2024-01-31 15:31:00,99,69,Eletrônico,2,168
44133,2024-01-31 15:32:00,88,17,Alimento,3,105
44134,2024-01-31 15:33:00,42,90,Eletrônico,2,132
44135,2024-01-31 15:34:00,32,51,Vestuário,5,83
44136,2024-01-31 15:35:00,35,104,Móvel,6,139
44137,2024-01-31 15:36:00,18,161,Móvel,8,179
44138,2024-01-31 15:37:00,51,94,Brinquedo,3,145
44139,2024-01-31 15:38:00,36,79,Alimento,2,115
44140,2024-01-31 15:39:00,25,40,Móvel,6,65
44141,2024-01-31 15:40:00,89,177,Vestuário,6,266
44142,2024-01-31 15:41:00,43,44,Vestuário,4,87
44143,2024-01-31 15:42:00,99,115,Vestuário,5,214
44144,2024-01-31 15:43:00,119,167,Eletrônico,3,286
44145,2024-01-31 15:44:00,89,154,Vestuário,9,243
44146,2024-01-31 15:45:00,53,94,Móvel,1,147
44147,2024-01-31 15:46:00,35,172,Vestuário,8,207
44148,2024-01-31 15:47:00,33,121,Alimento,2,154
44149,2024-01-31 15:48:00,94,38,Eletrônico,6,132
44150,2024-01-31 15:49:00,101,46,Alimento,7,147
44151,2024-01-31 15:50:00,100,18,Vestuário,6,118
44152,2024-01-31 15:51:00,42,99,Móvel,5,141
44153,2024-01-31 15:52:00,91,109,Brinquedo,5,200
44154,2024-01-31 15:53:00,23,171,Vestuário,1,194
44155,2024-01-31 15:54:00,17,54,Eletrônico,1,71
44156,2024-01-31 15:55:00,45,123,Eletrônico,5,168
44157,2024-01-31 15:56:00,30,11,Vestuário,6,41
44158,2024-01-31 15:57:00,41,102,Alimento,4,143
44159,2024-01-31 15:58:00,13,151,Vestuário,5,164
44160,2024-01-31 15:59:00,90,72,Eletrônico,7,162
44161,2024-01-31 16:00:00,114,46,Vestuário,2,160
44162,2024-01-31 16:01:00,20,55,Brinquedo,2,75
44163,2024-01-31 16:02:00,29,61,Alimento,1,90
44164,2024-01-31 16:03:00,51,110,Brinquedo,3,161
44165,2024-01-31 16:04:00,53,128,Brinquedo,9,181
44166,2024-01-31 16:05:00,32,16,Alimento,1,48
44167,2024-01-31 16:06:00,20,53,Brinquedo,1,73
44168,2024-01-31 16:07:00,39,172,Brinquedo,2,211
44169,2024-01-31 16:08:00,20,48,Eletrônico,7,68
44170,2024-01-31 16:09:00,80,70,Brinquedo,7,150
44171,2024-01-31 16:10:00,61,146,Eletrônico,3,207
44172,2024-01-31 16:11:00,92,144,Brinquedo,8,236
44173,2024-01-31 16:12:00,104,123,Vestuário,6,227
44174,2024-01-31 16:13:00,74,43,Móvel,6,117
44175,2024-01-31 16:14:00,94,170,Móvel,7,264
44176,2024-01-31 16:15:00,27,160,Brinquedo,1,187
44177,2024-01-31 16:16:00,88,92,Vestuário,1,180
44178,2024-01-31 16:17:00,117,46,Brinquedo,1,163
44179,2024-01-31 16:18:00,13,175,Eletrônico,7,188
44180,2024-01-31 16:19:00,33,45,Eletrônico,9,78
44181,2024-01-31 16:20:00,40,116,Brinquedo,2,156
44182,2024-01-31 16:21:00,108,105,Brinquedo,3,213
44183,2024-01-31 16:22:00,93,168,Eletrônico,7,261
44184,2024-01-31 16:23:00,80,172,Móvel,4,252
44185,2024-01-31 16:24:00,17,28,Brinquedo,4,45
44186,2024-01-31 16:25:00,14,67,Eletrônico,9,81
44187,2024-01-31 16:26:00,116,165,Alimento,4,281
44188,2024-01-31 16:27:00,19,94,Vestuário,9,113
44189,2024-01-31 16:28:00,41,57,Vestuário,5,98
44190,2024-01-31 16:29:00,13,118,Vestuário,5,131
44191,2024-01-31 16:30:00,85,145,Vestuário,5,230
44192,2024-01-31 16:31:00,88,10,Vestuário,6,98
44193,2024-01-31 16:32:00,30,85,Eletrônico,7,115
44194,2024-01-31 16:33:00,16,160,Alimento,8,176
44195,2024-01-31 16:34:00,112,68,Alimento,8,180
44196,2024-01-31 16:35:00,66,72,Vestuário,9,138
44197,2024-01-31 16:36:00,107,162,Brinquedo,1,269
44198,2024-01-31 16:37:00,34,35,Vestuário,7,69
44199,2024-01-31 16:38:00,65,59,Alimento,6,124
44200,2024-01-31 16:39:00,80,177,Alimento,3,257
44201,2024-01-31 16:40:00,16,174,Alimento,7,190
44202,2024-01-31 16:41:00,62,36,Brinquedo,5,98
44203,2024-01-31 16:42:00,18,121,Eletrônico,5,139
44204,2024-01-31 16:43:00,72,88,Brinquedo,4,160
44205,2024-01-31 16:44:00,74,75,Móvel,9,149
44206,2024-01-31 16:45:00,57,12,Móvel,4,69
44207,2024-01-31 16:46:00,38,128,Alimento,5,166
44208,2024-01-31 16:47:00,88,136,Móvel,9,224
44209,2024-01-31 16:48:00,116,104,Vestuário,8,220
44210,2024-01-31 16:49:00,66,159,Vestuário,4,225
44211,2024-01-31 16:50:00,83,33,Brinquedo,9,116
44212,2024-01-31 16:51:00,67,74,Móvel,3,141
44213,2024-01-31 16:52:00,103,145,Vestuário,4,248
44214,2024-01-31 16:53:00,36,97,Alimento,5,133
44215,2024-01-31 16:54:00,69,71,Eletrônico,3,140
44216,2024-01-31 16:55:00,89,92,Móvel,5,181
44217,2024-01-31 16:56:00,98,46,Eletrônico,2,144
44218,2024-01-31 16:57:00,102,106,Vestuário,4,208
44219,2024-01-31 16:58:00,61,14,Brinquedo,4,75
44220,2024-01-31 16:59:00,90,158,Alimento,5,248
44221,2024-01-31 17:00:00,14,72,Alimento,7,86
44222,2024-01-31 17:01:00,75,31,Móvel,5,106
44223,2024-01-31 17:02:00,102,31,Eletrônico,4,133
44224,2024-01-31 17:03:00,76,153,Alimento,4,229
44225,2024-01-31 17:04:00,32,175,Brinquedo,5,207
44226,2024-01-31 17:05:00,110,153,Móvel,9,263
44227,2024-01-31 17:06:00,11,57,Móvel,5,68
44228,2024-01-31 17:07:00,28,179,Móvel,7,207
44229,2024-01-31 17:08:00,34,106,Alimento,8,140
44230,2024-01-31 17:09:00,69,145,Móvel,1,214
44231,2024-01-31 17:10:00,28,46,Móvel,4,74
44232,2024-01-31 17:11:00,25,97,Eletrônico,6,122
44233,2024-01-31 17:12:00,31,53,Alimento,9,84
44234,2024-01-31 17:13:00,93,119,Alimento,9,212
44235,2024-01-31 17:14:00,20,157,Alimento,1,177
44236,2024-01-31 17:15:00,68,111,Eletrônico,1,179
44237,2024-01-31 17:16:00,55,142,Brinquedo,9,197
44238,2024-01-31 17:17:00,24,154,Eletrônico,8,178
44239,2024-01-31 17:18:00,26,68,Vestuário,4,94
44240,2024-01-31 17:19:00,49,49,Brinquedo,9,98
44241,2024-01-31 17:20:00,109,104,Alimento,7,213
44242,2024-01-31 17:21:00,40,146,Móvel,3,186
44243,2024-01-31 17:22:00,66,69,Brinquedo,5,135
44244,2024-01-31 17:23:00,23,130,Alimento,7,153
44245,2024-01-31 17:24:00,29,23,Brinquedo,1,52
44246,2024-01-31 17:25:00,11,16,Vestuário,2,27
44247,2024-01-31 17:26:00,99,97,Alimento,6,196
44248,2024-01-31 17:27:00,40,95,Brinquedo,6,135
44249,2024-01-31 17:28:00,53,147,Brinquedo,2,200
44250,2024-01-31 17:29:00,31,102,Móvel,8,133
44251,2024-01-31 17:30:00,105,46,Vestuário,2,151
44252,2024-01-31 17:31:00,92,90,Vestuário,6,182
44253,2024-01-31 17:32:00,36,92,Brinquedo,9,128
44254,2024-01-31 17:33:00,52,126,Alimento,4,178
44255,2024-01-31 17:34:00,118,36,Eletrônico,2,154
44256,2024-01-31 17:35:00,116,145,Móvel,6,261
44257,2024-01-31 17:36:00,82,41,Móvel,1,123
44258,2024-01-31 17:37:00,109,35,Vestuário,1,144
44259,2024-01-31 17:38:00,35,112,Móvel,9,147
44260,2024-01-31 17:39:00,116,51,Vestuário,9,167
44261,2024-01-31 17:40:00,75,148,Móvel,2,223
44262,2024-01-31 17:41:00,43,79,Brinquedo,4,122
44263,2024-01-31 17:42:00,62,142,Vestuário,9,204
44264,2024-01-31 17:43:00,49,100,Móvel,3,149
44265,2024-01-31 17:44:00,58,116,Eletrônico,2,174
44266,2024-01-31 17:45:00,38,126,Eletrônico,2,164
44267,2024-01-31 17:46:00,107,47,Vestuário,1,154
44268,2024-01-31 17:47:00,83,98,Vestuário,6,181
44269,2024-01-31 17:48:00,10,162,Vestuário,9,172
44270,2024-01-31 17:49:00,105,165,Móvel,2,270
44271,2024-01-31 17:50:00,75,130,Vestuário,8,205
44272,2024-01-31 17:51:00,105,177,Alimento,8,282
44273,2024-01-31 17:52:00,16,82,Móvel,5,98
44274,2024-01-31 17:53:00,20,137,Vestuário,3,157
44275,2024-01-31 17:54:00,63,111,Vestuário,1,174
44276,2024-01-31 17:55:00,95,101,Brinquedo,3,196
44277,2024-01-31 17:56:00,53,88,Brinquedo,5,141
44278,2024-01-31 17:57:00,88,148,Vestuário,3,236
44279,2024-01-31 17:58:00,96,154,Alimento,8,250
44280,2024-01-31 17:59:00,72,90,Vestuário,6,162
44281,2024-01-31 18:00:00,17,152,Móvel,3,169
44282,2024-01-31 18:01:00,94,26,Eletrônico,1,120
44283,2024-01-31 18:02:00,87,21,Brinquedo,9,108
44284,2024-01-31 18:03:00,99,31,Vestuário,2,130
44285,2024-01-31 18:04:00,113,27,Brinquedo,2,140
44286,2024-01-31 18:05:00,61,67,Móvel,6,128
44287,2024-01-31 18:06:00,70,59,Eletrônico,7,129
44288,2024-01-31 18:07:00,61,50,Móvel,6,111
44289,2024-01-31 18:08:00,44,107,Móvel,6,151
44290,2024-01-31 18:09:00,86,120,Brinquedo,4,206
44291,2024-01-31 18:10:00,95,161,Eletrônico,7,256
44292,2024-01-31 18:11:00,66,69,Eletrônico,5,135
44293,2024-01-31 18:12:00,38,11,Vestuário,7,49
44294,2024-01-31 18:13:00,46,16,Eletrônico,9,62
44295,2024-01-31 18:14:00,114,106,Vestuário,4,220
44296,2024-01-31 18:15:00,68,152,Eletrônico,8,220
44297,2024-01-31 18:16:00,105,142,Brinquedo,1,247
44298,2024-01-31 18:17:00,86,99,Brinquedo,1,185
44299,2024-01-31 18:18:00,91,94,Vestuário,3,185
44300,2024-01-31 18:19:00,58,38,Eletrônico,5,96
44301,2024-01-31 18:20:00,25,119,Brinquedo,6,144
44302,2024-01-31 18:21:00,69,82,Eletrônico,4,151
44303,2024-01-31 18:22:00,13,91,Vestuário,8,104
44304,2024-01-31 18:23:00,101,39,Alimento,8,140
44305,2024-01-31 18:24:00,64,142,Brinquedo,6,206
44306,2024-01-31 18:25:00,52,146,Brinquedo,3,198
44307,2024-01-31 18:26:00,58,152,Brinquedo,7,210
44308,2024-01-31 18:27:00,17,126,Alimento,9,143
44309,2024-01-31 18:28:00,35,84,Vestuário,7,119
44310,2024-01-31 18:29:00,111,96,Alimento,7,207
44311,2024-01-31 18:30:00,66,44,Eletrônico,2,110
44312,2024-01-31 18:31:00,117,29,Eletrônico,4,146
44313,2024-01-31 18:32:00,51,169,Eletrônico,2,220
44314,2024-01-31 18:33:00,25,39,Eletrônico,9,64
44315,2024-01-31 18:34:00,116,59,Vestuário,2,175
44316,2024-01-31 18:35:00,106,149,Vestuário,2,255
44317,2024-01-31 18:36:00,56,81,Móvel,8,137
44318,2024-01-31 18:37:00,16,34,Brinquedo,4,50
44319,2024-01-31 18:38:00,22,11,Alimento,9,33
44320,2024-01-31 18:39:00,74,143,Eletrônico,5,217
44321,2024-01-31 18:40:00,26,109,Brinquedo,2,135
44322,2024-01-31 18:41:00,97,63,Alimento,4,160
44323,2024-01-31 18:42:00,113,167,Vestuário,2,280
44324,2024-01-31 18:43:00,16,100,Eletrônico,7,116
44325,2024-01-31 18:44:00,115,86,Brinquedo,1,201
44326,2024-01-31 18:45:00,62,39,Brinquedo,7,101
44327,2024-01-31 18:46:00,49,80,Brinquedo,3,129
44328,2024-01-31 18:47:00,87,26,Móvel,8,113
44329,2024-01-31 18:48:00,26,102,Vestuário,7,128
44330,2024-01-31 18:49:00,70,118,Brinquedo,7,188
44331,2024-01-31 18:50:00,81,61,Móvel,6,142
44332,2024-01-31 18:51:00,32,159,Móvel,9,191
44333,2024-01-31 18:52:00,104,143,Brinquedo,9,247
44334,2024-01-31 18:53:00,93,70,Vestuário,8,163
44335,2024-01-31 18:54:00,49,128,Vestuário,2,177
44336,2024-01-31 18:55:00,54,39,Vestuário,5,93
44337,2024-01-31 18:56:00,78,148,Vestuário,3,226
44338,2024-01-31 18:57:00,32,174,Vestuário,9,206
44339,2024-01-31 18:58:00,45,144,Alimento,7,189
44340,2024-01-31 18:59:00,73,146,Alimento,8,219
44341,2024-01-31 19:00:00,77,19,Vestuário,8,96
44342,2024-01-31 19:01:00,29,99,Alimento,5,128
44343,2024-01-31 19:02:00,72,13,Vestuário,3,85
44344,2024-01-31 19:03:00,98,119,Alimento,4,217
44345,2024-01-31 19:04:00,51,55,Alimento,4,106
44346,2024-01-31 19:05:00,86,28,Alimento,6,114
44347,2024-01-31 19:06:00,70,115,Eletrônico,6,185
44348,2024-01-31 19:07:00,63,102,Alimento,2,165
44349,2024-01-31 19:08:00,17,116,Brinquedo,8,133
44350,2024-01-31 19:09:00,34,134,Móvel,7,168
44351,2024-01-31 19:10:00,94,25,Vestuário,6,119
44352,2024-01-31 19:11:00,92,46,Vestuário,3,138
44353,2024-01-31 19:12:00,60,56,Vestuário,3,116
44354,2024-01-31 19:13:00,74,177,Eletrônico,1,251
44355,2024-01-31 19:14:00,24,100,Vestuário,3,124
44356,2024-01-31 19:15:00,83,130,Vestuário,6,213
44357,2024-01-31 19:16:00,30,35,Brinquedo,5,65
44358,2024-01-31 19:17:00,38,72,Móvel,6,110
44359,2024-01-31 19:18:00,75,145,Eletrônico,4,220
44360,2024-01-31 19:19:00,72,125,Eletrônico,7,197
44361,2024-01-31 19:20:00,54,137,Móvel,8,191
44362,2024-01-31 19:21:00,114,90,Vestuário,3,204
44363,2024-01-31 19:22:00,28,78,Vestuário,2,106
44364,2024-01-31 19:23:00,77,83,Brinquedo,3,160
44365,2024-01-31 19:24:00,42,63,Vestuário,4,105
44366,2024-01-31 19:25:00,49,93,Móvel,1,142
44367,2024-01-31 19:26:00,56,154,Brinquedo,3,210
44368,2024-01-31 19:27:00,94,94,Eletrônico,7,188
44369,2024-01-31 19:28:00,33,157,Brinquedo,4,190
44370,2024-01-31 19:29:00,16,76,Alimento,7,92
44371,2024-01-31 19:30:00,83,148,Eletrônico,2,231
44372,2024-01-31 19:31:00,26,126,Brinquedo,3,152
44373,2024-01-31 19:32:00,61,132,Vestuário,4,193
44374,2024-01-31 19:33:00,70,108,Brinquedo,2,178
44375,2024-01-31 19:34:00,36,119,Brinquedo,8,155
44376,2024-01-31 19:35:00,35,71,Móvel,1,106
44377,2024-01-31 19:36:00,106,42,Móvel,5,148
44378,2024-01-31 19:37:00,118,134,Alimento,7,252
44379,2024-01-31 19:38:00,49,172,Eletrônico,8,221
44380,2024-01-31 19:39:00,74,25,Vestuário,2,99
44381,2024-01-31 19:40:00,66,173,Móvel,8,239
44382,2024-01-31 19:41:00,41,162,Brinquedo,4,203
44383,2024-01-31 19:42:00,72,60,Móvel,5,132
44384,2024-01-31 19:43:00,67,144,Eletrônico,5,211
44385,2024-01-31 19:44:00,90,119,Brinquedo,1,209
44386,2024-01-31 19:45:00,115,139,Eletrônico,8,254
44387,2024-01-31 19:46:00,87,69,Vestuário,6,156
44388,2024-01-31 19:47:00,80,102,Brinquedo,5,182
44389,2024-01-31 19:48:00,22,23,Vestuário,1,45
44390,2024-01-31 19:49:00,108,49,Alimento,7,157
44391,2024-01-31 19:50:00,12,100,Brinquedo,1,112
44392,2024-01-31 19:51:00,57,42,Alimento,4,99
44393,2024-01-31 19:52:00,69,21,Móvel,5,90
44394,2024-01-31 19:53:00,21,141,Eletrônico,6,162
44395,2024-01-31 19:54:00,10,25,Alimento,4,35
44396,2024-01-31 19:55:00,78,131,Móvel,2,209
44397,2024-01-31 19:56:00,93,26,Alimento,5,119
44398,2024-01-31 19:57:00,116,169,Móvel,1,285
44399,2024-01-31 19:58:00,110,121,Alimento,4,231
44400,2024-01-31 19:59:00,72,49,Brinquedo,5,121
44401,2024-01-31 20:00:00,63,167,Eletrônico,8,230
44402,2024-01-31 20:01:00,89,68,Brinquedo,9,157
44403,2024-01-31 20:02:00,73,152,Vestuário,4,225
44404,2024-01-31 20:03:00,94,33,Móvel,3,127
44405,2024-01-31 20:04:00,56,110,Alimento,9,166
44406,2024-01-31 20:05:00,23,124,Eletrônico,4,147
44407,2024-01-31 20:06:00,44,77,Eletrônico,7,121
44408,2024-01-31 20:07:00,63,171,Vestuário,7,234
44409,2024-01-31 20:08:00,115,144,Móvel,7,259
44410,2024-01-31 20:09:00,115,70,Móvel,6,185
44411,2024-01-31 20:10:00,39,111,Móvel,5,150
44412,2024-01-31 20:11:00,58,108,Vestuário,1,166
44413,2024-01-31 20:12:00,27,170,Alimento,9,197
44414,2024-01-31 20:13:00,66,57,Vestuário,8,123
44415,2024-01-31 20:14:00,72,56,Alimento,9,128
44416,2024-01-31 20:15:00,95,137,Brinquedo,1,232
44417,2024-01-31 20:16:00,56,90,Vestuário,5,146
44418,2024-01-31 20:17:00,27,175,Alimento,1,202
44419,2024-01-31 20:18:00,76,79,Alimento,8,155
44420,2024-01-31 20:19:00,71,112,Móvel,6,183
44421,2024-01-31 20:20:00,19,128,Eletrônico,8,147
44422,2024-01-31 20:21:00,37,57,Vestuário,7,94
44423,2024-01-31 20:22:00,25,63,Móvel,4,88
44424,2024-01-31 20:23:00,36,173,Alimento,7,209
44425,2024-01-31 20:24:00,48,106,Eletrônico,2,154
44426,2024-01-31 20:25:00,54,84,Móvel,8,138
44427,2024-01-31 20:26:00,46,122,Vestuário,1,168
44428,2024-01-31 20:27:00,110,172,Alimento,3,282
44429,2024-01-31 20:28:00,14,16,Brinquedo,4,30
44430,2024-01-31 20:29:00,21,11,Alimento,8,32
44431,2024-01-31 20:30:00,19,110,Vestuário,2,129
44432,2024-01-31 20:31:00,32,139,Brinquedo,2,171
44433,2024-01-31 20:32:00,52,31,Móvel,7,83
44434,2024-01-31 20:33:00,45,46,Alimento,7,91
44435,2024-01-31 20:34:00,10,158,Alimento,9,168
44436,2024-01-31 20:35:00,119,63,Brinquedo,3,182
44437,2024-01-31 20:36:00,16,122,Móvel,5,138
44438,2024-01-31 20:37:00,119,64,Alimento,1,183
44439,2024-01-31 20:38:00,14,113,Vestuário,8,127
44440,2024-01-31 20:39:00,96,150,Brinquedo,8,246
44441,2024-01-31 20:40:00,88,162,Brinquedo,2,250
44442,2024-01-31 20:41:00,72,155,Móvel,9,227
44443,2024-01-31 20:42:00,36,141,Brinquedo,2,177
44444,2024-01-31 20:43:00,69,92,Móvel,7,161
44445,2024-01-31 20:44:00,107,26,Vestuário,5,133
44446,2024-01-31 20:45:00,98,146,Móvel,4,244
44447,2024-01-31 20:46:00,31,134,Eletrônico,8,165
44448,2024-01-31 20:47:00,72,113,Móvel,4,185
44449,2024-01-31 20:48:00,87,128,Vestuário,7,215
44450,2024-01-31 20:49:00,101,172,Eletrônico,4,273
44451,2024-01-31 20:50:00,110,14,Brinquedo,2,124
44452,2024-01-31 20:51:00,60,116,Eletrônico,6,176
44453,2024-01-31 20:52:00,18,66,Brinquedo,1,84
44454,2024-01-31 20:53:00,48,129,Brinquedo,1,177
44455,2024-01-31 20:54:00,87,108,Alimento,7,195
44456,2024-01-31 20:55:00,100,176,Vestuário,9,276
44457,2024-01-31 20:56:00,37,81,Móvel,2,118
44458,2024-01-31 20:57:00,36,61,Móvel,3,97
44459,2024-01-31 20:58:00,107,166,Alimento,2,273
44460,2024-01-31 20:59:00,81,161,Eletrônico,2,242
44461,2024-01-31 21:00:00,28,12,Alimento,3,40
44462,2024-01-31 21:01:00,114,91,Vestuário,9,205
44463,2024-01-31 21:02:00,98,146,Vestuário,1,244
44464,2024-01-31 21:03:00,44,129,Alimento,1,173
44465,2024-01-31 21:04:00,33,11,Móvel,4,44
44466,2024-01-31 21:05:00,100,134,Eletrônico,2,234
44467,2024-01-31 21:06:00,59,93,Móvel,1,152
44468,2024-01-31 21:07:00,36,145,Eletrônico,4,181
44469,2024-01-31 21:08:00,106,150,Eletrônico,9,256
44470,2024-01-31 21:09:00,93,154,Alimento,1,247
44471,2024-01-31 21:10:00,74,77,Vestuário,9,151
44472,2024-01-31 21:11:00,59,23,Brinquedo,5,82
44473,2024-01-31 21:12:00,56,134,Eletrônico,2,190
44474,2024-01-31 21:13:00,112,162,Alimento,3,274
44475,2024-01-31 21:14:00,49,157,Alimento,3,206
44476,2024-01-31 21:15:00,11,100,Alimento,4,111
44477,2024-01-31 21:16:00,29,29,Eletrônico,6,58
44478,2024-01-31 21:17:00,77,173,Móvel,5,250
44479,2024-01-31 21:18:00,51,53,Eletrônico,6,104
44480,2024-01-31 21:19:00,11,128,Eletrônico,9,139
44481,2024-01-31 21:20:00,97,136,Alimento,2,233
44482,2024-01-31 21:21:00,118,78,Vestuário,4,196
44483,2024-01-31 21:22:00,118,62,Eletrônico,1,180
44484,2024-01-31 21:23:00,19,66,Alimento,5,85
44485,2024-01-31 21:24:00,80,68,Móvel,5,148
44486,2024-01-31 21:25:00,90,178,Alimento,4,268
44487,2024-01-31 21:26:00,119,65,Eletrônico,7,184
44488,2024-01-31 21:27:00,26,177,Brinquedo,2,203
44489,2024-01-31 21:28:00,62,142,Vestuário,6,204
44490,2024-01-31 21:29:00,26,47,Vestuário,4,73
44491,2024-01-31 21:30:00,95,99,Eletrônico,5,194
44492,2024-01-31 21:31:00,44,48,Vestuário,8,92
44493,2024-01-31 21:32:00,10,114,Alimento,1,124
44494,2024-01-31 21:33:00,55,167,Móvel,2,222
44495,2024-01-31 21:34:00,58,56,Vestuário,4,114
44496,2024-01-31 21:35:00,88,116,Brinquedo,7,204
44497,2024-01-31 21:36:00,113,156,Eletrônico,5,269
44498,2024-01-31 21:37:00,95,71,Alimento,1,166
44499,2024-01-31 21:38:00,117,103,Alimento,7,220
44500,2024-01-31 21:39:00,97,167,Móvel,7,264
44501,2024-01-31 21:40:00,45,55,Vestuário,9,100
44502,2024-01-31 21:41:00,106,35,Móvel,9,141
44503,2024-01-31 21:42:00,55,74,Móvel,7,129
44504,2024-01-31 21:43:00,83,179,Alimento,6,262
44505,2024-01-31 21:44:00,82,130,Vestuário,7,212
44506,2024-01-31 21:45:00,110,96,Móvel,7,206
44507,2024-01-31 21:46:00,103,163,Brinquedo,4,266
44508,2024-01-31 21:47:00,22,88,Eletrônico,4,110
44509,2024-01-31 21:48:00,105,55,Vestuário,3,160
44510,2024-01-31 21:49:00,95,152,Brinquedo,7,247
44511,2024-01-31 21:50:00,113,143,Vestuário,2,256
44512,2024-01-31 21:51:00,81,127,Móvel,9,208
44513,2024-01-31 21:52:00,11,56,Brinquedo,3,67
44514,2024-01-31 21:53:00,78,19,Eletrônico,9,97
44515,2024-01-31 21:54:00,112,113,Móvel,6,225
44516,2024-01-31 21:55:00,69,17,Alimento,9,86
44517,2024-01-31 21:56:00,101,146,Alimento,1,247
44518,2024-01-31 21:57:00,99,56,Móvel,9,155
44519,2024-01-31 21:58:00,108,124,Alimento,7,232
44520,2024-01-31 21:59:00,27,124,Alimento,9,151
44521,2024-01-31 22:00:00,81,56,Móvel,7,137
44522,2024-01-31 22:01:00,78,106,Brinquedo,4,184
44523,2024-01-31 22:02:00,74,18,Móvel,5,92
44524,2024-01-31 22:03:00,32,100,Brinquedo,2,132
44525,2024-01-31 22:04:00,60,107,Eletrônico,2,167
44526,2024-01-31 22:05:00,64,62,Eletrônico,1,126
44527,2024-01-31 22:06:00,52,136,Eletrônico,2,188
44528,2024-01-31 22:07:00,90,40,Móvel,5,130
44529,2024-01-31 22:08:00,66,155,Eletrônico,5,221
44530,2024-01-31 22:09:00,79,131,Vestuário,7,210
44531,2024-01-31 22:10:00,81,166,Eletrônico,2,247
44532,2024-01-31 22:11:00,46,113,Móvel,1,159
44533,2024-01-31 22:12:00,70,16,Eletrônico,6,86
44534,2024-01-31 22:13:00,10,153,Brinquedo,7,163
44535,2024-01-31 22:14:00,45,79,Vestuário,9,124
44536,2024-01-31 22:15:00,44,143,Brinquedo,5,187
44537,2024-01-31 22:16:00,110,148,Alimento,7,258
44538,2024-01-31 22:17:00,102,93,Eletrônico,8,195
44539,2024-01-31 22:18:00,112,30,Vestuário,5,142
44540,2024-01-31 22:19:00,52,81,Brinquedo,8,133
44541,2024-01-31 22:20:00,63,63,Vestuário,3,126
44542,2024-01-31 22:21:00,115,89,Vestuário,6,204
44543,2024-01-31 22:22:00,20,78,Vestuário,8,98
44544,2024-01-31 22:23:00,78,100,Vestuário,6,178
44545,2024-01-31 22:24:00,37,165,Eletrônico,4,202
44546,2024-01-31 22:25:00,45,176,Eletrônico,4,221
44547,2024-01-31 22:26:00,26,82,Eletrônico,3,108
44548,2024-01-31 22:27:00,41,41,Vestuário,9,82
44549,2024-01-31 22:28:00,86,49,Alimento,1,135
44550,2024-01-31 22:29:00,95,111,Eletrônico,9,206
44551,2024-01-31 22:30:00,97,17,Vestuário,2,114
44552,2024-01-31 22:31:00,34,11,Eletrônico,9,45
44553,2024-01-31 22:32:00,90,68,Vestuário,9,158
44554,2024-01-31 22:33:00,30,29,Eletrônico,1,59
44555,2024-01-31 22:34:00,74,27,Móvel,9,101
44556,2024-01-31 22:35:00,65,64,Alimento,8,129
44557,2024-01-31 22:36:00,90,23,Vestuário,3,113
44558,2024-01-31 22:37:00,99,100,Móvel,5,199
44559,2024-01-31 22:38:00,62,148,Móvel,2,210
44560,2024-01-31 22:39:00,44,46,Móvel,4,90
44561,2024-01-31 22:40:00,10,11,Brinquedo,1,21
44562,2024-01-31 22:41:00,63,150,Eletrônico,1,213
44563,2024-01-31 22:42:00,54,11,Eletrônico,2,65
44564,2024-01-31 22:43:00,73,19,Brinquedo,4,92
44565,2024-01-31 22:44:00,23,97,Vestuário,1,120
44566,2024-01-31 22:45:00,103,127,Móvel,5,230
44567,2024-01-31 22:46:00,84,166,Móvel,8,250
44568,2024-01-31 22:47:00,117,86,Brinquedo,2,203
44569,2024-01-31 22:48:00,14,152,Móvel,2,166
44570,2024-01-31 22:49:00,108,32,Alimento,9,140
44571,2024-01-31 22:50:00,86,114,Vestuário,2,200
44572,2024-01-31 22:51:00,26,155,Alimento,7,181
44573,2024-01-31 22:52:00,50,89,Brinquedo,6,139
44574,2024-01-31 22:53:00,79,172,Eletrônico,7,251
44575,2024-01-31 22:54:00,74,152,Vestuário,3,226
44576,2024-01-31 22:55:00,77,91,Vestuário,2,168
44577,2024-01-31 22:56:00,89,72,Móvel,1,161
44578,2024-01-31 22:57:00,67,167,Eletrônico,4,234
44579,2024-01-31 22:58:00,94,105,Móvel,2,199
44580,2024-01-31 22:59:00,21,135,Alimento,1,156
44581,2024-01-31 23:00:00,68,97,Brinquedo,7,165
44582,2024-01-31 23:01:00,71,127,Vestuário,7,198
44583,2024-01-31 23:02:00,116,87,Vestuário,2,203
44584,2024-01-31 23:03:00,31,38,Eletrônico,8,69
44585,2024-01-31 23:04:00,97,15,Vestuário,7,112
44586,2024-01-31 23:05:00,46,26,Alimento,8,72
44587,2024-01-31 23:06:00,48,68,Brinquedo,4,116
44588,2024-01-31 23:07:00,86,71,Eletrônico,5,157
44589,2024-01-31 23:08:00,43,163,Móvel,1,206
44590,2024-01-31 23:09:00,80,28,Alimento,8,108
44591,2024-01-31 23:10:00,41,119,Móvel,9,160
44592,2024-01-31 23:11:00,109,155,Alimento,1,264
44593,2024-01-31 23:12:00,70,110,Brinquedo,7,180
44594,2024-01-31 23:13:00,113,156,Móvel,2,269
44595,2024-01-31 23:14:00,23,83,Alimento,3,106
44596,2024-01-31 23:15:00,64,84,Eletrônico,7,148
44597,2024-01-31 23:16:00,26,132,Eletrônico,6,158
44598,2024-01-31 23:17:00,58,102,Vestuário,6,160
44599,2024-01-31 23:18:00,31,20,Eletrônico,3,51
44600,2024-01-31 23:19:00,23,58,Eletrônico,3,81
44601,2024-01-31 23:20:00,106,93,Vestuário,7,199
44602,2024-01-31 23:21:00,44,132,Vestuário,1,176
44603,2024-01-31 23:22:00,13,36,Móvel,2,49
44604,2024-01-31 23:23:00,13,115,Alimento,4,128
44605,2024-01-31 23:24:00,44,136,Vestuário,6,180
44606,2024-01-31 23:25:00,41,119,Móvel,8,160
44607,2024-01-31 23:26:00,19,74,Brinquedo,9,93
44608,2024-01-31 23:27:00,26,83,Móvel,8,109
44609,2024-01-31 23:28:00,21,108,Vestuário,7,129
44610,2024-01-31 23:29:00,92,80,Eletrônico,5,172
44611,2024-01-31 23:30:00,67,178,Eletrônico,3,245
44612,2024-01-31 23:31:00,39,57,Eletrônico,2,96
44613,2024-01-31 23:32:00,40,94,Eletrônico,9,134
44614,2024-01-31 23:33:00,114,15,Eletrônico,3,129
44615,2024-01-31 23:34:00,82,72,Alimento,4,154
44616,2024-01-31 23:35:00,13,44,Alimento,2,57
44617,2024-01-31 23:36:00,84,24,Eletrônico,3,108
44618,2024-01-31 23:37:00,61,83,Brinquedo,9,144
44619,2024-01-31 23:38:00,52,174,Vestuário,8,226
44620,2024-01-31 23:39:00,13,103,Vestuário,1,116
44621,2024-01-31 23:40:00,15,120,Vestuário,8,135
44622,2024-01-31 23:41:00,24,40,Alimento,8,64
44623,2024-01-31 23:42:00,108,39,Brinquedo,6,147
44624,2024-01-31 23:43:00,115,85,Vestuário,6,200
44625,2024-01-31 23:44:00,28,153,Brinquedo,7,181
44626,2024-01-31 23:45:00,12,14,Eletrônico,8,26
44627,2024-01-31 23:46:00,30,161,Alimento,2,191
44628,2024-01-31 23:47:00,84,13,Brinquedo,8,97
44629,2024-01-31 23:48:00,68,137,Alimento,1,205
44630,2024-01-31 23:49:00,72,21,Alimento,2,93
44631,2024-01-31 23:50:00,55,10,Móvel,2,65
44632,2024-01-31 23:51:00,59,84,Eletrônico,9,143
44633,2024-01-31 23:52:00,54,147,Brinquedo,5,201
44634,2024-01-31 23:53:00,104,37,Eletrônico,3,141
44635,2024-01-31 23:54:00,12,140,Alimento,3,152
44636,2024-01-31 23:55:00,42,44,Vestuário,4,86
44637,2024-01-31 23:56:00,74,94,Alimento,1,168
44638,2024-01-31 23:57:00,82,55,Eletrônico,3,137
44639,2024-01-31 23:58:00,102,166,Alimento,4,268
44640,2024-01-31 23:59:00,103,122,Eletrônico,4,225
44641,2024-02-01 00:00:00,119,137,Brinquedo,7,256
44642,2024-02-01 00:01:00,13,97,Eletrônico,4,110
44643,2024-02-01 00:02:00,91,129,Vestuário,2,220
44644,2024-02-01 00:03:00,71,123,Móvel,6,194
44645,2024-02-01 00:04:00,18,111,Móvel,2,129
44646,2024-02-01 00:05:00,119,14,Eletrônico,2,133
44647,2024-02-01 00:06:00,22,137,Brinquedo,7,159
44648,2024-02-01 00:07:00,37,145,Móvel,8,182
44649,2024-02-01 00:08:00,85,164,Móvel,1,249
44650,2024-02-01 00:09:00,12,51,Móvel,2,63
44651,2024-02-01 00:10:00,74,48,Brinquedo,1,122
44652,2024-02-01 00:11:00,71,138,Alimento,7,209
44653,2024-02-01 00:12:00,116,33,Eletrônico,1,149
44654,2024-02-01 00:13:00,32,95,Brinquedo,7,127
44655,2024-02-01 00:14:00,114,118,Vestuário,7,232
44656,2024-02-01 00:15:00,62,136,Brinquedo,3,198
44657,2024-02-01 00:16:00,91,44,Brinquedo,6,135
44658,2024-02-01 00:17:00,12,41,Vestuário,1,53
44659,2024-02-01 00:18:00,40,69,Vestuário,8,109
44660,2024-02-01 00:19:00,33,122,Eletrônico,3,155
44661,2024-02-01 00:20:00,29,140,Móvel,5,169
44662,2024-02-01 00:21:00,28,156,Brinquedo,6,184
44663,2024-02-01 00:22:00,115,100,Eletrônico,5,215
44664,2024-02-01 00:23:00,48,104,Alimento,9,152
44665,2024-02-01 00:24:00,74,165,Brinquedo,9,239
44666,2024-02-01 00:25:00,93,14,Alimento,8,107
44667,2024-02-01 00:26:00,90,159,Eletrônico,2,249
44668,2024-02-01 00:27:00,18,156,Vestuário,7,174
44669,2024-02-01 00:28:00,113,10,Eletrônico,2,123
44670,2024-02-01 00:29:00,68,106,Brinquedo,2,174
44671,2024-02-01 00:30:00,15,106,Móvel,7,121
44672,2024-02-01 00:31:00,69,167,Vestuário,1,236
44673,2024-02-01 00:32:00,91,57,Alimento,6,148
44674,2024-02-01 00:33:00,40,92,Alimento,8,132
44675,2024-02-01 00:34:00,44,43,Alimento,5,87
44676,2024-02-01 00:35:00,34,103,Eletrônico,4,137
44677,2024-02-01 00:36:00,90,53,Vestuário,5,143
44678,2024-02-01 00:37:00,56,64,Eletrônico,1,120
44679,2024-02-01 00:38:00,102,30,Brinquedo,2,132
44680,2024-02-01 00:39:00,53,94,Brinquedo,8,147
44681,2024-02-01 00:40:00,44,101,Alimento,5,145
44682,2024-02-01 00:41:00,92,46,Eletrônico,5,138
44683,2024-02-01 00:42:00,46,31,Vestuário,2,77
44684,2024-02-01 00:43:00,93,178,Eletrônico,6,271
44685,2024-02-01 00:44:00,33,89,Alimento,7,122
44686,2024-02-01 00:45:00,11,170,Vestuário,3,181
44687,2024-02-01 00:46:00,99,158,Vestuário,9,257
44688,2024-02-01 00:47:00,12,32,Brinquedo,7,44
44689,2024-02-01 00:48:00,86,170,Brinquedo,4,256
44690,2024-02-01 00:49:00,11,58,Móvel,5,69
44691,2024-02-01 00:50:00,33,58,Brinquedo,5,91
44692,2024-02-01 00:51:00,100,41,Eletrônico,9,141
44693,2024-02-01 00:52:00,118,94,Vestuário,9,212
44694,2024-02-01 00:53:00,36,29,Eletrônico,3,65
44695,2024-02-01 00:54:00,71,80,Brinquedo,3,151
44696,2024-02-01 00:55:00,41,106,Móvel,3,147
44697,2024-02-01 00:56:00,93,86,Brinquedo,8,179
44698,2024-02-01 00:57:00,78,111,Eletrônico,9,189
44699,2024-02-01 00:58:00,117,153,Móvel,9,270
44700,2024-02-01 00:59:00,96,100,Eletrônico,8,196
44701,2024-02-01 01:00:00,87,106,Vestuário,1,193
44702,2024-02-01 01:01:00,50,136,Vestuário,8,186
44703,2024-02-01 01:02:00,34,115,Alimento,4,149
44704,2024-02-01 01:03:00,95,59,Brinquedo,7,154
44705,2024-02-01 01:04:00,82,155,Vestuário,1,237
44706,2024-02-01 01:05:00,33,24,Vestuário,7,57
44707,2024-02-01 01:06:00,30,20,Alimento,4,50
44708,2024-02-01 01:07:00,91,93,Eletrônico,5,184
44709,2024-02-01 01:08:00,101,95,Vestuário,5,196
44710,2024-02-01 01:09:00,71,18,Brinquedo,2,89
44711,2024-02-01 01:10:00,27,85,Eletrônico,9,112
44712,2024-02-01 01:11:00,55,88,Vestuário,7,143
44713,2024-02-01 01:12:00,89,87,Brinquedo,2,176
44714,2024-02-01 01:13:00,36,39,Vestuário,8,75
44715,2024-02-01 01:14:00,98,116,Brinquedo,1,214
44716,2024-02-01 01:15:00,92,119,Alimento,6,211
44717,2024-02-01 01:16:00,94,134,Vestuário,4,228
44718,2024-02-01 01:17:00,109,139,Eletrônico,7,248
44719,2024-02-01 01:18:00,82,105,Móvel,5,187
44720,2024-02-01 01:19:00,35,139,Alimento,3,174
44721,2024-02-01 01:20:00,10,174,Vestuário,4,184
44722,2024-02-01 01:21:00,50,118,Brinquedo,1,168
44723,2024-02-01 01:22:00,88,42,Brinquedo,7,130
44724,2024-02-01 01:23:00,37,139,Móvel,4,176
44725,2024-02-01 01:24:00,45,110,Móvel,3,155
44726,2024-02-01 01:25:00,14,12,Alimento,2,26
44727,2024-02-01 01:26:00,58,120,Eletrônico,6,178
44728,2024-02-01 01:27:00,31,79,Brinquedo,4,110
44729,2024-02-01 01:28:00,32,20,Móvel,4,52
44730,2024-02-01 01:29:00,18,148,Brinquedo,3,166
44731,2024-02-01 01:30:00,44,88,Alimento,7,132
44732,2024-02-01 01:31:00,77,129,Brinquedo,3,206
44733,2024-02-01 01:32:00,86,103,Móvel,8,189
44734,2024-02-01 01:33:00,99,83,Brinquedo,5,182
44735,2024-02-01 01:34:00,77,97,Alimento,9,174
44736,2024-02-01 01:35:00,106,171,Brinquedo,2,277
44737,2024-02-01 01:36:00,72,13,Vestuário,7,85
44738,2024-02-01 01:37:00,13,94,Eletrônico,2,107
44739,2024-02-01 01:38:00,43,22,Móvel,5,65
44740,2024-02-01 01:39:00,101,17,Vestuário,8,118
44741,2024-02-01 01:40:00,111,106,Eletrônico,3,217
44742,2024-02-01 01:41:00,70,150,Brinquedo,6,220
44743,2024-02-01 01:42:00,110,145,Brinquedo,7,255
44744,2024-02-01 01:43:00,114,115,Brinquedo,3,229
44745,2024-02-01 01:44:00,15,36,Eletrônico,8,51
44746,2024-02-01 01:45:00,19,67,Alimento,6,86
44747,2024-02-01 01:46:00,68,156,Alimento,4,224
44748,2024-02-01 01:47:00,49,98,Móvel,2,147
44749,2024-02-01 01:48:00,67,46,Móvel,5,113
44750,2024-02-01 01:49:00,11,156,Móvel,3,167
44751,2024-02-01 01:50:00,40,161,Alimento,1,201
44752,2024-02-01 01:51:00,98,129,Vestuário,6,227
44753,2024-02-01 01:52:00,115,126,Brinquedo,2,241
44754,2024-02-01 01:53:00,112,15,Móvel,6,127
44755,2024-02-01 01:54:00,34,175,Alimento,9,209
44756,2024-02-01 01:55:00,105,32,Brinquedo,2,137
44757,2024-02-01 01:56:00,66,113,Brinquedo,8,179
44758,2024-02-01 01:57:00,70,120,Eletrônico,6,190
44759,2024-02-01 01:58:00,29,173,Vestuário,9,202
44760,2024-02-01 01:59:00,26,60,Brinquedo,7,86
44761,2024-02-01 02:00:00,85,21,Vestuário,3,106
44762,2024-02-01 02:01:00,67,102,Vestuário,5,169
44763,2024-02-01 02:02:00,93,19,Alimento,7,112
44764,2024-02-01 02:03:00,37,10,Brinquedo,3,47
44765,2024-02-01 02:04:00,111,12,Eletrônico,9,123
44766,2024-02-01 02:05:00,77,101,Vestuário,9,178
44767,2024-02-01 02:06:00,67,39,Eletrônico,4,106
44768,2024-02-01 02:07:00,66,83,Móvel,9,149
44769,2024-02-01 02:08:00,33,82,Brinquedo,2,115
44770,2024-02-01 02:09:00,99,112,Eletrônico,3,211
44771,2024-02-01 02:10:00,13,122,Vestuário,3,135
44772,2024-02-01 02:11:00,94,82,Vestuário,8,176
44773,2024-02-01 02:12:00,55,40,Eletrônico,2,95
44774,2024-02-01 02:13:00,98,123,Vestuário,6,221
44775,2024-02-01 02:14:00,77,48,Alimento,9,125
44776,2024-02-01 02:15:00,78,159,Móvel,4,237
44777,2024-02-01 02:16:00,19,68,Vestuário,4,87
44778,2024-02-01 02:17:00,78,99,Móvel,3,177
44779,2024-02-01 02:18:00,88,114,Brinquedo,8,202
44780,2024-02-01 02:19:00,38,113,Eletrônico,6,151
44781,2024-02-01 02:20:00,93,103,Eletrônico,5,196
44782,2024-02-01 02:21:00,64,20,Eletrônico,6,84
44783,2024-02-01 02:22:00,108,111,Alimento,5,219
44784,2024-02-01 02:23:00,71,138,Móvel,6,209
44785,2024-02-01 02:24:00,77,154,Vestuário,4,231
44786,2024-02-01 02:25:00,76,32,Vestuário,3,108
44787,2024-02-01 02:26:00,71,44,Brinquedo,1,115
44788,2024-02-01 02:27:00,30,161,Eletrônico,9,191
44789,2024-02-01 02:28:00,26,71,Móvel,2,97
44790,2024-02-01 02:29:00,77,111,Móvel,3,188
44791,2024-02-01 02:30:00,57,133,Alimento,5,190
44792,2024-02-01 02:31:00,72,121,Móvel,7,193
44793,2024-02-01 02:32:00,26,64,Alimento,1,90
44794,2024-02-01 02:33:00,30,70,Móvel,7,100
44795,2024-02-01 02:34:00,102,166,Alimento,6,268
44796,2024-02-01 02:35:00,16,21,Brinquedo,9,37
44797,2024-02-01 02:36:00,84,109,Eletrônico,5,193
44798,2024-02-01 02:37:00,70,47,Móvel,1,117
44799,2024-02-01 02:38:00,81,10,Alimento,8,91
44800,2024-02-01 02:39:00,83,73,Móvel,9,156
44801,2024-02-01 02:40:00,29,112,Eletrônico,6,141
44802,2024-02-01 02:41:00,35,162,Móvel,6,197
44803,2024-02-01 02:42:00,50,120,Vestuário,5,170
44804,2024-02-01 02:43:00,36,100,Alimento,8,136
44805,2024-02-01 02:44:00,24,20,Móvel,2,44
44806,2024-02-01 02:45:00,89,47,Vestuário,1,136
44807,2024-02-01 02:46:00,20,86,Brinquedo,1,106
44808,2024-02-01 02:47:00,108,165,Vestuário,2,273
44809,2024-02-01 02:48:00,107,71,Vestuário,9,178
44810,2024-02-01 02:49:00,112,55,Eletrônico,9,167
44811,2024-02-01 02:50:00,36,81,Eletrônico,9,117
44812,2024-02-01 02:51:00,80,158,Alimento,6,238
44813,2024-02-01 02:52:00,105,144,Vestuário,4,249
44814,2024-02-01 02:53:00,12,116,Brinquedo,7,128
44815,2024-02-01 02:54:00,63,38,Vestuário,7,101
44816,2024-02-01 02:55:00,43,90,Brinquedo,6,133
44817,2024-02-01 02:56:00,71,82,Brinquedo,4,153
44818,2024-02-01 02:57:00,107,43,Alimento,7,150
44819,2024-02-01 02:58:00,75,162,Alimento,2,237
44820,2024-02-01 02:59:00,72,81,Brinquedo,7,153
44821,2024-02-01 03:00:00,77,176,Eletrônico,5,253
44822,2024-02-01 03:01:00,20,174,Brinquedo,4,194
44823,2024-02-01 03:02:00,101,102,Brinquedo,9,203
44824,2024-02-01 03:03:00,55,61,Alimento,2,116
44825,2024-02-01 03:04:00,84,75,Brinquedo,1,159
44826,2024-02-01 03:05:00,74,123,Brinquedo,3,197
44827,2024-02-01 03:06:00,109,149,Vestuário,9,258
44828,2024-02-01 03:07:00,92,144,Vestuário,1,236
44829,2024-02-01 03:08:00,109,76,Alimento,5,185
44830,2024-02-01 03:09:00,78,47,Eletrônico,3,125
44831,2024-02-01 03:10:00,17,103,Brinquedo,6,120
44832,2024-02-01 03:11:00,19,17,Alimento,8,36
44833,2024-02-01 03:12:00,20,122,Eletrônico,1,142
44834,2024-02-01 03:13:00,51,146,Vestuário,2,197
44835,2024-02-01 03:14:00,57,27,Alimento,6,84
44836,2024-02-01 03:15:00,27,93,Brinquedo,2,120
44837,2024-02-01 03:16:00,18,164,Brinquedo,7,182
44838,2024-02-01 03:17:00,46,130,Alimento,2,176
44839,2024-02-01 03:18:00,42,173,Vestuário,1,215
44840,2024-02-01 03:19:00,23,75,Eletrônico,8,98
44841,2024-02-01 03:20:00,67,96,Móvel,2,163
44842,2024-02-01 03:21:00,37,99,Vestuário,5,136
44843,2024-02-01 03:22:00,104,39,Vestuário,9,143
44844,2024-02-01 03:23:00,117,112,Móvel,2,229
44845,2024-02-01 03:24:00,44,67,Eletrônico,9,111
44846,2024-02-01 03:25:00,82,153,Alimento,7,235
44847,2024-02-01 03:26:00,79,21,Brinquedo,7,100
44848,2024-02-01 03:27:00,37,69,Brinquedo,6,106
44849,2024-02-01 03:28:00,72,160,Vestuário,9,232
44850,2024-02-01 03:29:00,67,157,Alimento,3,224
44851,2024-02-01 03:30:00,118,18,Brinquedo,7,136
44852,2024-02-01 03:31:00,110,117,Vestuário,5,227
44853,2024-02-01 03:32:00,113,146,Eletrônico,3,259
44854,2024-02-01 03:33:00,25,117,Vestuário,7,142
44855,2024-02-01 03:34:00,106,73,Alimento,2,179
44856,2024-02-01 03:35:00,85,96,Brinquedo,6,181
44857,2024-02-01 03:36:00,114,100,Vestuário,8,214
44858,2024-02-01 03:37:00,70,77,Móvel,4,147
44859,2024-02-01 03:38:00,20,71,Vestuário,9,91
44860,2024-02-01 03:39:00,65,40,Alimento,6,105
44861,2024-02-01 03:40:00,50,98,Brinquedo,7,148
44862,2024-02-01 03:41:00,115,70,Alimento,7,185
44863,2024-02-01 03:42:00,74,133,Alimento,1,207
44864,2024-02-01 03:43:00,89,75,Eletrônico,7,164
44865,2024-02-01 03:44:00,48,169,Brinquedo,6,217
44866,2024-02-01 03:45:00,64,74,Móvel,7,138
44867,2024-02-01 03:46:00,61,172,Brinquedo,8,233
44868,2024-02-01 03:47:00,30,168,Brinquedo,5,198
44869,2024-02-01 03:48:00,13,107,Eletrônico,7,120
44870,2024-02-01 03:49:00,68,122,Alimento,5,190
44871,2024-02-01 03:50:00,25,75,Brinquedo,6,100
44872,2024-02-01 03:51:00,14,179,Eletrônico,8,193
44873,2024-02-01 03:52:00,69,140,Móvel,7,209
44874,2024-02-01 03:53:00,80,150,Eletrônico,3,230
44875,2024-02-01 03:54:00,28,152,Brinquedo,4,180
44876,2024-02-01 03:55:00,22,32,Brinquedo,8,54
44877,2024-02-01 03:56:00,80,117,Brinquedo,6,197
44878,2024-02-01 03:57:00,99,116,Eletrônico,4,215
44879,2024-02-01 03:58:00,28,10,Alimento,6,38
44880,2024-02-01 03:59:00,88,48,Alimento,3,136
44881,2024-02-01 04:00:00,96,98,Brinquedo,1,194
44882,2024-02-01 04:01:00,53,21,Vestuário,1,74
44883,2024-02-01 04:02:00,55,175,Vestuário,9,230
44884,2024-02-01 04:03:00,118,70,Vestuário,1,188
44885,2024-02-01 04:04:00,36,165,Brinquedo,4,201
44886,2024-02-01 04:05:00,63,124,Brinquedo,6,187
44887,2024-02-01 04:06:00,18,76,Móvel,8,94
44888,2024-02-01 04:07:00,76,113,Alimento,2,189
44889,2024-02-01 04:08:00,24,54,Móvel,7,78
44890,2024-02-01 04:09:00,102,95,Alimento,9,197
44891,2024-02-01 04:10:00,69,93,Alimento,9,162
44892,2024-02-01 04:11:00,81,23,Alimento,1,104
44893,2024-02-01 04:12:00,41,75,Alimento,6,116
44894,2024-02-01 04:13:00,29,135,Alimento,5,164
44895,2024-02-01 04:14:00,66,123,Brinquedo,9,189
44896,2024-02-01 04:15:00,66,132,Vestuário,3,198
44897,2024-02-01 04:16:00,106,49,Alimento,2,155
44898,2024-02-01 04:17:00,89,30,Móvel,5,119
44899,2024-02-01 04:18:00,37,172,Vestuário,8,209
44900,2024-02-01 04:19:00,73,154,Vestuário,3,227
44901,2024-02-01 04:20:00,105,165,Vestuário,3,270
44902,2024-02-01 04:21:00,49,119,Eletrônico,8,168
44903,2024-02-01 04:22:00,53,88,Eletrônico,1,141
44904,2024-02-01 04:23:00,48,106,Móvel,8,154
44905,2024-02-01 04:24:00,94,165,Brinquedo,2,259
44906,2024-02-01 04:25:00,25,47,Vestuário,3,72
44907,2024-02-01 04:26:00,23,24,Vestuário,1,47
44908,2024-02-01 04:27:00,45,118,Eletrônico,5,163
44909,2024-02-01 04:28:00,53,75,Brinquedo,2,128
44910,2024-02-01 04:29:00,13,19,Eletrônico,3,32
44911,2024-02-01 04:30:00,103,28,Eletrônico,5,131
44912,2024-02-01 04:31:00,37,33,Brinquedo,4,70
44913,2024-02-01 04:32:00,47,135,Brinquedo,1,182
44914,2024-02-01 04:33:00,52,141,Alimento,1,193
44915,2024-02-01 04:34:00,88,12,Brinquedo,6,100
44916,2024-02-01 04:35:00,85,41,Vestuário,4,126
44917,2024-02-01 04:36:00,33,140,Vestuário,6,173
44918,2024-02-01 04:37:00,60,74,Eletrônico,5,134
44919,2024-02-01 04:38:00,32,169,Eletrônico,2,201
44920,2024-02-01 04:39:00,52,133,Eletrônico,1,185
44921,2024-02-01 04:40:00,36,86,Alimento,3,122
44922,2024-02-01 04:41:00,83,111,Móvel,1,194
44923,2024-02-01 04:42:00,95,16,Vestuário,9,111
44924,2024-02-01 04:43:00,36,121,Eletrônico,5,157
44925,2024-02-01 04:44:00,35,143,Brinquedo,1,178
44926,2024-02-01 04:45:00,119,102,Brinquedo,2,221
44927,2024-02-01 04:46:00,95,102,Móvel,3,197
44928,2024-02-01 04:47:00,14,104,Vestuário,8,118
44929,2024-02-01 04:48:00,75,102,Eletrônico,3,177
44930,2024-02-01 04:49:00,41,56,Móvel,6,97
44931,2024-02-01 04:50:00,58,123,Vestuário,1,181
44932,2024-02-01 04:51:00,79,77,Eletrônico,8,156
44933,2024-02-01 04:52:00,57,160,Eletrônico,9,217
44934,2024-02-01 04:53:00,29,24,Vestuário,5,53
44935,2024-02-01 04:54:00,13,172,Brinquedo,4,185
44936,2024-02-01 04:55:00,73,80,Eletrônico,9,153
44937,2024-02-01 04:56:00,51,26,Móvel,2,77
44938,2024-02-01 04:57:00,41,13,Eletrônico,8,54
44939,2024-02-01 04:58:00,42,86,Brinquedo,6,128
44940,2024-02-01 04:59:00,51,27,Vestuário,5,78
44941,2024-02-01 05:00:00,50,81,Eletrônico,8,131
44942,2024-02-01 05:01:00,78,121,Brinquedo,8,199
44943,2024-02-01 05:02:00,87,147,Alimento,8,234
44944,2024-02-01 05:03:00,101,122,Brinquedo,5,223
44945,2024-02-01 05:04:00,93,31,Vestuário,1,124
44946,2024-02-01 05:05:00,78,57,Vestuário,3,135
44947,2024-02-01 05:06:00,15,101,Brinquedo,2,116
44948,2024-02-01 05:07:00,29,18,Móvel,7,47
44949,2024-02-01 05:08:00,34,91,Móvel,4,125
44950,2024-02-01 05:09:00,93,16,Vestuário,8,109
44951,2024-02-01 05:10:00,34,27,Brinquedo,1,61
44952,2024-02-01 05:11:00,69,46,Alimento,5,115
44953,2024-02-01 05:12:00,103,21,Brinquedo,2,124
44954,2024-02-01 05:13:00,81,113,Vestuário,7,194
44955,2024-02-01 05:14:00,35,121,Vestuário,2,156
44956,2024-02-01 05:15:00,32,29,Brinquedo,9,61
44957,2024-02-01 05:16:00,23,164,Eletrônico,9,187
44958,2024-02-01 05:17:00,12,167,Brinquedo,1,179
44959,2024-02-01 05:18:00,46,97,Eletrônico,8,143
44960,2024-02-01 05:19:00,113,103,Eletrônico,1,216
44961,2024-02-01 05:20:00,29,100,Móvel,5,129
44962,2024-02-01 05:21:00,83,58,Vestuário,7,141
44963,2024-02-01 05:22:00,87,67,Eletrônico,3,154
44964,2024-02-01 05:23:00,34,142,Alimento,2,176
44965,2024-02-01 05:24:00,68,137,Brinquedo,2,205
44966,2024-02-01 05:25:00,55,45,Brinquedo,4,100
44967,2024-02-01 05:26:00,78,95,Eletrônico,2,173
44968,2024-02-01 05:27:00,86,57,Alimento,1,143
44969,2024-02-01 05:28:00,112,169,Vestuário,3,281
44970,2024-02-01 05:29:00,13,177,Vestuário,3,190
44971,2024-02-01 05:30:00,23,162,Brinquedo,6,185
44972,2024-02-01 05:31:00,62,32,Brinquedo,7,94
44973,2024-02-01 05:32:00,66,100,Vestuário,1,166
44974,2024-02-01 05:33:00,79,161,Vestuário,2,240
44975,2024-02-01 05:34:00,40,45,Vestuário,9,85
44976,2024-02-01 05:35:00,11,111,Eletrônico,9,122
44977,2024-02-01 05:36:00,29,42,Eletrônico,7,71
44978,2024-02-01 05:37:00,14,22,Móvel,4,36
44979,2024-02-01 05:38:00,38,172,Vestuário,7,210
44980,2024-02-01 05:39:00,83,44,Brinquedo,7,127
44981,2024-02-01 05:40:00,46,161,Eletrônico,2,207
44982,2024-02-01 05:41:00,46,55,Vestuário,4,101
44983,2024-02-01 05:42:00,23,39,Móvel,1,62
44984,2024-02-01 05:43:00,74,144,Eletrônico,7,218
44985,2024-02-01 05:44:00,61,170,Móvel,8,231
44986,2024-02-01 05:45:00,33,162,Brinquedo,8,195
44987,2024-02-01 05:46:00,41,52,Eletrônico,3,93
44988,2024-02-01 05:47:00,86,152,Eletrônico,1,238
44989,2024-02-01 05:48:00,87,10,Móvel,1,97
44990,2024-02-01 05:49:00,66,159,Móvel,7,225
44991,2024-02-01 05:50:00,64,119,Vestuário,3,183
44992,2024-02-01 05:51:00,85,92,Brinquedo,8,177
44993,2024-02-01 05:52:00,75,172,Eletrônico,6,247
44994,2024-02-01 05:53:00,59,106,Brinquedo,7,165
44995,2024-02-01 05:54:00,102,96,Eletrônico,6,198
44996,2024-02-01 05:55:00,76,176,Vestuário,6,252
44997,2024-02-01 05:56:00,13,29,Eletrônico,9,42
44998,2024-02-01 05:57:00,81,15,Móvel,2,96
44999,2024-02-01 05:58:00,67,116,Alimento,7,183
45000,2024-02-01 05:59:00,110,13,Vestuário,7,123
45001,2024-02-01 06:00:00,111,12,Eletrônico,1,123
45002,2024-02-01 06:01:00,56,49,Eletrônico,2,105
45003,2024-02-01 06:02:00,75,30,Brinquedo,4,105
45004,2024-02-01 06:03:00,73,47,Móvel,6,120
45005,2024-02-01 06:04:00,68,114,Vestuário,6,182
45006,2024-02-01 06:05:00,22,154,Eletrônico,5,176
45007,2024-02-01 06:06:00,60,176,Brinquedo,3,236
45008,2024-02-01 06:07:00,114,13,Alimento,8,127
45009,2024-02-01 06:08:00,112,151,Eletrônico,4,263
45010,2024-02-01 06:09:00,28,65,Brinquedo,5,93
45011,2024-02-01 06:10:00,50,81,Móvel,7,131
45012,2024-02-01 06:11:00,56,106,Brinquedo,8,162
45013,2024-02-01 06:12:00,18,59,Móvel,2,77
45014,2024-02-01 06:13:00,45,11,Eletrônico,8,56
45015,2024-02-01 06:14:00,12,154,Eletrônico,4,166
45016,2024-02-01 06:15:00,70,97,Eletrônico,6,167
45017,2024-02-01 06:16:00,11,78,Brinquedo,3,89
45018,2024-02-01 06:17:00,52,152,Vestuário,7,204
45019,2024-02-01 06:18:00,101,151,Móvel,9,252
45020,2024-02-01 06:19:00,110,174,Alimento,2,284
45021,2024-02-01 06:20:00,77,158,Vestuário,9,235
45022,2024-02-01 06:21:00,117,37,Móvel,3,154
45023,2024-02-01 06:22:00,47,14,Móvel,5,61
45024,2024-02-01 06:23:00,107,114,Eletrônico,6,221
45025,2024-02-01 06:24:00,62,127,Brinquedo,5,189
45026,2024-02-01 06:25:00,52,56,Brinquedo,1,108
45027,2024-02-01 06:26:00,72,72,Vestuário,8,144
45028,2024-02-01 06:27:00,98,21,Móvel,3,119
45029,2024-02-01 06:28:00,86,157,Alimento,3,243
45030,2024-02-01 06:29:00,48,124,Eletrônico,7,172
45031,2024-02-01 06:30:00,50,30,Alimento,4,80
45032,2024-02-01 06:31:00,23,105,Eletrônico,8,128
45033,2024-02-01 06:32:00,46,42,Vestuário,6,88
45034,2024-02-01 06:33:00,111,117,Alimento,5,228
45035,2024-02-01 06:34:00,118,134,Móvel,7,252
45036,2024-02-01 06:35:00,84,24,Vestuário,9,108
45037,2024-02-01 06:36:00,119,62,Móvel,4,181
45038,2024-02-01 06:37:00,87,93,Móvel,5,180
45039,2024-02-01 06:38:00,92,49,Vestuário,7,141
45040,2024-02-01 06:39:00,64,129,Brinquedo,3,193
45041,2024-02-01 06:40:00,108,166,Móvel,5,274
45042,2024-02-01 06:41:00,98,94,Vestuário,1,192
45043,2024-02-01 06:42:00,21,145,Móvel,2,166
45044,2024-02-01 06:43:00,71,144,Eletrônico,3,215
45045,2024-02-01 06:44:00,103,118,Brinquedo,6,221
45046,2024-02-01 06:45:00,61,127,Brinquedo,4,188
45047,2024-02-01 06:46:00,49,99,Vestuário,8,148
45048,2024-02-01 06:47:00,76,13,Brinquedo,9,89
45049,2024-02-01 06:48:00,90,57,Brinquedo,7,147
45050,2024-02-01 06:49:00,44,72,Eletrônico,5,116
45051,2024-02-01 06:50:00,75,56,Móvel,2,131
45052,2024-02-01 06:51:00,53,30,Vestuário,8,83
45053,2024-02-01 06:52:00,96,16,Alimento,1,112
45054,2024-02-01 06:53:00,63,29,Eletrônico,8,92
45055,2024-02-01 06:54:00,67,167,Móvel,5,234
45056,2024-02-01 06:55:00,34,169,Alimento,9,203
45057,2024-02-01 06:56:00,88,127,Brinquedo,2,215
45058,2024-02-01 06:57:00,80,77,Brinquedo,8,157
45059,2024-02-01 06:58:00,20,34,Eletrônico,8,54
45060,2024-02-01 06:59:00,12,85,Vestuário,5,97
45061,2024-02-01 07:00:00,24,164,Eletrônico,4,188
45062,2024-02-01 07:01:00,84,23,Eletrônico,6,107
45063,2024-02-01 07:02:00,99,107,Eletrônico,4,206
45064,2024-02-01 07:03:00,49,135,Eletrônico,3,184
45065,2024-02-01 07:04:00,65,174,Alimento,4,239
45066,2024-02-01 07:05:00,98,120,Vestuário,5,218
45067,2024-02-01 07:06:00,98,167,Eletrônico,3,265
45068,2024-02-01 07:07:00,73,30,Vestuário,9,103
45069,2024-02-01 07:08:00,104,172,Eletrônico,5,276
45070,2024-02-01 07:09:00,33,111,Alimento,8,144
45071,2024-02-01 07:10:00,43,72,Brinquedo,5,115
45072,2024-02-01 07:11:00,86,119,Brinquedo,7,205
45073,2024-02-01 07:12:00,110,174,Eletrônico,6,284
45074,2024-02-01 07:13:00,56,109,Alimento,9,165
45075,2024-02-01 07:14:00,70,27,Brinquedo,2,97
45076,2024-02-01 07:15:00,19,129,Eletrônico,3,148
45077,2024-02-01 07:16:00,20,82,Brinquedo,9,102
45078,2024-02-01 07:17:00,114,63,Móvel,6,177
45079,2024-02-01 07:18:00,68,60,Alimento,6,128
45080,2024-02-01 07:19:00,63,173,Alimento,3,236
45081,2024-02-01 07:20:00,11,104,Vestuário,4,115
45082,2024-02-01 07:21:00,27,28,Eletrônico,8,55
45083,2024-02-01 07:22:00,54,125,Móvel,4,179
45084,2024-02-01 07:23:00,34,14,Eletrônico,9,48
45085,2024-02-01 07:24:00,58,110,Vestuário,6,168
45086,2024-02-01 07:25:00,22,137,Alimento,8,159
45087,2024-02-01 07:26:00,31,52,Alimento,4,83
45088,2024-02-01 07:27:00,18,150,Vestuário,4,168
45089,2024-02-01 07:28:00,99,49,Brinquedo,2,148
45090,2024-02-01 07:29:00,54,20,Eletrônico,4,74
45091,2024-02-01 07:30:00,43,57,Alimento,8,100
45092,2024-02-01 07:31:00,64,35,Eletrônico,4,99
45093,2024-02-01 07:32:00,102,155,Brinquedo,8,257
45094,2024-02-01 07:33:00,23,79,Móvel,5,102
45095,2024-02-01 07:34:00,50,65,Móvel,4,115
45096,2024-02-01 07:35:00,81,36,Eletrônico,7,117
45097,2024-02-01 07:36:00,85,35,Brinquedo,2,120
45098,2024-02-01 07:37:00,64,82,Móvel,3,146
45099,2024-02-01 07:38:00,108,124,Brinquedo,2,232
45100,2024-02-01 07:39:00,87,22,Brinquedo,7,109
45101,2024-02-01 07:40:00,106,23,Móvel,8,129
45102,2024-02-01 07:41:00,53,17,Alimento,9,70
45103,2024-02-01 07:42:00,78,59,Móvel,8,137
45104,2024-02-01 07:43:00,106,111,Brinquedo,4,217
45105,2024-02-01 07:44:00,94,134,Alimento,9,228
45106,2024-02-01 07:45:00,115,37,Alimento,7,152
45107,2024-02-01 07:46:00,67,167,Eletrônico,2,234
45108,2024-02-01 07:47:00,102,61,Móvel,7,163
45109,2024-02-01 07:48:00,19,175,Brinquedo,4,194
45110,2024-02-01 07:49:00,44,44,Móvel,5,88
45111,2024-02-01 07:50:00,49,161,Móvel,9,210
45112,2024-02-01 07:51:00,96,86,Móvel,3,182
45113,2024-02-01 07:52:00,40,142,Eletrônico,7,182
45114,2024-02-01 07:53:00,79,63,Alimento,3,142
45115,2024-02-01 07:54:00,34,33,Vestuário,2,67
45116,2024-02-01 07:55:00,62,64,Eletrônico,5,126
45117,2024-02-01 07:56:00,89,49,Vestuário,4,138
45118,2024-02-01 07:57:00,21,13,Brinquedo,1,34
45119,2024-02-01 07:58:00,87,98,Móvel,2,185
45120,2024-02-01 07:59:00,13,53,Alimento,3,66
45121,2024-02-01 08:00:00,72,107,Vestuário,4,179
45122,2024-02-01 08:01:00,17,72,Brinquedo,6,89
45123,2024-02-01 08:02:00,35,164,Móvel,2,199
45124,2024-02-01 08:03:00,70,58,Vestuário,6,128
45125,2024-02-01 08:04:00,119,162,Vestuário,3,281
45126,2024-02-01 08:05:00,100,45,Móvel,1,145
45127,2024-02-01 08:06:00,103,91,Móvel,7,194
45128,2024-02-01 08:07:00,69,49,Brinquedo,2,118
45129,2024-02-01 08:08:00,96,154,Eletrônico,9,250
45130,2024-02-01 08:09:00,35,138,Brinquedo,2,173
45131,2024-02-01 08:10:00,108,125,Vestuário,3,233
45132,2024-02-01 08:11:00,112,15,Brinquedo,7,127
45133,2024-02-01 08:12:00,100,169,Móvel,5,269
45134,2024-02-01 08:13:00,119,102,Eletrônico,5,221
45135,2024-02-01 08:14:00,87,156,Eletrônico,9,243
45136,2024-02-01 08:15:00,10,95,Alimento,2,105
45137,2024-02-01 08:16:00,118,99,Vestuário,1,217
45138,2024-02-01 08:17:00,90,94,Móvel,1,184
45139,2024-02-01 08:18:00,58,77,Brinquedo,5,135
45140,2024-02-01 08:19:00,92,50,Eletrônico,5,142
45141,2024-02-01 08:20:00,31,177,Brinquedo,5,208
45142,2024-02-01 08:21:00,104,120,Brinquedo,3,224
45143,2024-02-01 08:22:00,71,86,Móvel,7,157
45144,2024-02-01 08:23:00,89,110,Alimento,5,199
45145,2024-02-01 08:24:00,69,163,Vestuário,8,232
45146,2024-02-01 08:25:00,16,90,Alimento,9,106
45147,2024-02-01 08:26:00,27,96,Alimento,7,123
45148,2024-02-01 08:27:00,71,158,Alimento,6,229
45149,2024-02-01 08:28:00,66,77,Eletrônico,6,143
45150,2024-02-01 08:29:00,107,83,Alimento,9,190
45151,2024-02-01 08:30:00,108,20,Vestuário,2,128
45152,2024-02-01 08:31:00,33,137,Brinquedo,6,170
45153,2024-02-01 08:32:00,13,98,Vestuário,3,111
45154,2024-02-01 08:33:00,24,130,Móvel,1,154
45155,2024-02-01 08:34:00,97,36,Alimento,1,133
45156,2024-02-01 08:35:00,91,128,Eletrônico,6,219
45157,2024-02-01 08:36:00,102,171,Vestuário,4,273
45158,2024-02-01 08:37:00,29,174,Brinquedo,6,203
45159,2024-02-01 08:38:00,57,96,Eletrônico,4,153
45160,2024-02-01 08:39:00,26,179,Eletrônico,5,205
45161,2024-02-01 08:40:00,66,124,Alimento,9,190
45162,2024-02-01 08:41:00,81,108,Vestuário,3,189
45163,2024-02-01 08:42:00,28,123,Móvel,5,151
45164,2024-02-01 08:43:00,83,51,Eletrônico,5,134
45165,2024-02-01 08:44:00,18,172,Brinquedo,9,190
45166,2024-02-01 08:45:00,48,13,Móvel,3,61
45167,2024-02-01 08:46:00,92,125,Vestuário,1,217
45168,2024-02-01 08:47:00,59,39,Móvel,8,98
45169,2024-02-01 08:48:00,103,54,Móvel,1,157
45170,2024-02-01 08:49:00,19,83,Eletrônico,6,102
45171,2024-02-01 08:50:00,100,80,Brinquedo,5,180
45172,2024-02-01 08:51:00,18,139,Eletrônico,6,157
45173,2024-02-01 08:52:00,55,45,Vestuário,7,100
45174,2024-02-01 08:53:00,75,170,Alimento,4,245
45175,2024-02-01 08:54:00,39,123,Eletrônico,6,162
45176,2024-02-01 08:55:00,46,56,Eletrônico,8,102
45177,2024-02-01 08:56:00,90,19,Alimento,6,109
45178,2024-02-01 08:57:00,100,129,Vestuário,6,229
45179,2024-02-01 08:58:00,31,53,Brinquedo,8,84
45180,2024-02-01 08:59:00,47,37,Móvel,2,84
45181,2024-02-01 09:00:00,62,63,Brinquedo,8,125
45182,2024-02-01 09:01:00,72,38,Vestuário,3,110
45183,2024-02-01 09:02:00,108,59,Eletrônico,3,167
45184,2024-02-01 09:03:00,82,176,Eletrônico,4,258
45185,2024-02-01 09:04:00,84,139,Alimento,7,223
45186,2024-02-01 09:05:00,81,37,Móvel,9,118
45187,2024-02-01 09:06:00,46,41,Alimento,3,87
45188,2024-02-01 09:07:00,24,80,Móvel,1,104
45189,2024-02-01 09:08:00,26,171,Vestuário,1,197
45190,2024-02-01 09:09:00,108,173,Móvel,4,281
45191,2024-02-01 09:10:00,39,99,Vestuário,6,138
45192,2024-02-01 09:11:00,29,132,Vestuário,3,161
45193,2024-02-01 09:12:00,89,36,Vestuário,1,125
45194,2024-02-01 09:13:00,25,141,Eletrônico,4,166
45195,2024-02-01 09:14:00,47,145,Vestuário,2,192
45196,2024-02-01 09:15:00,80,29,Alimento,7,109
45197,2024-02-01 09:16:00,48,57,Móvel,2,105
45198,2024-02-01 09:17:00,43,35,Eletrônico,9,78
45199,2024-02-01 09:18:00,29,54,Eletrônico,3,83
45200,2024-02-01 09:19:00,51,145,Eletrônico,5,196
45201,2024-02-01 09:20:00,75,164,Vestuário,4,239
45202,2024-02-01 09:21:00,102,82,Vestuário,5,184
45203,2024-02-01 09:22:00,88,90,Brinquedo,7,178
45204,2024-02-01 09:23:00,65,152,Brinquedo,1,217
45205,2024-02-01 09:24:00,37,95,Eletrônico,1,132
45206,2024-02-01 09:25:00,111,79,Vestuário,2,190
45207,2024-02-01 09:26:00,13,85,Brinquedo,4,98
45208,2024-02-01 09:27:00,66,172,Alimento,2,238
45209,2024-02-01 09:28:00,46,93,Alimento,7,139
45210,2024-02-01 09:29:00,41,97,Brinquedo,2,138
45211,2024-02-01 09:30:00,12,31,Alimento,4,43
45212,2024-02-01 09:31:00,107,34,Eletrônico,3,141
45213,2024-02-01 09:32:00,95,46,Eletrônico,6,141
45214,2024-02-01 09:33:00,69,21,Móvel,3,90
45215,2024-02-01 09:34:00,70,104,Brinquedo,1,174
45216,2024-02-01 09:35:00,108,89,Móvel,5,197
45217,2024-02-01 09:36:00,95,133,Alimento,1,228
45218,2024-02-01 09:37:00,71,176,Móvel,6,247
45219,2024-02-01 09:38:00,97,28,Brinquedo,3,125
45220,2024-02-01 09:39:00,59,37,Brinquedo,2,96
45221,2024-02-01 09:40:00,50,176,Alimento,9,226
45222,2024-02-01 09:41:00,65,47,Alimento,7,112
45223,2024-02-01 09:42:00,80,100,Eletrônico,6,180
45224,2024-02-01 09:43:00,33,159,Vestuário,8,192
45225,2024-02-01 09:44:00,31,47,Eletrônico,2,78
45226,2024-02-01 09:45:00,109,146,Alimento,7,255
45227,2024-02-01 09:46:00,104,159,Eletrônico,3,263
45228,2024-02-01 09:47:00,95,123,Eletrônico,3,218
45229,2024-02-01 09:48:00,55,26,Móvel,9,81
45230,2024-02-01 09:49:00,19,29,Brinquedo,1,48
45231,2024-02-01 09:50:00,95,143,Eletrônico,2,238
45232,2024-02-01 09:51:00,67,101,Móvel,3,168
45233,2024-02-01 09:52:00,10,48,Brinquedo,6,58
45234,2024-02-01 09:53:00,11,82,Alimento,9,93
45235,2024-02-01 09:54:00,20,148,Eletrônico,6,168
45236,2024-02-01 09:55:00,18,154,Eletrônico,8,172
45237,2024-02-01 09:56:00,13,93,Vestuário,4,106
45238,2024-02-01 09:57:00,73,169,Vestuário,8,242
45239,2024-02-01 09:58:00,33,45,Alimento,5,78
45240,2024-02-01 09:59:00,49,47,Móvel,9,96
45241,2024-02-01 10:00:00,86,30,Eletrônico,3,116
45242,2024-02-01 10:01:00,53,132,Móvel,7,185
45243,2024-02-01 10:02:00,57,162,Brinquedo,5,219
45244,2024-02-01 10:03:00,98,38,Móvel,4,136
45245,2024-02-01 10:04:00,43,71,Móvel,5,114
45246,2024-02-01 10:05:00,97,18,Alimento,2,115
45247,2024-02-01 10:06:00,36,22,Eletrônico,6,58
45248,2024-02-01 10:07:00,42,88,Vestuário,4,130
45249,2024-02-01 10:08:00,69,49,Eletrônico,2,118
45250,2024-02-01 10:09:00,95,146,Brinquedo,8,241
45251,2024-02-01 10:10:00,77,39,Móvel,2,116
45252,2024-02-01 10:11:00,63,134,Móvel,7,197
45253,2024-02-01 10:12:00,113,75,Vestuário,1,188
45254,2024-02-01 10:13:00,21,90,Móvel,7,111
45255,2024-02-01 10:14:00,34,83,Alimento,1,117
45256,2024-02-01 10:15:00,70,132,Eletrônico,3,202
45257,2024-02-01 10:16:00,10,42,Brinquedo,9,52
45258,2024-02-01 10:17:00,45,141,Alimento,5,186
45259,2024-02-01 10:18:00,64,85,Móvel,1,149
45260,2024-02-01 10:19:00,109,107,Móvel,4,216
45261,2024-02-01 10:20:00,105,115,Eletrônico,5,220
45262,2024-02-01 10:21:00,21,165,Vestuário,5,186
45263,2024-02-01 10:22:00,100,150,Móvel,3,250
45264,2024-02-01 10:23:00,76,64,Brinquedo,4,140
45265,2024-02-01 10:24:00,74,63,Brinquedo,7,137
45266,2024-02-01 10:25:00,19,19,Vestuário,2,38
45267,2024-02-01 10:26:00,102,79,Eletrônico,7,181
45268,2024-02-01 10:27:00,108,21,Eletrônico,9,129
45269,2024-02-01 10:28:00,110,152,Alimento,6,262
45270,2024-02-01 10:29:00,99,90,Móvel,5,189
45271,2024-02-01 10:30:00,10,144,Eletrônico,6,154
45272,2024-02-01 10:31:00,24,54,Alimento,9,78
45273,2024-02-01 10:32:00,82,108,Móvel,1,190
45274,2024-02-01 10:33:00,62,86,Vestuário,6,148
45275,2024-02-01 10:34:00,80,130,Eletrônico,2,210
45276,2024-02-01 10:35:00,94,52,Vestuário,9,146
45277,2024-02-01 10:36:00,100,62,Móvel,6,162
45278,2024-02-01 10:37:00,16,154,Eletrônico,1,170
45279,2024-02-01 10:38:00,31,168,Móvel,6,199
45280,2024-02-01 10:39:00,112,30,Móvel,4,142
45281,2024-02-01 10:40:00,112,112,Eletrônico,8,224
45282,2024-02-01 10:41:00,90,14,Alimento,3,104
45283,2024-02-01 10:42:00,14,15,Eletrônico,8,29
45284,2024-02-01 10:43:00,13,107,Vestuário,5,120
45285,2024-02-01 10:44:00,117,34,Alimento,2,151
45286,2024-02-01 10:45:00,41,45,Brinquedo,8,86
45287,2024-02-01 10:46:00,67,147,Eletrônico,2,214
45288,2024-02-01 10:47:00,108,174,Alimento,4,282
45289,2024-02-01 10:48:00,49,132,Vestuário,8,181
45290,2024-02-01 10:49:00,82,39,Brinquedo,5,121
45291,2024-02-01 10:50:00,111,67,Eletrônico,5,178
45292,2024-02-01 10:51:00,105,76,Vestuário,1,181
45293,2024-02-01 10:52:00,62,140,Alimento,1,202
45294,2024-02-01 10:53:00,98,22,Vestuário,7,120
45295,2024-02-01 10:54:00,45,29,Vestuário,6,74
45296,2024-02-01 10:55:00,53,37,Alimento,4,90
45297,2024-02-01 10:56:00,36,44,Móvel,4,80
45298,2024-02-01 10:57:00,37,141,Brinquedo,7,178
45299,2024-02-01 10:58:00,27,168,Alimento,9,195
45300,2024-02-01 10:59:00,34,173,Eletrônico,1,207
45301,2024-02-01 11:00:00,35,30,Eletrônico,9,65
45302,2024-02-01 11:01:00,105,148,Alimento,7,253
45303,2024-02-01 11:02:00,87,102,Vestuário,9,189
45304,2024-02-01 11:03:00,11,60,Alimento,4,71
45305,2024-02-01 11:04:00,88,52,Vestuário,4,140
45306,2024-02-01 11:05:00,118,14,Vestuário,5,132
45307,2024-02-01 11:06:00,79,103,Alimento,8,182
45308,2024-02-01 11:07:00,12,139,Móvel,9,151
45309,2024-02-01 11:08:00,36,110,Móvel,6,146
45310,2024-02-01 11:09:00,56,76,Vestuário,7,132
45311,2024-02-01 11:10:00,72,31,Alimento,2,103
45312,2024-02-01 11:11:00,52,144,Brinquedo,2,196
45313,2024-02-01 11:12:00,39,165,Eletrônico,5,204
45314,2024-02-01 11:13:00,93,113,Brinquedo,7,206
45315,2024-02-01 11:14:00,37,96,Brinquedo,3,133
45316,2024-02-01 11:15:00,50,19,Vestuário,4,69
45317,2024-02-01 11:16:00,74,131,Brinquedo,2,205
45318,2024-02-01 11:17:00,30,121,Brinquedo,3,151
45319,2024-02-01 11:18:00,45,61,Eletrônico,2,106
45320,2024-02-01 11:19:00,64,101,Móvel,3,165
45321,2024-02-01 11:20:00,41,169,Móvel,8,210
45322,2024-02-01 11:21:00,82,112,Alimento,6,194
45323,2024-02-01 11:22:00,69,12,Móvel,4,81
45324,2024-02-01 11:23:00,68,121,Brinquedo,2,189
45325,2024-02-01 11:24:00,103,18,Brinquedo,7,121
45326,2024-02-01 11:25:00,89,175,Eletrônico,3,264
45327,2024-02-01 11:26:00,95,63,Vestuário,9,158
45328,2024-02-01 11:27:00,100,172,Móvel,1,272
45329,2024-02-01 11:28:00,97,157,Móvel,9,254
45330,2024-02-01 11:29:00,15,178,Eletrônico,3,193
45331,2024-02-01 11:30:00,91,106,Vestuário,6,197
45332,2024-02-01 11:31:00,94,137,Eletrônico,3,231
45333,2024-02-01 11:32:00,94,178,Eletrônico,7,272
45334,2024-02-01 11:33:00,81,135,Vestuário,1,216
45335,2024-02-01 11:34:00,29,162,Brinquedo,8,191
45336,2024-02-01 11:35:00,112,176,Móvel,9,288
45337,2024-02-01 11:36:00,27,45,Alimento,9,72
45338,2024-02-01 11:37:00,117,95,Móvel,4,212
45339,2024-02-01 11:38:00,24,117,Brinquedo,3,141
45340,2024-02-01 11:39:00,56,18,Alimento,8,74
45341,2024-02-01 11:40:00,87,97,Alimento,5,184
45342,2024-02-01 11:41:00,103,154,Vestuário,3,257
45343,2024-02-01 11:42:00,54,141,Brinquedo,8,195
45344,2024-02-01 11:43:00,85,105,Móvel,2,190
45345,2024-02-01 11:44:00,110,159,Vestuário,5,269
45346,2024-02-01 11:45:00,13,109,Alimento,2,122
45347,2024-02-01 11:46:00,56,90,Brinquedo,9,146
45348,2024-02-01 11:47:00,62,27,Alimento,6,89
45349,2024-02-01 11:48:00,94,78,Vestuário,9,172
45350,2024-02-01 11:49:00,59,176,Alimento,2,235
45351,2024-02-01 11:50:00,40,94,Eletrônico,6,134
45352,2024-02-01 11:51:00,94,116,Alimento,2,210
45353,2024-02-01 11:52:00,61,67,Alimento,4,128
45354,2024-02-01 11:53:00,103,112,Vestuário,2,215
45355,2024-02-01 11:54:00,84,12,Alimento,1,96
45356,2024-02-01 11:55:00,46,22,Alimento,7,68
45357,2024-02-01 11:56:00,110,179,Brinquedo,2,289
45358,2024-02-01 11:57:00,102,179,Eletrônico,8,281
45359,2024-02-01 11:58:00,20,136,Móvel,7,156
45360,2024-02-01 11:59:00,112,75,Móvel,5,187
45361,2024-02-01 12:00:00,101,177,Brinquedo,1,278
45362,2024-02-01 12:01:00,87,134,Móvel,9,221
45363,2024-02-01 12:02:00,51,57,Alimento,5,108
45364,2024-02-01 12:03:00,118,80,Vestuário,3,198
45365,2024-02-01 12:04:00,100,59,Eletrônico,9,159
45366,2024-02-01 12:05:00,59,82,Móvel,2,141
45367,2024-02-01 12:06:00,112,73,Eletrônico,9,185
45368,2024-02-01 12:07:00,30,92,Vestuário,1,122
45369,2024-02-01 12:08:00,57,175,Eletrônico,1,232
45370,2024-02-01 12:09:00,82,46,Eletrônico,2,128
45371,2024-02-01 12:10:00,98,179,Alimento,4,277
45372,2024-02-01 12:11:00,117,16,Alimento,3,133
45373,2024-02-01 12:12:00,10,39,Eletrônico,7,49
45374,2024-02-01 12:13:00,38,14,Eletrônico,5,52
45375,2024-02-01 12:14:00,100,117,Vestuário,8,217
45376,2024-02-01 12:15:00,27,79,Eletrônico,8,106
45377,2024-02-01 12:16:00,76,22,Alimento,1,98
45378,2024-02-01 12:17:00,96,130,Brinquedo,3,226
45379,2024-02-01 12:18:00,18,39,Vestuário,9,57
45380,2024-02-01 12:19:00,79,109,Móvel,3,188
45381,2024-02-01 12:20:00,104,155,Vestuário,7,259
45382,2024-02-01 12:21:00,56,162,Eletrônico,1,218
45383,2024-02-01 12:22:00,34,95,Eletrônico,2,129
45384,2024-02-01 12:23:00,36,34,Vestuário,7,70
45385,2024-02-01 12:24:00,23,79,Brinquedo,9,102
45386,2024-02-01 12:25:00,84,109,Alimento,8,193
45387,2024-02-01 12:26:00,52,16,Vestuário,8,68
45388,2024-02-01 12:27:00,90,85,Brinquedo,4,175
45389,2024-02-01 12:28:00,16,167,Eletrônico,6,183
45390,2024-02-01 12:29:00,114,160,Móvel,3,274
45391,2024-02-01 12:30:00,93,162,Eletrônico,8,255
45392,2024-02-01 12:31:00,23,106,Eletrônico,8,129
45393,2024-02-01 12:32:00,112,62,Vestuário,1,174
45394,2024-02-01 12:33:00,68,114,Eletrônico,2,182
45395,2024-02-01 12:34:00,62,79,Brinquedo,6,141
45396,2024-02-01 12:35:00,85,80,Brinquedo,6,165
45397,2024-02-01 12:36:00,40,37,Alimento,6,77
45398,2024-02-01 12:37:00,60,86,Alimento,2,146
45399,2024-02-01 12:38:00,45,141,Vestuário,6,186
45400,2024-02-01 12:39:00,33,35,Brinquedo,4,68
45401,2024-02-01 12:40:00,33,122,Eletrônico,5,155
45402,2024-02-01 12:41:00,11,130,Brinquedo,4,141
45403,2024-02-01 12:42:00,32,23,Alimento,2,55
45404,2024-02-01 12:43:00,12,107,Brinquedo,5,119
45405,2024-02-01 12:44:00,20,63,Vestuário,7,83
45406,2024-02-01 12:45:00,85,49,Vestuário,1,134
45407,2024-02-01 12:46:00,59,39,Móvel,5,98
45408,2024-02-01 12:47:00,58,32,Alimento,7,90
45409,2024-02-01 12:48:00,61,25,Vestuário,6,86
45410,2024-02-01 12:49:00,18,145,Alimento,6,163
45411,2024-02-01 12:50:00,70,148,Vestuário,3,218
45412,2024-02-01 12:51:00,95,37,Brinquedo,5,132
45413,2024-02-01 12:52:00,81,94,Alimento,8,175
45414,2024-02-01 12:53:00,56,64,Vestuário,4,120
45415,2024-02-01 12:54:00,104,74,Alimento,5,178
45416,2024-02-01 12:55:00,32,39,Móvel,4,71
45417,2024-02-01 12:56:00,46,34,Alimento,8,80
45418,2024-02-01 12:57:00,66,24,Alimento,3,90
45419,2024-02-01 12:58:00,59,19,Eletrônico,4,78
45420,2024-02-01 12:59:00,118,44,Móvel,3,162
45421,2024-02-01 13:00:00,107,176,Móvel,4,283
45422,2024-02-01 13:01:00,76,171,Móvel,6,247
45423,2024-02-01 13:02:00,99,49,Alimento,9,148
45424,2024-02-01 13:03:00,58,158,Móvel,5,216
45425,2024-02-01 13:04:00,43,92,Vestuário,4,135
45426,2024-02-01 13:05:00,11,32,Vestuário,3,43
45427,2024-02-01 13:06:00,38,21,Móvel,6,59
45428,2024-02-01 13:07:00,10,56,Eletrônico,4,66
45429,2024-02-01 13:08:00,43,151,Brinquedo,1,194
45430,2024-02-01 13:09:00,103,90,Eletrônico,9,193
45431,2024-02-01 13:10:00,89,109,Móvel,1,198
45432,2024-02-01 13:11:00,51,63,Vestuário,9,114
45433,2024-02-01 13:12:00,102,124,Móvel,9,226
45434,2024-02-01 13:13:00,58,124,Brinquedo,7,182
45435,2024-02-01 13:14:00,109,48,Vestuário,4,157
45436,2024-02-01 13:15:00,51,144,Móvel,1,195
45437,2024-02-01 13:16:00,28,19,Vestuário,7,47
45438,2024-02-01 13:17:00,107,133,Vestuário,7,240
45439,2024-02-01 13:18:00,74,63,Vestuário,3,137
45440,2024-02-01 13:19:00,38,129,Alimento,5,167
45441,2024-02-01 13:20:00,60,95,Alimento,3,155
45442,2024-02-01 13:21:00,102,73,Brinquedo,1,175
45443,2024-02-01 13:22:00,115,77,Alimento,1,192
45444,2024-02-01 13:23:00,45,70,Eletrônico,6,115
45445,2024-02-01 13:24:00,17,55,Alimento,4,72
45446,2024-02-01 13:25:00,49,63,Vestuário,2,112
45447,2024-02-01 13:26:00,106,133,Eletrônico,7,239
45448,2024-02-01 13:27:00,66,77,Brinquedo,1,143
45449,2024-02-01 13:28:00,14,69,Brinquedo,8,83
45450,2024-02-01 13:29:00,98,163,Eletrônico,6,261
45451,2024-02-01 13:30:00,50,144,Móvel,8,194
45452,2024-02-01 13:31:00,71,107,Vestuário,4,178
45453,2024-02-01 13:32:00,60,17,Móvel,1,77
45454,2024-02-01 13:33:00,40,97,Vestuário,8,137
45455,2024-02-01 13:34:00,74,133,Vestuário,3,207
45456,2024-02-01 13:35:00,59,162,Eletrônico,7,221
45457,2024-02-01 13:36:00,105,152,Brinquedo,4,257
45458,2024-02-01 13:37:00,79,146,Alimento,8,225
45459,2024-02-01 13:38:00,85,101,Vestuário,2,186
45460,2024-02-01 13:39:00,23,109,Móvel,6,132
45461,2024-02-01 13:40:00,118,156,Móvel,5,274
45462,2024-02-01 13:41:00,25,148,Brinquedo,7,173
45463,2024-02-01 13:42:00,34,115,Brinquedo,7,149
45464,2024-02-01 13:43:00,98,117,Eletrônico,7,215
45465,2024-02-01 13:44:00,30,96,Brinquedo,7,126
45466,2024-02-01 13:45:00,75,131,Vestuário,3,206
45467,2024-02-01 13:46:00,76,18,Alimento,3,94
45468,2024-02-01 13:47:00,50,96,Móvel,4,146
45469,2024-02-01 13:48:00,115,159,Brinquedo,3,274
45470,2024-02-01 13:49:00,86,137,Eletrônico,2,223
45471,2024-02-01 13:50:00,22,19,Vestuário,4,41
45472,2024-02-01 13:51:00,73,121,Alimento,5,194
45473,2024-02-01 13:52:00,82,67,Vestuário,2,149
45474,2024-02-01 13:53:00,34,151,Móvel,1,185
45475,2024-02-01 13:54:00,65,113,Alimento,7,178
45476,2024-02-01 13:55:00,73,65,Brinquedo,8,138
45477,2024-02-01 13:56:00,86,179,Alimento,6,265
45478,2024-02-01 13:57:00,11,155,Brinquedo,9,166
45479,2024-02-01 13:58:00,22,127,Móvel,9,149
45480,2024-02-01 13:59:00,39,113,Brinquedo,6,152
45481,2024-02-01 14:00:00,30,19,Vestuário,9,49
45482,2024-02-01 14:01:00,77,149,Móvel,7,226
45483,2024-02-01 14:02:00,94,95,Vestuário,5,189
45484,2024-02-01 14:03:00,29,11,Vestuário,7,40
45485,2024-02-01 14:04:00,98,39,Vestuário,2,137
45486,2024-02-01 14:05:00,56,30,Brinquedo,2,86
45487,2024-02-01 14:06:00,49,28,Alimento,2,77
45488,2024-02-01 14:07:00,87,179,Eletrônico,8,266
45489,2024-02-01 14:08:00,21,49,Móvel,6,70
45490,2024-02-01 14:09:00,13,44,Móvel,2,57
45491,2024-02-01 14:10:00,111,42,Brinquedo,5,153
45492,2024-02-01 14:11:00,23,138,Vestuário,9,161
45493,2024-02-01 14:12:00,102,15,Brinquedo,9,117
45494,2024-02-01 14:13:00,80,136,Vestuário,6,216
45495,2024-02-01 14:14:00,37,65,Vestuário,7,102
45496,2024-02-01 14:15:00,56,40,Móvel,1,96
45497,2024-02-01 14:16:00,76,88,Brinquedo,3,164
45498,2024-02-01 14:17:00,72,65,Alimento,6,137
45499,2024-02-01 14:18:00,53,114,Brinquedo,1,167
45500,2024-02-01 14:19:00,13,142,Alimento,1,155
45501,2024-02-01 14:20:00,38,72,Móvel,7,110
45502,2024-02-01 14:21:00,47,17,Brinquedo,2,64
45503,2024-02-01 14:22:00,61,95,Móvel,7,156
45504,2024-02-01 14:23:00,96,69,Móvel,9,165
45505,2024-02-01 14:24:00,65,154,Móvel,4,219
45506,2024-02-01 14:25:00,109,99,Brinquedo,3,208
45507,2024-02-01 14:26:00,14,19,Eletrônico,7,33
45508,2024-02-01 14:27:00,79,162,Alimento,9,241
45509,2024-02-01 14:28:00,30,117,Alimento,2,147
45510,2024-02-01 14:29:00,77,129,Brinquedo,9,206
45511,2024-02-01 14:30:00,61,36,Alimento,4,97
45512,2024-02-01 14:31:00,12,24,Móvel,7,36
45513,2024-02-01 14:32:00,115,121,Móvel,4,236
45514,2024-02-01 14:33:00,60,92,Alimento,3,152
45515,2024-02-01 14:34:00,77,134,Eletrônico,1,211
45516,2024-02-01 14:35:00,98,32,Eletrônico,5,130
45517,2024-02-01 14:36:00,24,161,Móvel,1,185
45518,2024-02-01 14:37:00,58,13,Eletrônico,6,71
45519,2024-02-01 14:38:00,40,121,Vestuário,7,161
45520,2024-02-01 14:39:00,77,115,Alimento,3,192
45521,2024-02-01 14:40:00,14,73,Alimento,4,87
45522,2024-02-01 14:41:00,29,33,Eletrônico,8,62
45523,2024-02-01 14:42:00,77,35,Móvel,6,112
45524,2024-02-01 14:43:00,97,27,Brinquedo,8,124
45525,2024-02-01 14:44:00,99,131,Vestuário,9,230
45526,2024-02-01 14:45:00,91,158,Eletrônico,9,249
45527,2024-02-01 14:46:00,80,119,Móvel,2,199
45528,2024-02-01 14:47:00,117,167,Vestuário,2,284
45529,2024-02-01 14:48:00,78,151,Eletrônico,7,229
45530,2024-02-01 14:49:00,61,144,Brinquedo,8,205
45531,2024-02-01 14:50:00,57,90,Vestuário,9,147
45532,2024-02-01 14:51:00,36,77,Móvel,9,113
45533,2024-02-01 14:52:00,106,55,Vestuário,1,161
45534,2024-02-01 14:53:00,57,70,Eletrônico,7,127
45535,2024-02-01 14:54:00,20,51,Móvel,2,71
45536,2024-02-01 14:55:00,104,51,Alimento,6,155
45537,2024-02-01 14:56:00,88,127,Vestuário,3,215
45538,2024-02-01 14:57:00,90,79,Alimento,1,169
45539,2024-02-01 14:58:00,38,106,Alimento,5,144
45540,2024-02-01 14:59:00,104,53,Brinquedo,4,157
45541,2024-02-01 15:00:00,66,159,Móvel,2,225
45542,2024-02-01 15:01:00,107,135,Brinquedo,5,242
45543,2024-02-01 15:02:00,47,41,Eletrônico,8,88
45544,2024-02-01 15:03:00,86,42,Brinquedo,8,128
45545,2024-02-01 15:04:00,51,122,Vestuário,8,173
45546,2024-02-01 15:05:00,40,114,Eletrônico,5,154
45547,2024-02-01 15:06:00,22,162,Vestuário,6,184
45548,2024-02-01 15:07:00,112,130,Alimento,7,242
45549,2024-02-01 15:08:00,42,128,Eletrônico,1,170
45550,2024-02-01 15:09:00,89,90,Brinquedo,9,179
45551,2024-02-01 15:10:00,110,29,Eletrônico,4,139
45552,2024-02-01 15:11:00,106,30,Eletrônico,4,136
45553,2024-02-01 15:12:00,84,138,Brinquedo,6,222
45554,2024-02-01 15:13:00,35,37,Eletrônico,6,72
45555,2024-02-01 15:14:00,54,115,Alimento,2,169
45556,2024-02-01 15:15:00,59,61,Brinquedo,6,120
45557,2024-02-01 15:16:00,101,150,Vestuário,1,251
45558,2024-02-01 15:17:00,72,39,Eletrônico,9,111
45559,2024-02-01 15:18:00,65,40,Alimento,9,105
45560,2024-02-01 15:19:00,19,93,Eletrônico,6,112
45561,2024-02-01 15:20:00,92,85,Eletrônico,6,177
45562,2024-02-01 15:21:00,83,65,Vestuário,3,148
45563,2024-02-01 15:22:00,75,38,Vestuário,6,113
45564,2024-02-01 15:23:00,15,128,Vestuário,6,143
45565,2024-02-01 15:24:00,12,76,Vestuário,1,88
45566,2024-02-01 15:25:00,76,52,Vestuário,1,128
45567,2024-02-01 15:26:00,55,85,Móvel,4,140
45568,2024-02-01 15:27:00,10,80,Móvel,6,90
45569,2024-02-01 15:28:00,101,36,Alimento,7,137
45570,2024-02-01 15:29:00,113,29,Alimento,5,142
45571,2024-02-01 15:30:00,10,100,Vestuário,7,110
45572,2024-02-01 15:31:00,63,25,Alimento,7,88
45573,2024-02-01 15:32:00,94,69,Móvel,7,163
45574,2024-02-01 15:33:00,42,22,Brinquedo,5,64
45575,2024-02-01 15:34:00,95,117,Móvel,9,212
45576,2024-02-01 15:35:00,97,33,Alimento,6,130
45577,2024-02-01 15:36:00,110,177,Eletrônico,2,287
45578,2024-02-01 15:37:00,53,114,Móvel,1,167
45579,2024-02-01 15:38:00,44,99,Alimento,1,143
45580,2024-02-01 15:39:00,111,105,Eletrônico,3,216
45581,2024-02-01 15:40:00,38,142,Vestuário,5,180
45582,2024-02-01 15:41:00,65,10,Vestuário,5,75
45583,2024-02-01 15:42:00,35,150,Alimento,9,185
45584,2024-02-01 15:43:00,94,44,Móvel,6,138
45585,2024-02-01 15:44:00,86,60,Brinquedo,1,146
45586,2024-02-01 15:45:00,58,154,Brinquedo,7,212
45587,2024-02-01 15:46:00,104,134,Alimento,5,238
45588,2024-02-01 15:47:00,33,117,Brinquedo,2,150
45589,2024-02-01 15:48:00,43,80,Eletrônico,9,123
45590,2024-02-01 15:49:00,107,91,Alimento,3,198
45591,2024-02-01 15:50:00,90,31,Brinquedo,4,121
45592,2024-02-01 15:51:00,58,32,Móvel,2,90
45593,2024-02-01 15:52:00,21,158,Eletrônico,1,179
45594,2024-02-01 15:53:00,39,175,Alimento,9,214
45595,2024-02-01 15:54:00,39,69,Móvel,1,108
45596,2024-02-01 15:55:00,34,96,Móvel,6,130
45597,2024-02-01 15:56:00,41,128,Eletrônico,1,169
45598,2024-02-01 15:57:00,99,134,Alimento,4,233
45599,2024-02-01 15:58:00,81,82,Eletrônico,8,163
45600,2024-02-01 15:59:00,30,88,Alimento,5,118
45601,2024-02-01 16:00:00,51,31,Brinquedo,9,82
45602,2024-02-01 16:01:00,10,45,Brinquedo,7,55
45603,2024-02-01 16:02:00,72,88,Móvel,6,160
45604,2024-02-01 16:03:00,110,97,Vestuário,3,207
45605,2024-02-01 16:04:00,20,49,Eletrônico,5,69
45606,2024-02-01 16:05:00,98,173,Móvel,1,271
45607,2024-02-01 16:06:00,57,120,Brinquedo,3,177
45608,2024-02-01 16:07:00,29,37,Eletrônico,2,66
45609,2024-02-01 16:08:00,54,70,Brinquedo,1,124
45610,2024-02-01 16:09:00,68,141,Vestuário,7,209
45611,2024-02-01 16:10:00,64,131,Eletrônico,9,195
45612,2024-02-01 16:11:00,77,170,Brinquedo,9,247
45613,2024-02-01 16:12:00,58,169,Móvel,2,227
45614,2024-02-01 16:13:00,91,89,Alimento,4,180
45615,2024-02-01 16:14:00,52,108,Eletrônico,9,160
45616,2024-02-01 16:15:00,96,14,Vestuário,8,110
45617,2024-02-01 16:16:00,87,67,Eletrônico,7,154
45618,2024-02-01 16:17:00,86,105,Vestuário,9,191
45619,2024-02-01 16:18:00,19,143,Alimento,2,162
45620,2024-02-01 16:19:00,78,119,Eletrônico,7,197
45621,2024-02-01 16:20:00,60,130,Vestuário,7,190
45622,2024-02-01 16:21:00,13,28,Alimento,1,41
45623,2024-02-01 16:22:00,77,28,Eletrônico,6,105
45624,2024-02-01 16:23:00,100,42,Alimento,7,142
45625,2024-02-01 16:24:00,38,95,Brinquedo,4,133
45626,2024-02-01 16:25:00,80,54,Vestuário,5,134
45627,2024-02-01 16:26:00,71,60,Vestuário,1,131
45628,2024-02-01 16:27:00,21,175,Vestuário,9,196
45629,2024-02-01 16:28:00,89,136,Vestuário,3,225
45630,2024-02-01 16:29:00,63,88,Brinquedo,5,151
45631,2024-02-01 16:30:00,50,44,Eletrônico,2,94
45632,2024-02-01 16:31:00,92,93,Móvel,8,185
45633,2024-02-01 16:32:00,71,49,Brinquedo,4,120
45634,2024-02-01 16:33:00,81,67,Eletrônico,7,148
45635,2024-02-01 16:34:00,102,65,Vestuário,7,167
45636,2024-02-01 16:35:00,57,62,Alimento,9,119
45637,2024-02-01 16:36:00,96,18,Eletrônico,6,114
45638,2024-02-01 16:37:00,102,56,Alimento,8,158
45639,2024-02-01 16:38:00,43,171,Móvel,7,214
45640,2024-02-01 16:39:00,12,29,Brinquedo,7,41
45641,2024-02-01 16:40:00,16,142,Eletrônico,7,158
45642,2024-02-01 16:41:00,70,110,Brinquedo,3,180
45643,2024-02-01 16:42:00,96,39,Brinquedo,6,135
45644,2024-02-01 16:43:00,119,134,Eletrônico,1,253
45645,2024-02-01 16:44:00,118,145,Brinquedo,1,263
45646,2024-02-01 16:45:00,13,90,Alimento,4,103
45647,2024-02-01 16:46:00,100,147,Eletrônico,7,247
45648,2024-02-01 16:47:00,37,138,Vestuário,5,175
45649,2024-02-01 16:48:00,48,103,Eletrônico,6,151
45650,2024-02-01 16:49:00,105,60,Alimento,4,165
45651,2024-02-01 16:50:00,56,140,Vestuário,5,196
45652,2024-02-01 16:51:00,17,121,Vestuário,9,138
45653,2024-02-01 16:52:00,113,29,Eletrônico,7,142
45654,2024-02-01 16:53:00,79,120,Brinquedo,6,199
45655,2024-02-01 16:54:00,59,95,Móvel,7,154
45656,2024-02-01 16:55:00,95,52,Vestuário,5,147
45657,2024-02-01 16:56:00,76,140,Vestuário,1,216
45658,2024-02-01 16:57:00,96,80,Vestuário,2,176
45659,2024-02-01 16:58:00,38,149,Alimento,7,187
45660,2024-02-01 16:59:00,58,74,Móvel,7,132
45661,2024-02-01 17:00:00,17,91,Alimento,2,108
45662,2024-02-01 17:01:00,74,124,Vestuário,4,198
45663,2024-02-01 17:02:00,17,85,Eletrônico,2,102
45664,2024-02-01 17:03:00,60,20,Brinquedo,6,80
45665,2024-02-01 17:04:00,17,77,Eletrônico,1,94
45666,2024-02-01 17:05:00,53,35,Eletrônico,6,88
45667,2024-02-01 17:06:00,59,24,Brinquedo,6,83
45668,2024-02-01 17:07:00,38,176,Brinquedo,4,214
45669,2024-02-01 17:08:00,112,50,Eletrônico,3,162
45670,2024-02-01 17:09:00,13,152,Vestuário,7,165
45671,2024-02-01 17:10:00,43,16,Móvel,1,59
45672,2024-02-01 17:11:00,62,77,Eletrônico,2,139
45673,2024-02-01 17:12:00,11,130,Vestuário,3,141
45674,2024-02-01 17:13:00,18,97,Brinquedo,8,115
45675,2024-02-01 17:14:00,38,33,Alimento,9,71
45676,2024-02-01 17:15:00,105,62,Brinquedo,9,167
45677,2024-02-01 17:16:00,97,154,Eletrônico,7,251
45678,2024-02-01 17:17:00,60,51,Alimento,4,111
45679,2024-02-01 17:18:00,107,136,Brinquedo,4,243
45680,2024-02-01 17:19:00,40,119,Eletrônico,7,159
45681,2024-02-01 17:20:00,60,115,Móvel,3,175
45682,2024-02-01 17:21:00,107,88,Brinquedo,1,195
45683,2024-02-01 17:22:00,44,51,Brinquedo,8,95
45684,2024-02-01 17:23:00,78,119,Alimento,8,197
45685,2024-02-01 17:24:00,53,151,Brinquedo,8,204
45686,2024-02-01 17:25:00,55,164,Móvel,4,219
45687,2024-02-01 17:26:00,41,33,Brinquedo,4,74
45688,2024-02-01 17:27:00,23,143,Eletrônico,8,166
45689,2024-02-01 17:28:00,35,94,Vestuário,2,129
45690,2024-02-01 17:29:00,39,114,Móvel,5,153
45691,2024-02-01 17:30:00,108,34,Brinquedo,4,142
45692,2024-02-01 17:31:00,80,101,Eletrônico,8,181
45693,2024-02-01 17:32:00,54,129,Vestuário,7,183
45694,2024-02-01 17:33:00,107,115,Brinquedo,9,222
45695,2024-02-01 17:34:00,94,119,Vestuário,1,213
45696,2024-02-01 17:35:00,85,100,Eletrônico,9,185
45697,2024-02-01 17:36:00,58,98,Vestuário,3,156
45698,2024-02-01 17:37:00,17,147,Brinquedo,3,164
45699,2024-02-01 17:38:00,30,21,Vestuário,5,51
45700,2024-02-01 17:39:00,115,48,Móvel,4,163
45701,2024-02-01 17:40:00,41,56,Alimento,6,97
45702,2024-02-01 17:41:00,110,41,Móvel,4,151
45703,2024-02-01 17:42:00,56,63,Vestuário,9,119
45704,2024-02-01 17:43:00,45,46,Eletrônico,3,91
45705,2024-02-01 17:44:00,61,60,Móvel,4,121
45706,2024-02-01 17:45:00,28,115,Brinquedo,2,143
45707,2024-02-01 17:46:00,55,19,Eletrônico,2,74
45708,2024-02-01 17:47:00,63,73,Alimento,6,136
45709,2024-02-01 17:48:00,62,176,Brinquedo,4,238
45710,2024-02-01 17:49:00,95,15,Eletrônico,2,110
45711,2024-02-01 17:50:00,74,135,Móvel,4,209
45712,2024-02-01 17:51:00,116,25,Vestuário,6,141
45713,2024-02-01 17:52:00,52,130,Eletrônico,1,182
45714,2024-02-01 17:53:00,52,78,Eletrônico,2,130
45715,2024-02-01 17:54:00,74,61,Móvel,1,135
45716,2024-02-01 17:55:00,64,161,Alimento,7,225
45717,2024-02-01 17:56:00,70,171,Alimento,8,241
45718,2024-02-01 17:57:00,29,155,Brinquedo,7,184
45719,2024-02-01 17:58:00,39,140,Alimento,6,179
45720,2024-02-01 17:59:00,52,133,Alimento,1,185
45721,2024-02-01 18:00:00,54,100,Brinquedo,1,154
45722,2024-02-01 18:01:00,45,135,Vestuário,9,180
45723,2024-02-01 18:02:00,17,162,Eletrônico,1,179
45724,2024-02-01 18:03:00,24,74,Alimento,2,98
45725,2024-02-01 18:04:00,26,171,Eletrônico,5,197
45726,2024-02-01 18:05:00,29,102,Vestuário,8,131
45727,2024-02-01 18:06:00,24,31,Móvel,4,55
45728,2024-02-01 18:07:00,69,42,Móvel,5,111
45729,2024-02-01 18:08:00,86,96,Alimento,5,182
45730,2024-02-01 18:09:00,15,33,Eletrônico,3,48
45731,2024-02-01 18:10:00,104,75,Móvel,2,179
45732,2024-02-01 18:11:00,34,81,Vestuário,2,115
45733,2024-02-01 18:12:00,66,115,Brinquedo,7,181
45734,2024-02-01 18:13:00,108,167,Móvel,2,275
45735,2024-02-01 18:14:00,113,124,Brinquedo,5,237
45736,2024-02-01 18:15:00,87,154,Móvel,3,241
45737,2024-02-01 18:16:00,58,118,Vestuário,1,176
45738,2024-02-01 18:17:00,11,15,Móvel,8,26
45739,2024-02-01 18:18:00,65,78,Móvel,1,143
45740,2024-02-01 18:19:00,69,99,Móvel,3,168
45741,2024-02-01 18:20:00,24,129,Eletrônico,3,153
45742,2024-02-01 18:21:00,116,40,Eletrônico,1,156
45743,2024-02-01 18:22:00,78,174,Móvel,3,252
45744,2024-02-01 18:23:00,65,28,Eletrônico,8,93
45745,2024-02-01 18:24:00,74,48,Alimento,1,122
45746,2024-02-01 18:25:00,103,114,Brinquedo,3,217
45747,2024-02-01 18:26:00,21,61,Alimento,7,82
45748,2024-02-01 18:27:00,61,95,Brinquedo,1,156
45749,2024-02-01 18:28:00,48,77,Eletrônico,9,125
45750,2024-02-01 18:29:00,36,22,Alimento,6,58
45751,2024-02-01 18:30:00,76,94,Vestuário,5,170
45752,2024-02-01 18:31:00,100,25,Alimento,8,125
45753,2024-02-01 18:32:00,26,125,Alimento,6,151
45754,2024-02-01 18:33:00,70,65,Alimento,4,135
45755,2024-02-01 18:34:00,117,159,Alimento,1,276
45756,2024-02-01 18:35:00,109,101,Vestuário,6,210
45757,2024-02-01 18:36:00,44,163,Alimento,8,207
45758,2024-02-01 18:37:00,105,106,Móvel,2,211
45759,2024-02-01 18:38:00,118,149,Vestuário,3,267
45760,2024-02-01 18:39:00,44,88,Eletrônico,3,132
45761,2024-02-01 18:40:00,70,54,Eletrônico,8,124
45762,2024-02-01 18:41:00,87,161,Vestuário,1,248
45763,2024-02-01 18:42:00,71,31,Móvel,5,102
45764,2024-02-01 18:43:00,114,13,Brinquedo,9,127
45765,2024-02-01 18:44:00,71,46,Móvel,9,117
45766,2024-02-01 18:45:00,42,74,Vestuário,4,116
45767,2024-02-01 18:46:00,64,25,Móvel,5,89
45768,2024-02-01 18:47:00,32,55,Eletrônico,3,87
45769,2024-02-01 18:48:00,51,70,Eletrônico,7,121
45770,2024-02-01 18:49:00,97,86,Alimento,3,183
45771,2024-02-01 18:50:00,66,66,Alimento,2,132
45772,2024-02-01 18:51:00,81,154,Móvel,6,235
45773,2024-02-01 18:52:00,109,151,Eletrônico,5,260
45774,2024-02-01 18:53:00,75,169,Móvel,6,244
45775,2024-02-01 18:54:00,39,136,Eletrônico,4,175
45776,2024-02-01 18:55:00,97,74,Brinquedo,2,171
45777,2024-02-01 18:56:00,24,137,Eletrônico,6,161
45778,2024-02-01 18:57:00,42,154,Brinquedo,4,196
45779,2024-02-01 18:58:00,106,144,Móvel,4,250
45780,2024-02-01 18:59:00,27,71,Brinquedo,6,98
45781,2024-02-01 19:00:00,23,59,Móvel,4,82
45782,2024-02-01 19:01:00,69,101,Móvel,4,170
45783,2024-02-01 19:02:00,69,174,Móvel,8,243
45784,2024-02-01 19:03:00,62,73,Eletrônico,3,135
45785,2024-02-01 19:04:00,44,123,Brinquedo,6,167
45786,2024-02-01 19:05:00,12,88,Alimento,3,100
45787,2024-02-01 19:06:00,46,84,Móvel,1,130
45788,2024-02-01 19:07:00,19,17,Brinquedo,6,36
45789,2024-02-01 19:08:00,104,49,Vestuário,1,153
45790,2024-02-01 19:09:00,48,10,Vestuário,5,58
45791,2024-02-01 19:10:00,59,175,Vestuário,5,234
45792,2024-02-01 19:11:00,60,83,Brinquedo,3,143
45793,2024-02-01 19:12:00,55,48,Móvel,4,103
45794,2024-02-01 19:13:00,48,128,Alimento,9,176
45795,2024-02-01 19:14:00,12,66,Vestuário,1,78
45796,2024-02-01 19:15:00,63,168,Móvel,2,231
45797,2024-02-01 19:16:00,26,61,Eletrônico,2,87
45798,2024-02-01 19:17:00,55,30,Brinquedo,5,85
45799,2024-02-01 19:18:00,93,29,Vestuário,6,122
45800,2024-02-01 19:19:00,44,164,Eletrônico,9,208
45801,2024-02-01 19:20:00,18,93,Eletrônico,6,111
45802,2024-02-01 19:21:00,98,73,Móvel,6,171
45803,2024-02-01 19:22:00,113,105,Alimento,2,218
45804,2024-02-01 19:23:00,31,49,Alimento,1,80
45805,2024-02-01 19:24:00,94,99,Brinquedo,6,193
45806,2024-02-01 19:25:00,65,142,Brinquedo,2,207
45807,2024-02-01 19:26:00,117,54,Vestuário,8,171
45808,2024-02-01 19:27:00,47,78,Brinquedo,4,125
45809,2024-02-01 19:28:00,13,37,Móvel,8,50
45810,2024-02-01 19:29:00,82,31,Brinquedo,5,113
45811,2024-02-01 19:30:00,66,71,Vestuário,9,137
45812,2024-02-01 19:31:00,61,96,Alimento,6,157
45813,2024-02-01 19:32:00,105,108,Vestuário,5,213
45814,2024-02-01 19:33:00,91,75,Eletrônico,5,166
45815,2024-02-01 19:34:00,118,44,Brinquedo,7,162
45816,2024-02-01 19:35:00,46,143,Alimento,7,189
45817,2024-02-01 19:36:00,30,121,Alimento,6,151
45818,2024-02-01 19:37:00,36,41,Brinquedo,6,77
45819,2024-02-01 19:38:00,97,106,Vestuário,2,203
45820,2024-02-01 19:39:00,24,69,Alimento,9,93
45821,2024-02-01 19:40:00,118,74,Móvel,1,192
45822,2024-02-01 19:41:00,105,89,Alimento,2,194
45823,2024-02-01 19:42:00,63,95,Móvel,8,158
45824,2024-02-01 19:43:00,13,147,Vestuário,7,160
45825,2024-02-01 19:44:00,81,141,Eletrônico,2,222
45826,2024-02-01 19:45:00,38,26,Alimento,9,64
45827,2024-02-01 19:46:00,74,162,Móvel,1,236
45828,2024-02-01 19:47:00,115,53,Alimento,7,168
45829,2024-02-01 19:48:00,54,163,Móvel,6,217
45830,2024-02-01 19:49:00,100,52,Eletrônico,1,152
45831,2024-02-01 19:50:00,116,141,Brinquedo,3,257
45832,2024-02-01 19:51:00,40,79,Alimento,3,119
45833,2024-02-01 19:52:00,106,139,Eletrônico,2,245
45834,2024-02-01 19:53:00,118,97,Móvel,3,215
45835,2024-02-01 19:54:00,18,128,Brinquedo,3,146
45836,2024-02-01 19:55:00,36,146,Brinquedo,6,182
45837,2024-02-01 19:56:00,24,92,Vestuário,8,116
45838,2024-02-01 19:57:00,82,120,Eletrônico,1,202
45839,2024-02-01 19:58:00,20,106,Eletrônico,9,126
45840,2024-02-01 19:59:00,84,40,Móvel,8,124
45841,2024-02-01 20:00:00,17,131,Móvel,1,148
45842,2024-02-01 20:01:00,52,36,Móvel,7,88
45843,2024-02-01 20:02:00,68,177,Vestuário,5,245
45844,2024-02-01 20:03:00,82,44,Vestuário,1,126
45845,2024-02-01 20:04:00,21,165,Eletrônico,6,186
45846,2024-02-01 20:05:00,73,59,Eletrônico,9,132
45847,2024-02-01 20:06:00,10,42,Vestuário,7,52
45848,2024-02-01 20:07:00,75,126,Móvel,1,201
45849,2024-02-01 20:08:00,55,47,Alimento,5,102
45850,2024-02-01 20:09:00,90,49,Eletrônico,4,139
45851,2024-02-01 20:10:00,63,72,Móvel,2,135
45852,2024-02-01 20:11:00,112,152,Eletrônico,1,264
45853,2024-02-01 20:12:00,23,12,Móvel,6,35
45854,2024-02-01 20:13:00,35,32,Alimento,1,67
45855,2024-02-01 20:14:00,36,121,Alimento,5,157
45856,2024-02-01 20:15:00,31,65,Eletrônico,2,96
45857,2024-02-01 20:16:00,106,22,Brinquedo,3,128
45858,2024-02-01 20:17:00,41,98,Brinquedo,8,139
45859,2024-02-01 20:18:00,83,69,Móvel,6,152
45860,2024-02-01 20:19:00,18,171,Vestuário,7,189
45861,2024-02-01 20:20:00,98,37,Eletrônico,1,135
45862,2024-02-01 20:21:00,17,105,Vestuário,5,122
45863,2024-02-01 20:22:00,56,38,Móvel,5,94
45864,2024-02-01 20:23:00,106,92,Eletrônico,6,198
45865,2024-02-01 20:24:00,46,13,Eletrônico,1,59
45866,2024-02-01 20:25:00,101,37,Móvel,8,138
45867,2024-02-01 20:26:00,96,31,Eletrônico,5,127
45868,2024-02-01 20:27:00,92,162,Eletrônico,7,254
45869,2024-02-01 20:28:00,39,126,Eletrônico,4,165
45870,2024-02-01 20:29:00,42,74,Móvel,6,116
45871,2024-02-01 20:30:00,68,54,Eletrônico,9,122
45872,2024-02-01 20:31:00,37,144,Alimento,6,181
45873,2024-02-01 20:32:00,74,167,Vestuário,2,241
45874,2024-02-01 20:33:00,68,43,Brinquedo,9,111
45875,2024-02-01 20:34:00,13,127,Móvel,7,140
45876,2024-02-01 20:35:00,91,143,Eletrônico,5,234
45877,2024-02-01 20:36:00,20,124,Móvel,7,144
45878,2024-02-01 20:37:00,97,121,Brinquedo,4,218
45879,2024-02-01 20:38:00,95,129,Brinquedo,1,224
45880,2024-02-01 20:39:00,60,110,Eletrônico,7,170
45881,2024-02-01 20:40:00,106,38,Brinquedo,2,144
45882,2024-02-01 20:41:00,105,69,Brinquedo,1,174
45883,2024-02-01 20:42:00,118,162,Móvel,5,280
45884,2024-02-01 20:43:00,37,59,Alimento,4,96
45885,2024-02-01 20:44:00,77,55,Vestuário,7,132
45886,2024-02-01 20:45:00,79,45,Eletrônico,4,124
45887,2024-02-01 20:46:00,35,80,Brinquedo,9,115
45888,2024-02-01 20:47:00,37,138,Eletrônico,3,175
45889,2024-02-01 20:48:00,14,26,Eletrônico,4,40
45890,2024-02-01 20:49:00,61,48,Eletrônico,2,109
45891,2024-02-01 20:50:00,28,38,Brinquedo,9,66
45892,2024-02-01 20:51:00,52,110,Alimento,2,162
45893,2024-02-01 20:52:00,66,98,Vestuário,4,164
45894,2024-02-01 20:53:00,104,164,Eletrônico,9,268
45895,2024-02-01 20:54:00,43,10,Eletrônico,3,53
45896,2024-02-01 20:55:00,108,79,Vestuário,4,187
45897,2024-02-01 20:56:00,31,74,Alimento,7,105
45898,2024-02-01 20:57:00,35,130,Brinquedo,1,165
45899,2024-02-01 20:58:00,47,62,Móvel,7,109
45900,2024-02-01 20:59:00,70,63,Alimento,8,133
45901,2024-02-01 21:00:00,77,160,Vestuário,9,237
45902,2024-02-01 21:01:00,49,67,Vestuário,2,116
45903,2024-02-01 21:02:00,57,137,Eletrônico,4,194
45904,2024-02-01 21:03:00,81,88,Eletrônico,9,169
45905,2024-02-01 21:04:00,13,92,Brinquedo,4,105
45906,2024-02-01 21:05:00,20,34,Móvel,6,54
45907,2024-02-01 21:06:00,22,35,Eletrônico,5,57
45908,2024-02-01 21:07:00,116,73,Vestuário,5,189
45909,2024-02-01 21:08:00,99,22,Alimento,8,121
45910,2024-02-01 21:09:00,69,95,Alimento,7,164
45911,2024-02-01 21:10:00,17,33,Vestuário,3,50
45912,2024-02-01 21:11:00,100,49,Brinquedo,7,149
45913,2024-02-01 21:12:00,64,56,Eletrônico,5,120
45914,2024-02-01 21:13:00,54,106,Móvel,6,160
45915,2024-02-01 21:14:00,81,43,Vestuário,6,124
45916,2024-02-01 21:15:00,108,11,Alimento,9,119
45917,2024-02-01 21:16:00,49,161,Brinquedo,1,210
45918,2024-02-01 21:17:00,90,108,Móvel,9,198
45919,2024-02-01 21:18:00,49,145,Brinquedo,3,194
45920,2024-02-01 21:19:00,60,91,Móvel,1,151
45921,2024-02-01 21:20:00,76,101,Móvel,7,177
45922,2024-02-01 21:21:00,20,100,Vestuário,1,120
45923,2024-02-01 21:22:00,48,47,Alimento,6,95
45924,2024-02-01 21:23:00,100,144,Vestuário,6,244
45925,2024-02-01 21:24:00,36,137,Vestuário,3,173
45926,2024-02-01 21:25:00,11,30,Móvel,6,41
45927,2024-02-01 21:26:00,100,73,Eletrônico,2,173
45928,2024-02-01 21:27:00,30,93,Brinquedo,8,123
45929,2024-02-01 21:28:00,84,154,Alimento,1,238
45930,2024-02-01 21:29:00,28,88,Vestuário,1,116
45931,2024-02-01 21:30:00,117,90,Eletrônico,4,207
45932,2024-02-01 21:31:00,114,147,Alimento,7,261
45933,2024-02-01 21:32:00,73,90,Eletrônico,8,163
45934,2024-02-01 21:33:00,40,160,Brinquedo,2,200
45935,2024-02-01 21:34:00,69,160,Eletrônico,4,229
45936,2024-02-01 21:35:00,58,29,Brinquedo,6,87
45937,2024-02-01 21:36:00,100,28,Eletrônico,1,128
45938,2024-02-01 21:37:00,37,53,Móvel,5,90
45939,2024-02-01 21:38:00,67,29,Alimento,5,96
45940,2024-02-01 21:39:00,65,34,Brinquedo,3,99
45941,2024-02-01 21:40:00,105,70,Brinquedo,3,175
45942,2024-02-01 21:41:00,110,24,Alimento,2,134
45943,2024-02-01 21:42:00,102,81,Vestuário,1,183
45944,2024-02-01 21:43:00,88,68,Móvel,7,156
45945,2024-02-01 21:44:00,114,16,Alimento,2,130
45946,2024-02-01 21:45:00,57,55,Móvel,6,112
45947,2024-02-01 21:46:00,58,18,Móvel,1,76
45948,2024-02-01 21:47:00,22,19,Móvel,8,41
45949,2024-02-01 21:48:00,48,22,Brinquedo,2,70
45950,2024-02-01 21:49:00,108,133,Alimento,5,241
45951,2024-02-01 21:50:00,107,82,Eletrônico,6,189
45952,2024-02-01 21:51:00,51,55,Vestuário,5,106
45953,2024-02-01 21:52:00,102,145,Eletrônico,5,247
45954,2024-02-01 21:53:00,78,109,Brinquedo,1,187
45955,2024-02-01 21:54:00,38,134,Móvel,3,172
45956,2024-02-01 21:55:00,12,41,Alimento,9,53
45957,2024-02-01 21:56:00,62,39,Vestuário,9,101
45958,2024-02-01 21:57:00,24,169,Brinquedo,7,193
45959,2024-02-01 21:58:00,109,19,Brinquedo,3,128
45960,2024-02-01 21:59:00,51,41,Brinquedo,7,92
45961,2024-02-01 22:00:00,34,155,Brinquedo,9,189
45962,2024-02-01 22:01:00,114,112,Móvel,8,226
45963,2024-02-01 22:02:00,74,76,Móvel,4,150
45964,2024-02-01 22:03:00,61,37,Eletrônico,4,98
45965,2024-02-01 22:04:00,58,134,Brinquedo,9,192
45966,2024-02-01 22:05:00,12,86,Vestuário,5,98
45967,2024-02-01 22:06:00,81,91,Eletrônico,9,172
45968,2024-02-01 22:07:00,72,161,Vestuário,5,233
45969,2024-02-01 22:08:00,27,115,Móvel,1,142
45970,2024-02-01 22:09:00,113,126,Alimento,3,239
45971,2024-02-01 22:10:00,29,87,Brinquedo,6,116
45972,2024-02-01 22:11:00,75,64,Móvel,7,139
45973,2024-02-01 22:12:00,108,145,Eletrônico,1,253
45974,2024-02-01 22:13:00,87,44,Eletrônico,4,131
45975,2024-02-01 22:14:00,54,43,Alimento,5,97
45976,2024-02-01 22:15:00,86,173,Vestuário,8,259
45977,2024-02-01 22:16:00,52,113,Móvel,8,165
45978,2024-02-01 22:17:00,55,171,Brinquedo,5,226
45979,2024-02-01 22:18:00,83,147,Vestuário,2,230
45980,2024-02-01 22:19:00,83,32,Alimento,3,115
45981,2024-02-01 22:20:00,43,96,Eletrônico,3,139
45982,2024-02-01 22:21:00,32,159,Vestuário,9,191
45983,2024-02-01 22:22:00,79,52,Móvel,6,131
45984,2024-02-01 22:23:00,97,24,Eletrônico,8,121
45985,2024-02-01 22:24:00,86,173,Vestuário,3,259
45986,2024-02-01 22:25:00,28,135,Móvel,6,163
45987,2024-02-01 22:26:00,25,23,Móvel,1,48
45988,2024-02-01 22:27:00,61,84,Móvel,8,145
45989,2024-02-01 22:28:00,68,66,Alimento,6,134
45990,2024-02-01 22:29:00,91,166,Eletrônico,3,257
45991,2024-02-01 22:30:00,82,146,Vestuário,6,228
45992,2024-02-01 22:31:00,83,60,Móvel,4,143
45993,2024-02-01 22:32:00,36,144,Alimento,6,180
45994,2024-02-01 22:33:00,87,37,Alimento,9,124
45995,2024-02-01 22:34:00,35,62,Brinquedo,5,97
45996,2024-02-01 22:35:00,87,159,Eletrônico,8,246
45997,2024-02-01 22:36:00,64,92,Eletrônico,4,156
45998,2024-02-01 22:37:00,31,154,Vestuário,2,185
45999,2024-02-01 22:38:00,80,146,Eletrônico,7,226
46000,2024-02-01 22:39:00,85,49,Móvel,7,134
46001,2024-02-01 22:40:00,82,122,Eletrônico,5,204
46002,2024-02-01 22:41:00,94,114,Eletrônico,5,208
46003,2024-02-01 22:42:00,26,132,Vestuário,4,158
46004,2024-02-01 22:43:00,72,124,Vestuário,8,196
46005,2024-02-01 22:44:00,76,179,Alimento,1,255
46006,2024-02-01 22:45:00,92,20,Móvel,6,112
46007,2024-02-01 22:46:00,69,179,Eletrônico,9,248
46008,2024-02-01 22:47:00,28,135,Alimento,8,163
46009,2024-02-01 22:48:00,68,18,Brinquedo,3,86
46010,2024-02-01 22:49:00,72,16,Brinquedo,4,88
46011,2024-02-01 22:50:00,80,19,Brinquedo,6,99
46012,2024-02-01 22:51:00,90,144,Móvel,2,234
46013,2024-02-01 22:52:00,73,56,Brinquedo,8,129
46014,2024-02-01 22:53:00,19,139,Eletrônico,6,158
46015,2024-02-01 22:54:00,57,150,Alimento,6,207
46016,2024-02-01 22:55:00,29,89,Eletrônico,1,118
46017,2024-02-01 22:56:00,13,109,Vestuário,8,122
46018,2024-02-01 22:57:00,62,112,Brinquedo,4,174
46019,2024-02-01 22:58:00,50,64,Alimento,9,114
46020,2024-02-01 22:59:00,10,85,Alimento,9,95
46021,2024-02-01 23:00:00,29,162,Eletrônico,1,191
46022,2024-02-01 23:01:00,90,142,Alimento,6,232
46023,2024-02-01 23:02:00,71,100,Eletrônico,8,171
46024,2024-02-01 23:03:00,76,31,Alimento,6,107
46025,2024-02-01 23:04:00,53,105,Alimento,2,158
46026,2024-02-01 23:05:00,54,33,Móvel,2,87
46027,2024-02-01 23:06:00,49,109,Eletrônico,2,158
46028,2024-02-01 23:07:00,89,119,Eletrônico,6,208
46029,2024-02-01 23:08:00,106,16,Móvel,2,122
46030,2024-02-01 23:09:00,70,140,Móvel,3,210
46031,2024-02-01 23:10:00,114,78,Móvel,5,192
46032,2024-02-01 23:11:00,30,125,Móvel,1,155
46033,2024-02-01 23:12:00,35,25,Brinquedo,6,60
46034,2024-02-01 23:13:00,99,43,Vestuário,2,142
46035,2024-02-01 23:14:00,114,118,Móvel,8,232
46036,2024-02-01 23:15:00,15,152,Brinquedo,1,167
46037,2024-02-01 23:16:00,55,133,Vestuário,7,188
46038,2024-02-01 23:17:00,66,43,Eletrônico,1,109
46039,2024-02-01 23:18:00,40,130,Vestuário,2,170
46040,2024-02-01 23:19:00,111,33,Vestuário,5,144
46041,2024-02-01 23:20:00,69,100,Alimento,5,169
46042,2024-02-01 23:21:00,55,80,Alimento,1,135
46043,2024-02-01 23:22:00,99,160,Vestuário,5,259
46044,2024-02-01 23:23:00,70,41,Móvel,9,111
46045,2024-02-01 23:24:00,100,63,Vestuário,3,163
46046,2024-02-01 23:25:00,115,45,Vestuário,9,160
46047,2024-02-01 23:26:00,74,149,Vestuário,3,223
46048,2024-02-01 23:27:00,66,32,Eletrônico,6,98
46049,2024-02-01 23:28:00,16,60,Eletrônico,8,76
46050,2024-02-01 23:29:00,23,90,Alimento,5,113
46051,2024-02-01 23:30:00,113,15,Eletrônico,7,128
46052,2024-02-01 23:31:00,22,33,Brinquedo,2,55
46053,2024-02-01 23:32:00,94,17,Móvel,1,111
46054,2024-02-01 23:33:00,67,60,Eletrônico,4,127
46055,2024-02-01 23:34:00,116,46,Móvel,4,162
46056,2024-02-01 23:35:00,30,98,Alimento,9,128
46057,2024-02-01 23:36:00,55,142,Brinquedo,9,197
46058,2024-02-01 23:37:00,53,160,Brinquedo,7,213
46059,2024-02-01 23:38:00,11,18,Brinquedo,8,29
46060,2024-02-01 23:39:00,70,58,Móvel,2,128
46061,2024-02-01 23:40:00,64,32,Vestuário,2,96
46062,2024-02-01 23:41:00,62,26,Móvel,8,88
46063,2024-02-01 23:42:00,24,158,Eletrônico,5,182
46064,2024-02-01 23:43:00,21,99,Móvel,4,120
46065,2024-02-01 23:44:00,19,170,Eletrônico,4,189
46066,2024-02-01 23:45:00,65,103,Alimento,7,168
46067,2024-02-01 23:46:00,91,147,Vestuário,2,238
46068,2024-02-01 23:47:00,103,163,Brinquedo,3,266
46069,2024-02-01 23:48:00,40,25,Brinquedo,1,65
46070,2024-02-01 23:49:00,14,51,Alimento,2,65
46071,2024-02-01 23:50:00,77,176,Brinquedo,3,253
46072,2024-02-01 23:51:00,91,54,Brinquedo,9,145
46073,2024-02-01 23:52:00,49,25,Vestuário,6,74
46074,2024-02-01 23:53:00,20,177,Vestuário,9,197
46075,2024-02-01 23:54:00,99,130,Eletrônico,9,229
46076,2024-02-01 23:55:00,93,124,Brinquedo,8,217
46077,2024-02-01 23:56:00,107,38,Móvel,4,145
46078,2024-02-01 23:57:00,103,15,Brinquedo,2,118
46079,2024-02-01 23:58:00,78,131,Móvel,2,209
46080,2024-02-01 23:59:00,67,87,Eletrônico,7,154
46081,2024-02-02 00:00:00,96,178,Alimento,2,274
46082,2024-02-02 00:01:00,103,68,Eletrônico,9,171
46083,2024-02-02 00:02:00,54,142,Brinquedo,1,196
46084,2024-02-02 00:03:00,112,96,Brinquedo,8,208
46085,2024-02-02 00:04:00,80,63,Alimento,5,143
46086,2024-02-02 00:05:00,89,114,Alimento,5,203
46087,2024-02-02 00:06:00,89,167,Eletrônico,5,256
46088,2024-02-02 00:07:00,10,146,Alimento,2,156
46089,2024-02-02 00:08:00,13,156,Alimento,7,169
46090,2024-02-02 00:09:00,102,34,Vestuário,6,136
46091,2024-02-02 00:10:00,42,148,Móvel,3,190
46092,2024-02-02 00:11:00,31,144,Eletrônico,5,175
46093,2024-02-02 00:12:00,93,119,Móvel,7,212
46094,2024-02-02 00:13:00,25,30,Brinquedo,4,55
46095,2024-02-02 00:14:00,38,10,Brinquedo,8,48
46096,2024-02-02 00:15:00,103,92,Brinquedo,1,195
46097,2024-02-02 00:16:00,83,123,Móvel,5,206
46098,2024-02-02 00:17:00,98,70,Brinquedo,4,168
46099,2024-02-02 00:18:00,60,78,Móvel,2,138
46100,2024-02-02 00:19:00,93,100,Vestuário,9,193
46101,2024-02-02 00:20:00,69,22,Eletrônico,6,91
46102,2024-02-02 00:21:00,104,133,Eletrônico,3,237
46103,2024-02-02 00:22:00,30,102,Móvel,9,132
46104,2024-02-02 00:23:00,27,18,Alimento,5,45
46105,2024-02-02 00:24:00,21,108,Móvel,1,129
46106,2024-02-02 00:25:00,65,40,Brinquedo,6,105
46107,2024-02-02 00:26:00,89,160,Eletrônico,9,249
46108,2024-02-02 00:27:00,102,30,Eletrônico,6,132
46109,2024-02-02 00:28:00,110,60,Eletrônico,6,170
46110,2024-02-02 00:29:00,107,122,Eletrônico,1,229
46111,2024-02-02 00:30:00,116,32,Eletrônico,7,148
46112,2024-02-02 00:31:00,10,104,Alimento,1,114
46113,2024-02-02 00:32:00,99,58,Móvel,7,157
46114,2024-02-02 00:33:00,71,84,Vestuário,1,155
46115,2024-02-02 00:34:00,10,67,Alimento,6,77
46116,2024-02-02 00:35:00,93,130,Móvel,5,223
46117,2024-02-02 00:36:00,113,47,Eletrônico,3,160
46118,2024-02-02 00:37:00,79,95,Móvel,1,174
46119,2024-02-02 00:38:00,36,149,Eletrônico,2,185
46120,2024-02-02 00:39:00,117,18,Vestuário,1,135
46121,2024-02-02 00:40:00,76,48,Eletrônico,4,124
46122,2024-02-02 00:41:00,100,118,Brinquedo,2,218
46123,2024-02-02 00:42:00,117,71,Móvel,4,188
46124,2024-02-02 00:43:00,36,118,Vestuário,5,154
46125,2024-02-02 00:44:00,35,74,Alimento,7,109
46126,2024-02-02 00:45:00,108,113,Vestuário,5,221
46127,2024-02-02 00:46:00,56,169,Móvel,9,225
46128,2024-02-02 00:47:00,97,131,Alimento,8,228
46129,2024-02-02 00:48:00,66,179,Vestuário,4,245
46130,2024-02-02 00:49:00,55,154,Eletrônico,5,209
46131,2024-02-02 00:50:00,16,63,Alimento,6,79
46132,2024-02-02 00:51:00,61,39,Eletrônico,2,100
46133,2024-02-02 00:52:00,40,153,Eletrônico,5,193
46134,2024-02-02 00:53:00,81,11,Alimento,5,92
46135,2024-02-02 00:54:00,88,132,Móvel,5,220
46136,2024-02-02 00:55:00,112,47,Móvel,9,159
46137,2024-02-02 00:56:00,118,19,Eletrônico,7,137
46138,2024-02-02 00:57:00,101,55,Eletrônico,8,156
46139,2024-02-02 00:58:00,103,127,Alimento,5,230
46140,2024-02-02 00:59:00,49,22,Móvel,8,71
46141,2024-02-02 01:00:00,29,78,Alimento,1,107
46142,2024-02-02 01:01:00,49,87,Vestuário,5,136
46143,2024-02-02 01:02:00,11,89,Alimento,9,100
46144,2024-02-02 01:03:00,26,20,Alimento,2,46
46145,2024-02-02 01:04:00,70,46,Eletrônico,4,116
46146,2024-02-02 01:05:00,93,130,Alimento,9,223
46147,2024-02-02 01:06:00,110,48,Eletrônico,1,158
46148,2024-02-02 01:07:00,40,59,Vestuário,3,99
46149,2024-02-02 01:08:00,30,121,Brinquedo,9,151
46150,2024-02-02 01:09:00,67,169,Alimento,7,236
46151,2024-02-02 01:10:00,81,60,Eletrônico,9,141
46152,2024-02-02 01:11:00,15,175,Eletrônico,9,190
46153,2024-02-02 01:12:00,44,27,Móvel,7,71
46154,2024-02-02 01:13:00,59,105,Eletrônico,8,164
46155,2024-02-02 01:14:00,33,35,Brinquedo,9,68
46156,2024-02-02 01:15:00,108,164,Brinquedo,6,272
46157,2024-02-02 01:16:00,115,93,Brinquedo,9,208
46158,2024-02-02 01:17:00,52,136,Móvel,8,188
46159,2024-02-02 01:18:00,93,124,Brinquedo,8,217
46160,2024-02-02 01:19:00,108,10,Eletrônico,1,118
46161,2024-02-02 01:20:00,99,24,Móvel,5,123
46162,2024-02-02 01:21:00,60,153,Eletrônico,1,213
46163,2024-02-02 01:22:00,86,14,Eletrônico,3,100
46164,2024-02-02 01:23:00,14,51,Móvel,3,65
46165,2024-02-02 01:24:00,77,50,Alimento,7,127
46166,2024-02-02 01:25:00,57,123,Alimento,8,180
46167,2024-02-02 01:26:00,80,129,Vestuário,1,209
46168,2024-02-02 01:27:00,71,98,Móvel,1,169
46169,2024-02-02 01:28:00,109,99,Eletrônico,3,208
46170,2024-02-02 01:29:00,85,121,Brinquedo,3,206
46171,2024-02-02 01:30:00,71,103,Alimento,8,174
46172,2024-02-02 01:31:00,60,11,Vestuário,2,71
46173,2024-02-02 01:32:00,118,33,Eletrônico,2,151
46174,2024-02-02 01:33:00,10,28,Vestuário,7,38
46175,2024-02-02 01:34:00,31,173,Móvel,9,204
46176,2024-02-02 01:35:00,46,43,Móvel,1,89
46177,2024-02-02 01:36:00,17,143,Brinquedo,3,160
46178,2024-02-02 01:37:00,62,122,Vestuário,9,184
46179,2024-02-02 01:38:00,78,118,Brinquedo,2,196
46180,2024-02-02 01:39:00,66,107,Eletrônico,4,173
46181,2024-02-02 01:40:00,108,26,Eletrônico,8,134
46182,2024-02-02 01:41:00,77,94,Brinquedo,9,171
46183,2024-02-02 01:42:00,80,133,Alimento,2,213
46184,2024-02-02 01:43:00,37,20,Móvel,8,57
46185,2024-02-02 01:44:00,107,89,Brinquedo,4,196
46186,2024-02-02 01:45:00,92,106,Alimento,6,198
46187,2024-02-02 01:46:00,74,175,Eletrônico,8,249
46188,2024-02-02 01:47:00,117,100,Brinquedo,2,217
46189,2024-02-02 01:48:00,60,168,Vestuário,9,228
46190,2024-02-02 01:49:00,48,109,Eletrônico,8,157
46191,2024-02-02 01:50:00,92,173,Brinquedo,7,265
46192,2024-02-02 01:51:00,58,85,Brinquedo,9,143
46193,2024-02-02 01:52:00,29,129,Eletrônico,9,158
46194,2024-02-02 01:53:00,102,42,Brinquedo,5,144
46195,2024-02-02 01:54:00,30,52,Eletrônico,7,82
46196,2024-02-02 01:55:00,83,35,Vestuário,7,118
46197,2024-02-02 01:56:00,10,89,Alimento,4,99
46198,2024-02-02 01:57:00,55,126,Alimento,4,181
46199,2024-02-02 01:58:00,21,125,Eletrônico,2,146
46200,2024-02-02 01:59:00,10,147,Eletrônico,5,157
46201,2024-02-02 02:00:00,75,178,Brinquedo,3,253
46202,2024-02-02 02:01:00,87,31,Vestuário,6,118
46203,2024-02-02 02:02:00,113,21,Móvel,2,134
46204,2024-02-02 02:03:00,56,92,Brinquedo,9,148
46205,2024-02-02 02:04:00,107,49,Brinquedo,1,156
46206,2024-02-02 02:05:00,112,133,Brinquedo,1,245
46207,2024-02-02 02:06:00,11,76,Alimento,5,87
46208,2024-02-02 02:07:00,54,96,Alimento,6,150
46209,2024-02-02 02:08:00,35,119,Brinquedo,3,154
46210,2024-02-02 02:09:00,42,17,Eletrônico,4,59
46211,2024-02-02 02:10:00,56,83,Alimento,7,139
46212,2024-02-02 02:11:00,66,17,Vestuário,8,83
46213,2024-02-02 02:12:00,97,22,Móvel,9,119
46214,2024-02-02 02:13:00,37,99,Vestuário,1,136
46215,2024-02-02 02:14:00,61,93,Vestuário,7,154
46216,2024-02-02 02:15:00,24,134,Alimento,4,158
46217,2024-02-02 02:16:00,111,96,Móvel,3,207
46218,2024-02-02 02:17:00,43,143,Brinquedo,7,186
46219,2024-02-02 02:18:00,41,56,Móvel,2,97
46220,2024-02-02 02:19:00,63,62,Brinquedo,1,125
46221,2024-02-02 02:20:00,55,91,Móvel,9,146
46222,2024-02-02 02:21:00,99,102,Alimento,1,201
46223,2024-02-02 02:22:00,110,123,Alimento,9,233
46224,2024-02-02 02:23:00,104,91,Eletrônico,6,195
46225,2024-02-02 02:24:00,64,79,Eletrônico,9,143
46226,2024-02-02 02:25:00,26,66,Brinquedo,6,92
46227,2024-02-02 02:26:00,43,11,Brinquedo,6,54
46228,2024-02-02 02:27:00,53,176,Brinquedo,8,229
46229,2024-02-02 02:28:00,71,113,Eletrônico,2,184
46230,2024-02-02 02:29:00,33,17,Vestuário,9,50
46231,2024-02-02 02:30:00,20,139,Brinquedo,8,159
46232,2024-02-02 02:31:00,21,28,Eletrônico,7,49
46233,2024-02-02 02:32:00,56,54,Brinquedo,5,110
46234,2024-02-02 02:33:00,21,125,Eletrônico,7,146
46235,2024-02-02 02:34:00,24,146,Alimento,5,170
46236,2024-02-02 02:35:00,43,56,Brinquedo,5,99
46237,2024-02-02 02:36:00,91,95,Eletrônico,2,186
46238,2024-02-02 02:37:00,105,158,Eletrônico,7,263
46239,2024-02-02 02:38:00,113,84,Alimento,2,197
46240,2024-02-02 02:39:00,35,112,Vestuário,9,147
46241,2024-02-02 02:40:00,62,113,Brinquedo,5,175
46242,2024-02-02 02:41:00,97,14,Eletrônico,4,111
46243,2024-02-02 02:42:00,64,21,Alimento,4,85
46244,2024-02-02 02:43:00,43,67,Eletrônico,8,110
46245,2024-02-02 02:44:00,107,97,Eletrônico,1,204
46246,2024-02-02 02:45:00,65,145,Vestuário,7,210
46247,2024-02-02 02:46:00,32,133,Eletrônico,5,165
46248,2024-02-02 02:47:00,116,47,Alimento,2,163
46249,2024-02-02 02:48:00,38,175,Móvel,9,213
46250,2024-02-02 02:49:00,11,53,Eletrônico,8,64
46251,2024-02-02 02:50:00,57,140,Eletrônico,6,197
46252,2024-02-02 02:51:00,110,169,Móvel,9,279
46253,2024-02-02 02:52:00,28,10,Eletrônico,4,38
46254,2024-02-02 02:53:00,79,89,Brinquedo,1,168
46255,2024-02-02 02:54:00,46,175,Brinquedo,3,221
46256,2024-02-02 02:55:00,39,15,Eletrônico,2,54
46257,2024-02-02 02:56:00,98,51,Eletrônico,4,149
46258,2024-02-02 02:57:00,67,91,Brinquedo,6,158
46259,2024-02-02 02:58:00,87,174,Brinquedo,2,261
46260,2024-02-02 02:59:00,62,49,Eletrônico,6,111
46261,2024-02-02 03:00:00,84,145,Vestuário,3,229
46262,2024-02-02 03:01:00,106,69,Eletrônico,5,175
46263,2024-02-02 03:02:00,103,39,Vestuário,7,142
46264,2024-02-02 03:03:00,45,146,Móvel,9,191
46265,2024-02-02 03:04:00,37,36,Móvel,8,73
46266,2024-02-02 03:05:00,23,60,Alimento,5,83
46267,2024-02-02 03:06:00,35,109,Móvel,3,144
46268,2024-02-02 03:07:00,27,131,Alimento,2,158
46269,2024-02-02 03:08:00,118,137,Alimento,9,255
46270,2024-02-02 03:09:00,80,157,Brinquedo,9,237
46271,2024-02-02 03:10:00,68,36,Móvel,3,104
46272,2024-02-02 03:11:00,107,95,Brinquedo,4,202
46273,2024-02-02 03:12:00,51,61,Vestuário,9,112
46274,2024-02-02 03:13:00,78,24,Brinquedo,3,102
46275,2024-02-02 03:14:00,61,108,Eletrônico,5,169
46276,2024-02-02 03:15:00,43,61,Eletrônico,8,104
46277,2024-02-02 03:16:00,26,172,Vestuário,4,198
46278,2024-02-02 03:17:00,79,153,Eletrônico,3,232
46279,2024-02-02 03:18:00,81,105,Alimento,4,186
46280,2024-02-02 03:19:00,106,168,Alimento,8,274
46281,2024-02-02 03:20:00,88,70,Alimento,2,158
46282,2024-02-02 03:21:00,113,48,Alimento,5,161
46283,2024-02-02 03:22:00,118,72,Móvel,1,190
46284,2024-02-02 03:23:00,94,74,Móvel,7,168
46285,2024-02-02 03:24:00,90,178,Eletrônico,3,268
46286,2024-02-02 03:25:00,116,89,Brinquedo,9,205
46287,2024-02-02 03:26:00,110,68,Vestuário,7,178
46288,2024-02-02 03:27:00,26,87,Alimento,2,113
46289,2024-02-02 03:28:00,104,175,Brinquedo,2,279
46290,2024-02-02 03:29:00,90,177,Eletrônico,5,267
46291,2024-02-02 03:30:00,74,12,Vestuário,8,86
46292,2024-02-02 03:31:00,41,25,Eletrônico,6,66
46293,2024-02-02 03:32:00,79,170,Vestuário,2,249
46294,2024-02-02 03:33:00,119,24,Eletrônico,7,143
46295,2024-02-02 03:34:00,81,64,Vestuário,8,145
46296,2024-02-02 03:35:00,99,90,Eletrônico,9,189
46297,2024-02-02 03:36:00,110,43,Vestuário,1,153
46298,2024-02-02 03:37:00,53,120,Eletrônico,1,173
46299,2024-02-02 03:38:00,61,34,Vestuário,7,95
46300,2024-02-02 03:39:00,22,112,Eletrônico,2,134
46301,2024-02-02 03:40:00,19,91,Vestuário,7,110
46302,2024-02-02 03:41:00,89,110,Alimento,9,199
46303,2024-02-02 03:42:00,91,76,Móvel,7,167
46304,2024-02-02 03:43:00,63,10,Eletrônico,2,73
46305,2024-02-02 03:44:00,42,74,Móvel,6,116
46306,2024-02-02 03:45:00,78,81,Eletrônico,4,159
46307,2024-02-02 03:46:00,112,84,Brinquedo,5,196
46308,2024-02-02 03:47:00,114,67,Alimento,1,181
46309,2024-02-02 03:48:00,23,178,Brinquedo,3,201
46310,2024-02-02 03:49:00,90,150,Alimento,3,240
46311,2024-02-02 03:50:00,27,80,Alimento,7,107
46312,2024-02-02 03:51:00,93,95,Eletrônico,3,188
46313,2024-02-02 03:52:00,27,43,Brinquedo,9,70
46314,2024-02-02 03:53:00,63,51,Vestuário,6,114
46315,2024-02-02 03:54:00,78,31,Brinquedo,1,109
46316,2024-02-02 03:55:00,69,13,Vestuário,4,82
46317,2024-02-02 03:56:00,64,138,Móvel,5,202
46318,2024-02-02 03:57:00,54,161,Alimento,5,215
46319,2024-02-02 03:58:00,110,19,Móvel,5,129
46320,2024-02-02 03:59:00,107,76,Brinquedo,2,183
46321,2024-02-02 04:00:00,43,160,Alimento,2,203
46322,2024-02-02 04:01:00,92,173,Vestuário,2,265
46323,2024-02-02 04:02:00,86,105,Vestuário,8,191
46324,2024-02-02 04:03:00,32,156,Brinquedo,9,188
46325,2024-02-02 04:04:00,73,101,Brinquedo,5,174
46326,2024-02-02 04:05:00,45,59,Móvel,7,104
46327,2024-02-02 04:06:00,37,64,Vestuário,7,101
46328,2024-02-02 04:07:00,58,49,Alimento,3,107
46329,2024-02-02 04:08:00,19,129,Brinquedo,4,148
46330,2024-02-02 04:09:00,32,46,Brinquedo,7,78
46331,2024-02-02 04:10:00,22,51,Alimento,5,73
46332,2024-02-02 04:11:00,90,145,Eletrônico,1,235
46333,2024-02-02 04:12:00,64,96,Alimento,5,160
46334,2024-02-02 04:13:00,70,73,Eletrônico,9,143
46335,2024-02-02 04:14:00,41,49,Vestuário,6,90
46336,2024-02-02 04:15:00,14,138,Móvel,2,152
46337,2024-02-02 04:16:00,112,58,Móvel,1,170
46338,2024-02-02 04:17:00,38,102,Vestuário,3,140
46339,2024-02-02 04:18:00,20,174,Móvel,1,194
46340,2024-02-02 04:19:00,67,48,Vestuário,2,115
46341,2024-02-02 04:20:00,78,135,Brinquedo,8,213
46342,2024-02-02 04:21:00,23,26,Móvel,1,49
46343,2024-02-02 04:22:00,77,16,Alimento,4,93
46344,2024-02-02 04:23:00,10,123,Eletrônico,8,133
46345,2024-02-02 04:24:00,107,108,Alimento,5,215
46346,2024-02-02 04:25:00,53,165,Móvel,6,218
46347,2024-02-02 04:26:00,34,75,Móvel,2,109
46348,2024-02-02 04:27:00,55,81,Brinquedo,8,136
46349,2024-02-02 04:28:00,10,36,Vestuário,9,46
46350,2024-02-02 04:29:00,117,125,Brinquedo,3,242
46351,2024-02-02 04:30:00,40,126,Brinquedo,9,166
46352,2024-02-02 04:31:00,110,58,Vestuário,2,168
46353,2024-02-02 04:32:00,46,16,Eletrônico,1,62
46354,2024-02-02 04:33:00,102,118,Vestuário,9,220
46355,2024-02-02 04:34:00,100,46,Eletrônico,6,146
46356,2024-02-02 04:35:00,25,149,Eletrônico,7,174
46357,2024-02-02 04:36:00,104,113,Móvel,3,217
46358,2024-02-02 04:37:00,31,53,Alimento,4,84
46359,2024-02-02 04:38:00,76,60,Eletrônico,6,136
46360,2024-02-02 04:39:00,93,121,Brinquedo,4,214
46361,2024-02-02 04:40:00,72,133,Alimento,6,205
46362,2024-02-02 04:41:00,64,81,Móvel,4,145
46363,2024-02-02 04:42:00,51,75,Alimento,2,126
46364,2024-02-02 04:43:00,117,26,Brinquedo,6,143
46365,2024-02-02 04:44:00,119,70,Vestuário,7,189
46366,2024-02-02 04:45:00,22,82,Alimento,2,104
46367,2024-02-02 04:46:00,117,76,Eletrônico,3,193
46368,2024-02-02 04:47:00,68,135,Móvel,4,203
46369,2024-02-02 04:48:00,94,126,Vestuário,5,220
46370,2024-02-02 04:49:00,96,84,Vestuário,1,180
46371,2024-02-02 04:50:00,13,11,Vestuário,9,24
46372,2024-02-02 04:51:00,49,172,Vestuário,4,221
46373,2024-02-02 04:52:00,75,18,Eletrônico,9,93
46374,2024-02-02 04:53:00,89,94,Alimento,3,183
46375,2024-02-02 04:54:00,100,28,Vestuário,5,128
46376,2024-02-02 04:55:00,114,169,Móvel,9,283
46377,2024-02-02 04:56:00,86,54,Brinquedo,4,140
46378,2024-02-02 04:57:00,59,88,Móvel,6,147
46379,2024-02-02 04:58:00,29,90,Brinquedo,6,119
46380,2024-02-02 04:59:00,101,79,Alimento,3,180
46381,2024-02-02 05:00:00,95,113,Móvel,2,208
46382,2024-02-02 05:01:00,98,13,Vestuário,4,111
46383,2024-02-02 05:02:00,21,131,Eletrônico,8,152
46384,2024-02-02 05:03:00,108,135,Móvel,1,243
46385,2024-02-02 05:04:00,83,82,Eletrônico,9,165
46386,2024-02-02 05:05:00,77,23,Eletrônico,3,100
46387,2024-02-02 05:06:00,54,117,Brinquedo,1,171
46388,2024-02-02 05:07:00,19,30,Eletrônico,1,49
46389,2024-02-02 05:08:00,75,22,Alimento,4,97
46390,2024-02-02 05:09:00,16,102,Brinquedo,5,118
46391,2024-02-02 05:10:00,35,134,Brinquedo,9,169
46392,2024-02-02 05:11:00,94,118,Eletrônico,5,212
46393,2024-02-02 05:12:00,11,128,Móvel,9,139
46394,2024-02-02 05:13:00,110,38,Alimento,3,148
46395,2024-02-02 05:14:00,24,57,Vestuário,1,81
46396,2024-02-02 05:15:00,54,55,Vestuário,8,109
46397,2024-02-02 05:16:00,119,163,Móvel,8,282
46398,2024-02-02 05:17:00,106,45,Móvel,6,151
46399,2024-02-02 05:18:00,114,169,Móvel,3,283
46400,2024-02-02 05:19:00,30,101,Alimento,4,131
46401,2024-02-02 05:20:00,86,172,Alimento,9,258
46402,2024-02-02 05:21:00,76,124,Vestuário,5,200
46403,2024-02-02 05:22:00,43,115,Móvel,5,158
46404,2024-02-02 05:23:00,60,38,Brinquedo,2,98
46405,2024-02-02 05:24:00,72,18,Alimento,1,90
46406,2024-02-02 05:25:00,105,61,Alimento,5,166
46407,2024-02-02 05:26:00,29,115,Alimento,6,144
46408,2024-02-02 05:27:00,25,164,Alimento,3,189
46409,2024-02-02 05:28:00,19,153,Brinquedo,3,172
46410,2024-02-02 05:29:00,45,136,Eletrônico,6,181
46411,2024-02-02 05:30:00,12,50,Móvel,7,62
46412,2024-02-02 05:31:00,44,30,Eletrônico,4,74
46413,2024-02-02 05:32:00,54,138,Brinquedo,7,192
46414,2024-02-02 05:33:00,20,71,Móvel,5,91
46415,2024-02-02 05:34:00,74,94,Eletrônico,7,168
46416,2024-02-02 05:35:00,77,85,Vestuário,7,162
46417,2024-02-02 05:36:00,101,42,Móvel,7,143
46418,2024-02-02 05:37:00,75,112,Eletrônico,6,187
46419,2024-02-02 05:38:00,110,121,Alimento,4,231
46420,2024-02-02 05:39:00,83,43,Móvel,8,126
46421,2024-02-02 05:40:00,84,148,Vestuário,5,232
46422,2024-02-02 05:41:00,100,29,Vestuário,9,129
46423,2024-02-02 05:42:00,23,26,Móvel,6,49
46424,2024-02-02 05:43:00,17,96,Móvel,9,113
46425,2024-02-02 05:44:00,53,90,Móvel,2,143
46426,2024-02-02 05:45:00,23,55,Vestuário,6,78
46427,2024-02-02 05:46:00,58,33,Móvel,5,91
46428,2024-02-02 05:47:00,19,17,Brinquedo,6,36
46429,2024-02-02 05:48:00,55,24,Vestuário,5,79
46430,2024-02-02 05:49:00,44,161,Brinquedo,8,205
46431,2024-02-02 05:50:00,19,55,Brinquedo,1,74
46432,2024-02-02 05:51:00,87,63,Eletrônico,6,150
46433,2024-02-02 05:52:00,58,55,Alimento,9,113
46434,2024-02-02 05:53:00,119,35,Eletrônico,3,154
46435,2024-02-02 05:54:00,46,162,Eletrônico,9,208
46436,2024-02-02 05:55:00,94,141,Móvel,2,235
46437,2024-02-02 05:56:00,65,142,Alimento,8,207
46438,2024-02-02 05:57:00,85,176,Vestuário,5,261
46439,2024-02-02 05:58:00,108,65,Vestuário,4,173
46440,2024-02-02 05:59:00,18,108,Eletrônico,5,126
46441,2024-02-02 06:00:00,109,46,Brinquedo,5,155
46442,2024-02-02 06:01:00,79,52,Vestuário,6,131
46443,2024-02-02 06:02:00,71,72,Brinquedo,6,143
46444,2024-02-02 06:03:00,64,123,Alimento,5,187
46445,2024-02-02 06:04:00,23,107,Móvel,2,130
46446,2024-02-02 06:05:00,94,147,Vestuário,8,241
46447,2024-02-02 06:06:00,54,83,Móvel,9,137
46448,2024-02-02 06:07:00,90,137,Alimento,7,227
46449,2024-02-02 06:08:00,17,153,Brinquedo,4,170
46450,2024-02-02 06:09:00,27,67,Alimento,5,94
46451,2024-02-02 06:10:00,94,102,Brinquedo,3,196
46452,2024-02-02 06:11:00,78,155,Eletrônico,7,233
46453,2024-02-02 06:12:00,22,171,Alimento,3,193
46454,2024-02-02 06:13:00,23,105,Vestuário,8,128
46455,2024-02-02 06:14:00,38,99,Eletrônico,3,137
46456,2024-02-02 06:15:00,66,144,Móvel,5,210
46457,2024-02-02 06:16:00,81,118,Eletrônico,9,199
46458,2024-02-02 06:17:00,94,11,Vestuário,6,105
46459,2024-02-02 06:18:00,112,91,Brinquedo,1,203
46460,2024-02-02 06:19:00,73,140,Eletrônico,7,213
46461,2024-02-02 06:20:00,76,54,Alimento,8,130
46462,2024-02-02 06:21:00,117,101,Eletrônico,7,218
46463,2024-02-02 06:22:00,26,48,Eletrônico,1,74
46464,2024-02-02 06:23:00,22,105,Eletrônico,8,127
46465,2024-02-02 06:24:00,15,113,Brinquedo,3,128
46466,2024-02-02 06:25:00,64,146,Móvel,7,210
46467,2024-02-02 06:26:00,113,27,Móvel,2,140
46468,2024-02-02 06:27:00,112,148,Vestuário,6,260
46469,2024-02-02 06:28:00,19,113,Móvel,8,132
46470,2024-02-02 06:29:00,15,78,Alimento,2,93
46471,2024-02-02 06:30:00,73,140,Brinquedo,3,213
46472,2024-02-02 06:31:00,68,108,Brinquedo,1,176
46473,2024-02-02 06:32:00,34,155,Eletrônico,1,189
46474,2024-02-02 06:33:00,90,103,Alimento,1,193
46475,2024-02-02 06:34:00,39,130,Móvel,5,169
46476,2024-02-02 06:35:00,108,176,Alimento,7,284
46477,2024-02-02 06:36:00,15,112,Alimento,8,127
46478,2024-02-02 06:37:00,29,18,Eletrônico,1,47
46479,2024-02-02 06:38:00,108,163,Móvel,7,271
46480,2024-02-02 06:39:00,21,146,Eletrônico,8,167
46481,2024-02-02 06:40:00,76,164,Alimento,3,240
46482,2024-02-02 06:41:00,25,72,Vestuário,9,97
46483,2024-02-02 06:42:00,109,36,Eletrônico,3,145
46484,2024-02-02 06:43:00,12,21,Vestuário,1,33
46485,2024-02-02 06:44:00,60,99,Brinquedo,4,159
46486,2024-02-02 06:45:00,28,120,Brinquedo,3,148
46487,2024-02-02 06:46:00,119,118,Eletrônico,5,237
46488,2024-02-02 06:47:00,22,130,Eletrônico,2,152
46489,2024-02-02 06:48:00,88,74,Brinquedo,5,162
46490,2024-02-02 06:49:00,19,127,Móvel,1,146
46491,2024-02-02 06:50:00,22,158,Alimento,3,180
46492,2024-02-02 06:51:00,93,71,Móvel,6,164
46493,2024-02-02 06:52:00,74,92,Eletrônico,7,166
46494,2024-02-02 06:53:00,40,145,Móvel,1,185
46495,2024-02-02 06:54:00,74,135,Eletrônico,9,209
46496,2024-02-02 06:55:00,75,41,Alimento,3,116
46497,2024-02-02 06:56:00,58,15,Eletrônico,9,73
46498,2024-02-02 06:57:00,79,95,Móvel,5,174
46499,2024-02-02 06:58:00,38,119,Brinquedo,5,157
46500,2024-02-02 06:59:00,94,16,Alimento,7,110
46501,2024-02-02 07:00:00,117,69,Vestuário,3,186
46502,2024-02-02 07:01:00,30,109,Alimento,9,139
46503,2024-02-02 07:02:00,40,11,Móvel,9,51
46504,2024-02-02 07:03:00,115,66,Vestuário,7,181
46505,2024-02-02 07:04:00,28,143,Vestuário,2,171
46506,2024-02-02 07:05:00,114,94,Vestuário,8,208
46507,2024-02-02 07:06:00,55,75,Alimento,8,130
46508,2024-02-02 07:07:00,96,68,Vestuário,5,164
46509,2024-02-02 07:08:00,13,112,Alimento,3,125
46510,2024-02-02 07:09:00,37,135,Vestuário,4,172
46511,2024-02-02 07:10:00,30,21,Móvel,4,51
46512,2024-02-02 07:11:00,102,67,Móvel,9,169
46513,2024-02-02 07:12:00,112,58,Móvel,7,170
46514,2024-02-02 07:13:00,63,174,Eletrônico,2,237
46515,2024-02-02 07:14:00,103,73,Eletrônico,9,176
46516,2024-02-02 07:15:00,91,61,Eletrônico,2,152
46517,2024-02-02 07:16:00,54,17,Alimento,4,71
46518,2024-02-02 07:17:00,98,122,Eletrônico,7,220
46519,2024-02-02 07:18:00,44,109,Móvel,4,153
46520,2024-02-02 07:19:00,28,77,Vestuário,4,105
46521,2024-02-02 07:20:00,17,76,Vestuário,9,93
46522,2024-02-02 07:21:00,108,22,Alimento,4,130
46523,2024-02-02 07:22:00,14,145,Móvel,1,159
46524,2024-02-02 07:23:00,83,168,Móvel,3,251
46525,2024-02-02 07:24:00,105,137,Vestuário,4,242
46526,2024-02-02 07:25:00,61,103,Vestuário,6,164
46527,2024-02-02 07:26:00,53,135,Móvel,3,188
46528,2024-02-02 07:27:00,25,175,Alimento,3,200
46529,2024-02-02 07:28:00,56,157,Vestuário,8,213
46530,2024-02-02 07:29:00,70,30,Alimento,3,100
46531,2024-02-02 07:30:00,12,162,Eletrônico,6,174
46532,2024-02-02 07:31:00,46,85,Móvel,6,131
46533,2024-02-02 07:32:00,63,107,Alimento,3,170
46534,2024-02-02 07:33:00,87,156,Alimento,6,243
46535,2024-02-02 07:34:00,42,66,Vestuário,9,108
46536,2024-02-02 07:35:00,71,161,Móvel,8,232
46537,2024-02-02 07:36:00,97,118,Eletrônico,5,215
46538,2024-02-02 07:37:00,63,172,Alimento,2,235
46539,2024-02-02 07:38:00,105,94,Eletrônico,7,199
46540,2024-02-02 07:39:00,20,19,Móvel,7,39
46541,2024-02-02 07:40:00,25,111,Brinquedo,5,136
46542,2024-02-02 07:41:00,91,99,Móvel,3,190
46543,2024-02-02 07:42:00,73,148,Móvel,8,221
46544,2024-02-02 07:43:00,43,21,Eletrônico,5,64
46545,2024-02-02 07:44:00,116,61,Brinquedo,7,177
46546,2024-02-02 07:45:00,105,179,Móvel,9,284
46547,2024-02-02 07:46:00,96,147,Alimento,3,243
46548,2024-02-02 07:47:00,27,124,Brinquedo,6,151
46549,2024-02-02 07:48:00,76,87,Eletrônico,9,163
46550,2024-02-02 07:49:00,74,137,Alimento,8,211
46551,2024-02-02 07:50:00,78,115,Vestuário,8,193
46552,2024-02-02 07:51:00,53,58,Alimento,5,111
46553,2024-02-02 07:52:00,81,103,Alimento,8,184
46554,2024-02-02 07:53:00,16,73,Eletrônico,9,89
46555,2024-02-02 07:54:00,44,122,Alimento,1,166
46556,2024-02-02 07:55:00,97,24,Eletrônico,4,121
46557,2024-02-02 07:56:00,75,51,Vestuário,9,126
46558,2024-02-02 07:57:00,105,10,Vestuário,3,115
46559,2024-02-02 07:58:00,105,175,Brinquedo,6,280
46560,2024-02-02 07:59:00,26,133,Alimento,2,159
46561,2024-02-02 08:00:00,54,24,Brinquedo,4,78
46562,2024-02-02 08:01:00,42,100,Vestuário,3,142
46563,2024-02-02 08:02:00,55,25,Alimento,5,80
46564,2024-02-02 08:03:00,63,80,Eletrônico,4,143
46565,2024-02-02 08:04:00,96,21,Eletrônico,2,117
46566,2024-02-02 08:05:00,73,146,Alimento,3,219
46567,2024-02-02 08:06:00,49,124,Brinquedo,8,173
46568,2024-02-02 08:07:00,55,35,Brinquedo,4,90
46569,2024-02-02 08:08:00,102,11,Eletrônico,9,113
46570,2024-02-02 08:09:00,10,16,Vestuário,1,26
46571,2024-02-02 08:10:00,44,76,Eletrônico,9,120
46572,2024-02-02 08:11:00,56,154,Brinquedo,3,210
46573,2024-02-02 08:12:00,34,161,Brinquedo,2,195
46574,2024-02-02 08:13:00,40,16,Vestuário,8,56
46575,2024-02-02 08:14:00,24,138,Alimento,9,162
46576,2024-02-02 08:15:00,101,91,Alimento,7,192
46577,2024-02-02 08:16:00,55,92,Alimento,6,147
46578,2024-02-02 08:17:00,96,132,Móvel,7,228
46579,2024-02-02 08:18:00,54,22,Vestuário,9,76
46580,2024-02-02 08:19:00,102,61,Móvel,6,163
46581,2024-02-02 08:20:00,29,60,Móvel,5,89
46582,2024-02-02 08:21:00,34,51,Vestuário,8,85
46583,2024-02-02 08:22:00,107,121,Brinquedo,6,228
46584,2024-02-02 08:23:00,53,30,Eletrônico,2,83
46585,2024-02-02 08:24:00,15,138,Vestuário,9,153
46586,2024-02-02 08:25:00,53,14,Brinquedo,8,67
46587,2024-02-02 08:26:00,18,37,Alimento,6,55
46588,2024-02-02 08:27:00,28,155,Móvel,2,183
46589,2024-02-02 08:28:00,94,175,Vestuário,8,269
46590,2024-02-02 08:29:00,22,31,Brinquedo,6,53
46591,2024-02-02 08:30:00,54,55,Móvel,5,109
46592,2024-02-02 08:31:00,89,99,Móvel,4,188
46593,2024-02-02 08:32:00,31,32,Eletrônico,3,63
46594,2024-02-02 08:33:00,77,107,Vestuário,3,184
46595,2024-02-02 08:34:00,96,89,Eletrônico,9,185
46596,2024-02-02 08:35:00,53,87,Móvel,3,140
46597,2024-02-02 08:36:00,46,95,Vestuário,5,141
46598,2024-02-02 08:37:00,26,22,Alimento,6,48
46599,2024-02-02 08:38:00,71,19,Eletrônico,9,90
46600,2024-02-02 08:39:00,40,53,Vestuário,1,93
46601,2024-02-02 08:40:00,85,155,Vestuário,7,240
46602,2024-02-02 08:41:00,118,39,Brinquedo,9,157
46603,2024-02-02 08:42:00,116,72,Eletrônico,5,188
46604,2024-02-02 08:43:00,41,73,Eletrônico,3,114
46605,2024-02-02 08:44:00,62,83,Eletrônico,6,145
46606,2024-02-02 08:45:00,115,11,Vestuário,9,126
46607,2024-02-02 08:46:00,12,65,Alimento,7,77
46608,2024-02-02 08:47:00,106,148,Alimento,1,254
46609,2024-02-02 08:48:00,45,125,Alimento,9,170
46610,2024-02-02 08:49:00,107,104,Eletrônico,3,211
46611,2024-02-02 08:50:00,64,18,Brinquedo,8,82
46612,2024-02-02 08:51:00,90,154,Móvel,6,244
46613,2024-02-02 08:52:00,22,11,Eletrônico,4,33
46614,2024-02-02 08:53:00,78,78,Alimento,2,156
46615,2024-02-02 08:54:00,37,72,Eletrônico,9,109
46616,2024-02-02 08:55:00,29,119,Eletrônico,7,148
46617,2024-02-02 08:56:00,71,132,Móvel,6,203
46618,2024-02-02 08:57:00,37,133,Vestuário,4,170
46619,2024-02-02 08:58:00,37,90,Eletrônico,6,127
46620,2024-02-02 08:59:00,72,120,Vestuário,4,192
46621,2024-02-02 09:00:00,17,113,Móvel,2,130
46622,2024-02-02 09:01:00,44,137,Vestuário,7,181
46623,2024-02-02 09:02:00,10,53,Eletrônico,1,63
46624,2024-02-02 09:03:00,64,39,Vestuário,4,103
46625,2024-02-02 09:04:00,69,142,Brinquedo,6,211
46626,2024-02-02 09:05:00,31,96,Alimento,1,127
46627,2024-02-02 09:06:00,62,173,Eletrônico,9,235
46628,2024-02-02 09:07:00,37,34,Vestuário,9,71
46629,2024-02-02 09:08:00,17,35,Alimento,2,52
46630,2024-02-02 09:09:00,34,56,Alimento,5,90
46631,2024-02-02 09:10:00,37,66,Eletrônico,5,103
46632,2024-02-02 09:11:00,29,48,Vestuário,9,77
46633,2024-02-02 09:12:00,103,105,Eletrônico,7,208
46634,2024-02-02 09:13:00,10,12,Eletrônico,9,22
46635,2024-02-02 09:14:00,34,131,Eletrônico,5,165
46636,2024-02-02 09:15:00,81,123,Móvel,8,204
46637,2024-02-02 09:16:00,111,149,Brinquedo,1,260
46638,2024-02-02 09:17:00,48,97,Móvel,6,145
46639,2024-02-02 09:18:00,95,163,Brinquedo,3,258
46640,2024-02-02 09:19:00,78,137,Vestuário,4,215
46641,2024-02-02 09:20:00,89,141,Alimento,7,230
46642,2024-02-02 09:21:00,80,132,Brinquedo,2,212
46643,2024-02-02 09:22:00,35,126,Brinquedo,3,161
46644,2024-02-02 09:23:00,29,126,Eletrônico,3,155
46645,2024-02-02 09:24:00,48,134,Móvel,1,182
46646,2024-02-02 09:25:00,92,65,Móvel,6,157
46647,2024-02-02 09:26:00,118,158,Eletrônico,4,276
46648,2024-02-02 09:27:00,25,157,Eletrônico,3,182
46649,2024-02-02 09:28:00,57,119,Móvel,1,176
46650,2024-02-02 09:29:00,28,66,Alimento,7,94
46651,2024-02-02 09:30:00,17,80,Vestuário,8,97
46652,2024-02-02 09:31:00,15,52,Alimento,5,67
46653,2024-02-02 09:32:00,53,166,Vestuário,1,219
46654,2024-02-02 09:33:00,92,128,Alimento,6,220
46655,2024-02-02 09:34:00,51,125,Eletrônico,1,176
46656,2024-02-02 09:35:00,102,141,Eletrônico,7,243
46657,2024-02-02 09:36:00,87,52,Brinquedo,3,139
46658,2024-02-02 09:37:00,96,160,Eletrônico,1,256
46659,2024-02-02 09:38:00,39,62,Alimento,9,101
46660,2024-02-02 09:39:00,72,70,Móvel,8,142
46661,2024-02-02 09:40:00,36,58,Vestuário,4,94
46662,2024-02-02 09:41:00,69,25,Vestuário,7,94
46663,2024-02-02 09:42:00,24,96,Brinquedo,1,120
46664,2024-02-02 09:43:00,76,10,Vestuário,6,86
46665,2024-02-02 09:44:00,31,22,Vestuário,4,53
46666,2024-02-02 09:45:00,58,179,Brinquedo,8,237
46667,2024-02-02 09:46:00,59,146,Brinquedo,7,205
46668,2024-02-02 09:47:00,25,82,Vestuário,9,107
46669,2024-02-02 09:48:00,76,174,Alimento,4,250
46670,2024-02-02 09:49:00,32,70,Vestuário,7,102
46671,2024-02-02 09:50:00,52,37,Brinquedo,5,89
46672,2024-02-02 09:51:00,66,165,Eletrônico,2,231
46673,2024-02-02 09:52:00,20,170,Alimento,3,190
46674,2024-02-02 09:53:00,95,51,Vestuário,8,146
46675,2024-02-02 09:54:00,90,47,Brinquedo,2,137
46676,2024-02-02 09:55:00,77,155,Vestuário,2,232
46677,2024-02-02 09:56:00,112,25,Alimento,8,137
46678,2024-02-02 09:57:00,41,166,Móvel,1,207
46679,2024-02-02 09:58:00,37,42,Alimento,5,79
46680,2024-02-02 09:59:00,70,66,Vestuário,6,136
46681,2024-02-02 10:00:00,111,44,Eletrônico,5,155
46682,2024-02-02 10:01:00,116,152,Móvel,1,268
46683,2024-02-02 10:02:00,84,61,Alimento,8,145
46684,2024-02-02 10:03:00,16,146,Brinquedo,8,162
46685,2024-02-02 10:04:00,101,32,Brinquedo,1,133
46686,2024-02-02 10:05:00,104,123,Vestuário,9,227
46687,2024-02-02 10:06:00,96,175,Alimento,1,271
46688,2024-02-02 10:07:00,29,84,Brinquedo,2,113
46689,2024-02-02 10:08:00,21,118,Brinquedo,6,139
46690,2024-02-02 10:09:00,60,34,Alimento,7,94
46691,2024-02-02 10:10:00,96,105,Eletrônico,9,201
46692,2024-02-02 10:11:00,117,155,Alimento,9,272
46693,2024-02-02 10:12:00,96,165,Móvel,7,261
46694,2024-02-02 10:13:00,11,55,Eletrônico,5,66
46695,2024-02-02 10:14:00,70,86,Móvel,5,156
46696,2024-02-02 10:15:00,42,166,Brinquedo,8,208
46697,2024-02-02 10:16:00,16,50,Brinquedo,9,66
46698,2024-02-02 10:17:00,17,120,Eletrônico,8,137
46699,2024-02-02 10:18:00,62,31,Brinquedo,4,93
46700,2024-02-02 10:19:00,110,109,Alimento,8,219
46701,2024-02-02 10:20:00,76,46,Brinquedo,1,122
46702,2024-02-02 10:21:00,52,173,Brinquedo,2,225
46703,2024-02-02 10:22:00,48,115,Eletrônico,9,163
46704,2024-02-02 10:23:00,48,74,Móvel,7,122
46705,2024-02-02 10:24:00,20,116,Brinquedo,7,136
46706,2024-02-02 10:25:00,98,79,Alimento,2,177
46707,2024-02-02 10:26:00,29,44,Móvel,9,73
46708,2024-02-02 10:27:00,113,83,Eletrônico,7,196
46709,2024-02-02 10:28:00,95,57,Brinquedo,7,152
46710,2024-02-02 10:29:00,10,117,Eletrônico,7,127
46711,2024-02-02 10:30:00,41,100,Móvel,1,141
46712,2024-02-02 10:31:00,106,143,Alimento,2,249
46713,2024-02-02 10:32:00,72,103,Móvel,3,175
46714,2024-02-02 10:33:00,98,21,Vestuário,7,119
46715,2024-02-02 10:34:00,62,176,Vestuário,8,238
46716,2024-02-02 10:35:00,72,19,Alimento,9,91
46717,2024-02-02 10:36:00,21,102,Alimento,7,123
46718,2024-02-02 10:37:00,17,149,Brinquedo,1,166
46719,2024-02-02 10:38:00,50,94,Eletrônico,7,144
46720,2024-02-02 10:39:00,32,50,Alimento,2,82
46721,2024-02-02 10:40:00,64,163,Alimento,9,227
46722,2024-02-02 10:41:00,104,82,Móvel,2,186
46723,2024-02-02 10:42:00,32,41,Vestuário,9,73
46724,2024-02-02 10:43:00,82,173,Alimento,9,255
46725,2024-02-02 10:44:00,53,51,Eletrônico,3,104
46726,2024-02-02 10:45:00,68,97,Móvel,2,165
46727,2024-02-02 10:46:00,18,52,Alimento,3,70
46728,2024-02-02 10:47:00,94,38,Eletrônico,3,132
46729,2024-02-02 10:48:00,19,136,Móvel,3,155
46730,2024-02-02 10:49:00,37,65,Alimento,4,102
46731,2024-02-02 10:50:00,78,13,Eletrônico,3,91
46732,2024-02-02 10:51:00,36,45,Móvel,3,81
46733,2024-02-02 10:52:00,111,165,Móvel,6,276
46734,2024-02-02 10:53:00,59,157,Móvel,5,216
46735,2024-02-02 10:54:00,107,21,Alimento,5,128
46736,2024-02-02 10:55:00,61,126,Eletrônico,2,187
46737,2024-02-02 10:56:00,75,119,Eletrônico,8,194
46738,2024-02-02 10:57:00,100,79,Eletrônico,2,179
46739,2024-02-02 10:58:00,24,117,Eletrônico,5,141
46740,2024-02-02 10:59:00,39,77,Eletrônico,5,116
46741,2024-02-02 11:00:00,40,120,Brinquedo,8,160
46742,2024-02-02 11:01:00,55,79,Móvel,9,134
46743,2024-02-02 11:02:00,54,54,Vestuário,5,108
46744,2024-02-02 11:03:00,57,32,Brinquedo,3,89
46745,2024-02-02 11:04:00,26,109,Eletrônico,6,135
46746,2024-02-02 11:05:00,106,20,Eletrônico,8,126
46747,2024-02-02 11:06:00,30,157,Vestuário,9,187
46748,2024-02-02 11:07:00,39,151,Vestuário,3,190
46749,2024-02-02 11:08:00,53,178,Brinquedo,3,231
46750,2024-02-02 11:09:00,70,124,Brinquedo,6,194
46751,2024-02-02 11:10:00,55,20,Móvel,2,75
46752,2024-02-02 11:11:00,84,125,Brinquedo,3,209
46753,2024-02-02 11:12:00,86,177,Alimento,1,263
46754,2024-02-02 11:13:00,85,170,Eletrônico,9,255
46755,2024-02-02 11:14:00,98,17,Móvel,6,115
46756,2024-02-02 11:15:00,12,52,Brinquedo,2,64
46757,2024-02-02 11:16:00,10,25,Móvel,1,35
46758,2024-02-02 11:17:00,100,168,Móvel,2,268
46759,2024-02-02 11:18:00,103,115,Vestuário,2,218
46760,2024-02-02 11:19:00,95,50,Brinquedo,6,145
46761,2024-02-02 11:20:00,104,85,Brinquedo,7,189
46762,2024-02-02 11:21:00,62,160,Brinquedo,8,222
46763,2024-02-02 11:22:00,118,123,Alimento,8,241
46764,2024-02-02 11:23:00,103,113,Móvel,6,216
46765,2024-02-02 11:24:00,26,175,Eletrônico,9,201
46766,2024-02-02 11:25:00,93,45,Alimento,7,138
46767,2024-02-02 11:26:00,70,84,Alimento,9,154
46768,2024-02-02 11:27:00,109,59,Vestuário,7,168
46769,2024-02-02 11:28:00,16,17,Móvel,6,33
46770,2024-02-02 11:29:00,69,60,Alimento,9,129
46771,2024-02-02 11:30:00,94,15,Brinquedo,3,109
46772,2024-02-02 11:31:00,12,170,Vestuário,5,182
46773,2024-02-02 11:32:00,63,129,Móvel,4,192
46774,2024-02-02 11:33:00,62,10,Alimento,9,72
46775,2024-02-02 11:34:00,73,37,Móvel,8,110
46776,2024-02-02 11:35:00,92,146,Alimento,6,238
46777,2024-02-02 11:36:00,101,134,Móvel,6,235
46778,2024-02-02 11:37:00,12,140,Brinquedo,3,152
46779,2024-02-02 11:38:00,118,35,Alimento,4,153
46780,2024-02-02 11:39:00,70,84,Brinquedo,1,154
46781,2024-02-02 11:40:00,43,141,Eletrônico,6,184
46782,2024-02-02 11:41:00,35,14,Móvel,8,49
46783,2024-02-02 11:42:00,26,17,Alimento,9,43
46784,2024-02-02 11:43:00,24,106,Eletrônico,5,130
46785,2024-02-02 11:44:00,70,65,Brinquedo,3,135
46786,2024-02-02 11:45:00,55,161,Móvel,5,216
46787,2024-02-02 11:46:00,118,43,Eletrônico,1,161
46788,2024-02-02 11:47:00,119,106,Eletrônico,6,225
46789,2024-02-02 11:48:00,83,161,Móvel,6,244
46790,2024-02-02 11:49:00,72,103,Móvel,9,175
46791,2024-02-02 11:50:00,84,46,Eletrônico,4,130
46792,2024-02-02 11:51:00,11,144,Alimento,7,155
46793,2024-02-02 11:52:00,102,178,Brinquedo,6,280
46794,2024-02-02 11:53:00,100,13,Eletrônico,2,113
46795,2024-02-02 11:54:00,54,164,Móvel,8,218
46796,2024-02-02 11:55:00,77,55,Móvel,1,132
46797,2024-02-02 11:56:00,67,86,Móvel,6,153
46798,2024-02-02 11:57:00,49,159,Eletrônico,6,208
46799,2024-02-02 11:58:00,77,102,Brinquedo,1,179
46800,2024-02-02 11:59:00,107,36,Móvel,2,143
46801,2024-02-02 12:00:00,60,121,Móvel,4,181
46802,2024-02-02 12:01:00,88,36,Vestuário,8,124
46803,2024-02-02 12:02:00,49,12,Móvel,6,61
46804,2024-02-02 12:03:00,36,45,Alimento,5,81
46805,2024-02-02 12:04:00,10,169,Móvel,8,179
46806,2024-02-02 12:05:00,106,169,Brinquedo,4,275
46807,2024-02-02 12:06:00,90,82,Móvel,5,172
46808,2024-02-02 12:07:00,108,23,Móvel,6,131
46809,2024-02-02 12:08:00,21,179,Vestuário,6,200
46810,2024-02-02 12:09:00,18,173,Eletrônico,3,191
46811,2024-02-02 12:10:00,69,173,Eletrônico,1,242
46812,2024-02-02 12:11:00,73,94,Eletrônico,2,167
46813,2024-02-02 12:12:00,50,163,Brinquedo,9,213
46814,2024-02-02 12:13:00,31,88,Vestuário,3,119
46815,2024-02-02 12:14:00,12,105,Vestuário,6,117
46816,2024-02-02 12:15:00,65,160,Móvel,8,225
46817,2024-02-02 12:16:00,81,79,Móvel,9,160
46818,2024-02-02 12:17:00,87,78,Alimento,9,165
46819,2024-02-02 12:18:00,51,149,Brinquedo,7,200
46820,2024-02-02 12:19:00,54,58,Vestuário,7,112
46821,2024-02-02 12:20:00,10,86,Brinquedo,1,96
46822,2024-02-02 12:21:00,12,49,Brinquedo,1,61
46823,2024-02-02 12:22:00,66,85,Alimento,4,151
46824,2024-02-02 12:23:00,47,117,Alimento,7,164
46825,2024-02-02 12:24:00,38,25,Móvel,3,63
46826,2024-02-02 12:25:00,50,98,Alimento,9,148
46827,2024-02-02 12:26:00,48,69,Brinquedo,6,117
46828,2024-02-02 12:27:00,105,81,Alimento,6,186
46829,2024-02-02 12:28:00,86,140,Alimento,3,226
46830,2024-02-02 12:29:00,74,41,Móvel,6,115
46831,2024-02-02 12:30:00,92,15,Eletrônico,1,107
46832,2024-02-02 12:31:00,85,173,Vestuário,1,258
46833,2024-02-02 12:32:00,112,62,Móvel,8,174
46834,2024-02-02 12:33:00,57,172,Móvel,4,229
46835,2024-02-02 12:34:00,53,133,Vestuário,4,186
46836,2024-02-02 12:35:00,61,167,Móvel,7,228
46837,2024-02-02 12:36:00,53,137,Brinquedo,6,190
46838,2024-02-02 12:37:00,116,128,Móvel,9,244
46839,2024-02-02 12:38:00,69,113,Vestuário,3,182
46840,2024-02-02 12:39:00,14,163,Vestuário,5,177
46841,2024-02-02 12:40:00,41,10,Eletrônico,4,51
46842,2024-02-02 12:41:00,28,36,Alimento,5,64
46843,2024-02-02 12:42:00,16,21,Alimento,2,37
46844,2024-02-02 12:43:00,116,139,Móvel,8,255
46845,2024-02-02 12:44:00,68,96,Móvel,6,164
46846,2024-02-02 12:45:00,48,56,Vestuário,8,104
46847,2024-02-02 12:46:00,31,58,Alimento,4,89
46848,2024-02-02 12:47:00,42,135,Alimento,6,177
46849,2024-02-02 12:48:00,117,155,Alimento,7,272
46850,2024-02-02 12:49:00,33,126,Alimento,3,159
46851,2024-02-02 12:50:00,78,75,Eletrônico,6,153
46852,2024-02-02 12:51:00,68,165,Alimento,1,233
46853,2024-02-02 12:52:00,33,76,Vestuário,5,109
46854,2024-02-02 12:53:00,81,11,Vestuário,9,92
46855,2024-02-02 12:54:00,69,93,Móvel,5,162
46856,2024-02-02 12:55:00,112,72,Vestuário,8,184
46857,2024-02-02 12:56:00,97,107,Eletrônico,3,204
46858,2024-02-02 12:57:00,116,96,Vestuário,4,212
46859,2024-02-02 12:58:00,42,179,Alimento,8,221
46860,2024-02-02 12:59:00,14,85,Móvel,2,99
46861,2024-02-02 13:00:00,23,156,Móvel,2,179
46862,2024-02-02 13:01:00,26,10,Brinquedo,7,36
46863,2024-02-02 13:02:00,90,63,Móvel,2,153
46864,2024-02-02 13:03:00,15,167,Vestuário,2,182
46865,2024-02-02 13:04:00,28,118,Móvel,3,146
46866,2024-02-02 13:05:00,69,53,Móvel,3,122
46867,2024-02-02 13:06:00,32,119,Vestuário,5,151
46868,2024-02-02 13:07:00,52,112,Alimento,5,164
46869,2024-02-02 13:08:00,80,155,Móvel,3,235
46870,2024-02-02 13:09:00,108,21,Eletrônico,9,129
46871,2024-02-02 13:10:00,119,41,Vestuário,8,160
46872,2024-02-02 13:11:00,47,136,Vestuário,4,183
46873,2024-02-02 13:12:00,109,174,Eletrônico,4,283
46874,2024-02-02 13:13:00,40,70,Móvel,6,110
46875,2024-02-02 13:14:00,47,78,Eletrônico,7,125
46876,2024-02-02 13:15:00,90,108,Vestuário,1,198
46877,2024-02-02 13:16:00,67,18,Alimento,4,85
46878,2024-02-02 13:17:00,10,112,Vestuário,6,122
46879,2024-02-02 13:18:00,47,107,Móvel,8,154
46880,2024-02-02 13:19:00,22,116,Alimento,3,138
46881,2024-02-02 13:20:00,56,178,Vestuário,6,234
46882,2024-02-02 13:21:00,114,70,Alimento,6,184
46883,2024-02-02 13:22:00,46,29,Móvel,5,75
46884,2024-02-02 13:23:00,16,26,Brinquedo,5,42
46885,2024-02-02 13:24:00,29,116,Alimento,3,145
46886,2024-02-02 13:25:00,75,127,Alimento,8,202
46887,2024-02-02 13:26:00,52,98,Móvel,6,150
46888,2024-02-02 13:27:00,16,17,Brinquedo,8,33
46889,2024-02-02 13:28:00,107,116,Móvel,8,223
46890,2024-02-02 13:29:00,19,124,Móvel,6,143
46891,2024-02-02 13:30:00,80,40,Móvel,9,120
46892,2024-02-02 13:31:00,112,125,Alimento,7,237
46893,2024-02-02 13:32:00,12,76,Alimento,2,88
46894,2024-02-02 13:33:00,40,141,Móvel,8,181
46895,2024-02-02 13:34:00,38,165,Eletrônico,1,203
46896,2024-02-02 13:35:00,42,152,Brinquedo,4,194
46897,2024-02-02 13:36:00,112,98,Brinquedo,6,210
46898,2024-02-02 13:37:00,100,167,Vestuário,4,267
46899,2024-02-02 13:38:00,108,77,Brinquedo,7,185
46900,2024-02-02 13:39:00,30,140,Alimento,7,170
46901,2024-02-02 13:40:00,35,97,Brinquedo,4,132
46902,2024-02-02 13:41:00,33,167,Alimento,8,200
46903,2024-02-02 13:42:00,56,36,Eletrônico,1,92
46904,2024-02-02 13:43:00,39,13,Eletrônico,6,52
46905,2024-02-02 13:44:00,69,88,Brinquedo,8,157
46906,2024-02-02 13:45:00,99,30,Brinquedo,2,129
46907,2024-02-02 13:46:00,57,13,Eletrônico,1,70
46908,2024-02-02 13:47:00,80,60,Brinquedo,4,140
46909,2024-02-02 13:48:00,34,86,Brinquedo,3,120
46910,2024-02-02 13:49:00,60,68,Eletrônico,7,128
46911,2024-02-02 13:50:00,44,99,Brinquedo,4,143
46912,2024-02-02 13:51:00,110,34,Eletrônico,7,144
46913,2024-02-02 13:52:00,14,138,Vestuário,8,152
46914,2024-02-02 13:53:00,112,80,Eletrônico,6,192
46915,2024-02-02 13:54:00,82,114,Eletrônico,3,196
46916,2024-02-02 13:55:00,50,102,Alimento,9,152
46917,2024-02-02 13:56:00,42,167,Brinquedo,9,209
46918,2024-02-02 13:57:00,52,13,Móvel,3,65
46919,2024-02-02 13:58:00,20,49,Alimento,3,69
46920,2024-02-02 13:59:00,52,55,Vestuário,6,107
46921,2024-02-02 14:00:00,81,99,Brinquedo,2,180
46922,2024-02-02 14:01:00,49,64,Brinquedo,3,113
46923,2024-02-02 14:02:00,17,168,Brinquedo,4,185
46924,2024-02-02 14:03:00,23,105,Alimento,8,128
46925,2024-02-02 14:04:00,87,136,Alimento,8,223
46926,2024-02-02 14:05:00,20,128,Móvel,9,148
46927,2024-02-02 14:06:00,118,101,Móvel,1,219
46928,2024-02-02 14:07:00,97,78,Vestuário,1,175
46929,2024-02-02 14:08:00,96,60,Eletrônico,2,156
46930,2024-02-02 14:09:00,32,49,Alimento,2,81
46931,2024-02-02 14:10:00,115,157,Alimento,5,272
46932,2024-02-02 14:11:00,89,135,Vestuário,8,224
46933,2024-02-02 14:12:00,40,72,Alimento,3,112
46934,2024-02-02 14:13:00,86,149,Móvel,3,235
46935,2024-02-02 14:14:00,42,106,Alimento,9,148
46936,2024-02-02 14:15:00,80,75,Móvel,1,155
46937,2024-02-02 14:16:00,115,157,Alimento,2,272
46938,2024-02-02 14:17:00,23,76,Móvel,8,99
46939,2024-02-02 14:18:00,69,137,Eletrônico,3,206
46940,2024-02-02 14:19:00,12,36,Eletrônico,3,48
46941,2024-02-02 14:20:00,118,129,Alimento,2,247
46942,2024-02-02 14:21:00,55,119,Brinquedo,1,174
46943,2024-02-02 14:22:00,63,129,Alimento,5,192
46944,2024-02-02 14:23:00,108,37,Brinquedo,4,145
46945,2024-02-02 14:24:00,11,10,Brinquedo,2,21
46946,2024-02-02 14:25:00,21,139,Brinquedo,1,160
46947,2024-02-02 14:26:00,57,36,Brinquedo,1,93
46948,2024-02-02 14:27:00,39,16,Alimento,8,55
46949,2024-02-02 14:28:00,41,158,Eletrônico,2,199
46950,2024-02-02 14:29:00,86,144,Alimento,1,230
46951,2024-02-02 14:30:00,41,118,Alimento,9,159
46952,2024-02-02 14:31:00,103,75,Alimento,5,178
46953,2024-02-02 14:32:00,75,40,Alimento,5,115
46954,2024-02-02 14:33:00,83,76,Brinquedo,2,159
46955,2024-02-02 14:34:00,23,36,Brinquedo,3,59
46956,2024-02-02 14:35:00,29,118,Móvel,9,147
46957,2024-02-02 14:36:00,40,25,Vestuário,6,65
46958,2024-02-02 14:37:00,97,105,Brinquedo,2,202
46959,2024-02-02 14:38:00,59,97,Móvel,7,156
46960,2024-02-02 14:39:00,28,27,Brinquedo,4,55
46961,2024-02-02 14:40:00,49,39,Alimento,1,88
46962,2024-02-02 14:41:00,12,10,Brinquedo,5,22
46963,2024-02-02 14:42:00,78,11,Eletrônico,9,89
46964,2024-02-02 14:43:00,92,82,Móvel,7,174
46965,2024-02-02 14:44:00,59,85,Alimento,2,144
46966,2024-02-02 14:45:00,85,12,Alimento,5,97
46967,2024-02-02 14:46:00,25,43,Brinquedo,3,68
46968,2024-02-02 14:47:00,51,40,Móvel,7,91
46969,2024-02-02 14:48:00,29,106,Alimento,2,135
46970,2024-02-02 14:49:00,46,176,Vestuário,4,222
46971,2024-02-02 14:50:00,43,96,Alimento,6,139
46972,2024-02-02 14:51:00,30,23,Vestuário,2,53
46973,2024-02-02 14:52:00,26,178,Móvel,1,204
46974,2024-02-02 14:53:00,22,53,Brinquedo,7,75
46975,2024-02-02 14:54:00,117,134,Vestuário,8,251
46976,2024-02-02 14:55:00,104,78,Alimento,1,182
46977,2024-02-02 14:56:00,52,93,Eletrônico,3,145
46978,2024-02-02 14:57:00,31,55,Eletrônico,6,86
46979,2024-02-02 14:58:00,52,130,Brinquedo,6,182
46980,2024-02-02 14:59:00,67,74,Alimento,8,141
46981,2024-02-02 15:00:00,108,139,Vestuário,6,247
46982,2024-02-02 15:01:00,12,46,Brinquedo,1,58
46983,2024-02-02 15:02:00,102,89,Móvel,8,191
46984,2024-02-02 15:03:00,75,157,Móvel,9,232
46985,2024-02-02 15:04:00,37,116,Brinquedo,2,153
46986,2024-02-02 15:05:00,76,31,Alimento,8,107
46987,2024-02-02 15:06:00,21,69,Brinquedo,7,90
46988,2024-02-02 15:07:00,43,11,Brinquedo,7,54
46989,2024-02-02 15:08:00,104,89,Móvel,7,193
46990,2024-02-02 15:09:00,117,27,Eletrônico,3,144
46991,2024-02-02 15:10:00,51,167,Eletrônico,1,218
46992,2024-02-02 15:11:00,70,169,Brinquedo,9,239
46993,2024-02-02 15:12:00,78,26,Alimento,6,104
46994,2024-02-02 15:13:00,17,120,Alimento,3,137
46995,2024-02-02 15:14:00,27,152,Móvel,6,179
46996,2024-02-02 15:15:00,32,173,Brinquedo,3,205
46997,2024-02-02 15:16:00,118,86,Eletrônico,4,204
46998,2024-02-02 15:17:00,93,179,Alimento,4,272
46999,2024-02-02 15:18:00,55,119,Alimento,8,174
47000,2024-02-02 15:19:00,60,95,Eletrônico,7,155
47001,2024-02-02 15:20:00,24,44,Móvel,8,68
47002,2024-02-02 15:21:00,77,87,Alimento,8,164
47003,2024-02-02 15:22:00,17,99,Vestuário,5,116
47004,2024-02-02 15:23:00,71,72,Alimento,5,143
47005,2024-02-02 15:24:00,100,114,Alimento,9,214
47006,2024-02-02 15:25:00,41,111,Móvel,7,152
47007,2024-02-02 15:26:00,77,159,Brinquedo,7,236
47008,2024-02-02 15:27:00,70,174,Móvel,8,244
47009,2024-02-02 15:28:00,62,35,Brinquedo,8,97
47010,2024-02-02 15:29:00,19,39,Alimento,6,58
47011,2024-02-02 15:30:00,26,43,Alimento,1,69
47012,2024-02-02 15:31:00,28,71,Móvel,8,99
47013,2024-02-02 15:32:00,97,120,Móvel,4,217
47014,2024-02-02 15:33:00,75,171,Eletrônico,3,246
47015,2024-02-02 15:34:00,107,134,Eletrônico,8,241
47016,2024-02-02 15:35:00,114,101,Móvel,7,215
47017,2024-02-02 15:36:00,88,75,Móvel,1,163
47018,2024-02-02 15:37:00,45,154,Alimento,8,199
47019,2024-02-02 15:38:00,48,113,Móvel,1,161
47020,2024-02-02 15:39:00,11,137,Móvel,5,148
47021,2024-02-02 15:40:00,109,59,Eletrônico,7,168
47022,2024-02-02 15:41:00,28,132,Vestuário,5,160
47023,2024-02-02 15:42:00,107,10,Brinquedo,9,117
47024,2024-02-02 15:43:00,76,175,Vestuário,3,251
47025,2024-02-02 15:44:00,32,171,Eletrônico,3,203
47026,2024-02-02 15:45:00,114,113,Eletrônico,3,227
47027,2024-02-02 15:46:00,87,67,Vestuário,4,154
47028,2024-02-02 15:47:00,109,174,Brinquedo,4,283
47029,2024-02-02 15:48:00,18,47,Brinquedo,5,65
47030,2024-02-02 15:49:00,101,126,Móvel,7,227
47031,2024-02-02 15:50:00,60,37,Móvel,9,97
47032,2024-02-02 15:51:00,16,84,Móvel,2,100
47033,2024-02-02 15:52:00,12,21,Eletrônico,6,33
47034,2024-02-02 15:53:00,51,80,Vestuário,4,131
47035,2024-02-02 15:54:00,104,176,Móvel,5,280
47036,2024-02-02 15:55:00,90,73,Móvel,7,163
47037,2024-02-02 15:56:00,100,109,Eletrônico,6,209
47038,2024-02-02 15:57:00,74,46,Alimento,5,120
47039,2024-02-02 15:58:00,115,148,Brinquedo,1,263
47040,2024-02-02 15:59:00,59,157,Eletrônico,2,216
47041,2024-02-02 16:00:00,39,169,Brinquedo,6,208
47042,2024-02-02 16:01:00,92,74,Vestuário,3,166
47043,2024-02-02 16:02:00,68,143,Alimento,8,211
47044,2024-02-02 16:03:00,76,73,Móvel,2,149
47045,2024-02-02 16:04:00,71,102,Vestuário,7,173
47046,2024-02-02 16:05:00,114,126,Eletrônico,2,240
47047,2024-02-02 16:06:00,109,22,Alimento,8,131
47048,2024-02-02 16:07:00,45,146,Vestuário,9,191
47049,2024-02-02 16:08:00,70,141,Vestuário,4,211
47050,2024-02-02 16:09:00,51,155,Vestuário,8,206
47051,2024-02-02 16:10:00,98,174,Vestuário,1,272
47052,2024-02-02 16:11:00,114,176,Brinquedo,9,290
47053,2024-02-02 16:12:00,26,127,Vestuário,2,153
47054,2024-02-02 16:13:00,101,69,Alimento,2,170
47055,2024-02-02 16:14:00,49,86,Brinquedo,3,135
47056,2024-02-02 16:15:00,30,56,Eletrônico,8,86
47057,2024-02-02 16:16:00,72,60,Eletrônico,8,132
47058,2024-02-02 16:17:00,89,40,Alimento,9,129
47059,2024-02-02 16:18:00,81,153,Eletrônico,6,234
47060,2024-02-02 16:19:00,68,137,Móvel,8,205
47061,2024-02-02 16:20:00,95,126,Brinquedo,4,221
47062,2024-02-02 16:21:00,93,45,Vestuário,2,138
47063,2024-02-02 16:22:00,42,29,Brinquedo,1,71
47064,2024-02-02 16:23:00,29,26,Vestuário,8,55
47065,2024-02-02 16:24:00,37,101,Brinquedo,5,138
47066,2024-02-02 16:25:00,29,150,Brinquedo,7,179
47067,2024-02-02 16:26:00,43,59,Móvel,8,102
47068,2024-02-02 16:27:00,81,91,Eletrônico,9,172
47069,2024-02-02 16:28:00,78,160,Eletrônico,6,238
47070,2024-02-02 16:29:00,12,18,Vestuário,2,30
47071,2024-02-02 16:30:00,25,27,Alimento,5,52
47072,2024-02-02 16:31:00,101,168,Brinquedo,9,269
47073,2024-02-02 16:32:00,112,107,Brinquedo,8,219
47074,2024-02-02 16:33:00,83,19,Eletrônico,4,102
47075,2024-02-02 16:34:00,117,169,Móvel,6,286
47076,2024-02-02 16:35:00,20,165,Vestuário,5,185
47077,2024-02-02 16:36:00,47,85,Brinquedo,2,132
47078,2024-02-02 16:37:00,86,35,Alimento,9,121
47079,2024-02-02 16:38:00,53,58,Eletrônico,2,111
47080,2024-02-02 16:39:00,65,125,Brinquedo,1,190
47081,2024-02-02 16:40:00,98,20,Eletrônico,7,118
47082,2024-02-02 16:41:00,42,27,Alimento,1,69
47083,2024-02-02 16:42:00,19,91,Eletrônico,3,110
47084,2024-02-02 16:43:00,72,136,Brinquedo,3,208
47085,2024-02-02 16:44:00,79,130,Alimento,3,209
47086,2024-02-02 16:45:00,41,51,Eletrônico,8,92
47087,2024-02-02 16:46:00,96,105,Vestuário,9,201
47088,2024-02-02 16:47:00,44,67,Alimento,3,111
47089,2024-02-02 16:48:00,67,21,Vestuário,5,88
47090,2024-02-02 16:49:00,35,129,Móvel,7,164
47091,2024-02-02 16:50:00,13,126,Vestuário,7,139
47092,2024-02-02 16:51:00,29,121,Alimento,1,150
47093,2024-02-02 16:52:00,108,138,Eletrônico,8,246
47094,2024-02-02 16:53:00,68,12,Móvel,5,80
47095,2024-02-02 16:54:00,52,20,Eletrônico,2,72
47096,2024-02-02 16:55:00,44,62,Móvel,5,106
47097,2024-02-02 16:56:00,49,61,Alimento,4,110
47098,2024-02-02 16:57:00,87,85,Eletrônico,8,172
47099,2024-02-02 16:58:00,95,115,Eletrônico,9,210
47100,2024-02-02 16:59:00,114,116,Móvel,2,230
47101,2024-02-02 17:00:00,20,152,Móvel,6,172
47102,2024-02-02 17:01:00,10,169,Móvel,7,179
47103,2024-02-02 17:02:00,25,95,Brinquedo,1,120
47104,2024-02-02 17:03:00,15,83,Eletrônico,6,98
47105,2024-02-02 17:04:00,17,14,Vestuário,3,31
47106,2024-02-02 17:05:00,22,71,Eletrônico,9,93
47107,2024-02-02 17:06:00,32,15,Vestuário,8,47
47108,2024-02-02 17:07:00,37,80,Eletrônico,3,117
47109,2024-02-02 17:08:00,11,84,Eletrônico,7,95
47110,2024-02-02 17:09:00,65,66,Móvel,3,131
47111,2024-02-02 17:10:00,37,12,Eletrônico,3,49
47112,2024-02-02 17:11:00,21,85,Eletrônico,5,106
47113,2024-02-02 17:12:00,79,59,Móvel,4,138
47114,2024-02-02 17:13:00,95,84,Eletrônico,6,179
47115,2024-02-02 17:14:00,77,89,Móvel,3,166
47116,2024-02-02 17:15:00,118,94,Brinquedo,4,212
47117,2024-02-02 17:16:00,82,37,Alimento,3,119
47118,2024-02-02 17:17:00,80,157,Alimento,6,237
47119,2024-02-02 17:18:00,32,155,Brinquedo,8,187
47120,2024-02-02 17:19:00,75,131,Eletrônico,6,206
47121,2024-02-02 17:20:00,58,71,Vestuário,9,129
47122,2024-02-02 17:21:00,70,24,Eletrônico,5,94
47123,2024-02-02 17:22:00,37,99,Móvel,3,136
47124,2024-02-02 17:23:00,117,94,Móvel,8,211
47125,2024-02-02 17:24:00,113,39,Vestuário,6,152
47126,2024-02-02 17:25:00,95,40,Eletrônico,8,135
47127,2024-02-02 17:26:00,111,130,Vestuário,3,241
47128,2024-02-02 17:27:00,38,95,Móvel,3,133
47129,2024-02-02 17:28:00,42,158,Vestuário,5,200
47130,2024-02-02 17:29:00,49,32,Brinquedo,4,81
47131,2024-02-02 17:30:00,35,57,Vestuário,2,92
47132,2024-02-02 17:31:00,90,129,Brinquedo,3,219
47133,2024-02-02 17:32:00,118,11,Eletrônico,5,129
47134,2024-02-02 17:33:00,69,22,Móvel,1,91
47135,2024-02-02 17:34:00,30,82,Móvel,2,112
47136,2024-02-02 17:35:00,35,157,Vestuário,7,192
47137,2024-02-02 17:36:00,72,50,Brinquedo,7,122
47138,2024-02-02 17:37:00,51,136,Móvel,1,187
47139,2024-02-02 17:38:00,87,138,Alimento,2,225
47140,2024-02-02 17:39:00,117,38,Alimento,7,155
47141,2024-02-02 17:40:00,30,73,Móvel,3,103
47142,2024-02-02 17:41:00,54,27,Alimento,7,81
47143,2024-02-02 17:42:00,68,115,Brinquedo,5,183
47144,2024-02-02 17:43:00,98,80,Alimento,3,178
47145,2024-02-02 17:44:00,87,105,Brinquedo,5,192
47146,2024-02-02 17:45:00,38,138,Móvel,7,176
47147,2024-02-02 17:46:00,65,108,Alimento,4,173
47148,2024-02-02 17:47:00,95,98,Brinquedo,4,193
47149,2024-02-02 17:48:00,52,109,Eletrônico,3,161
47150,2024-02-02 17:49:00,19,149,Brinquedo,6,168
47151,2024-02-02 17:50:00,80,99,Móvel,7,179
47152,2024-02-02 17:51:00,39,120,Móvel,1,159
47153,2024-02-02 17:52:00,51,18,Brinquedo,2,69
47154,2024-02-02 17:53:00,68,142,Eletrônico,4,210
47155,2024-02-02 17:54:00,28,87,Brinquedo,8,115
47156,2024-02-02 17:55:00,82,117,Eletrônico,8,199
47157,2024-02-02 17:56:00,43,151,Brinquedo,9,194
47158,2024-02-02 17:57:00,31,159,Móvel,2,190
47159,2024-02-02 17:58:00,33,59,Vestuário,5,92
47160,2024-02-02 17:59:00,22,136,Brinquedo,2,158
47161,2024-02-02 18:00:00,45,147,Vestuário,8,192
47162,2024-02-02 18:01:00,45,102,Alimento,3,147
47163,2024-02-02 18:02:00,31,59,Vestuário,2,90
47164,2024-02-02 18:03:00,47,56,Alimento,2,103
47165,2024-02-02 18:04:00,76,144,Móvel,1,220
47166,2024-02-02 18:05:00,89,68,Vestuário,1,157
47167,2024-02-02 18:06:00,51,40,Brinquedo,3,91
47168,2024-02-02 18:07:00,98,123,Alimento,7,221
47169,2024-02-02 18:08:00,102,72,Brinquedo,1,174
47170,2024-02-02 18:09:00,97,127,Alimento,4,224
47171,2024-02-02 18:10:00,58,171,Vestuário,5,229
47172,2024-02-02 18:11:00,89,82,Móvel,9,171
47173,2024-02-02 18:12:00,83,138,Móvel,4,221
47174,2024-02-02 18:13:00,117,179,Eletrônico,2,296
47175,2024-02-02 18:14:00,94,73,Vestuário,6,167
47176,2024-02-02 18:15:00,19,128,Vestuário,3,147
47177,2024-02-02 18:16:00,85,92,Brinquedo,2,177
47178,2024-02-02 18:17:00,40,97,Eletrônico,2,137
47179,2024-02-02 18:18:00,39,147,Alimento,3,186
47180,2024-02-02 18:19:00,72,100,Móvel,3,172
47181,2024-02-02 18:20:00,116,78,Brinquedo,2,194
47182,2024-02-02 18:21:00,35,107,Móvel,4,142
47183,2024-02-02 18:22:00,93,45,Eletrônico,3,138
47184,2024-02-02 18:23:00,35,89,Eletrônico,2,124
47185,2024-02-02 18:24:00,52,31,Alimento,1,83
47186,2024-02-02 18:25:00,56,107,Eletrônico,7,163
47187,2024-02-02 18:26:00,54,151,Eletrônico,3,205
47188,2024-02-02 18:27:00,112,88,Vestuário,3,200
47189,2024-02-02 18:28:00,19,89,Brinquedo,4,108
47190,2024-02-02 18:29:00,40,179,Alimento,5,219
47191,2024-02-02 18:30:00,38,148,Vestuário,2,186
47192,2024-02-02 18:31:00,48,57,Brinquedo,9,105
47193,2024-02-02 18:32:00,93,32,Brinquedo,8,125
47194,2024-02-02 18:33:00,84,96,Alimento,3,180
47195,2024-02-02 18:34:00,10,110,Vestuário,7,120
47196,2024-02-02 18:35:00,117,97,Brinquedo,5,214
47197,2024-02-02 18:36:00,10,149,Alimento,3,159
47198,2024-02-02 18:37:00,88,149,Móvel,8,237
47199,2024-02-02 18:38:00,96,52,Alimento,2,148
47200,2024-02-02 18:39:00,13,47,Brinquedo,1,60
47201,2024-02-02 18:40:00,55,104,Vestuário,2,159
47202,2024-02-02 18:41:00,70,69,Alimento,6,139
47203,2024-02-02 18:42:00,113,161,Eletrônico,7,274
47204,2024-02-02 18:43:00,68,149,Móvel,8,217
47205,2024-02-02 18:44:00,64,81,Brinquedo,5,145
47206,2024-02-02 18:45:00,14,21,Brinquedo,5,35
47207,2024-02-02 18:46:00,118,11,Brinquedo,8,129
47208,2024-02-02 18:47:00,47,82,Móvel,4,129
47209,2024-02-02 18:48:00,17,83,Brinquedo,8,100
47210,2024-02-02 18:49:00,80,155,Brinquedo,6,235
47211,2024-02-02 18:50:00,58,58,Eletrônico,4,116
47212,2024-02-02 18:51:00,32,55,Vestuário,4,87
47213,2024-02-02 18:52:00,36,102,Vestuário,1,138
47214,2024-02-02 18:53:00,43,52,Brinquedo,2,95
47215,2024-02-02 18:54:00,88,128,Vestuário,7,216
47216,2024-02-02 18:55:00,109,70,Vestuário,1,179
47217,2024-02-02 18:56:00,36,40,Alimento,1,76
47218,2024-02-02 18:57:00,69,149,Brinquedo,8,218
47219,2024-02-02 18:58:00,64,161,Móvel,6,225
47220,2024-02-02 18:59:00,119,46,Vestuário,1,165
47221,2024-02-02 19:00:00,55,19,Brinquedo,4,74
47222,2024-02-02 19:01:00,112,80,Vestuário,5,192
47223,2024-02-02 19:02:00,16,68,Brinquedo,9,84
47224,2024-02-02 19:03:00,22,47,Móvel,6,69
47225,2024-02-02 19:04:00,92,123,Brinquedo,6,215
47226,2024-02-02 19:05:00,25,31,Brinquedo,5,56
47227,2024-02-02 19:06:00,91,79,Alimento,6,170
47228,2024-02-02 19:07:00,52,10,Eletrônico,9,62
47229,2024-02-02 19:08:00,12,92,Móvel,7,104
47230,2024-02-02 19:09:00,99,155,Vestuário,3,254
47231,2024-02-02 19:10:00,60,171,Brinquedo,6,231
47232,2024-02-02 19:11:00,116,96,Alimento,3,212
47233,2024-02-02 19:12:00,110,173,Eletrônico,5,283
47234,2024-02-02 19:13:00,94,115,Eletrônico,1,209
47235,2024-02-02 19:14:00,50,70,Vestuário,4,120
47236,2024-02-02 19:15:00,114,78,Eletrônico,4,192
47237,2024-02-02 19:16:00,115,63,Eletrônico,1,178
47238,2024-02-02 19:17:00,67,164,Brinquedo,3,231
47239,2024-02-02 19:18:00,106,27,Móvel,1,133
47240,2024-02-02 19:19:00,36,45,Brinquedo,2,81
47241,2024-02-02 19:20:00,46,78,Brinquedo,7,124
47242,2024-02-02 19:21:00,18,45,Eletrônico,8,63
47243,2024-02-02 19:22:00,62,46,Alimento,2,108
47244,2024-02-02 19:23:00,73,162,Móvel,8,235
47245,2024-02-02 19:24:00,19,164,Vestuário,4,183
47246,2024-02-02 19:25:00,42,27,Alimento,6,69
47247,2024-02-02 19:26:00,104,138,Brinquedo,6,242
47248,2024-02-02 19:27:00,77,135,Eletrônico,4,212
47249,2024-02-02 19:28:00,14,79,Móvel,3,93
47250,2024-02-02 19:29:00,21,91,Móvel,8,112
47251,2024-02-02 19:30:00,97,92,Eletrônico,5,189
47252,2024-02-02 19:31:00,16,119,Vestuário,3,135
47253,2024-02-02 19:32:00,79,80,Móvel,6,159
47254,2024-02-02 19:33:00,62,79,Brinquedo,1,141
47255,2024-02-02 19:34:00,51,108,Alimento,9,159
47256,2024-02-02 19:35:00,77,39,Vestuário,8,116
47257,2024-02-02 19:36:00,60,33,Móvel,1,93
47258,2024-02-02 19:37:00,96,154,Brinquedo,6,250
47259,2024-02-02 19:38:00,76,150,Alimento,2,226
47260,2024-02-02 19:39:00,65,168,Brinquedo,8,233
47261,2024-02-02 19:40:00,93,158,Móvel,8,251
47262,2024-02-02 19:41:00,28,86,Vestuário,4,114
47263,2024-02-02 19:42:00,23,112,Eletrônico,2,135
47264,2024-02-02 19:43:00,67,157,Vestuário,8,224
47265,2024-02-02 19:44:00,97,25,Móvel,6,122
47266,2024-02-02 19:45:00,51,94,Brinquedo,8,145
47267,2024-02-02 19:46:00,82,105,Móvel,9,187
47268,2024-02-02 19:47:00,104,171,Alimento,7,275
47269,2024-02-02 19:48:00,47,30,Brinquedo,9,77
47270,2024-02-02 19:49:00,32,20,Alimento,5,52
47271,2024-02-02 19:50:00,97,62,Eletrônico,3,159
47272,2024-02-02 19:51:00,97,69,Móvel,6,166
47273,2024-02-02 19:52:00,34,82,Vestuário,3,116
47274,2024-02-02 19:53:00,45,129,Alimento,1,174
47275,2024-02-02 19:54:00,116,90,Móvel,9,206
47276,2024-02-02 19:55:00,14,85,Alimento,2,99
47277,2024-02-02 19:56:00,54,176,Brinquedo,1,230
47278,2024-02-02 19:57:00,82,77,Móvel,1,159
47279,2024-02-02 19:58:00,36,138,Brinquedo,4,174
47280,2024-02-02 19:59:00,116,156,Brinquedo,1,272
47281,2024-02-02 20:00:00,22,150,Alimento,7,172
47282,2024-02-02 20:01:00,77,138,Móvel,9,215
47283,2024-02-02 20:02:00,10,12,Móvel,8,22
47284,2024-02-02 20:03:00,79,96,Móvel,2,175
47285,2024-02-02 20:04:00,26,110,Móvel,8,136
47286,2024-02-02 20:05:00,82,19,Móvel,6,101
47287,2024-02-02 20:06:00,20,64,Móvel,6,84
47288,2024-02-02 20:07:00,56,107,Alimento,6,163
47289,2024-02-02 20:08:00,22,131,Alimento,6,153
47290,2024-02-02 20:09:00,22,166,Móvel,7,188
47291,2024-02-02 20:10:00,96,146,Alimento,1,242
47292,2024-02-02 20:11:00,20,139,Alimento,4,159
47293,2024-02-02 20:12:00,70,142,Eletrônico,7,212
47294,2024-02-02 20:13:00,71,95,Móvel,8,166
47295,2024-02-02 20:14:00,91,144,Vestuário,2,235
47296,2024-02-02 20:15:00,47,15,Móvel,2,62
47297,2024-02-02 20:16:00,23,49,Móvel,5,72
47298,2024-02-02 20:17:00,24,164,Eletrônico,3,188
47299,2024-02-02 20:18:00,52,149,Vestuário,3,201
47300,2024-02-02 20:19:00,68,60,Brinquedo,8,128
47301,2024-02-02 20:20:00,48,86,Brinquedo,5,134
47302,2024-02-02 20:21:00,100,26,Móvel,1,126
47303,2024-02-02 20:22:00,37,116,Alimento,6,153
47304,2024-02-02 20:23:00,67,17,Móvel,6,84
47305,2024-02-02 20:24:00,36,41,Brinquedo,2,77
47306,2024-02-02 20:25:00,38,138,Alimento,2,176
47307,2024-02-02 20:26:00,117,56,Eletrônico,7,173
47308,2024-02-02 20:27:00,83,173,Móvel,3,256
47309,2024-02-02 20:28:00,56,10,Eletrônico,2,66
47310,2024-02-02 20:29:00,115,74,Eletrônico,2,189
47311,2024-02-02 20:30:00,13,42,Vestuário,1,55
47312,2024-02-02 20:31:00,42,84,Alimento,3,126
47313,2024-02-02 20:32:00,88,170,Alimento,9,258
47314,2024-02-02 20:33:00,51,13,Eletrônico,1,64
47315,2024-02-02 20:34:00,102,94,Eletrônico,4,196
47316,2024-02-02 20:35:00,91,29,Alimento,5,120
47317,2024-02-02 20:36:00,100,114,Vestuário,6,214
47318,2024-02-02 20:37:00,114,40,Alimento,9,154
47319,2024-02-02 20:38:00,44,77,Brinquedo,6,121
47320,2024-02-02 20:39:00,14,13,Eletrônico,1,27
47321,2024-02-02 20:40:00,93,169,Alimento,9,262
47322,2024-02-02 20:41:00,34,89,Eletrônico,5,123
47323,2024-02-02 20:42:00,54,28,Móvel,3,82
47324,2024-02-02 20:43:00,21,96,Móvel,9,117
47325,2024-02-02 20:44:00,67,101,Móvel,8,168
47326,2024-02-02 20:45:00,24,90,Eletrônico,2,114
47327,2024-02-02 20:46:00,36,168,Brinquedo,5,204
47328,2024-02-02 20:47:00,90,129,Móvel,2,219
47329,2024-02-02 20:48:00,94,51,Eletrônico,4,145
47330,2024-02-02 20:49:00,62,88,Brinquedo,5,150
47331,2024-02-02 20:50:00,16,64,Alimento,9,80
47332,2024-02-02 20:51:00,24,129,Eletrônico,7,153
47333,2024-02-02 20:52:00,34,106,Alimento,7,140
47334,2024-02-02 20:53:00,116,68,Alimento,8,184
47335,2024-02-02 20:54:00,56,129,Alimento,1,185
47336,2024-02-02 20:55:00,116,79,Alimento,8,195
47337,2024-02-02 20:56:00,118,122,Alimento,1,240
47338,2024-02-02 20:57:00,31,37,Móvel,8,68
47339,2024-02-02 20:58:00,78,74,Brinquedo,3,152
47340,2024-02-02 20:59:00,100,67,Eletrônico,8,167
47341,2024-02-02 21:00:00,64,24,Brinquedo,4,88
47342,2024-02-02 21:01:00,79,77,Vestuário,2,156
47343,2024-02-02 21:02:00,110,35,Móvel,6,145
47344,2024-02-02 21:03:00,54,160,Alimento,4,214
47345,2024-02-02 21:04:00,36,93,Brinquedo,7,129
47346,2024-02-02 21:05:00,54,107,Vestuário,9,161
47347,2024-02-02 21:06:00,64,124,Brinquedo,9,188
47348,2024-02-02 21:07:00,92,156,Alimento,2,248
47349,2024-02-02 21:08:00,112,140,Alimento,6,252
47350,2024-02-02 21:09:00,95,139,Alimento,2,234
47351,2024-02-02 21:10:00,102,66,Móvel,4,168
47352,2024-02-02 21:11:00,100,33,Móvel,6,133
47353,2024-02-02 21:12:00,25,10,Eletrônico,6,35
47354,2024-02-02 21:13:00,55,37,Brinquedo,1,92
47355,2024-02-02 21:14:00,90,141,Móvel,6,231
47356,2024-02-02 21:15:00,79,16,Eletrônico,7,95
47357,2024-02-02 21:16:00,117,88,Eletrônico,4,205
47358,2024-02-02 21:17:00,60,107,Vestuário,1,167
47359,2024-02-02 21:18:00,34,69,Brinquedo,2,103
47360,2024-02-02 21:19:00,87,20,Móvel,3,107
47361,2024-02-02 21:20:00,49,115,Móvel,6,164
47362,2024-02-02 21:21:00,95,77,Alimento,2,172
47363,2024-02-02 21:22:00,100,42,Vestuário,7,142
47364,2024-02-02 21:23:00,50,32,Móvel,4,82
47365,2024-02-02 21:24:00,52,111,Vestuário,3,163
47366,2024-02-02 21:25:00,114,124,Móvel,3,238
47367,2024-02-02 21:26:00,33,129,Brinquedo,5,162
47368,2024-02-02 21:27:00,22,145,Alimento,3,167
47369,2024-02-02 21:28:00,43,14,Eletrônico,5,57
47370,2024-02-02 21:29:00,53,157,Brinquedo,3,210
47371,2024-02-02 21:30:00,72,127,Vestuário,2,199
47372,2024-02-02 21:31:00,28,82,Alimento,2,110
47373,2024-02-02 21:32:00,107,135,Móvel,5,242
47374,2024-02-02 21:33:00,110,170,Móvel,7,280
47375,2024-02-02 21:34:00,84,131,Alimento,1,215
47376,2024-02-02 21:35:00,24,114,Alimento,3,138
47377,2024-02-02 21:36:00,19,128,Alimento,7,147
47378,2024-02-02 21:37:00,28,66,Eletrônico,8,94
47379,2024-02-02 21:38:00,67,135,Alimento,5,202
47380,2024-02-02 21:39:00,80,100,Alimento,6,180
47381,2024-02-02 21:40:00,115,54,Brinquedo,3,169
47382,2024-02-02 21:41:00,53,69,Eletrônico,5,122
47383,2024-02-02 21:42:00,76,159,Brinquedo,4,235
47384,2024-02-02 21:43:00,71,117,Alimento,4,188
47385,2024-02-02 21:44:00,26,77,Brinquedo,2,103
47386,2024-02-02 21:45:00,116,151,Móvel,1,267
47387,2024-02-02 21:46:00,46,71,Eletrônico,2,117
47388,2024-02-02 21:47:00,80,47,Eletrônico,9,127
47389,2024-02-02 21:48:00,113,99,Brinquedo,6,212
47390,2024-02-02 21:49:00,99,155,Alimento,9,254
47391,2024-02-02 21:50:00,67,23,Eletrônico,6,90
47392,2024-02-02 21:51:00,108,39,Vestuário,3,147
47393,2024-02-02 21:52:00,66,158,Vestuário,8,224
47394,2024-02-02 21:53:00,80,59,Brinquedo,4,139
47395,2024-02-02 21:54:00,66,158,Eletrônico,1,224
47396,2024-02-02 21:55:00,10,11,Brinquedo,7,21
47397,2024-02-02 21:56:00,29,134,Brinquedo,7,163
47398,2024-02-02 21:57:00,82,104,Vestuário,5,186
47399,2024-02-02 21:58:00,116,121,Brinquedo,9,237
47400,2024-02-02 21:59:00,16,103,Vestuário,2,119
47401,2024-02-02 22:00:00,10,31,Alimento,6,41
47402,2024-02-02 22:01:00,61,69,Alimento,5,130
47403,2024-02-02 22:02:00,35,77,Brinquedo,9,112
47404,2024-02-02 22:03:00,54,49,Brinquedo,8,103
47405,2024-02-02 22:04:00,51,24,Alimento,3,75
47406,2024-02-02 22:05:00,43,179,Alimento,8,222
47407,2024-02-02 22:06:00,13,100,Eletrônico,3,113
47408,2024-02-02 22:07:00,63,164,Vestuário,2,227
47409,2024-02-02 22:08:00,34,15,Brinquedo,3,49
47410,2024-02-02 22:09:00,35,139,Eletrônico,3,174
47411,2024-02-02 22:10:00,79,26,Alimento,7,105
47412,2024-02-02 22:11:00,58,90,Eletrônico,5,148
47413,2024-02-02 22:12:00,42,31,Brinquedo,8,73
47414,2024-02-02 22:13:00,118,164,Móvel,2,282
47415,2024-02-02 22:14:00,22,137,Eletrônico,9,159
47416,2024-02-02 22:15:00,102,74,Brinquedo,9,176
47417,2024-02-02 22:16:00,26,109,Vestuário,9,135
47418,2024-02-02 22:17:00,89,93,Brinquedo,3,182
47419,2024-02-02 22:18:00,73,176,Eletrônico,4,249
47420,2024-02-02 22:19:00,69,126,Eletrônico,4,195
47421,2024-02-02 22:20:00,101,78,Vestuário,5,179
47422,2024-02-02 22:21:00,108,27,Vestuário,1,135
47423,2024-02-02 22:22:00,33,152,Móvel,4,185
47424,2024-02-02 22:23:00,107,39,Alimento,1,146
47425,2024-02-02 22:24:00,103,85,Alimento,9,188
47426,2024-02-02 22:25:00,36,71,Alimento,5,107
47427,2024-02-02 22:26:00,10,177,Alimento,2,187
47428,2024-02-02 22:27:00,74,96,Brinquedo,2,170
47429,2024-02-02 22:28:00,113,21,Eletrônico,8,134
47430,2024-02-02 22:29:00,73,136,Eletrônico,9,209
47431,2024-02-02 22:30:00,104,80,Eletrônico,4,184
47432,2024-02-02 22:31:00,116,175,Vestuário,3,291
47433,2024-02-02 22:32:00,104,36,Brinquedo,2,140
47434,2024-02-02 22:33:00,89,56,Brinquedo,2,145
47435,2024-02-02 22:34:00,68,72,Brinquedo,7,140
47436,2024-02-02 22:35:00,117,121,Vestuário,7,238
47437,2024-02-02 22:36:00,43,121,Alimento,4,164
47438,2024-02-02 22:37:00,61,30,Vestuário,6,91
47439,2024-02-02 22:38:00,54,95,Vestuário,4,149
47440,2024-02-02 22:39:00,26,42,Móvel,3,68
47441,2024-02-02 22:40:00,17,22,Eletrônico,8,39
47442,2024-02-02 22:41:00,57,150,Brinquedo,4,207
47443,2024-02-02 22:42:00,99,20,Móvel,5,119
47444,2024-02-02 22:43:00,42,97,Vestuário,5,139
47445,2024-02-02 22:44:00,41,82,Brinquedo,5,123
47446,2024-02-02 22:45:00,25,168,Eletrônico,6,193
47447,2024-02-02 22:46:00,104,47,Brinquedo,5,151
47448,2024-02-02 22:47:00,83,109,Alimento,1,192
47449,2024-02-02 22:48:00,95,73,Alimento,1,168
47450,2024-02-02 22:49:00,61,141,Alimento,8,202
47451,2024-02-02 22:50:00,91,32,Eletrônico,9,123
47452,2024-02-02 22:51:00,70,109,Alimento,7,179
47453,2024-02-02 22:52:00,50,94,Brinquedo,5,144
47454,2024-02-02 22:53:00,73,65,Brinquedo,8,138
47455,2024-02-02 22:54:00,113,79,Vestuário,3,192
47456,2024-02-02 22:55:00,58,178,Móvel,9,236
47457,2024-02-02 22:56:00,108,132,Alimento,4,240
47458,2024-02-02 22:57:00,68,173,Móvel,4,241
47459,2024-02-02 22:58:00,49,171,Móvel,9,220
47460,2024-02-02 22:59:00,52,64,Eletrônico,7,116
47461,2024-02-02 23:00:00,101,104,Brinquedo,2,205
47462,2024-02-02 23:01:00,110,72,Brinquedo,7,182
47463,2024-02-02 23:02:00,85,142,Eletrônico,9,227
47464,2024-02-02 23:03:00,69,65,Eletrônico,4,134
47465,2024-02-02 23:04:00,88,104,Eletrônico,8,192
47466,2024-02-02 23:05:00,24,143,Vestuário,5,167
47467,2024-02-02 23:06:00,30,173,Vestuário,6,203
47468,2024-02-02 23:07:00,83,30,Alimento,2,113
47469,2024-02-02 23:08:00,19,139,Alimento,2,158
47470,2024-02-02 23:09:00,44,49,Vestuário,6,93
47471,2024-02-02 23:10:00,66,97,Alimento,9,163
47472,2024-02-02 23:11:00,28,58,Móvel,8,86
47473,2024-02-02 23:12:00,17,80,Alimento,2,97
47474,2024-02-02 23:13:00,55,11,Brinquedo,8,66
47475,2024-02-02 23:14:00,73,84,Móvel,8,157
47476,2024-02-02 23:15:00,99,71,Vestuário,9,170
47477,2024-02-02 23:16:00,28,94,Alimento,2,122
47478,2024-02-02 23:17:00,109,48,Brinquedo,9,157
47479,2024-02-02 23:18:00,79,120,Móvel,8,199
47480,2024-02-02 23:19:00,79,137,Vestuário,6,216
47481,2024-02-02 23:20:00,94,60,Alimento,9,154
47482,2024-02-02 23:21:00,115,93,Alimento,5,208
47483,2024-02-02 23:22:00,67,71,Eletrônico,3,138
47484,2024-02-02 23:23:00,68,87,Móvel,9,155
47485,2024-02-02 23:24:00,93,107,Alimento,9,200
47486,2024-02-02 23:25:00,36,170,Alimento,8,206
47487,2024-02-02 23:26:00,74,167,Eletrônico,4,241
47488,2024-02-02 23:27:00,113,46,Eletrônico,6,159
47489,2024-02-02 23:28:00,118,15,Alimento,1,133
47490,2024-02-02 23:29:00,96,140,Eletrônico,8,236
47491,2024-02-02 23:30:00,104,61,Eletrônico,1,165
47492,2024-02-02 23:31:00,78,45,Brinquedo,3,123
47493,2024-02-02 23:32:00,31,65,Alimento,4,96
47494,2024-02-02 23:33:00,45,135,Eletrônico,3,180
47495,2024-02-02 23:34:00,15,73,Vestuário,7,88
47496,2024-02-02 23:35:00,10,89,Móvel,4,99
47497,2024-02-02 23:36:00,106,47,Eletrônico,9,153
47498,2024-02-02 23:37:00,60,100,Alimento,2,160
47499,2024-02-02 23:38:00,117,122,Alimento,1,239
47500,2024-02-02 23:39:00,57,176,Móvel,4,233
47501,2024-02-02 23:40:00,48,137,Vestuário,2,185
47502,2024-02-02 23:41:00,96,74,Brinquedo,6,170
47503,2024-02-02 23:42:00,13,143,Móvel,6,156
47504,2024-02-02 23:43:00,87,147,Eletrônico,2,234
47505,2024-02-02 23:44:00,72,166,Alimento,5,238
47506,2024-02-02 23:45:00,106,75,Móvel,8,181
47507,2024-02-02 23:46:00,70,15,Eletrônico,9,85
47508,2024-02-02 23:47:00,26,106,Vestuário,5,132
47509,2024-02-02 23:48:00,38,133,Alimento,8,171
47510,2024-02-02 23:49:00,73,56,Móvel,5,129
47511,2024-02-02 23:50:00,29,66,Móvel,6,95
47512,2024-02-02 23:51:00,17,101,Eletrônico,6,118
47513,2024-02-02 23:52:00,75,106,Eletrônico,9,181
47514,2024-02-02 23:53:00,60,173,Brinquedo,6,233
47515,2024-02-02 23:54:00,100,44,Vestuário,7,144
47516,2024-02-02 23:55:00,97,163,Vestuário,1,260
47517,2024-02-02 23:56:00,42,111,Brinquedo,7,153
47518,2024-02-02 23:57:00,96,36,Eletrônico,1,132
47519,2024-02-02 23:58:00,88,14,Vestuário,6,102
47520,2024-02-02 23:59:00,15,175,Vestuário,3,190
47521,2024-02-03 00:00:00,16,89,Eletrônico,7,105
47522,2024-02-03 00:01:00,85,11,Móvel,2,96
47523,2024-02-03 00:02:00,42,129,Eletrônico,1,171
47524,2024-02-03 00:03:00,71,155,Móvel,1,226
47525,2024-02-03 00:04:00,62,55,Móvel,2,117
47526,2024-02-03 00:05:00,43,122,Eletrônico,9,165
47527,2024-02-03 00:06:00,47,143,Vestuário,8,190
47528,2024-02-03 00:07:00,83,165,Alimento,6,248
47529,2024-02-03 00:08:00,15,61,Móvel,2,76
47530,2024-02-03 00:09:00,41,91,Alimento,4,132
47531,2024-02-03 00:10:00,116,134,Alimento,4,250
47532,2024-02-03 00:11:00,81,64,Alimento,3,145
47533,2024-02-03 00:12:00,68,117,Alimento,6,185
47534,2024-02-03 00:13:00,33,133,Eletrônico,8,166
47535,2024-02-03 00:14:00,116,151,Brinquedo,1,267
47536,2024-02-03 00:15:00,105,34,Móvel,7,139
47537,2024-02-03 00:16:00,26,113,Vestuário,6,139
47538,2024-02-03 00:17:00,70,121,Brinquedo,5,191
47539,2024-02-03 00:18:00,102,136,Móvel,1,238
47540,2024-02-03 00:19:00,89,92,Brinquedo,6,181
47541,2024-02-03 00:20:00,33,114,Brinquedo,9,147
47542,2024-02-03 00:21:00,33,111,Alimento,6,144
47543,2024-02-03 00:22:00,61,108,Móvel,7,169
47544,2024-02-03 00:23:00,20,105,Vestuário,8,125
47545,2024-02-03 00:24:00,108,101,Vestuário,7,209
47546,2024-02-03 00:25:00,102,72,Eletrônico,7,174
47547,2024-02-03 00:26:00,68,74,Vestuário,5,142
47548,2024-02-03 00:27:00,50,161,Eletrônico,7,211
47549,2024-02-03 00:28:00,54,60,Eletrônico,8,114
47550,2024-02-03 00:29:00,80,81,Alimento,9,161
47551,2024-02-03 00:30:00,103,133,Vestuário,9,236
47552,2024-02-03 00:31:00,31,74,Móvel,2,105
47553,2024-02-03 00:32:00,56,56,Vestuário,4,112
47554,2024-02-03 00:33:00,24,110,Brinquedo,4,134
47555,2024-02-03 00:34:00,37,114,Vestuário,9,151
47556,2024-02-03 00:35:00,75,22,Brinquedo,3,97
47557,2024-02-03 00:36:00,76,31,Vestuário,9,107
47558,2024-02-03 00:37:00,101,84,Alimento,5,185
47559,2024-02-03 00:38:00,75,19,Alimento,7,94
47560,2024-02-03 00:39:00,64,138,Brinquedo,5,202
47561,2024-02-03 00:40:00,18,22,Vestuário,6,40
47562,2024-02-03 00:41:00,19,163,Eletrônico,1,182
47563,2024-02-03 00:42:00,87,125,Móvel,7,212
47564,2024-02-03 00:43:00,79,101,Móvel,7,180
47565,2024-02-03 00:44:00,26,122,Alimento,5,148
47566,2024-02-03 00:45:00,41,122,Móvel,9,163
47567,2024-02-03 00:46:00,83,61,Vestuário,6,144
47568,2024-02-03 00:47:00,18,94,Alimento,8,112
47569,2024-02-03 00:48:00,44,115,Brinquedo,3,159
47570,2024-02-03 00:49:00,24,72,Brinquedo,3,96
47571,2024-02-03 00:50:00,23,25,Móvel,9,48
47572,2024-02-03 00:51:00,15,38,Móvel,3,53
47573,2024-02-03 00:52:00,80,116,Móvel,5,196
47574,2024-02-03 00:53:00,33,110,Vestuário,8,143
47575,2024-02-03 00:54:00,76,135,Eletrônico,1,211
47576,2024-02-03 00:55:00,103,76,Móvel,6,179
47577,2024-02-03 00:56:00,111,16,Móvel,5,127
47578,2024-02-03 00:57:00,34,64,Móvel,7,98
47579,2024-02-03 00:58:00,60,21,Eletrônico,5,81
47580,2024-02-03 00:59:00,13,116,Eletrônico,1,129
47581,2024-02-03 01:00:00,40,14,Móvel,4,54
47582,2024-02-03 01:01:00,109,23,Eletrônico,2,132
47583,2024-02-03 01:02:00,57,55,Móvel,3,112
47584,2024-02-03 01:03:00,87,80,Alimento,6,167
47585,2024-02-03 01:04:00,34,117,Móvel,9,151
47586,2024-02-03 01:05:00,91,73,Brinquedo,7,164
47587,2024-02-03 01:06:00,88,104,Brinquedo,9,192
47588,2024-02-03 01:07:00,39,12,Vestuário,7,51
47589,2024-02-03 01:08:00,95,155,Brinquedo,2,250
47590,2024-02-03 01:09:00,87,12,Eletrônico,5,99
47591,2024-02-03 01:10:00,95,45,Alimento,2,140
47592,2024-02-03 01:11:00,48,66,Móvel,4,114
47593,2024-02-03 01:12:00,68,137,Vestuário,9,205
47594,2024-02-03 01:13:00,68,132,Vestuário,2,200
47595,2024-02-03 01:14:00,14,112,Alimento,5,126
47596,2024-02-03 01:15:00,116,78,Eletrônico,4,194
47597,2024-02-03 01:16:00,48,14,Móvel,1,62
47598,2024-02-03 01:17:00,17,36,Eletrônico,6,53
47599,2024-02-03 01:18:00,68,141,Vestuário,1,209
47600,2024-02-03 01:19:00,113,148,Móvel,7,261
47601,2024-02-03 01:20:00,100,135,Alimento,6,235
47602,2024-02-03 01:21:00,64,105,Vestuário,3,169
47603,2024-02-03 01:22:00,50,54,Móvel,7,104
47604,2024-02-03 01:23:00,116,167,Alimento,9,283
47605,2024-02-03 01:24:00,11,42,Alimento,9,53
47606,2024-02-03 01:25:00,28,14,Brinquedo,1,42
47607,2024-02-03 01:26:00,72,174,Brinquedo,9,246
47608,2024-02-03 01:27:00,80,164,Eletrônico,4,244
47609,2024-02-03 01:28:00,90,118,Eletrônico,9,208
47610,2024-02-03 01:29:00,54,13,Alimento,7,67
47611,2024-02-03 01:30:00,63,124,Móvel,1,187
47612,2024-02-03 01:31:00,71,72,Alimento,6,143
47613,2024-02-03 01:32:00,19,10,Brinquedo,5,29
47614,2024-02-03 01:33:00,73,144,Alimento,4,217
47615,2024-02-03 01:34:00,74,43,Eletrônico,3,117
47616,2024-02-03 01:35:00,72,15,Eletrônico,3,87
47617,2024-02-03 01:36:00,35,118,Alimento,7,153
47618,2024-02-03 01:37:00,54,63,Móvel,9,117
47619,2024-02-03 01:38:00,113,139,Vestuário,2,252
47620,2024-02-03 01:39:00,53,10,Brinquedo,9,63
47621,2024-02-03 01:40:00,64,24,Brinquedo,5,88
47622,2024-02-03 01:41:00,18,138,Eletrônico,5,156
47623,2024-02-03 01:42:00,84,32,Brinquedo,5,116
47624,2024-02-03 01:43:00,47,164,Móvel,6,211
47625,2024-02-03 01:44:00,58,33,Vestuário,8,91
47626,2024-02-03 01:45:00,40,91,Vestuário,4,131
47627,2024-02-03 01:46:00,109,132,Alimento,6,241
47628,2024-02-03 01:47:00,11,62,Alimento,3,73
47629,2024-02-03 01:48:00,87,119,Móvel,7,206
47630,2024-02-03 01:49:00,119,145,Móvel,5,264
47631,2024-02-03 01:50:00,80,171,Brinquedo,1,251
47632,2024-02-03 01:51:00,11,69,Brinquedo,6,80
47633,2024-02-03 01:52:00,29,19,Móvel,6,48
47634,2024-02-03 01:53:00,71,118,Eletrônico,5,189
47635,2024-02-03 01:54:00,84,176,Brinquedo,5,260
47636,2024-02-03 01:55:00,11,133,Eletrônico,6,144
47637,2024-02-03 01:56:00,38,36,Eletrônico,8,74
47638,2024-02-03 01:57:00,98,133,Móvel,9,231
47639,2024-02-03 01:58:00,117,127,Alimento,6,244
47640,2024-02-03 01:59:00,17,157,Alimento,1,174
47641,2024-02-03 02:00:00,61,131,Eletrônico,4,192
47642,2024-02-03 02:01:00,106,22,Eletrônico,8,128
47643,2024-02-03 02:02:00,91,126,Brinquedo,7,217
47644,2024-02-03 02:03:00,10,179,Móvel,1,189
47645,2024-02-03 02:04:00,89,173,Alimento,4,262
47646,2024-02-03 02:05:00,106,58,Eletrônico,9,164
47647,2024-02-03 02:06:00,110,86,Brinquedo,5,196
47648,2024-02-03 02:07:00,42,149,Brinquedo,4,191
47649,2024-02-03 02:08:00,80,23,Alimento,5,103
47650,2024-02-03 02:09:00,13,141,Eletrônico,3,154
47651,2024-02-03 02:10:00,80,86,Eletrônico,6,166
47652,2024-02-03 02:11:00,73,99,Brinquedo,4,172
47653,2024-02-03 02:12:00,114,175,Móvel,1,289
47654,2024-02-03 02:13:00,46,59,Brinquedo,8,105
47655,2024-02-03 02:14:00,93,155,Móvel,9,248
47656,2024-02-03 02:15:00,69,133,Móvel,6,202
47657,2024-02-03 02:16:00,50,136,Alimento,1,186
47658,2024-02-03 02:17:00,44,134,Vestuário,7,178
47659,2024-02-03 02:18:00,61,66,Eletrônico,2,127
47660,2024-02-03 02:19:00,42,130,Móvel,2,172
47661,2024-02-03 02:20:00,49,169,Eletrônico,8,218
47662,2024-02-03 02:21:00,111,106,Alimento,4,217
47663,2024-02-03 02:22:00,53,14,Móvel,8,67
47664,2024-02-03 02:23:00,82,97,Móvel,2,179
47665,2024-02-03 02:24:00,65,71,Móvel,8,136
47666,2024-02-03 02:25:00,36,90,Brinquedo,2,126
47667,2024-02-03 02:26:00,16,128,Eletrônico,5,144
47668,2024-02-03 02:27:00,99,162,Alimento,4,261
47669,2024-02-03 02:28:00,61,59,Eletrônico,9,120
47670,2024-02-03 02:29:00,95,27,Vestuário,3,122
47671,2024-02-03 02:30:00,119,62,Vestuário,3,181
47672,2024-02-03 02:31:00,67,138,Alimento,3,205
47673,2024-02-03 02:32:00,20,157,Móvel,5,177
47674,2024-02-03 02:33:00,107,166,Eletrônico,3,273
47675,2024-02-03 02:34:00,50,85,Vestuário,9,135
47676,2024-02-03 02:35:00,62,56,Alimento,8,118
47677,2024-02-03 02:36:00,63,23,Vestuário,7,86
47678,2024-02-03 02:37:00,96,96,Alimento,5,192
47679,2024-02-03 02:38:00,104,170,Eletrônico,1,274
47680,2024-02-03 02:39:00,87,82,Alimento,8,169
47681,2024-02-03 02:40:00,55,22,Brinquedo,9,77
47682,2024-02-03 02:41:00,24,42,Vestuário,9,66
47683,2024-02-03 02:42:00,116,171,Móvel,6,287
47684,2024-02-03 02:43:00,14,60,Eletrônico,1,74
47685,2024-02-03 02:44:00,49,12,Alimento,9,61
47686,2024-02-03 02:45:00,111,155,Alimento,9,266
47687,2024-02-03 02:46:00,94,126,Alimento,2,220
47688,2024-02-03 02:47:00,111,106,Eletrônico,4,217
47689,2024-02-03 02:48:00,67,177,Brinquedo,8,244
47690,2024-02-03 02:49:00,68,167,Brinquedo,9,235
47691,2024-02-03 02:50:00,49,99,Vestuário,8,148
47692,2024-02-03 02:51:00,82,97,Eletrônico,9,179
47693,2024-02-03 02:52:00,60,17,Móvel,4,77
47694,2024-02-03 02:53:00,73,115,Vestuário,6,188
47695,2024-02-03 02:54:00,30,104,Móvel,7,134
47696,2024-02-03 02:55:00,70,117,Brinquedo,8,187
47697,2024-02-03 02:56:00,50,66,Eletrônico,4,116
47698,2024-02-03 02:57:00,24,155,Alimento,5,179
47699,2024-02-03 02:58:00,17,56,Eletrônico,2,73
47700,2024-02-03 02:59:00,25,82,Brinquedo,2,107
47701,2024-02-03 03:00:00,75,23,Eletrônico,1,98
47702,2024-02-03 03:01:00,45,177,Eletrônico,2,222
47703,2024-02-03 03:02:00,11,121,Móvel,6,132
47704,2024-02-03 03:03:00,90,166,Alimento,4,256
47705,2024-02-03 03:04:00,111,55,Vestuário,3,166
47706,2024-02-03 03:05:00,105,105,Eletrônico,3,210
47707,2024-02-03 03:06:00,69,103,Alimento,1,172
47708,2024-02-03 03:07:00,33,88,Alimento,8,121
47709,2024-02-03 03:08:00,102,144,Vestuário,5,246
47710,2024-02-03 03:09:00,90,42,Brinquedo,3,132
47711,2024-02-03 03:10:00,109,44,Vestuário,8,153
47712,2024-02-03 03:11:00,112,55,Brinquedo,2,167
47713,2024-02-03 03:12:00,106,36,Vestuário,9,142
47714,2024-02-03 03:13:00,99,65,Eletrônico,3,164
47715,2024-02-03 03:14:00,10,107,Eletrônico,2,117
47716,2024-02-03 03:15:00,103,117,Móvel,5,220
47717,2024-02-03 03:16:00,84,24,Eletrônico,4,108
47718,2024-02-03 03:17:00,25,23,Brinquedo,1,48
47719,2024-02-03 03:18:00,19,43,Vestuário,1,62
47720,2024-02-03 03:19:00,80,82,Eletrônico,7,162
47721,2024-02-03 03:20:00,96,43,Brinquedo,8,139
47722,2024-02-03 03:21:00,48,99,Alimento,2,147
47723,2024-02-03 03:22:00,44,57,Brinquedo,1,101
47724,2024-02-03 03:23:00,105,135,Eletrônico,6,240
47725,2024-02-03 03:24:00,106,116,Vestuário,1,222
47726,2024-02-03 03:25:00,85,98,Brinquedo,4,183
47727,2024-02-03 03:26:00,83,136,Alimento,7,219
47728,2024-02-03 03:27:00,83,84,Alimento,3,167
47729,2024-02-03 03:28:00,34,13,Brinquedo,9,47
47730,2024-02-03 03:29:00,14,139,Eletrônico,4,153
47731,2024-02-03 03:30:00,81,146,Vestuário,1,227
47732,2024-02-03 03:31:00,67,120,Eletrônico,2,187
47733,2024-02-03 03:32:00,34,164,Eletrônico,4,198
47734,2024-02-03 03:33:00,82,166,Eletrônico,1,248
47735,2024-02-03 03:34:00,92,114,Móvel,8,206
47736,2024-02-03 03:35:00,79,96,Alimento,7,175
47737,2024-02-03 03:36:00,104,57,Móvel,1,161
47738,2024-02-03 03:37:00,110,49,Alimento,1,159
47739,2024-02-03 03:38:00,79,130,Móvel,3,209
47740,2024-02-03 03:39:00,77,20,Vestuário,4,97
47741,2024-02-03 03:40:00,83,12,Alimento,5,95
47742,2024-02-03 03:41:00,17,138,Alimento,9,155
47743,2024-02-03 03:42:00,31,139,Eletrônico,8,170
47744,2024-02-03 03:43:00,31,93,Brinquedo,5,124
47745,2024-02-03 03:44:00,16,90,Alimento,9,106
47746,2024-02-03 03:45:00,117,61,Vestuário,4,178
47747,2024-02-03 03:46:00,79,153,Alimento,7,232
47748,2024-02-03 03:47:00,78,34,Móvel,9,112
47749,2024-02-03 03:48:00,88,99,Eletrônico,9,187
47750,2024-02-03 03:49:00,18,78,Vestuário,5,96
47751,2024-02-03 03:50:00,90,37,Alimento,7,127
47752,2024-02-03 03:51:00,105,175,Eletrônico,2,280
47753,2024-02-03 03:52:00,73,111,Eletrônico,3,184
47754,2024-02-03 03:53:00,10,69,Vestuário,9,79
47755,2024-02-03 03:54:00,57,91,Alimento,3,148
47756,2024-02-03 03:55:00,104,60,Alimento,1,164
47757,2024-02-03 03:56:00,65,132,Vestuário,8,197
47758,2024-02-03 03:57:00,61,113,Móvel,1,174
47759,2024-02-03 03:58:00,101,39,Brinquedo,6,140
47760,2024-02-03 03:59:00,49,72,Vestuário,7,121
47761,2024-02-03 04:00:00,39,151,Vestuário,6,190
47762,2024-02-03 04:01:00,61,155,Eletrônico,2,216
47763,2024-02-03 04:02:00,84,139,Vestuário,3,223
47764,2024-02-03 04:03:00,68,67,Vestuário,4,135
47765,2024-02-03 04:04:00,102,17,Brinquedo,6,119
47766,2024-02-03 04:05:00,77,20,Brinquedo,4,97
47767,2024-02-03 04:06:00,13,88,Eletrônico,7,101
47768,2024-02-03 04:07:00,38,96,Brinquedo,5,134
47769,2024-02-03 04:08:00,87,58,Eletrônico,2,145
47770,2024-02-03 04:09:00,72,66,Brinquedo,4,138
47771,2024-02-03 04:10:00,72,43,Alimento,1,115
47772,2024-02-03 04:11:00,109,37,Brinquedo,7,146
47773,2024-02-03 04:12:00,91,45,Vestuário,3,136
47774,2024-02-03 04:13:00,105,121,Brinquedo,3,226
47775,2024-02-03 04:14:00,61,171,Brinquedo,3,232
47776,2024-02-03 04:15:00,105,22,Eletrônico,3,127
47777,2024-02-03 04:16:00,33,61,Brinquedo,7,94
47778,2024-02-03 04:17:00,85,92,Vestuário,3,177
47779,2024-02-03 04:18:00,61,72,Vestuário,9,133
47780,2024-02-03 04:19:00,83,142,Vestuário,9,225
47781,2024-02-03 04:20:00,41,130,Eletrônico,5,171
47782,2024-02-03 04:21:00,105,32,Eletrônico,2,137
47783,2024-02-03 04:22:00,113,112,Eletrônico,4,225
47784,2024-02-03 04:23:00,114,47,Móvel,1,161
47785,2024-02-03 04:24:00,35,112,Alimento,4,147
47786,2024-02-03 04:25:00,19,108,Móvel,5,127
47787,2024-02-03 04:26:00,70,147,Móvel,6,217
47788,2024-02-03 04:27:00,56,62,Eletrônico,4,118
47789,2024-02-03 04:28:00,17,151,Eletrônico,4,168
47790,2024-02-03 04:29:00,100,28,Brinquedo,2,128
47791,2024-02-03 04:30:00,82,111,Alimento,4,193
47792,2024-02-03 04:31:00,31,13,Eletrônico,7,44
47793,2024-02-03 04:32:00,91,131,Móvel,8,222
47794,2024-02-03 04:33:00,117,12,Alimento,1,129
47795,2024-02-03 04:34:00,33,16,Eletrônico,5,49
47796,2024-02-03 04:35:00,49,27,Vestuário,2,76
47797,2024-02-03 04:36:00,82,19,Vestuário,7,101
47798,2024-02-03 04:37:00,37,65,Móvel,5,102
47799,2024-02-03 04:38:00,50,101,Móvel,1,151
47800,2024-02-03 04:39:00,58,155,Móvel,2,213
47801,2024-02-03 04:40:00,37,38,Brinquedo,3,75
47802,2024-02-03 04:41:00,92,15,Vestuário,6,107
47803,2024-02-03 04:42:00,45,128,Vestuário,7,173
47804,2024-02-03 04:43:00,41,124,Alimento,5,165
47805,2024-02-03 04:44:00,92,90,Móvel,5,182
47806,2024-02-03 04:45:00,116,84,Móvel,8,200
47807,2024-02-03 04:46:00,84,145,Eletrônico,1,229
47808,2024-02-03 04:47:00,22,145,Eletrônico,7,167
47809,2024-02-03 04:48:00,71,159,Brinquedo,9,230
47810,2024-02-03 04:49:00,108,24,Móvel,8,132
47811,2024-02-03 04:50:00,97,138,Brinquedo,4,235
47812,2024-02-03 04:51:00,27,44,Vestuário,8,71
47813,2024-02-03 04:52:00,34,12,Vestuário,2,46
47814,2024-02-03 04:53:00,26,149,Brinquedo,2,175
47815,2024-02-03 04:54:00,49,34,Brinquedo,2,83
47816,2024-02-03 04:55:00,10,19,Eletrônico,2,29
47817,2024-02-03 04:56:00,12,91,Eletrônico,5,103
47818,2024-02-03 04:57:00,100,74,Eletrônico,7,174
47819,2024-02-03 04:58:00,29,32,Móvel,9,61
47820,2024-02-03 04:59:00,31,131,Eletrônico,2,162
47821,2024-02-03 05:00:00,118,88,Vestuário,2,206
47822,2024-02-03 05:01:00,13,86,Vestuário,8,99
47823,2024-02-03 05:02:00,29,41,Vestuário,4,70
47824,2024-02-03 05:03:00,90,52,Alimento,4,142
47825,2024-02-03 05:04:00,85,13,Eletrônico,4,98
47826,2024-02-03 05:05:00,79,150,Vestuário,8,229
47827,2024-02-03 05:06:00,70,101,Vestuário,7,171
47828,2024-02-03 05:07:00,18,54,Brinquedo,8,72
47829,2024-02-03 05:08:00,88,138,Alimento,7,226
47830,2024-02-03 05:09:00,99,65,Alimento,1,164
47831,2024-02-03 05:10:00,114,66,Móvel,6,180
47832,2024-02-03 05:11:00,88,108,Brinquedo,6,196
47833,2024-02-03 05:12:00,47,59,Eletrônico,3,106
47834,2024-02-03 05:13:00,29,39,Vestuário,4,68
47835,2024-02-03 05:14:00,46,174,Alimento,6,220
47836,2024-02-03 05:15:00,113,78,Eletrônico,3,191
47837,2024-02-03 05:16:00,54,105,Brinquedo,2,159
47838,2024-02-03 05:17:00,23,33,Alimento,8,56
47839,2024-02-03 05:18:00,89,84,Eletrônico,7,173
47840,2024-02-03 05:19:00,52,147,Eletrônico,1,199
47841,2024-02-03 05:20:00,62,122,Móvel,7,184
47842,2024-02-03 05:21:00,109,131,Vestuário,7,240
47843,2024-02-03 05:22:00,43,128,Eletrônico,2,171
47844,2024-02-03 05:23:00,49,129,Móvel,6,178
47845,2024-02-03 05:24:00,113,118,Móvel,2,231
47846,2024-02-03 05:25:00,37,46,Brinquedo,2,83
47847,2024-02-03 05:26:00,27,19,Eletrônico,3,46
47848,2024-02-03 05:27:00,93,111,Alimento,9,204
47849,2024-02-03 05:28:00,33,45,Móvel,3,78
47850,2024-02-03 05:29:00,11,120,Brinquedo,6,131
47851,2024-02-03 05:30:00,16,179,Eletrônico,5,195
47852,2024-02-03 05:31:00,73,60,Alimento,5,133
47853,2024-02-03 05:32:00,50,66,Alimento,9,116
47854,2024-02-03 05:33:00,41,179,Brinquedo,1,220
47855,2024-02-03 05:34:00,16,179,Vestuário,4,195
47856,2024-02-03 05:35:00,113,78,Móvel,4,191
47857,2024-02-03 05:36:00,31,14,Vestuário,4,45
47858,2024-02-03 05:37:00,36,124,Vestuário,2,160
47859,2024-02-03 05:38:00,48,65,Eletrônico,6,113
47860,2024-02-03 05:39:00,111,96,Móvel,7,207
47861,2024-02-03 05:40:00,52,153,Vestuário,2,205
47862,2024-02-03 05:41:00,74,94,Brinquedo,8,168
47863,2024-02-03 05:42:00,65,153,Móvel,4,218
47864,2024-02-03 05:43:00,47,56,Eletrônico,2,103
47865,2024-02-03 05:44:00,96,127,Alimento,2,223
47866,2024-02-03 05:45:00,107,80,Móvel,8,187
47867,2024-02-03 05:46:00,55,38,Alimento,8,93
47868,2024-02-03 05:47:00,18,142,Móvel,9,160
47869,2024-02-03 05:48:00,118,175,Móvel,4,293
47870,2024-02-03 05:49:00,111,47,Alimento,9,158
47871,2024-02-03 05:50:00,106,167,Vestuário,3,273
47872,2024-02-03 05:51:00,49,64,Móvel,5,113
47873,2024-02-03 05:52:00,113,55,Eletrônico,3,168
47874,2024-02-03 05:53:00,93,163,Eletrônico,6,256
47875,2024-02-03 05:54:00,97,75,Eletrônico,8,172
47876,2024-02-03 05:55:00,64,155,Brinquedo,1,219
47877,2024-02-03 05:56:00,113,153,Eletrônico,6,266
47878,2024-02-03 05:57:00,61,168,Alimento,7,229
47879,2024-02-03 05:58:00,62,25,Alimento,8,87
47880,2024-02-03 05:59:00,68,55,Eletrônico,4,123
47881,2024-02-03 06:00:00,64,51,Eletrônico,1,115
47882,2024-02-03 06:01:00,56,52,Brinquedo,5,108
47883,2024-02-03 06:02:00,74,31,Eletrônico,4,105
47884,2024-02-03 06:03:00,87,148,Brinquedo,4,235
47885,2024-02-03 06:04:00,48,167,Eletrônico,9,215
47886,2024-02-03 06:05:00,103,95,Vestuário,8,198
47887,2024-02-03 06:06:00,86,162,Eletrônico,9,248
47888,2024-02-03 06:07:00,84,175,Móvel,1,259
47889,2024-02-03 06:08:00,118,35,Eletrônico,4,153
47890,2024-02-03 06:09:00,111,143,Móvel,6,254
47891,2024-02-03 06:10:00,77,171,Alimento,6,248
47892,2024-02-03 06:11:00,68,74,Alimento,9,142
47893,2024-02-03 06:12:00,28,142,Móvel,9,170
47894,2024-02-03 06:13:00,45,131,Móvel,7,176
47895,2024-02-03 06:14:00,62,118,Alimento,7,180
47896,2024-02-03 06:15:00,91,15,Alimento,7,106
47897,2024-02-03 06:16:00,49,148,Alimento,5,197
47898,2024-02-03 06:17:00,15,54,Alimento,4,69
47899,2024-02-03 06:18:00,23,147,Eletrônico,7,170
47900,2024-02-03 06:19:00,50,35,Eletrônico,7,85
47901,2024-02-03 06:20:00,39,145,Alimento,9,184
47902,2024-02-03 06:21:00,116,162,Vestuário,3,278
47903,2024-02-03 06:22:00,99,177,Eletrônico,3,276
47904,2024-02-03 06:23:00,56,68,Eletrônico,2,124
47905,2024-02-03 06:24:00,79,138,Eletrônico,2,217
47906,2024-02-03 06:25:00,66,10,Móvel,2,76
47907,2024-02-03 06:26:00,100,105,Alimento,7,205
47908,2024-02-03 06:27:00,55,137,Móvel,6,192
47909,2024-02-03 06:28:00,14,163,Eletrônico,3,177
47910,2024-02-03 06:29:00,92,135,Eletrônico,8,227
47911,2024-02-03 06:30:00,99,170,Alimento,1,269
47912,2024-02-03 06:31:00,32,35,Vestuário,8,67
47913,2024-02-03 06:32:00,95,121,Eletrônico,2,216
47914,2024-02-03 06:33:00,29,96,Brinquedo,1,125
47915,2024-02-03 06:34:00,107,170,Vestuário,8,277
47916,2024-02-03 06:35:00,57,148,Vestuário,7,205
47917,2024-02-03 06:36:00,110,162,Vestuário,7,272
47918,2024-02-03 06:37:00,116,162,Alimento,1,278
47919,2024-02-03 06:38:00,111,50,Eletrônico,4,161
47920,2024-02-03 06:39:00,33,112,Alimento,9,145
47921,2024-02-03 06:40:00,28,79,Vestuário,7,107
47922,2024-02-03 06:41:00,44,159,Alimento,7,203
47923,2024-02-03 06:42:00,66,25,Alimento,5,91
47924,2024-02-03 06:43:00,16,136,Móvel,5,152
47925,2024-02-03 06:44:00,116,16,Eletrônico,5,132
47926,2024-02-03 06:45:00,54,29,Alimento,6,83
47927,2024-02-03 06:46:00,37,88,Alimento,3,125
47928,2024-02-03 06:47:00,44,15,Móvel,8,59
47929,2024-02-03 06:48:00,92,107,Móvel,5,199
47930,2024-02-03 06:49:00,61,48,Móvel,1,109
47931,2024-02-03 06:50:00,59,92,Vestuário,6,151
47932,2024-02-03 06:51:00,95,29,Eletrônico,3,124
47933,2024-02-03 06:52:00,106,162,Vestuário,2,268
47934,2024-02-03 06:53:00,55,165,Móvel,2,220
47935,2024-02-03 06:54:00,77,96,Alimento,7,173
47936,2024-02-03 06:55:00,25,130,Móvel,8,155
47937,2024-02-03 06:56:00,30,139,Alimento,8,169
47938,2024-02-03 06:57:00,11,133,Móvel,8,144
47939,2024-02-03 06:58:00,119,68,Vestuário,5,187
47940,2024-02-03 06:59:00,82,13,Brinquedo,7,95
47941,2024-02-03 07:00:00,77,58,Móvel,3,135
47942,2024-02-03 07:01:00,56,69,Móvel,6,125
47943,2024-02-03 07:02:00,27,161,Eletrônico,1,188
47944,2024-02-03 07:03:00,21,72,Alimento,7,93
47945,2024-02-03 07:04:00,88,119,Móvel,1,207
47946,2024-02-03 07:05:00,47,139,Brinquedo,9,186
47947,2024-02-03 07:06:00,50,64,Eletrônico,2,114
47948,2024-02-03 07:07:00,91,47,Vestuário,9,138
47949,2024-02-03 07:08:00,36,58,Eletrônico,8,94
47950,2024-02-03 07:09:00,97,74,Alimento,4,171
47951,2024-02-03 07:10:00,72,169,Alimento,4,241
47952,2024-02-03 07:11:00,73,50,Eletrônico,4,123
47953,2024-02-03 07:12:00,31,139,Alimento,4,170
47954,2024-02-03 07:13:00,43,98,Alimento,4,141
47955,2024-02-03 07:14:00,18,69,Brinquedo,1,87
47956,2024-02-03 07:15:00,14,139,Brinquedo,1,153
47957,2024-02-03 07:16:00,84,160,Alimento,9,244
47958,2024-02-03 07:17:00,95,94,Alimento,1,189
47959,2024-02-03 07:18:00,100,137,Alimento,7,237
47960,2024-02-03 07:19:00,111,72,Eletrônico,6,183
47961,2024-02-03 07:20:00,78,148,Eletrônico,3,226
47962,2024-02-03 07:21:00,19,81,Móvel,5,100
47963,2024-02-03 07:22:00,114,93,Eletrônico,3,207
47964,2024-02-03 07:23:00,101,157,Alimento,1,258
47965,2024-02-03 07:24:00,58,125,Vestuário,1,183
47966,2024-02-03 07:25:00,118,118,Vestuário,2,236
47967,2024-02-03 07:26:00,115,46,Eletrônico,3,161
47968,2024-02-03 07:27:00,35,70,Brinquedo,6,105
47969,2024-02-03 07:28:00,88,150,Vestuário,9,238
47970,2024-02-03 07:29:00,22,145,Vestuário,5,167
47971,2024-02-03 07:30:00,19,123,Alimento,5,142
47972,2024-02-03 07:31:00,76,91,Móvel,6,167
47973,2024-02-03 07:32:00,25,88,Eletrônico,2,113
47974,2024-02-03 07:33:00,111,122,Alimento,3,233
47975,2024-02-03 07:34:00,14,78,Vestuário,4,92
47976,2024-02-03 07:35:00,29,110,Brinquedo,3,139
47977,2024-02-03 07:36:00,86,102,Alimento,9,188
47978,2024-02-03 07:37:00,37,137,Eletrônico,5,174
47979,2024-02-03 07:38:00,110,35,Eletrônico,6,145
47980,2024-02-03 07:39:00,65,65,Eletrônico,5,130
47981,2024-02-03 07:40:00,111,39,Eletrônico,3,150
47982,2024-02-03 07:41:00,113,21,Móvel,7,134
47983,2024-02-03 07:42:00,28,164,Eletrônico,3,192
47984,2024-02-03 07:43:00,34,172,Eletrônico,6,206
47985,2024-02-03 07:44:00,40,34,Eletrônico,5,74
47986,2024-02-03 07:45:00,25,62,Alimento,1,87
47987,2024-02-03 07:46:00,47,28,Eletrônico,8,75
47988,2024-02-03 07:47:00,48,72,Alimento,1,120
47989,2024-02-03 07:48:00,91,56,Alimento,9,147
47990,2024-02-03 07:49:00,33,16,Vestuário,4,49
47991,2024-02-03 07:50:00,36,14,Brinquedo,4,50
47992,2024-02-03 07:51:00,98,116,Eletrônico,4,214
47993,2024-02-03 07:52:00,64,174,Brinquedo,4,238
47994,2024-02-03 07:53:00,108,103,Vestuário,3,211
47995,2024-02-03 07:54:00,116,15,Eletrônico,3,131
47996,2024-02-03 07:55:00,24,44,Eletrônico,1,68
47997,2024-02-03 07:56:00,107,150,Eletrônico,6,257
47998,2024-02-03 07:57:00,42,68,Vestuário,9,110
47999,2024-02-03 07:58:00,89,158,Brinquedo,2,247
48000,2024-02-03 07:59:00,92,121,Alimento,3,213
48001,2024-02-03 08:00:00,21,49,Alimento,2,70
48002,2024-02-03 08:01:00,84,157,Vestuário,4,241
48003,2024-02-03 08:02:00,36,105,Alimento,4,141
48004,2024-02-03 08:03:00,85,170,Móvel,8,255
48005,2024-02-03 08:04:00,79,98,Vestuário,7,177
48006,2024-02-03 08:05:00,99,134,Vestuário,6,233
48007,2024-02-03 08:06:00,46,100,Alimento,3,146
48008,2024-02-03 08:07:00,13,123,Móvel,3,136
48009,2024-02-03 08:08:00,110,145,Brinquedo,7,255
48010,2024-02-03 08:09:00,108,87,Eletrônico,4,195
48011,2024-02-03 08:10:00,60,98,Vestuário,1,158
48012,2024-02-03 08:11:00,27,101,Alimento,3,128
48013,2024-02-03 08:12:00,92,179,Brinquedo,4,271
48014,2024-02-03 08:13:00,29,47,Alimento,9,76
48015,2024-02-03 08:14:00,45,164,Eletrônico,4,209
48016,2024-02-03 08:15:00,75,79,Brinquedo,9,154
48017,2024-02-03 08:16:00,11,75,Eletrônico,4,86
48018,2024-02-03 08:17:00,39,88,Móvel,6,127
48019,2024-02-03 08:18:00,16,36,Vestuário,2,52
48020,2024-02-03 08:19:00,76,59,Móvel,4,135
48021,2024-02-03 08:20:00,20,141,Alimento,7,161
48022,2024-02-03 08:21:00,56,53,Alimento,9,109
48023,2024-02-03 08:22:00,94,23,Brinquedo,1,117
48024,2024-02-03 08:23:00,76,51,Vestuário,4,127
48025,2024-02-03 08:24:00,50,33,Brinquedo,9,83
48026,2024-02-03 08:25:00,63,11,Móvel,7,74
48027,2024-02-03 08:26:00,20,109,Vestuário,1,129
48028,2024-02-03 08:27:00,102,117,Eletrônico,2,219
48029,2024-02-03 08:28:00,10,67,Móvel,9,77
48030,2024-02-03 08:29:00,102,74,Brinquedo,6,176
48031,2024-02-03 08:30:00,76,11,Alimento,8,87
48032,2024-02-03 08:31:00,79,178,Alimento,6,257
48033,2024-02-03 08:32:00,75,177,Alimento,7,252
48034,2024-02-03 08:33:00,51,128,Eletrônico,7,179
48035,2024-02-03 08:34:00,104,154,Brinquedo,5,258
48036,2024-02-03 08:35:00,14,129,Vestuário,7,143
48037,2024-02-03 08:36:00,57,179,Alimento,8,236
48038,2024-02-03 08:37:00,35,106,Móvel,7,141
48039,2024-02-03 08:38:00,17,53,Brinquedo,8,70
48040,2024-02-03 08:39:00,102,177,Brinquedo,9,279
48041,2024-02-03 08:40:00,63,154,Móvel,7,217
48042,2024-02-03 08:41:00,45,110,Móvel,5,155
48043,2024-02-03 08:42:00,39,85,Eletrônico,2,124
48044,2024-02-03 08:43:00,18,146,Alimento,5,164
48045,2024-02-03 08:44:00,115,171,Brinquedo,9,286
48046,2024-02-03 08:45:00,38,156,Eletrônico,2,194
48047,2024-02-03 08:46:00,50,110,Eletrônico,8,160
48048,2024-02-03 08:47:00,71,174,Brinquedo,4,245
48049,2024-02-03 08:48:00,48,19,Móvel,9,67
48050,2024-02-03 08:49:00,109,24,Móvel,5,133
48051,2024-02-03 08:50:00,75,106,Vestuário,1,181
48052,2024-02-03 08:51:00,93,161,Alimento,3,254
48053,2024-02-03 08:52:00,82,116,Brinquedo,1,198
48054,2024-02-03 08:53:00,105,160,Vestuário,3,265
48055,2024-02-03 08:54:00,93,135,Brinquedo,6,228
48056,2024-02-03 08:55:00,40,56,Móvel,4,96
48057,2024-02-03 08:56:00,104,169,Alimento,4,273
48058,2024-02-03 08:57:00,115,143,Alimento,4,258
48059,2024-02-03 08:58:00,62,35,Eletrônico,3,97
48060,2024-02-03 08:59:00,21,49,Vestuário,4,70
48061,2024-02-03 09:00:00,65,96,Móvel,4,161
48062,2024-02-03 09:01:00,50,14,Brinquedo,1,64
48063,2024-02-03 09:02:00,30,86,Alimento,7,116
48064,2024-02-03 09:03:00,54,136,Vestuário,9,190
48065,2024-02-03 09:04:00,109,126,Brinquedo,1,235
48066,2024-02-03 09:05:00,26,141,Vestuário,4,167
48067,2024-02-03 09:06:00,60,158,Eletrônico,9,218
48068,2024-02-03 09:07:00,94,44,Móvel,1,138
48069,2024-02-03 09:08:00,34,88,Eletrônico,6,122
48070,2024-02-03 09:09:00,80,162,Móvel,1,242
48071,2024-02-03 09:10:00,60,157,Eletrônico,5,217
48072,2024-02-03 09:11:00,24,152,Móvel,3,176
48073,2024-02-03 09:12:00,99,107,Alimento,1,206
48074,2024-02-03 09:13:00,119,120,Alimento,9,239
48075,2024-02-03 09:14:00,20,73,Vestuário,5,93
48076,2024-02-03 09:15:00,79,38,Vestuário,2,117
48077,2024-02-03 09:16:00,80,39,Alimento,1,119
48078,2024-02-03 09:17:00,111,60,Alimento,4,171
48079,2024-02-03 09:18:00,70,65,Móvel,5,135
48080,2024-02-03 09:19:00,94,154,Vestuário,4,248
48081,2024-02-03 09:20:00,101,48,Vestuário,7,149
48082,2024-02-03 09:21:00,52,71,Alimento,1,123
48083,2024-02-03 09:22:00,92,38,Vestuário,3,130
48084,2024-02-03 09:23:00,43,108,Brinquedo,2,151
48085,2024-02-03 09:24:00,23,160,Alimento,9,183
48086,2024-02-03 09:25:00,76,93,Vestuário,8,169
48087,2024-02-03 09:26:00,113,29,Eletrônico,7,142
48088,2024-02-03 09:27:00,106,48,Móvel,4,154
48089,2024-02-03 09:28:00,103,156,Brinquedo,8,259
48090,2024-02-03 09:29:00,110,83,Vestuário,1,193
48091,2024-02-03 09:30:00,106,40,Móvel,4,146
48092,2024-02-03 09:31:00,101,96,Alimento,8,197
48093,2024-02-03 09:32:00,93,128,Brinquedo,6,221
48094,2024-02-03 09:33:00,18,76,Eletrônico,4,94
48095,2024-02-03 09:34:00,26,160,Vestuário,5,186
48096,2024-02-03 09:35:00,81,31,Brinquedo,5,112
48097,2024-02-03 09:36:00,51,77,Brinquedo,5,128
48098,2024-02-03 09:37:00,20,97,Alimento,3,117
48099,2024-02-03 09:38:00,34,19,Brinquedo,1,53
48100,2024-02-03 09:39:00,105,30,Brinquedo,4,135
48101,2024-02-03 09:40:00,89,33,Brinquedo,6,122
48102,2024-02-03 09:41:00,21,11,Eletrônico,5,32
48103,2024-02-03 09:42:00,112,24,Alimento,7,136
48104,2024-02-03 09:43:00,49,153,Móvel,1,202
48105,2024-02-03 09:44:00,26,151,Móvel,9,177
48106,2024-02-03 09:45:00,30,35,Eletrônico,6,65
48107,2024-02-03 09:46:00,28,156,Eletrônico,6,184
48108,2024-02-03 09:47:00,45,77,Vestuário,5,122
48109,2024-02-03 09:48:00,68,123,Vestuário,6,191
48110,2024-02-03 09:49:00,94,13,Vestuário,2,107
48111,2024-02-03 09:50:00,86,46,Alimento,4,132
48112,2024-02-03 09:51:00,66,163,Eletrônico,2,229
48113,2024-02-03 09:52:00,39,137,Eletrônico,4,176
48114,2024-02-03 09:53:00,46,12,Móvel,2,58
48115,2024-02-03 09:54:00,103,30,Eletrônico,3,133
48116,2024-02-03 09:55:00,37,164,Móvel,5,201
48117,2024-02-03 09:56:00,109,67,Eletrônico,2,176
48118,2024-02-03 09:57:00,17,169,Móvel,9,186
48119,2024-02-03 09:58:00,45,23,Vestuário,5,68
48120,2024-02-03 09:59:00,50,19,Móvel,7,69
48121,2024-02-03 10:00:00,53,130,Alimento,7,183
48122,2024-02-03 10:01:00,98,89,Vestuário,2,187
48123,2024-02-03 10:02:00,52,61,Vestuário,2,113
48124,2024-02-03 10:03:00,34,78,Vestuário,8,112
48125,2024-02-03 10:04:00,80,92,Alimento,5,172
48126,2024-02-03 10:05:00,93,178,Móvel,7,271
48127,2024-02-03 10:06:00,61,30,Alimento,6,91
48128,2024-02-03 10:07:00,33,167,Eletrônico,6,200
48129,2024-02-03 10:08:00,60,141,Alimento,4,201
48130,2024-02-03 10:09:00,85,130,Vestuário,6,215
48131,2024-02-03 10:10:00,45,86,Alimento,1,131
48132,2024-02-03 10:11:00,97,177,Vestuário,9,274
48133,2024-02-03 10:12:00,52,67,Móvel,9,119
48134,2024-02-03 10:13:00,90,108,Vestuário,9,198
48135,2024-02-03 10:14:00,54,156,Vestuário,2,210
48136,2024-02-03 10:15:00,33,76,Vestuário,8,109
48137,2024-02-03 10:16:00,72,100,Vestuário,3,172
48138,2024-02-03 10:17:00,38,101,Eletrônico,7,139
48139,2024-02-03 10:18:00,39,31,Brinquedo,8,70
48140,2024-02-03 10:19:00,61,111,Móvel,4,172
48141,2024-02-03 10:20:00,106,74,Vestuário,3,180
48142,2024-02-03 10:21:00,115,142,Vestuário,4,257
48143,2024-02-03 10:22:00,16,149,Móvel,6,165
48144,2024-02-03 10:23:00,33,115,Brinquedo,9,148
48145,2024-02-03 10:24:00,104,161,Alimento,6,265
48146,2024-02-03 10:25:00,71,50,Vestuário,4,121
48147,2024-02-03 10:26:00,80,115,Vestuário,8,195
48148,2024-02-03 10:27:00,57,177,Vestuário,1,234
48149,2024-02-03 10:28:00,64,88,Alimento,8,152
48150,2024-02-03 10:29:00,116,78,Alimento,5,194
48151,2024-02-03 10:30:00,113,82,Eletrônico,4,195
48152,2024-02-03 10:31:00,13,57,Vestuário,5,70
48153,2024-02-03 10:32:00,70,14,Brinquedo,5,84
48154,2024-02-03 10:33:00,93,162,Eletrônico,9,255
48155,2024-02-03 10:34:00,115,151,Móvel,6,266
48156,2024-02-03 10:35:00,68,91,Eletrônico,6,159
48157,2024-02-03 10:36:00,33,64,Brinquedo,6,97
48158,2024-02-03 10:37:00,33,101,Móvel,5,134
48159,2024-02-03 10:38:00,10,132,Eletrônico,3,142
48160,2024-02-03 10:39:00,63,80,Vestuário,1,143
48161,2024-02-03 10:40:00,81,48,Brinquedo,4,129
48162,2024-02-03 10:41:00,49,26,Vestuário,7,75
48163,2024-02-03 10:42:00,40,55,Eletrônico,3,95
48164,2024-02-03 10:43:00,97,26,Alimento,3,123
48165,2024-02-03 10:44:00,88,31,Vestuário,7,119
48166,2024-02-03 10:45:00,77,131,Alimento,3,208
48167,2024-02-03 10:46:00,100,32,Móvel,2,132
48168,2024-02-03 10:47:00,82,116,Alimento,6,198
48169,2024-02-03 10:48:00,71,178,Eletrônico,1,249
48170,2024-02-03 10:49:00,33,67,Brinquedo,3,100
48171,2024-02-03 10:50:00,14,73,Vestuário,1,87
48172,2024-02-03 10:51:00,36,67,Alimento,8,103
48173,2024-02-03 10:52:00,103,153,Móvel,4,256
48174,2024-02-03 10:53:00,42,124,Vestuário,8,166
48175,2024-02-03 10:54:00,25,161,Alimento,7,186
48176,2024-02-03 10:55:00,110,163,Vestuário,5,273
48177,2024-02-03 10:56:00,90,129,Eletrônico,4,219
48178,2024-02-03 10:57:00,68,42,Vestuário,4,110
48179,2024-02-03 10:58:00,15,84,Vestuário,1,99
48180,2024-02-03 10:59:00,53,122,Brinquedo,6,175
48181,2024-02-03 11:00:00,36,50,Vestuário,4,86
48182,2024-02-03 11:01:00,113,144,Eletrônico,5,257
48183,2024-02-03 11:02:00,100,100,Eletrônico,1,200
48184,2024-02-03 11:03:00,74,83,Brinquedo,5,157
48185,2024-02-03 11:04:00,65,58,Alimento,1,123
48186,2024-02-03 11:05:00,13,165,Vestuário,9,178
48187,2024-02-03 11:06:00,44,26,Eletrônico,1,70
48188,2024-02-03 11:07:00,21,108,Eletrônico,8,129
48189,2024-02-03 11:08:00,81,165,Alimento,7,246
48190,2024-02-03 11:09:00,109,116,Vestuário,8,225
48191,2024-02-03 11:10:00,64,87,Eletrônico,9,151
48192,2024-02-03 11:11:00,73,151,Móvel,9,224
48193,2024-02-03 11:12:00,74,92,Vestuário,3,166
48194,2024-02-03 11:13:00,80,103,Móvel,7,183
48195,2024-02-03 11:14:00,72,176,Eletrônico,8,248
48196,2024-02-03 11:15:00,75,24,Vestuário,2,99
48197,2024-02-03 11:16:00,31,162,Móvel,2,193
48198,2024-02-03 11:17:00,105,157,Brinquedo,3,262
48199,2024-02-03 11:18:00,93,102,Brinquedo,1,195
48200,2024-02-03 11:19:00,35,143,Móvel,4,178
48201,2024-02-03 11:20:00,62,179,Eletrônico,7,241
48202,2024-02-03 11:21:00,74,24,Eletrônico,5,98
48203,2024-02-03 11:22:00,80,18,Móvel,6,98
48204,2024-02-03 11:23:00,51,50,Alimento,3,101
48205,2024-02-03 11:24:00,12,153,Brinquedo,5,165
48206,2024-02-03 11:25:00,46,147,Alimento,4,193
48207,2024-02-03 11:26:00,73,129,Eletrônico,1,202
48208,2024-02-03 11:27:00,52,174,Móvel,9,226
48209,2024-02-03 11:28:00,114,146,Vestuário,6,260
48210,2024-02-03 11:29:00,93,158,Vestuário,2,251
48211,2024-02-03 11:30:00,86,132,Brinquedo,5,218
48212,2024-02-03 11:31:00,12,146,Brinquedo,4,158
48213,2024-02-03 11:32:00,90,68,Eletrônico,3,158
48214,2024-02-03 11:33:00,85,175,Brinquedo,1,260
48215,2024-02-03 11:34:00,81,55,Brinquedo,4,136
48216,2024-02-03 11:35:00,85,58,Móvel,6,143
48217,2024-02-03 11:36:00,108,131,Brinquedo,8,239
48218,2024-02-03 11:37:00,85,20,Alimento,7,105
48219,2024-02-03 11:38:00,23,121,Brinquedo,8,144
48220,2024-02-03 11:39:00,93,39,Móvel,5,132
48221,2024-02-03 11:40:00,105,49,Brinquedo,1,154
48222,2024-02-03 11:41:00,53,10,Vestuário,2,63
48223,2024-02-03 11:42:00,23,88,Brinquedo,2,111
48224,2024-02-03 11:43:00,80,138,Móvel,4,218
48225,2024-02-03 11:44:00,111,64,Alimento,3,175
48226,2024-02-03 11:45:00,119,157,Vestuário,5,276
48227,2024-02-03 11:46:00,51,101,Vestuário,1,152
48228,2024-02-03 11:47:00,31,58,Brinquedo,2,89
48229,2024-02-03 11:48:00,116,75,Vestuário,3,191
48230,2024-02-03 11:49:00,32,161,Móvel,2,193
48231,2024-02-03 11:50:00,12,54,Brinquedo,1,66
48232,2024-02-03 11:51:00,103,159,Brinquedo,1,262
48233,2024-02-03 11:52:00,59,43,Vestuário,9,102
48234,2024-02-03 11:53:00,117,24,Alimento,7,141
48235,2024-02-03 11:54:00,53,63,Brinquedo,2,116
48236,2024-02-03 11:55:00,15,133,Alimento,4,148
48237,2024-02-03 11:56:00,31,46,Móvel,6,77
48238,2024-02-03 11:57:00,37,92,Alimento,3,129
48239,2024-02-03 11:58:00,20,77,Vestuário,2,97
48240,2024-02-03 11:59:00,66,170,Vestuário,7,236
48241,2024-02-03 12:00:00,53,38,Vestuário,5,91
48242,2024-02-03 12:01:00,42,91,Vestuário,5,133
48243,2024-02-03 12:02:00,105,38,Vestuário,9,143
48244,2024-02-03 12:03:00,89,110,Alimento,7,199
48245,2024-02-03 12:04:00,62,127,Vestuário,2,189
48246,2024-02-03 12:05:00,61,135,Alimento,4,196
48247,2024-02-03 12:06:00,77,16,Brinquedo,8,93
48248,2024-02-03 12:07:00,34,121,Móvel,1,155
48249,2024-02-03 12:08:00,36,90,Móvel,6,126
48250,2024-02-03 12:09:00,118,63,Eletrônico,3,181
48251,2024-02-03 12:10:00,24,22,Eletrônico,1,46
48252,2024-02-03 12:11:00,98,104,Móvel,1,202
48253,2024-02-03 12:12:00,47,178,Móvel,3,225
48254,2024-02-03 12:13:00,72,36,Vestuário,4,108
48255,2024-02-03 12:14:00,24,63,Vestuário,4,87
48256,2024-02-03 12:15:00,52,156,Vestuário,7,208
48257,2024-02-03 12:16:00,14,128,Brinquedo,1,142
48258,2024-02-03 12:17:00,111,154,Vestuário,4,265
48259,2024-02-03 12:18:00,41,149,Brinquedo,8,190
48260,2024-02-03 12:19:00,104,28,Eletrônico,2,132
48261,2024-02-03 12:20:00,21,138,Eletrônico,2,159
48262,2024-02-03 12:21:00,15,86,Eletrônico,2,101
48263,2024-02-03 12:22:00,68,10,Brinquedo,4,78
48264,2024-02-03 12:23:00,54,39,Vestuário,2,93
48265,2024-02-03 12:24:00,60,11,Vestuário,3,71
48266,2024-02-03 12:25:00,58,151,Vestuário,8,209
48267,2024-02-03 12:26:00,79,152,Alimento,1,231
48268,2024-02-03 12:27:00,11,115,Alimento,9,126
48269,2024-02-03 12:28:00,56,142,Móvel,9,198
48270,2024-02-03 12:29:00,106,36,Brinquedo,3,142
48271,2024-02-03 12:30:00,116,127,Brinquedo,4,243
48272,2024-02-03 12:31:00,114,168,Brinquedo,8,282
48273,2024-02-03 12:32:00,21,27,Móvel,6,48
48274,2024-02-03 12:33:00,71,172,Alimento,6,243
48275,2024-02-03 12:34:00,23,41,Alimento,5,64
48276,2024-02-03 12:35:00,70,144,Brinquedo,9,214
48277,2024-02-03 12:36:00,25,114,Eletrônico,2,139
48278,2024-02-03 12:37:00,111,126,Móvel,8,237
48279,2024-02-03 12:38:00,43,162,Alimento,3,205
48280,2024-02-03 12:39:00,71,159,Móvel,3,230
48281,2024-02-03 12:40:00,108,106,Alimento,7,214
48282,2024-02-03 12:41:00,54,164,Móvel,8,218
48283,2024-02-03 12:42:00,31,62,Móvel,1,93
48284,2024-02-03 12:43:00,45,12,Alimento,7,57
48285,2024-02-03 12:44:00,15,143,Alimento,2,158
48286,2024-02-03 12:45:00,48,100,Eletrônico,4,148
48287,2024-02-03 12:46:00,30,127,Eletrônico,4,157
48288,2024-02-03 12:47:00,92,70,Brinquedo,9,162
48289,2024-02-03 12:48:00,93,54,Vestuário,1,147
48290,2024-02-03 12:49:00,30,47,Brinquedo,7,77
48291,2024-02-03 12:50:00,117,53,Alimento,5,170
48292,2024-02-03 12:51:00,18,86,Brinquedo,7,104
48293,2024-02-03 12:52:00,74,33,Móvel,3,107
48294,2024-02-03 12:53:00,64,34,Alimento,3,98
48295,2024-02-03 12:54:00,27,157,Móvel,4,184
48296,2024-02-03 12:55:00,42,58,Móvel,4,100
48297,2024-02-03 12:56:00,98,52,Vestuário,4,150
48298,2024-02-03 12:57:00,79,82,Brinquedo,4,161
48299,2024-02-03 12:58:00,47,168,Eletrônico,4,215
48300,2024-02-03 12:59:00,98,45,Eletrônico,8,143
48301,2024-02-03 13:00:00,86,28,Vestuário,7,114
48302,2024-02-03 13:01:00,89,43,Eletrônico,6,132
48303,2024-02-03 13:02:00,113,101,Brinquedo,2,214
48304,2024-02-03 13:03:00,49,140,Móvel,4,189
48305,2024-02-03 13:04:00,20,53,Eletrônico,1,73
48306,2024-02-03 13:05:00,35,13,Vestuário,8,48
48307,2024-02-03 13:06:00,111,111,Alimento,8,222
48308,2024-02-03 13:07:00,35,164,Eletrônico,3,199
48309,2024-02-03 13:08:00,80,41,Móvel,9,121
48310,2024-02-03 13:09:00,101,158,Brinquedo,3,259
48311,2024-02-03 13:10:00,68,71,Móvel,8,139
48312,2024-02-03 13:11:00,24,156,Vestuário,4,180
48313,2024-02-03 13:12:00,39,167,Móvel,6,206
48314,2024-02-03 13:13:00,29,111,Móvel,7,140
48315,2024-02-03 13:14:00,51,95,Vestuário,3,146
48316,2024-02-03 13:15:00,104,102,Brinquedo,9,206
48317,2024-02-03 13:16:00,89,70,Móvel,8,159
48318,2024-02-03 13:17:00,84,32,Móvel,2,116
48319,2024-02-03 13:18:00,62,72,Vestuário,5,134
48320,2024-02-03 13:19:00,29,98,Móvel,2,127
48321,2024-02-03 13:20:00,79,37,Brinquedo,9,116
48322,2024-02-03 13:21:00,17,152,Móvel,7,169
48323,2024-02-03 13:22:00,45,143,Brinquedo,6,188
48324,2024-02-03 13:23:00,102,44,Móvel,5,146
48325,2024-02-03 13:24:00,94,138,Vestuário,5,232
48326,2024-02-03 13:25:00,26,150,Vestuário,5,176
48327,2024-02-03 13:26:00,104,58,Eletrônico,4,162
48328,2024-02-03 13:27:00,82,70,Alimento,6,152
48329,2024-02-03 13:28:00,108,52,Eletrônico,4,160
48330,2024-02-03 13:29:00,43,107,Eletrônico,1,150
48331,2024-02-03 13:30:00,103,175,Brinquedo,3,278
48332,2024-02-03 13:31:00,101,24,Brinquedo,6,125
48333,2024-02-03 13:32:00,80,110,Móvel,2,190
48334,2024-02-03 13:33:00,62,72,Alimento,6,134
48335,2024-02-03 13:34:00,33,58,Brinquedo,2,91
48336,2024-02-03 13:35:00,97,166,Brinquedo,3,263
48337,2024-02-03 13:36:00,59,158,Móvel,4,217
48338,2024-02-03 13:37:00,62,72,Alimento,9,134
48339,2024-02-03 13:38:00,58,89,Móvel,3,147
48340,2024-02-03 13:39:00,41,173,Eletrônico,9,214
48341,2024-02-03 13:40:00,23,92,Alimento,8,115
48342,2024-02-03 13:41:00,101,79,Eletrônico,6,180
48343,2024-02-03 13:42:00,41,99,Vestuário,3,140
48344,2024-02-03 13:43:00,85,69,Eletrônico,9,154
48345,2024-02-03 13:44:00,115,57,Vestuário,1,172
48346,2024-02-03 13:45:00,77,154,Vestuário,1,231
48347,2024-02-03 13:46:00,89,112,Brinquedo,8,201
48348,2024-02-03 13:47:00,97,120,Brinquedo,5,217
48349,2024-02-03 13:48:00,15,65,Brinquedo,3,80
48350,2024-02-03 13:49:00,84,16,Móvel,9,100
48351,2024-02-03 13:50:00,67,65,Brinquedo,4,132
48352,2024-02-03 13:51:00,55,28,Brinquedo,4,83
48353,2024-02-03 13:52:00,68,162,Móvel,3,230
48354,2024-02-03 13:53:00,42,153,Móvel,2,195
48355,2024-02-03 13:54:00,69,140,Alimento,3,209
48356,2024-02-03 13:55:00,31,75,Brinquedo,6,106
48357,2024-02-03 13:56:00,108,120,Eletrônico,5,228
48358,2024-02-03 13:57:00,104,45,Eletrônico,1,149
48359,2024-02-03 13:58:00,76,42,Brinquedo,4,118
48360,2024-02-03 13:59:00,83,148,Alimento,2,231
48361,2024-02-03 14:00:00,66,78,Vestuário,3,144
48362,2024-02-03 14:01:00,113,100,Móvel,8,213
48363,2024-02-03 14:02:00,22,154,Móvel,5,176
48364,2024-02-03 14:03:00,90,143,Vestuário,4,233
48365,2024-02-03 14:04:00,111,100,Vestuário,2,211
48366,2024-02-03 14:05:00,64,127,Vestuário,5,191
48367,2024-02-03 14:06:00,50,132,Vestuário,7,182
48368,2024-02-03 14:07:00,41,142,Eletrônico,3,183
48369,2024-02-03 14:08:00,118,46,Brinquedo,5,164
48370,2024-02-03 14:09:00,100,159,Alimento,1,259
48371,2024-02-03 14:10:00,116,13,Eletrônico,4,129
48372,2024-02-03 14:11:00,20,135,Alimento,4,155
48373,2024-02-03 14:12:00,44,129,Alimento,2,173
48374,2024-02-03 14:13:00,94,94,Vestuário,2,188
48375,2024-02-03 14:14:00,72,65,Brinquedo,9,137
48376,2024-02-03 14:15:00,76,81,Móvel,6,157
48377,2024-02-03 14:16:00,97,36,Eletrônico,9,133
48378,2024-02-03 14:17:00,116,79,Eletrônico,2,195
48379,2024-02-03 14:18:00,52,79,Vestuário,4,131
48380,2024-02-03 14:19:00,44,169,Alimento,7,213
48381,2024-02-03 14:20:00,50,83,Brinquedo,5,133
48382,2024-02-03 14:21:00,28,66,Alimento,3,94
48383,2024-02-03 14:22:00,13,45,Alimento,6,58
48384,2024-02-03 14:23:00,62,17,Eletrônico,9,79
48385,2024-02-03 14:24:00,11,15,Alimento,3,26
48386,2024-02-03 14:25:00,76,36,Móvel,5,112
48387,2024-02-03 14:26:00,105,87,Móvel,6,192
48388,2024-02-03 14:27:00,28,101,Alimento,4,129
48389,2024-02-03 14:28:00,116,138,Brinquedo,9,254
48390,2024-02-03 14:29:00,51,22,Alimento,8,73
48391,2024-02-03 14:30:00,85,99,Brinquedo,8,184
48392,2024-02-03 14:31:00,93,44,Brinquedo,5,137
48393,2024-02-03 14:32:00,33,55,Eletrônico,2,88
48394,2024-02-03 14:33:00,97,172,Vestuário,1,269
48395,2024-02-03 14:34:00,47,28,Eletrônico,3,75
48396,2024-02-03 14:35:00,118,107,Móvel,5,225
48397,2024-02-03 14:36:00,15,51,Móvel,3,66
48398,2024-02-03 14:37:00,37,88,Móvel,4,125
48399,2024-02-03 14:38:00,105,74,Alimento,7,179
48400,2024-02-03 14:39:00,119,40,Eletrônico,1,159
48401,2024-02-03 14:40:00,92,29,Brinquedo,1,121
48402,2024-02-03 14:41:00,112,50,Alimento,6,162
48403,2024-02-03 14:42:00,75,120,Vestuário,1,195
48404,2024-02-03 14:43:00,87,85,Alimento,6,172
48405,2024-02-03 14:44:00,43,80,Brinquedo,4,123
48406,2024-02-03 14:45:00,16,165,Eletrônico,9,181
48407,2024-02-03 14:46:00,15,81,Eletrônico,7,96
48408,2024-02-03 14:47:00,42,112,Brinquedo,3,154
48409,2024-02-03 14:48:00,34,30,Vestuário,9,64
48410,2024-02-03 14:49:00,64,46,Móvel,9,110
48411,2024-02-03 14:50:00,38,58,Vestuário,6,96
48412,2024-02-03 14:51:00,69,147,Móvel,4,216
48413,2024-02-03 14:52:00,101,61,Alimento,4,162
48414,2024-02-03 14:53:00,44,110,Eletrônico,1,154
48415,2024-02-03 14:54:00,13,69,Alimento,1,82
48416,2024-02-03 14:55:00,48,151,Alimento,3,199
48417,2024-02-03 14:56:00,116,152,Eletrônico,8,268
48418,2024-02-03 14:57:00,76,171,Brinquedo,2,247
48419,2024-02-03 14:58:00,99,66,Eletrônico,2,165
48420,2024-02-03 14:59:00,105,87,Móvel,7,192
48421,2024-02-03 15:00:00,20,109,Móvel,2,129
48422,2024-02-03 15:01:00,73,92,Alimento,7,165
48423,2024-02-03 15:02:00,53,129,Móvel,9,182
48424,2024-02-03 15:03:00,80,71,Brinquedo,4,151
48425,2024-02-03 15:04:00,25,162,Vestuário,1,187
48426,2024-02-03 15:05:00,53,18,Vestuário,5,71
48427,2024-02-03 15:06:00,24,153,Eletrônico,7,177
48428,2024-02-03 15:07:00,101,134,Móvel,4,235
48429,2024-02-03 15:08:00,115,109,Eletrônico,8,224
48430,2024-02-03 15:09:00,104,151,Alimento,7,255
48431,2024-02-03 15:10:00,28,67,Vestuário,2,95
48432,2024-02-03 15:11:00,18,88,Alimento,2,106
48433,2024-02-03 15:12:00,106,54,Vestuário,5,160
48434,2024-02-03 15:13:00,32,138,Alimento,5,170
48435,2024-02-03 15:14:00,79,32,Alimento,5,111
48436,2024-02-03 15:15:00,79,11,Vestuário,1,90
48437,2024-02-03 15:16:00,54,64,Vestuário,3,118
48438,2024-02-03 15:17:00,88,73,Móvel,8,161
48439,2024-02-03 15:18:00,113,124,Eletrônico,6,237
48440,2024-02-03 15:19:00,117,54,Eletrônico,9,171
48441,2024-02-03 15:20:00,56,16,Eletrônico,1,72
48442,2024-02-03 15:21:00,112,21,Vestuário,8,133
48443,2024-02-03 15:22:00,106,177,Eletrônico,8,283
48444,2024-02-03 15:23:00,116,44,Eletrônico,4,160
48445,2024-02-03 15:24:00,95,111,Alimento,9,206
48446,2024-02-03 15:25:00,94,158,Brinquedo,5,252
48447,2024-02-03 15:26:00,52,70,Alimento,5,122
48448,2024-02-03 15:27:00,17,79,Vestuário,3,96
48449,2024-02-03 15:28:00,84,47,Vestuário,5,131
48450,2024-02-03 15:29:00,84,148,Vestuário,1,232
48451,2024-02-03 15:30:00,60,30,Eletrônico,6,90
48452,2024-02-03 15:31:00,112,170,Brinquedo,7,282
48453,2024-02-03 15:32:00,105,120,Brinquedo,2,225
48454,2024-02-03 15:33:00,119,87,Brinquedo,8,206
48455,2024-02-03 15:34:00,39,34,Alimento,2,73
48456,2024-02-03 15:35:00,78,120,Alimento,8,198
48457,2024-02-03 15:36:00,41,95,Eletrônico,6,136
48458,2024-02-03 15:37:00,89,141,Móvel,7,230
48459,2024-02-03 15:38:00,69,122,Eletrônico,6,191
48460,2024-02-03 15:39:00,112,177,Móvel,6,289
48461,2024-02-03 15:40:00,90,142,Brinquedo,8,232
48462,2024-02-03 15:41:00,25,67,Eletrônico,9,92
48463,2024-02-03 15:42:00,102,36,Brinquedo,9,138
48464,2024-02-03 15:43:00,17,134,Alimento,7,151
48465,2024-02-03 15:44:00,110,133,Brinquedo,7,243
48466,2024-02-03 15:45:00,48,103,Alimento,6,151
48467,2024-02-03 15:46:00,51,138,Alimento,9,189
48468,2024-02-03 15:47:00,17,73,Móvel,9,90
48469,2024-02-03 15:48:00,29,105,Brinquedo,5,134
48470,2024-02-03 15:49:00,51,61,Alimento,2,112
48471,2024-02-03 15:50:00,35,32,Móvel,6,67
48472,2024-02-03 15:51:00,79,117,Brinquedo,7,196
48473,2024-02-03 15:52:00,65,111,Vestuário,5,176
48474,2024-02-03 15:53:00,104,23,Eletrônico,3,127
48475,2024-02-03 15:54:00,96,123,Móvel,8,219
48476,2024-02-03 15:55:00,15,30,Móvel,9,45
48477,2024-02-03 15:56:00,63,42,Vestuário,7,105
48478,2024-02-03 15:57:00,115,89,Alimento,9,204
48479,2024-02-03 15:58:00,64,86,Eletrônico,6,150
48480,2024-02-03 15:59:00,70,73,Alimento,4,143
48481,2024-02-03 16:00:00,18,124,Eletrônico,6,142
48482,2024-02-03 16:01:00,66,120,Eletrônico,1,186
48483,2024-02-03 16:02:00,48,173,Vestuário,9,221
48484,2024-02-03 16:03:00,37,151,Vestuário,6,188
48485,2024-02-03 16:04:00,94,59,Brinquedo,6,153
48486,2024-02-03 16:05:00,66,56,Vestuário,6,122
48487,2024-02-03 16:06:00,80,128,Eletrônico,5,208
48488,2024-02-03 16:07:00,57,61,Móvel,7,118
48489,2024-02-03 16:08:00,11,160,Eletrônico,8,171
48490,2024-02-03 16:09:00,42,26,Eletrônico,1,68
48491,2024-02-03 16:10:00,119,62,Móvel,2,181
48492,2024-02-03 16:11:00,79,22,Móvel,1,101
48493,2024-02-03 16:12:00,59,138,Móvel,4,197
48494,2024-02-03 16:13:00,116,34,Vestuário,7,150
48495,2024-02-03 16:14:00,51,91,Alimento,2,142
48496,2024-02-03 16:15:00,92,132,Alimento,6,224
48497,2024-02-03 16:16:00,63,25,Eletrônico,3,88
48498,2024-02-03 16:17:00,114,131,Brinquedo,4,245
48499,2024-02-03 16:18:00,70,166,Eletrônico,5,236
48500,2024-02-03 16:19:00,101,168,Brinquedo,2,269
48501,2024-02-03 16:20:00,102,81,Vestuário,8,183
48502,2024-02-03 16:21:00,116,107,Brinquedo,9,223
48503,2024-02-03 16:22:00,50,96,Eletrônico,4,146
48504,2024-02-03 16:23:00,109,85,Vestuário,1,194
48505,2024-02-03 16:24:00,61,121,Brinquedo,8,182
48506,2024-02-03 16:25:00,48,65,Alimento,3,113
48507,2024-02-03 16:26:00,45,45,Alimento,2,90
48508,2024-02-03 16:27:00,19,18,Alimento,2,37
48509,2024-02-03 16:28:00,109,147,Eletrônico,8,256
48510,2024-02-03 16:29:00,65,150,Vestuário,6,215
48511,2024-02-03 16:30:00,111,118,Eletrônico,1,229
48512,2024-02-03 16:31:00,106,112,Eletrônico,9,218
48513,2024-02-03 16:32:00,14,76,Brinquedo,8,90
48514,2024-02-03 16:33:00,116,52,Móvel,8,168
48515,2024-02-03 16:34:00,117,104,Vestuário,5,221
48516,2024-02-03 16:35:00,45,107,Brinquedo,9,152
48517,2024-02-03 16:36:00,76,64,Móvel,1,140
48518,2024-02-03 16:37:00,39,171,Alimento,7,210
48519,2024-02-03 16:38:00,69,90,Móvel,9,159
48520,2024-02-03 16:39:00,62,137,Brinquedo,2,199
48521,2024-02-03 16:40:00,70,26,Vestuário,6,96
48522,2024-02-03 16:41:00,12,150,Brinquedo,2,162
48523,2024-02-03 16:42:00,15,35,Vestuário,5,50
48524,2024-02-03 16:43:00,115,102,Alimento,4,217
48525,2024-02-03 16:44:00,109,142,Eletrônico,1,251
48526,2024-02-03 16:45:00,80,99,Móvel,8,179
48527,2024-02-03 16:46:00,76,161,Brinquedo,1,237
48528,2024-02-03 16:47:00,58,170,Vestuário,1,228
48529,2024-02-03 16:48:00,72,141,Vestuário,4,213
48530,2024-02-03 16:49:00,10,17,Eletrônico,6,27
48531,2024-02-03 16:50:00,32,71,Eletrônico,1,103
48532,2024-02-03 16:51:00,42,25,Vestuário,9,67
48533,2024-02-03 16:52:00,100,144,Eletrônico,6,244
48534,2024-02-03 16:53:00,48,35,Brinquedo,8,83
48535,2024-02-03 16:54:00,73,56,Alimento,1,129
48536,2024-02-03 16:55:00,51,26,Móvel,9,77
48537,2024-02-03 16:56:00,98,56,Vestuário,1,154
48538,2024-02-03 16:57:00,28,20,Brinquedo,6,48
48539,2024-02-03 16:58:00,15,150,Móvel,5,165
48540,2024-02-03 16:59:00,76,96,Alimento,8,172
48541,2024-02-03 17:00:00,116,36,Brinquedo,1,152
48542,2024-02-03 17:01:00,60,62,Eletrônico,7,122
48543,2024-02-03 17:02:00,14,73,Alimento,6,87
48544,2024-02-03 17:03:00,98,113,Eletrônico,3,211
48545,2024-02-03 17:04:00,21,170,Alimento,5,191
48546,2024-02-03 17:05:00,79,107,Alimento,4,186
48547,2024-02-03 17:06:00,88,15,Alimento,6,103
48548,2024-02-03 17:07:00,11,11,Vestuário,7,22
48549,2024-02-03 17:08:00,49,104,Alimento,8,153
48550,2024-02-03 17:09:00,44,102,Brinquedo,9,146
48551,2024-02-03 17:10:00,21,99,Vestuário,5,120
48552,2024-02-03 17:11:00,109,19,Móvel,7,128
48553,2024-02-03 17:12:00,117,131,Vestuário,3,248
48554,2024-02-03 17:13:00,53,111,Eletrônico,9,164
48555,2024-02-03 17:14:00,71,173,Vestuário,3,244
48556,2024-02-03 17:15:00,41,150,Vestuário,4,191
48557,2024-02-03 17:16:00,105,62,Eletrônico,5,167
48558,2024-02-03 17:17:00,41,160,Alimento,3,201
48559,2024-02-03 17:18:00,77,119,Vestuário,4,196
48560,2024-02-03 17:19:00,53,78,Alimento,7,131
48561,2024-02-03 17:20:00,55,148,Móvel,1,203
48562,2024-02-03 17:21:00,85,69,Vestuário,8,154
48563,2024-02-03 17:22:00,73,63,Vestuário,9,136
48564,2024-02-03 17:23:00,98,62,Brinquedo,6,160
48565,2024-02-03 17:24:00,118,139,Eletrônico,8,257
48566,2024-02-03 17:25:00,50,158,Móvel,1,208
48567,2024-02-03 17:26:00,106,63,Vestuário,8,169
48568,2024-02-03 17:27:00,27,81,Vestuário,2,108
48569,2024-02-03 17:28:00,72,100,Vestuário,4,172
48570,2024-02-03 17:29:00,115,163,Alimento,6,278
48571,2024-02-03 17:30:00,57,16,Alimento,9,73
48572,2024-02-03 17:31:00,34,164,Brinquedo,3,198
48573,2024-02-03 17:32:00,63,39,Móvel,3,102
48574,2024-02-03 17:33:00,70,71,Móvel,1,141
48575,2024-02-03 17:34:00,32,65,Brinquedo,2,97
48576,2024-02-03 17:35:00,64,51,Brinquedo,4,115
48577,2024-02-03 17:36:00,112,130,Alimento,5,242
48578,2024-02-03 17:37:00,95,43,Móvel,4,138
48579,2024-02-03 17:38:00,46,11,Alimento,5,57
48580,2024-02-03 17:39:00,108,86,Eletrônico,6,194
48581,2024-02-03 17:40:00,71,115,Eletrônico,6,186
48582,2024-02-03 17:41:00,55,112,Brinquedo,4,167
48583,2024-02-03 17:42:00,99,122,Móvel,3,221
48584,2024-02-03 17:43:00,101,129,Vestuário,4,230
48585,2024-02-03 17:44:00,73,176,Brinquedo,6,249
48586,2024-02-03 17:45:00,37,32,Brinquedo,7,69
48587,2024-02-03 17:46:00,11,53,Eletrônico,6,64
48588,2024-02-03 17:47:00,23,35,Vestuário,6,58
48589,2024-02-03 17:48:00,58,24,Móvel,1,82
48590,2024-02-03 17:49:00,57,19,Vestuário,6,76
48591,2024-02-03 17:50:00,20,38,Alimento,3,58
48592,2024-02-03 17:51:00,37,34,Alimento,5,71
48593,2024-02-03 17:52:00,56,73,Alimento,9,129
48594,2024-02-03 17:53:00,58,69,Móvel,7,127
48595,2024-02-03 17:54:00,102,159,Eletrônico,5,261
48596,2024-02-03 17:55:00,72,159,Móvel,8,231
48597,2024-02-03 17:56:00,42,179,Alimento,3,221
48598,2024-02-03 17:57:00,82,176,Brinquedo,4,258
48599,2024-02-03 17:58:00,81,53,Alimento,9,134
48600,2024-02-03 17:59:00,48,49,Alimento,7,97
48601,2024-02-03 18:00:00,11,133,Alimento,5,144
48602,2024-02-03 18:01:00,113,147,Alimento,4,260
48603,2024-02-03 18:02:00,28,170,Brinquedo,6,198
48604,2024-02-03 18:03:00,100,88,Brinquedo,8,188
48605,2024-02-03 18:04:00,46,133,Vestuário,3,179
48606,2024-02-03 18:05:00,90,111,Brinquedo,3,201
48607,2024-02-03 18:06:00,23,83,Eletrônico,4,106
48608,2024-02-03 18:07:00,105,139,Vestuário,7,244
48609,2024-02-03 18:08:00,28,75,Brinquedo,8,103
48610,2024-02-03 18:09:00,63,111,Brinquedo,1,174
48611,2024-02-03 18:10:00,100,148,Eletrônico,6,248
48612,2024-02-03 18:11:00,67,106,Móvel,1,173
48613,2024-02-03 18:12:00,117,81,Móvel,9,198
48614,2024-02-03 18:13:00,87,26,Móvel,3,113
48615,2024-02-03 18:14:00,54,55,Móvel,7,109
48616,2024-02-03 18:15:00,36,157,Eletrônico,8,193
48617,2024-02-03 18:16:00,58,93,Eletrônico,9,151
48618,2024-02-03 18:17:00,97,75,Vestuário,6,172
48619,2024-02-03 18:18:00,82,172,Vestuário,6,254
48620,2024-02-03 18:19:00,87,25,Alimento,5,112
48621,2024-02-03 18:20:00,92,94,Alimento,1,186
48622,2024-02-03 18:21:00,113,131,Vestuário,9,244
48623,2024-02-03 18:22:00,93,122,Brinquedo,8,215
48624,2024-02-03 18:23:00,54,10,Eletrônico,2,64
48625,2024-02-03 18:24:00,78,27,Brinquedo,6,105
48626,2024-02-03 18:25:00,97,78,Alimento,7,175
48627,2024-02-03 18:26:00,12,21,Eletrônico,8,33
48628,2024-02-03 18:27:00,107,91,Alimento,2,198
48629,2024-02-03 18:28:00,29,24,Móvel,4,53
48630,2024-02-03 18:29:00,92,59,Brinquedo,8,151
48631,2024-02-03 18:30:00,80,171,Alimento,2,251
48632,2024-02-03 18:31:00,97,120,Vestuário,4,217
48633,2024-02-03 18:32:00,64,101,Brinquedo,3,165
48634,2024-02-03 18:33:00,30,37,Brinquedo,1,67
48635,2024-02-03 18:34:00,47,161,Alimento,2,208
48636,2024-02-03 18:35:00,32,38,Eletrônico,2,70
48637,2024-02-03 18:36:00,97,123,Alimento,1,220
48638,2024-02-03 18:37:00,30,149,Alimento,7,179
48639,2024-02-03 18:38:00,12,88,Eletrônico,1,100
48640,2024-02-03 18:39:00,60,170,Brinquedo,6,230
48641,2024-02-03 18:40:00,87,100,Móvel,7,187
48642,2024-02-03 18:41:00,86,68,Móvel,7,154
48643,2024-02-03 18:42:00,36,157,Móvel,4,193
48644,2024-02-03 18:43:00,91,117,Vestuário,5,208
48645,2024-02-03 18:44:00,28,76,Eletrônico,5,104
48646,2024-02-03 18:45:00,15,69,Brinquedo,7,84
48647,2024-02-03 18:46:00,65,125,Eletrônico,4,190
48648,2024-02-03 18:47:00,81,40,Eletrônico,6,121
48649,2024-02-03 18:48:00,96,48,Vestuário,6,144
48650,2024-02-03 18:49:00,22,100,Vestuário,1,122
48651,2024-02-03 18:50:00,35,42,Móvel,6,77
48652,2024-02-03 18:51:00,75,144,Móvel,4,219
48653,2024-02-03 18:52:00,95,163,Eletrônico,1,258
48654,2024-02-03 18:53:00,95,23,Brinquedo,3,118
48655,2024-02-03 18:54:00,93,110,Móvel,3,203
48656,2024-02-03 18:55:00,102,139,Alimento,4,241
48657,2024-02-03 18:56:00,114,95,Brinquedo,8,209
48658,2024-02-03 18:57:00,60,41,Móvel,3,101
48659,2024-02-03 18:58:00,67,97,Vestuário,7,164
48660,2024-02-03 18:59:00,56,77,Brinquedo,8,133
48661,2024-02-03 19:00:00,89,110,Brinquedo,8,199
48662,2024-02-03 19:01:00,63,123,Brinquedo,6,186
48663,2024-02-03 19:02:00,57,118,Eletrônico,8,175
48664,2024-02-03 19:03:00,70,56,Brinquedo,3,126
48665,2024-02-03 19:04:00,108,39,Móvel,3,147
48666,2024-02-03 19:05:00,67,50,Móvel,9,117
48667,2024-02-03 19:06:00,87,54,Eletrônico,9,141
48668,2024-02-03 19:07:00,16,95,Brinquedo,8,111
48669,2024-02-03 19:08:00,111,154,Alimento,3,265
48670,2024-02-03 19:09:00,11,49,Alimento,8,60
48671,2024-02-03 19:10:00,61,104,Alimento,4,165
48672,2024-02-03 19:11:00,101,145,Eletrônico,3,246
48673,2024-02-03 19:12:00,40,161,Brinquedo,6,201
48674,2024-02-03 19:13:00,41,115,Brinquedo,1,156
48675,2024-02-03 19:14:00,110,65,Vestuário,7,175
48676,2024-02-03 19:15:00,70,134,Eletrônico,2,204
48677,2024-02-03 19:16:00,118,84,Brinquedo,8,202
48678,2024-02-03 19:17:00,110,11,Brinquedo,8,121
48679,2024-02-03 19:18:00,31,62,Alimento,6,93
48680,2024-02-03 19:19:00,118,158,Vestuário,4,276
48681,2024-02-03 19:20:00,119,30,Brinquedo,6,149
48682,2024-02-03 19:21:00,113,120,Vestuário,3,233
48683,2024-02-03 19:22:00,31,139,Brinquedo,9,170
48684,2024-02-03 19:23:00,81,134,Alimento,7,215
48685,2024-02-03 19:24:00,117,176,Móvel,2,293
48686,2024-02-03 19:25:00,28,151,Vestuário,7,179
48687,2024-02-03 19:26:00,110,88,Eletrônico,8,198
48688,2024-02-03 19:27:00,33,78,Vestuário,9,111
48689,2024-02-03 19:28:00,116,93,Vestuário,8,209
48690,2024-02-03 19:29:00,117,113,Alimento,1,230
48691,2024-02-03 19:30:00,43,118,Móvel,8,161
48692,2024-02-03 19:31:00,39,83,Vestuário,9,122
48693,2024-02-03 19:32:00,49,128,Móvel,3,177
48694,2024-02-03 19:33:00,39,129,Vestuário,9,168
48695,2024-02-03 19:34:00,67,100,Eletrônico,1,167
48696,2024-02-03 19:35:00,79,173,Móvel,9,252
48697,2024-02-03 19:36:00,44,119,Alimento,9,163
48698,2024-02-03 19:37:00,26,14,Vestuário,3,40
48699,2024-02-03 19:38:00,71,45,Vestuário,6,116
48700,2024-02-03 19:39:00,80,75,Alimento,5,155
48701,2024-02-03 19:40:00,97,122,Alimento,5,219
48702,2024-02-03 19:41:00,112,87,Móvel,3,199
48703,2024-02-03 19:42:00,69,144,Vestuário,5,213
48704,2024-02-03 19:43:00,113,83,Móvel,9,196
48705,2024-02-03 19:44:00,84,85,Alimento,4,169
48706,2024-02-03 19:45:00,90,172,Eletrônico,4,262
48707,2024-02-03 19:46:00,87,135,Alimento,4,222
48708,2024-02-03 19:47:00,115,82,Eletrônico,3,197
48709,2024-02-03 19:48:00,42,31,Móvel,3,73
48710,2024-02-03 19:49:00,93,61,Eletrônico,1,154
48711,2024-02-03 19:50:00,84,101,Móvel,2,185
48712,2024-02-03 19:51:00,37,111,Brinquedo,3,148
48713,2024-02-03 19:52:00,25,101,Alimento,4,126
48714,2024-02-03 19:53:00,29,19,Vestuário,1,48
48715,2024-02-03 19:54:00,57,10,Vestuário,8,67
48716,2024-02-03 19:55:00,103,35,Eletrônico,3,138
48717,2024-02-03 19:56:00,97,19,Brinquedo,5,116
48718,2024-02-03 19:57:00,41,114,Eletrônico,1,155
48719,2024-02-03 19:58:00,44,79,Brinquedo,9,123
48720,2024-02-03 19:59:00,80,119,Eletrônico,2,199
48721,2024-02-03 20:00:00,18,23,Vestuário,8,41
48722,2024-02-03 20:01:00,92,84,Vestuário,3,176
48723,2024-02-03 20:02:00,26,100,Vestuário,9,126
48724,2024-02-03 20:03:00,64,88,Vestuário,1,152
48725,2024-02-03 20:04:00,49,122,Alimento,7,171
48726,2024-02-03 20:05:00,105,155,Brinquedo,5,260
48727,2024-02-03 20:06:00,97,168,Móvel,9,265
48728,2024-02-03 20:07:00,50,168,Brinquedo,7,218
48729,2024-02-03 20:08:00,16,86,Vestuário,6,102
48730,2024-02-03 20:09:00,53,58,Móvel,9,111
48731,2024-02-03 20:10:00,44,27,Vestuário,8,71
48732,2024-02-03 20:11:00,114,96,Alimento,6,210
48733,2024-02-03 20:12:00,94,85,Eletrônico,7,179
48734,2024-02-03 20:13:00,53,94,Eletrônico,3,147
48735,2024-02-03 20:14:00,57,21,Alimento,9,78
48736,2024-02-03 20:15:00,61,11,Alimento,8,72
48737,2024-02-03 20:16:00,82,65,Alimento,3,147
48738,2024-02-03 20:17:00,94,99,Brinquedo,1,193
48739,2024-02-03 20:18:00,54,47,Alimento,6,101
48740,2024-02-03 20:19:00,23,80,Alimento,5,103
48741,2024-02-03 20:20:00,63,60,Móvel,6,123
48742,2024-02-03 20:21:00,89,81,Alimento,2,170
48743,2024-02-03 20:22:00,119,63,Vestuário,7,182
48744,2024-02-03 20:23:00,41,14,Brinquedo,5,55
48745,2024-02-03 20:24:00,65,15,Vestuário,3,80
48746,2024-02-03 20:25:00,10,122,Móvel,9,132
48747,2024-02-03 20:26:00,43,91,Brinquedo,8,134
48748,2024-02-03 20:27:00,16,119,Alimento,3,135
48749,2024-02-03 20:28:00,26,20,Eletrônico,2,46
48750,2024-02-03 20:29:00,47,81,Móvel,2,128
48751,2024-02-03 20:30:00,56,82,Alimento,9,138
48752,2024-02-03 20:31:00,54,40,Alimento,4,94
48753,2024-02-03 20:32:00,114,109,Brinquedo,2,223
48754,2024-02-03 20:33:00,17,71,Eletrônico,7,88
48755,2024-02-03 20:34:00,42,167,Eletrônico,9,209
48756,2024-02-03 20:35:00,78,120,Brinquedo,5,198
48757,2024-02-03 20:36:00,115,49,Vestuário,4,164
48758,2024-02-03 20:37:00,93,151,Vestuário,5,244
48759,2024-02-03 20:38:00,93,156,Alimento,3,249
48760,2024-02-03 20:39:00,28,61,Alimento,9,89
48761,2024-02-03 20:40:00,90,71,Móvel,2,161
48762,2024-02-03 20:41:00,118,153,Vestuário,1,271
48763,2024-02-03 20:42:00,88,97,Eletrônico,4,185
48764,2024-02-03 20:43:00,93,149,Brinquedo,7,242
48765,2024-02-03 20:44:00,18,59,Brinquedo,3,77
48766,2024-02-03 20:45:00,30,97,Alimento,4,127
48767,2024-02-03 20:46:00,106,11,Brinquedo,9,117
48768,2024-02-03 20:47:00,24,157,Móvel,1,181
48769,2024-02-03 20:48:00,115,108,Brinquedo,9,223
48770,2024-02-03 20:49:00,50,146,Brinquedo,6,196
48771,2024-02-03 20:50:00,101,22,Eletrônico,6,123
48772,2024-02-03 20:51:00,112,12,Brinquedo,7,124
48773,2024-02-03 20:52:00,54,178,Vestuário,3,232
48774,2024-02-03 20:53:00,14,133,Móvel,6,147
48775,2024-02-03 20:54:00,25,124,Alimento,1,149
48776,2024-02-03 20:55:00,43,108,Móvel,6,151
48777,2024-02-03 20:56:00,68,122,Alimento,8,190
48778,2024-02-03 20:57:00,56,71,Vestuário,9,127
48779,2024-02-03 20:58:00,93,127,Brinquedo,9,220
48780,2024-02-03 20:59:00,115,55,Alimento,3,170
48781,2024-02-03 21:00:00,28,38,Alimento,8,66
48782,2024-02-03 21:01:00,101,100,Vestuário,8,201
48783,2024-02-03 21:02:00,98,34,Móvel,4,132
48784,2024-02-03 21:03:00,84,47,Brinquedo,6,131
48785,2024-02-03 21:04:00,118,161,Vestuário,9,279
48786,2024-02-03 21:05:00,77,138,Vestuário,3,215
48787,2024-02-03 21:06:00,36,43,Vestuário,7,79
48788,2024-02-03 21:07:00,79,124,Vestuário,9,203
48789,2024-02-03 21:08:00,55,124,Vestuário,1,179
48790,2024-02-03 21:09:00,47,123,Eletrônico,5,170
48791,2024-02-03 21:10:00,61,108,Vestuário,1,169
48792,2024-02-03 21:11:00,38,77,Vestuário,6,115
48793,2024-02-03 21:12:00,26,137,Brinquedo,3,163
48794,2024-02-03 21:13:00,50,45,Móvel,7,95
48795,2024-02-03 21:14:00,58,45,Alimento,1,103
48796,2024-02-03 21:15:00,46,145,Vestuário,9,191
48797,2024-02-03 21:16:00,106,142,Brinquedo,6,248
48798,2024-02-03 21:17:00,56,128,Eletrônico,9,184
48799,2024-02-03 21:18:00,24,44,Vestuário,3,68
48800,2024-02-03 21:19:00,40,146,Brinquedo,8,186
48801,2024-02-03 21:20:00,115,158,Eletrônico,9,273
48802,2024-02-03 21:21:00,46,107,Eletrônico,3,153
48803,2024-02-03 21:22:00,118,178,Vestuário,5,296
48804,2024-02-03 21:23:00,58,123,Eletrônico,2,181
48805,2024-02-03 21:24:00,12,60,Vestuário,1,72
48806,2024-02-03 21:25:00,10,141,Móvel,6,151
48807,2024-02-03 21:26:00,96,107,Vestuário,5,203
48808,2024-02-03 21:27:00,60,169,Eletrônico,2,229
48809,2024-02-03 21:28:00,87,138,Vestuário,8,225
48810,2024-02-03 21:29:00,21,130,Alimento,8,151
48811,2024-02-03 21:30:00,116,164,Vestuário,3,280
48812,2024-02-03 21:31:00,55,144,Alimento,8,199
48813,2024-02-03 21:32:00,26,70,Brinquedo,2,96
48814,2024-02-03 21:33:00,33,22,Móvel,7,55
48815,2024-02-03 21:34:00,60,112,Móvel,4,172
48816,2024-02-03 21:35:00,108,58,Móvel,9,166
48817,2024-02-03 21:36:00,11,83,Eletrônico,5,94
48818,2024-02-03 21:37:00,38,123,Vestuário,9,161
48819,2024-02-03 21:38:00,16,80,Móvel,3,96
48820,2024-02-03 21:39:00,90,154,Móvel,6,244
48821,2024-02-03 21:40:00,89,126,Eletrônico,1,215
48822,2024-02-03 21:41:00,58,20,Alimento,8,78
48823,2024-02-03 21:42:00,69,44,Móvel,1,113
48824,2024-02-03 21:43:00,49,44,Brinquedo,8,93
48825,2024-02-03 21:44:00,71,144,Vestuário,3,215
48826,2024-02-03 21:45:00,25,169,Vestuário,9,194
48827,2024-02-03 21:46:00,95,125,Alimento,3,220
48828,2024-02-03 21:47:00,22,47,Eletrônico,9,69
48829,2024-02-03 21:48:00,34,107,Brinquedo,5,141
48830,2024-02-03 21:49:00,60,146,Brinquedo,3,206
48831,2024-02-03 21:50:00,71,56,Eletrônico,9,127
48832,2024-02-03 21:51:00,117,16,Brinquedo,2,133
48833,2024-02-03 21:52:00,26,146,Eletrônico,9,172
48834,2024-02-03 21:53:00,89,104,Brinquedo,6,193
48835,2024-02-03 21:54:00,45,33,Brinquedo,3,78
48836,2024-02-03 21:55:00,119,105,Alimento,1,224
48837,2024-02-03 21:56:00,81,130,Vestuário,1,211
48838,2024-02-03 21:57:00,80,144,Alimento,1,224
48839,2024-02-03 21:58:00,51,174,Vestuário,1,225
48840,2024-02-03 21:59:00,12,178,Móvel,9,190
48841,2024-02-03 22:00:00,42,109,Brinquedo,1,151
48842,2024-02-03 22:01:00,25,79,Vestuário,8,104
48843,2024-02-03 22:02:00,17,58,Eletrônico,8,75
48844,2024-02-03 22:03:00,95,142,Vestuário,8,237
48845,2024-02-03 22:04:00,101,137,Brinquedo,8,238
48846,2024-02-03 22:05:00,84,129,Brinquedo,8,213
48847,2024-02-03 22:06:00,14,161,Vestuário,8,175
48848,2024-02-03 22:07:00,18,43,Eletrônico,5,61
48849,2024-02-03 22:08:00,13,109,Móvel,2,122
48850,2024-02-03 22:09:00,75,86,Alimento,6,161
48851,2024-02-03 22:10:00,56,140,Brinquedo,4,196
48852,2024-02-03 22:11:00,112,70,Vestuário,5,182
48853,2024-02-03 22:12:00,42,66,Alimento,7,108
48854,2024-02-03 22:13:00,19,178,Alimento,4,197
48855,2024-02-03 22:14:00,61,148,Móvel,1,209
48856,2024-02-03 22:15:00,98,20,Móvel,7,118
48857,2024-02-03 22:16:00,72,173,Brinquedo,7,245
48858,2024-02-03 22:17:00,54,104,Vestuário,9,158
48859,2024-02-03 22:18:00,98,80,Vestuário,9,178
48860,2024-02-03 22:19:00,114,58,Vestuário,5,172
48861,2024-02-03 22:20:00,42,120,Vestuário,1,162
48862,2024-02-03 22:21:00,79,151,Móvel,1,230
48863,2024-02-03 22:22:00,40,117,Alimento,6,157
48864,2024-02-03 22:23:00,47,31,Brinquedo,4,78
48865,2024-02-03 22:24:00,33,32,Móvel,1,65
48866,2024-02-03 22:25:00,110,22,Alimento,4,132
48867,2024-02-03 22:26:00,36,22,Eletrônico,1,58
48868,2024-02-03 22:27:00,113,36,Brinquedo,7,149
48869,2024-02-03 22:28:00,108,138,Brinquedo,5,246
48870,2024-02-03 22:29:00,11,144,Móvel,3,155
48871,2024-02-03 22:30:00,107,132,Alimento,4,239
48872,2024-02-03 22:31:00,36,169,Eletrônico,2,205
48873,2024-02-03 22:32:00,28,126,Vestuário,9,154
48874,2024-02-03 22:33:00,23,43,Vestuário,8,66
48875,2024-02-03 22:34:00,59,67,Brinquedo,8,126
48876,2024-02-03 22:35:00,99,132,Brinquedo,6,231
48877,2024-02-03 22:36:00,13,27,Alimento,9,40
48878,2024-02-03 22:37:00,90,162,Alimento,8,252
48879,2024-02-03 22:38:00,62,79,Móvel,6,141
48880,2024-02-03 22:39:00,34,46,Vestuário,3,80
48881,2024-02-03 22:40:00,96,179,Brinquedo,6,275
48882,2024-02-03 22:41:00,114,92,Móvel,7,206
48883,2024-02-03 22:42:00,118,53,Brinquedo,3,171
48884,2024-02-03 22:43:00,108,77,Eletrônico,6,185
48885,2024-02-03 22:44:00,68,144,Eletrônico,5,212
48886,2024-02-03 22:45:00,79,84,Móvel,3,163
48887,2024-02-03 22:46:00,13,82,Eletrônico,1,95
48888,2024-02-03 22:47:00,77,86,Brinquedo,5,163
48889,2024-02-03 22:48:00,96,40,Móvel,2,136
48890,2024-02-03 22:49:00,28,143,Alimento,5,171
48891,2024-02-03 22:50:00,17,54,Vestuário,5,71
48892,2024-02-03 22:51:00,39,99,Eletrônico,2,138
48893,2024-02-03 22:52:00,106,97,Eletrônico,2,203
48894,2024-02-03 22:53:00,45,80,Móvel,4,125
48895,2024-02-03 22:54:00,48,55,Móvel,1,103
48896,2024-02-03 22:55:00,12,44,Vestuário,3,56
48897,2024-02-03 22:56:00,59,97,Alimento,2,156
48898,2024-02-03 22:57:00,85,126,Eletrônico,9,211
48899,2024-02-03 22:58:00,19,126,Alimento,8,145
48900,2024-02-03 22:59:00,20,95,Brinquedo,5,115
48901,2024-02-03 23:00:00,29,12,Eletrônico,2,41
48902,2024-02-03 23:01:00,18,128,Alimento,2,146
48903,2024-02-03 23:02:00,92,17,Eletrônico,8,109
48904,2024-02-03 23:03:00,34,126,Eletrônico,1,160
48905,2024-02-03 23:04:00,12,34,Móvel,2,46
48906,2024-02-03 23:05:00,70,152,Móvel,8,222
48907,2024-02-03 23:06:00,44,147,Vestuário,7,191
48908,2024-02-03 23:07:00,90,47,Móvel,9,137
48909,2024-02-03 23:08:00,68,32,Móvel,5,100
48910,2024-02-03 23:09:00,104,162,Alimento,3,266
48911,2024-02-03 23:10:00,68,36,Alimento,6,104
48912,2024-02-03 23:11:00,88,170,Alimento,3,258
48913,2024-02-03 23:12:00,110,28,Brinquedo,9,138
48914,2024-02-03 23:13:00,40,178,Brinquedo,8,218
48915,2024-02-03 23:14:00,47,10,Eletrônico,3,57
48916,2024-02-03 23:15:00,68,134,Brinquedo,2,202
48917,2024-02-03 23:16:00,37,101,Alimento,1,138
48918,2024-02-03 23:17:00,89,105,Móvel,2,194
48919,2024-02-03 23:18:00,45,24,Alimento,2,69
48920,2024-02-03 23:19:00,27,154,Móvel,2,181
48921,2024-02-03 23:20:00,82,75,Brinquedo,6,157
48922,2024-02-03 23:21:00,116,13,Alimento,3,129
48923,2024-02-03 23:22:00,39,85,Móvel,9,124
48924,2024-02-03 23:23:00,18,132,Alimento,6,150
48925,2024-02-03 23:24:00,104,38,Alimento,4,142
48926,2024-02-03 23:25:00,82,57,Vestuário,7,139
48927,2024-02-03 23:26:00,29,151,Alimento,7,180
48928,2024-02-03 23:27:00,19,127,Brinquedo,4,146
48929,2024-02-03 23:28:00,57,13,Eletrônico,7,70
48930,2024-02-03 23:29:00,35,110,Brinquedo,4,145
48931,2024-02-03 23:30:00,76,177,Vestuário,9,253
48932,2024-02-03 23:31:00,89,60,Brinquedo,1,149
48933,2024-02-03 23:32:00,117,149,Brinquedo,1,266
48934,2024-02-03 23:33:00,105,73,Alimento,1,178
48935,2024-02-03 23:34:00,57,60,Vestuário,3,117
48936,2024-02-03 23:35:00,41,115,Alimento,6,156
48937,2024-02-03 23:36:00,42,22,Eletrônico,7,64
48938,2024-02-03 23:37:00,13,155,Alimento,9,168
48939,2024-02-03 23:38:00,57,42,Vestuário,8,99
48940,2024-02-03 23:39:00,28,38,Alimento,1,66
48941,2024-02-03 23:40:00,18,164,Brinquedo,4,182
48942,2024-02-03 23:41:00,30,91,Vestuário,2,121
48943,2024-02-03 23:42:00,55,146,Móvel,9,201
48944,2024-02-03 23:43:00,66,87,Alimento,3,153
48945,2024-02-03 23:44:00,28,56,Móvel,1,84
48946,2024-02-03 23:45:00,43,132,Vestuário,3,175
48947,2024-02-03 23:46:00,30,44,Brinquedo,2,74
48948,2024-02-03 23:47:00,68,39,Brinquedo,7,107
48949,2024-02-03 23:48:00,73,78,Eletrônico,9,151
48950,2024-02-03 23:49:00,66,160,Brinquedo,2,226
48951,2024-02-03 23:50:00,28,17,Móvel,7,45
48952,2024-02-03 23:51:00,14,117,Vestuário,2,131
48953,2024-02-03 23:52:00,84,45,Vestuário,2,129
48954,2024-02-03 23:53:00,18,36,Vestuário,6,54
48955,2024-02-03 23:54:00,32,155,Móvel,7,187
48956,2024-02-03 23:55:00,88,132,Brinquedo,8,220
48957,2024-02-03 23:56:00,60,16,Alimento,2,76
48958,2024-02-03 23:57:00,87,154,Vestuário,3,241
48959,2024-02-03 23:58:00,101,20,Vestuário,6,121
48960,2024-02-03 23:59:00,92,11,Eletrônico,3,103
48961,2024-02-04 00:00:00,39,91,Alimento,6,130
48962,2024-02-04 00:01:00,47,73,Alimento,5,120
48963,2024-02-04 00:02:00,98,40,Alimento,8,138
48964,2024-02-04 00:03:00,114,158,Alimento,9,272
48965,2024-02-04 00:04:00,92,69,Eletrônico,2,161
48966,2024-02-04 00:05:00,52,47,Brinquedo,3,99
48967,2024-02-04 00:06:00,33,10,Vestuário,5,43
48968,2024-02-04 00:07:00,74,163,Eletrônico,7,237
48969,2024-02-04 00:08:00,115,113,Vestuário,5,228
48970,2024-02-04 00:09:00,78,86,Eletrônico,4,164
48971,2024-02-04 00:10:00,53,32,Móvel,7,85
48972,2024-02-04 00:11:00,111,159,Móvel,2,270
48973,2024-02-04 00:12:00,104,38,Vestuário,8,142
48974,2024-02-04 00:13:00,118,156,Vestuário,7,274
48975,2024-02-04 00:14:00,61,175,Eletrônico,3,236
48976,2024-02-04 00:15:00,49,18,Eletrônico,1,67
48977,2024-02-04 00:16:00,59,171,Vestuário,3,230
48978,2024-02-04 00:17:00,69,116,Eletrônico,3,185
48979,2024-02-04 00:18:00,60,116,Alimento,7,176
48980,2024-02-04 00:19:00,60,36,Vestuário,3,96
48981,2024-02-04 00:20:00,110,55,Móvel,6,165
48982,2024-02-04 00:21:00,60,154,Vestuário,5,214
48983,2024-02-04 00:22:00,87,45,Brinquedo,2,132
48984,2024-02-04 00:23:00,108,65,Móvel,8,173
48985,2024-02-04 00:24:00,18,24,Brinquedo,5,42
48986,2024-02-04 00:25:00,110,13,Brinquedo,6,123
48987,2024-02-04 00:26:00,25,75,Eletrônico,1,100
48988,2024-02-04 00:27:00,89,158,Brinquedo,5,247
48989,2024-02-04 00:28:00,107,50,Alimento,5,157
48990,2024-02-04 00:29:00,90,57,Alimento,4,147
48991,2024-02-04 00:30:00,115,102,Móvel,1,217
48992,2024-02-04 00:31:00,94,20,Brinquedo,4,114
48993,2024-02-04 00:32:00,40,86,Brinquedo,3,126
48994,2024-02-04 00:33:00,47,177,Alimento,3,224
48995,2024-02-04 00:34:00,118,175,Móvel,7,293
48996,2024-02-04 00:35:00,64,98,Eletrônico,7,162
48997,2024-02-04 00:36:00,100,113,Brinquedo,5,213
48998,2024-02-04 00:37:00,19,69,Eletrônico,8,88
48999,2024-02-04 00:38:00,78,19,Brinquedo,8,97
49000,2024-02-04 00:39:00,105,119,Móvel,5,224
49001,2024-02-04 00:40:00,75,39,Vestuário,3,114
49002,2024-02-04 00:41:00,26,133,Vestuário,2,159
49003,2024-02-04 00:42:00,74,153,Brinquedo,1,227
49004,2024-02-04 00:43:00,76,41,Vestuário,3,117
49005,2024-02-04 00:44:00,92,157,Brinquedo,1,249
49006,2024-02-04 00:45:00,68,143,Brinquedo,1,211
49007,2024-02-04 00:46:00,115,149,Móvel,7,264
49008,2024-02-04 00:47:00,41,178,Vestuário,7,219
49009,2024-02-04 00:48:00,46,178,Brinquedo,7,224
49010,2024-02-04 00:49:00,93,74,Alimento,1,167
49011,2024-02-04 00:50:00,57,112,Brinquedo,3,169
49012,2024-02-04 00:51:00,35,160,Eletrônico,5,195
49013,2024-02-04 00:52:00,63,98,Vestuário,6,161
49014,2024-02-04 00:53:00,90,119,Brinquedo,9,209
49015,2024-02-04 00:54:00,111,73,Vestuário,7,184
49016,2024-02-04 00:55:00,92,108,Brinquedo,7,200
49017,2024-02-04 00:56:00,106,61,Alimento,3,167
49018,2024-02-04 00:57:00,12,87,Alimento,7,99
49019,2024-02-04 00:58:00,79,62,Eletrônico,1,141
49020,2024-02-04 00:59:00,62,120,Móvel,5,182
49021,2024-02-04 01:00:00,87,49,Vestuário,6,136
49022,2024-02-04 01:01:00,61,34,Brinquedo,7,95
49023,2024-02-04 01:02:00,44,152,Vestuário,4,196
49024,2024-02-04 01:03:00,33,103,Alimento,6,136
49025,2024-02-04 01:04:00,115,124,Eletrônico,9,239
49026,2024-02-04 01:05:00,87,132,Móvel,4,219
49027,2024-02-04 01:06:00,106,170,Móvel,5,276
49028,2024-02-04 01:07:00,50,147,Brinquedo,8,197
49029,2024-02-04 01:08:00,14,58,Brinquedo,6,72
49030,2024-02-04 01:09:00,54,69,Vestuário,3,123
49031,2024-02-04 01:10:00,85,131,Alimento,8,216
49032,2024-02-04 01:11:00,67,73,Vestuário,1,140
49033,2024-02-04 01:12:00,113,136,Vestuário,5,249
49034,2024-02-04 01:13:00,57,72,Móvel,2,129
49035,2024-02-04 01:14:00,108,20,Alimento,1,128
49036,2024-02-04 01:15:00,52,147,Móvel,5,199
49037,2024-02-04 01:16:00,16,21,Alimento,5,37
49038,2024-02-04 01:17:00,104,126,Eletrônico,5,230
49039,2024-02-04 01:18:00,107,89,Brinquedo,1,196
49040,2024-02-04 01:19:00,80,49,Eletrônico,6,129
49041,2024-02-04 01:20:00,116,89,Eletrônico,6,205
49042,2024-02-04 01:21:00,89,170,Eletrônico,5,259
49043,2024-02-04 01:22:00,118,172,Brinquedo,6,290
49044,2024-02-04 01:23:00,20,20,Móvel,3,40
49045,2024-02-04 01:24:00,38,31,Eletrônico,1,69
49046,2024-02-04 01:25:00,58,80,Alimento,2,138
49047,2024-02-04 01:26:00,50,67,Eletrônico,2,117
49048,2024-02-04 01:27:00,79,94,Brinquedo,4,173
49049,2024-02-04 01:28:00,64,169,Vestuário,8,233
49050,2024-02-04 01:29:00,32,113,Eletrônico,9,145
49051,2024-02-04 01:30:00,23,64,Eletrônico,8,87
49052,2024-02-04 01:31:00,86,106,Eletrônico,8,192
49053,2024-02-04 01:32:00,37,138,Vestuário,4,175
49054,2024-02-04 01:33:00,111,136,Móvel,1,247
49055,2024-02-04 01:34:00,106,109,Brinquedo,6,215
49056,2024-02-04 01:35:00,26,72,Alimento,3,98
49057,2024-02-04 01:36:00,91,99,Eletrônico,4,190
49058,2024-02-04 01:37:00,78,136,Alimento,7,214
49059,2024-02-04 01:38:00,80,101,Brinquedo,3,181
49060,2024-02-04 01:39:00,116,25,Vestuário,5,141
49061,2024-02-04 01:40:00,17,161,Brinquedo,5,178
49062,2024-02-04 01:41:00,69,38,Alimento,3,107
49063,2024-02-04 01:42:00,46,150,Móvel,8,196
49064,2024-02-04 01:43:00,68,95,Vestuário,7,163
49065,2024-02-04 01:44:00,116,22,Vestuário,4,138
49066,2024-02-04 01:45:00,118,151,Brinquedo,2,269
49067,2024-02-04 01:46:00,36,54,Brinquedo,3,90
49068,2024-02-04 01:47:00,25,98,Brinquedo,9,123
49069,2024-02-04 01:48:00,53,155,Vestuário,3,208
49070,2024-02-04 01:49:00,48,68,Móvel,2,116
49071,2024-02-04 01:50:00,63,82,Móvel,4,145
49072,2024-02-04 01:51:00,95,87,Alimento,1,182
49073,2024-02-04 01:52:00,93,57,Eletrônico,6,150
49074,2024-02-04 01:53:00,82,96,Eletrônico,4,178
49075,2024-02-04 01:54:00,104,170,Eletrônico,3,274
49076,2024-02-04 01:55:00,44,82,Eletrônico,8,126
49077,2024-02-04 01:56:00,13,133,Alimento,2,146
49078,2024-02-04 01:57:00,41,166,Eletrônico,7,207
49079,2024-02-04 01:58:00,61,103,Vestuário,5,164
49080,2024-02-04 01:59:00,85,92,Vestuário,5,177
49081,2024-02-04 02:00:00,57,83,Eletrônico,9,140
49082,2024-02-04 02:01:00,101,124,Alimento,3,225
49083,2024-02-04 02:02:00,50,24,Eletrônico,1,74
49084,2024-02-04 02:03:00,107,147,Vestuário,1,254
49085,2024-02-04 02:04:00,51,20,Eletrônico,2,71
49086,2024-02-04 02:05:00,112,152,Vestuário,8,264
49087,2024-02-04 02:06:00,28,20,Eletrônico,3,48
49088,2024-02-04 02:07:00,21,111,Móvel,9,132
49089,2024-02-04 02:08:00,81,77,Alimento,6,158
49090,2024-02-04 02:09:00,53,22,Eletrônico,6,75
49091,2024-02-04 02:10:00,67,50,Vestuário,1,117
49092,2024-02-04 02:11:00,93,118,Vestuário,8,211
49093,2024-02-04 02:12:00,105,35,Brinquedo,8,140
49094,2024-02-04 02:13:00,53,171,Móvel,9,224
49095,2024-02-04 02:14:00,114,12,Alimento,1,126
49096,2024-02-04 02:15:00,62,101,Alimento,7,163
49097,2024-02-04 02:16:00,46,130,Móvel,7,176
49098,2024-02-04 02:17:00,110,85,Móvel,5,195
49099,2024-02-04 02:18:00,17,125,Móvel,1,142
49100,2024-02-04 02:19:00,38,98,Brinquedo,9,136
49101,2024-02-04 02:20:00,44,120,Alimento,5,164
49102,2024-02-04 02:21:00,52,99,Brinquedo,1,151
49103,2024-02-04 02:22:00,99,168,Brinquedo,2,267
49104,2024-02-04 02:23:00,45,87,Brinquedo,6,132
49105,2024-02-04 02:24:00,37,15,Móvel,2,52
49106,2024-02-04 02:25:00,27,50,Móvel,1,77
49107,2024-02-04 02:26:00,44,148,Brinquedo,3,192
49108,2024-02-04 02:27:00,39,53,Móvel,2,92
49109,2024-02-04 02:28:00,14,169,Eletrônico,8,183
49110,2024-02-04 02:29:00,100,67,Eletrônico,7,167
49111,2024-02-04 02:30:00,77,79,Eletrônico,8,156
49112,2024-02-04 02:31:00,32,106,Brinquedo,6,138
49113,2024-02-04 02:32:00,46,130,Eletrônico,7,176
49114,2024-02-04 02:33:00,104,13,Eletrônico,2,117
49115,2024-02-04 02:34:00,15,150,Vestuário,5,165
49116,2024-02-04 02:35:00,98,107,Brinquedo,7,205
49117,2024-02-04 02:36:00,19,37,Vestuário,6,56
49118,2024-02-04 02:37:00,70,138,Brinquedo,4,208
49119,2024-02-04 02:38:00,100,73,Brinquedo,9,173
49120,2024-02-04 02:39:00,35,113,Vestuário,8,148
49121,2024-02-04 02:40:00,73,172,Brinquedo,5,245
49122,2024-02-04 02:41:00,20,83,Brinquedo,4,103
49123,2024-02-04 02:42:00,106,82,Alimento,9,188
49124,2024-02-04 02:43:00,39,23,Vestuário,7,62
49125,2024-02-04 02:44:00,37,161,Vestuário,6,198
49126,2024-02-04 02:45:00,79,156,Alimento,5,235
49127,2024-02-04 02:46:00,23,151,Brinquedo,1,174
49128,2024-02-04 02:47:00,92,167,Eletrônico,4,259
49129,2024-02-04 02:48:00,32,99,Alimento,8,131
49130,2024-02-04 02:49:00,44,64,Brinquedo,8,108
49131,2024-02-04 02:50:00,52,41,Vestuário,9,93
49132,2024-02-04 02:51:00,118,61,Brinquedo,6,179
49133,2024-02-04 02:52:00,12,23,Móvel,1,35
49134,2024-02-04 02:53:00,20,15,Móvel,8,35
49135,2024-02-04 02:54:00,41,161,Brinquedo,1,202
49136,2024-02-04 02:55:00,78,70,Brinquedo,9,148
49137,2024-02-04 02:56:00,15,121,Alimento,4,136
49138,2024-02-04 02:57:00,53,70,Alimento,4,123
49139,2024-02-04 02:58:00,104,16,Alimento,4,120
49140,2024-02-04 02:59:00,108,98,Móvel,5,206
49141,2024-02-04 03:00:00,64,109,Eletrônico,3,173
49142,2024-02-04 03:01:00,118,84,Móvel,2,202
49143,2024-02-04 03:02:00,86,151,Móvel,5,237
49144,2024-02-04 03:03:00,68,96,Vestuário,3,164
49145,2024-02-04 03:04:00,47,58,Móvel,2,105
49146,2024-02-04 03:05:00,59,66,Móvel,9,125
49147,2024-02-04 03:06:00,50,148,Alimento,7,198
49148,2024-02-04 03:07:00,30,69,Móvel,6,99
49149,2024-02-04 03:08:00,84,30,Brinquedo,9,114
49150,2024-02-04 03:09:00,77,126,Eletrônico,1,203
49151,2024-02-04 03:10:00,55,103,Alimento,7,158
49152,2024-02-04 03:11:00,99,152,Brinquedo,1,251
49153,2024-02-04 03:12:00,110,127,Alimento,5,237
49154,2024-02-04 03:13:00,75,25,Vestuário,7,100
49155,2024-02-04 03:14:00,74,133,Alimento,1,207
49156,2024-02-04 03:15:00,58,109,Eletrônico,2,167
49157,2024-02-04 03:16:00,71,50,Vestuário,8,121
49158,2024-02-04 03:17:00,51,54,Móvel,1,105
49159,2024-02-04 03:18:00,81,70,Eletrônico,4,151
49160,2024-02-04 03:19:00,37,79,Alimento,5,116
49161,2024-02-04 03:20:00,81,40,Brinquedo,1,121
49162,2024-02-04 03:21:00,91,106,Alimento,6,197
49163,2024-02-04 03:22:00,105,51,Alimento,3,156
49164,2024-02-04 03:23:00,110,171,Alimento,4,281
49165,2024-02-04 03:24:00,95,12,Alimento,9,107
49166,2024-02-04 03:25:00,87,42,Móvel,7,129
49167,2024-02-04 03:26:00,55,51,Vestuário,3,106
49168,2024-02-04 03:27:00,43,13,Brinquedo,2,56
49169,2024-02-04 03:28:00,11,81,Eletrônico,1,92
49170,2024-02-04 03:29:00,106,26,Eletrônico,8,132
49171,2024-02-04 03:30:00,19,101,Eletrônico,5,120
49172,2024-02-04 03:31:00,71,57,Vestuário,2,128
49173,2024-02-04 03:32:00,87,127,Eletrônico,3,214
49174,2024-02-04 03:33:00,92,151,Brinquedo,9,243
49175,2024-02-04 03:34:00,87,43,Móvel,7,130
49176,2024-02-04 03:35:00,119,100,Brinquedo,9,219
49177,2024-02-04 03:36:00,36,150,Móvel,6,186
49178,2024-02-04 03:37:00,14,64,Alimento,9,78
49179,2024-02-04 03:38:00,77,57,Eletrônico,8,134
49180,2024-02-04 03:39:00,116,160,Brinquedo,3,276
49181,2024-02-04 03:40:00,81,124,Móvel,7,205
49182,2024-02-04 03:41:00,107,75,Móvel,9,182
49183,2024-02-04 03:42:00,83,27,Eletrônico,6,110
49184,2024-02-04 03:43:00,94,18,Eletrônico,4,112
49185,2024-02-04 03:44:00,16,161,Vestuário,2,177
49186,2024-02-04 03:45:00,94,132,Alimento,1,226
49187,2024-02-04 03:46:00,38,85,Brinquedo,7,123
49188,2024-02-04 03:47:00,101,161,Vestuário,5,262
49189,2024-02-04 03:48:00,114,172,Vestuário,8,286
49190,2024-02-04 03:49:00,111,172,Eletrônico,7,283
49191,2024-02-04 03:50:00,48,143,Móvel,5,191
49192,2024-02-04 03:51:00,35,173,Móvel,3,208
49193,2024-02-04 03:52:00,18,63,Brinquedo,6,81
49194,2024-02-04 03:53:00,44,159,Alimento,6,203
49195,2024-02-04 03:54:00,43,98,Móvel,3,141
49196,2024-02-04 03:55:00,77,50,Vestuário,4,127
49197,2024-02-04 03:56:00,10,58,Alimento,1,68
49198,2024-02-04 03:57:00,84,41,Brinquedo,3,125
49199,2024-02-04 03:58:00,28,157,Eletrônico,4,185
49200,2024-02-04 03:59:00,109,40,Vestuário,1,149
49201,2024-02-04 04:00:00,107,109,Móvel,2,216
49202,2024-02-04 04:01:00,72,47,Vestuário,9,119
49203,2024-02-04 04:02:00,66,33,Móvel,3,99
49204,2024-02-04 04:03:00,111,111,Eletrônico,4,222
49205,2024-02-04 04:04:00,37,31,Vestuário,4,68
49206,2024-02-04 04:05:00,102,163,Alimento,3,265
49207,2024-02-04 04:06:00,39,108,Móvel,2,147
49208,2024-02-04 04:07:00,110,108,Eletrônico,9,218
49209,2024-02-04 04:08:00,41,159,Alimento,6,200
49210,2024-02-04 04:09:00,91,119,Vestuário,5,210
49211,2024-02-04 04:10:00,97,112,Móvel,6,209
49212,2024-02-04 04:11:00,15,71,Vestuário,3,86
49213,2024-02-04 04:12:00,109,144,Alimento,8,253
49214,2024-02-04 04:13:00,62,132,Móvel,3,194
49215,2024-02-04 04:14:00,79,115,Brinquedo,7,194
49216,2024-02-04 04:15:00,49,166,Alimento,9,215
49217,2024-02-04 04:16:00,77,56,Móvel,7,133
49218,2024-02-04 04:17:00,96,39,Vestuário,4,135
49219,2024-02-04 04:18:00,69,79,Alimento,3,148
49220,2024-02-04 04:19:00,49,10,Eletrônico,4,59
49221,2024-02-04 04:20:00,80,62,Eletrônico,8,142
49222,2024-02-04 04:21:00,48,37,Brinquedo,5,85
49223,2024-02-04 04:22:00,25,102,Móvel,5,127
49224,2024-02-04 04:23:00,44,116,Móvel,1,160
49225,2024-02-04 04:24:00,78,116,Vestuário,9,194
49226,2024-02-04 04:25:00,77,99,Vestuário,7,176
49227,2024-02-04 04:26:00,91,147,Vestuário,1,238
49228,2024-02-04 04:27:00,45,42,Móvel,9,87
49229,2024-02-04 04:28:00,102,91,Brinquedo,5,193
49230,2024-02-04 04:29:00,55,106,Vestuário,4,161
49231,2024-02-04 04:30:00,66,160,Vestuário,9,226
49232,2024-02-04 04:31:00,32,88,Vestuário,3,120
49233,2024-02-04 04:32:00,22,91,Vestuário,8,113
49234,2024-02-04 04:33:00,35,95,Móvel,4,130
49235,2024-02-04 04:34:00,96,124,Alimento,2,220
49236,2024-02-04 04:35:00,49,164,Vestuário,4,213
49237,2024-02-04 04:36:00,54,106,Eletrônico,1,160
49238,2024-02-04 04:37:00,41,62,Vestuário,9,103
49239,2024-02-04 04:38:00,111,72,Vestuário,4,183
49240,2024-02-04 04:39:00,75,87,Alimento,7,162
49241,2024-02-04 04:40:00,42,123,Brinquedo,9,165
49242,2024-02-04 04:41:00,37,147,Móvel,1,184
49243,2024-02-04 04:42:00,11,71,Brinquedo,8,82
49244,2024-02-04 04:43:00,30,150,Brinquedo,4,180
49245,2024-02-04 04:44:00,110,82,Eletrônico,2,192
49246,2024-02-04 04:45:00,110,37,Eletrônico,3,147
49247,2024-02-04 04:46:00,43,101,Eletrônico,8,144
49248,2024-02-04 04:47:00,109,143,Móvel,5,252
49249,2024-02-04 04:48:00,31,75,Brinquedo,2,106
49250,2024-02-04 04:49:00,21,27,Brinquedo,5,48
49251,2024-02-04 04:50:00,19,53,Eletrônico,9,72
49252,2024-02-04 04:51:00,105,120,Vestuário,3,225
49253,2024-02-04 04:52:00,94,92,Móvel,9,186
49254,2024-02-04 04:53:00,93,36,Alimento,4,129
49255,2024-02-04 04:54:00,52,108,Móvel,4,160
49256,2024-02-04 04:55:00,84,73,Vestuário,7,157
49257,2024-02-04 04:56:00,68,163,Móvel,8,231
49258,2024-02-04 04:57:00,80,68,Alimento,4,148
49259,2024-02-04 04:58:00,112,39,Vestuário,1,151
49260,2024-02-04 04:59:00,29,17,Eletrônico,8,46
49261,2024-02-04 05:00:00,73,58,Móvel,8,131
49262,2024-02-04 05:01:00,87,53,Brinquedo,3,140
49263,2024-02-04 05:02:00,72,85,Móvel,5,157
49264,2024-02-04 05:03:00,10,136,Eletrônico,7,146
49265,2024-02-04 05:04:00,10,84,Alimento,6,94
49266,2024-02-04 05:05:00,42,64,Brinquedo,1,106
49267,2024-02-04 05:06:00,99,86,Brinquedo,5,185
49268,2024-02-04 05:07:00,74,22,Vestuário,9,96
49269,2024-02-04 05:08:00,55,148,Alimento,3,203
49270,2024-02-04 05:09:00,19,133,Móvel,2,152
49271,2024-02-04 05:10:00,41,119,Vestuário,8,160
49272,2024-02-04 05:11:00,91,15,Alimento,6,106
49273,2024-02-04 05:12:00,51,33,Brinquedo,6,84
49274,2024-02-04 05:13:00,67,87,Eletrônico,5,154
49275,2024-02-04 05:14:00,83,31,Brinquedo,1,114
49276,2024-02-04 05:15:00,27,152,Eletrônico,4,179
49277,2024-02-04 05:16:00,15,94,Brinquedo,2,109
49278,2024-02-04 05:17:00,67,173,Vestuário,9,240
49279,2024-02-04 05:18:00,79,67,Eletrônico,3,146
49280,2024-02-04 05:19:00,99,115,Vestuário,9,214
49281,2024-02-04 05:20:00,49,93,Móvel,8,142
49282,2024-02-04 05:21:00,47,103,Alimento,5,150
49283,2024-02-04 05:22:00,13,21,Móvel,6,34
49284,2024-02-04 05:23:00,38,101,Móvel,1,139
49285,2024-02-04 05:24:00,51,171,Alimento,9,222
49286,2024-02-04 05:25:00,61,122,Alimento,9,183
49287,2024-02-04 05:26:00,31,10,Vestuário,4,41
49288,2024-02-04 05:27:00,82,160,Móvel,6,242
49289,2024-02-04 05:28:00,22,166,Alimento,7,188
49290,2024-02-04 05:29:00,103,83,Móvel,6,186
49291,2024-02-04 05:30:00,44,85,Alimento,8,129
49292,2024-02-04 05:31:00,62,89,Eletrônico,8,151
49293,2024-02-04 05:32:00,21,107,Eletrônico,1,128
49294,2024-02-04 05:33:00,51,167,Eletrônico,1,218
49295,2024-02-04 05:34:00,105,124,Brinquedo,1,229
49296,2024-02-04 05:35:00,39,97,Brinquedo,9,136
49297,2024-02-04 05:36:00,80,95,Eletrônico,8,175
49298,2024-02-04 05:37:00,75,43,Vestuário,7,118
49299,2024-02-04 05:38:00,48,97,Móvel,8,145
49300,2024-02-04 05:39:00,110,64,Brinquedo,3,174
49301,2024-02-04 05:40:00,63,91,Alimento,5,154
49302,2024-02-04 05:41:00,64,154,Alimento,7,218
49303,2024-02-04 05:42:00,64,28,Eletrônico,8,92
49304,2024-02-04 05:43:00,72,63,Móvel,1,135
49305,2024-02-04 05:44:00,101,125,Eletrônico,8,226
49306,2024-02-04 05:45:00,113,86,Móvel,9,199
49307,2024-02-04 05:46:00,30,12,Eletrônico,7,42
49308,2024-02-04 05:47:00,61,124,Alimento,1,185
49309,2024-02-04 05:48:00,36,142,Móvel,5,178
49310,2024-02-04 05:49:00,48,137,Vestuário,7,185
49311,2024-02-04 05:50:00,105,172,Brinquedo,9,277
49312,2024-02-04 05:51:00,107,17,Eletrônico,1,124
49313,2024-02-04 05:52:00,28,57,Brinquedo,5,85
49314,2024-02-04 05:53:00,61,153,Brinquedo,8,214
49315,2024-02-04 05:54:00,116,150,Móvel,1,266
49316,2024-02-04 05:55:00,26,113,Alimento,6,139
49317,2024-02-04 05:56:00,88,151,Alimento,4,239
49318,2024-02-04 05:57:00,108,39,Alimento,1,147
49319,2024-02-04 05:58:00,54,85,Alimento,3,139
49320,2024-02-04 05:59:00,65,143,Alimento,6,208
49321,2024-02-04 06:00:00,35,141,Alimento,8,176
49322,2024-02-04 06:01:00,81,139,Brinquedo,2,220
49323,2024-02-04 06:02:00,26,74,Vestuário,9,100
49324,2024-02-04 06:03:00,33,168,Brinquedo,6,201
49325,2024-02-04 06:04:00,73,170,Móvel,4,243
49326,2024-02-04 06:05:00,47,45,Brinquedo,7,92
49327,2024-02-04 06:06:00,110,40,Eletrônico,6,150
49328,2024-02-04 06:07:00,20,150,Brinquedo,3,170
49329,2024-02-04 06:08:00,115,51,Vestuário,2,166
49330,2024-02-04 06:09:00,49,113,Móvel,3,162
49331,2024-02-04 06:10:00,83,127,Móvel,4,210
49332,2024-02-04 06:11:00,107,25,Eletrônico,3,132
49333,2024-02-04 06:12:00,32,12,Brinquedo,9,44
49334,2024-02-04 06:13:00,94,118,Alimento,4,212
49335,2024-02-04 06:14:00,100,102,Vestuário,9,202
49336,2024-02-04 06:15:00,23,113,Móvel,4,136
49337,2024-02-04 06:16:00,71,10,Brinquedo,2,81
49338,2024-02-04 06:17:00,95,88,Móvel,7,183
49339,2024-02-04 06:18:00,52,149,Alimento,9,201
49340,2024-02-04 06:19:00,46,121,Vestuário,7,167
49341,2024-02-04 06:20:00,82,33,Móvel,9,115
49342,2024-02-04 06:21:00,90,137,Alimento,3,227
49343,2024-02-04 06:22:00,96,64,Vestuário,3,160
49344,2024-02-04 06:23:00,64,40,Eletrônico,3,104
49345,2024-02-04 06:24:00,49,161,Alimento,5,210
49346,2024-02-04 06:25:00,63,140,Vestuário,9,203
49347,2024-02-04 06:26:00,90,64,Eletrônico,4,154
49348,2024-02-04 06:27:00,109,24,Brinquedo,4,133
49349,2024-02-04 06:28:00,33,21,Eletrônico,3,54
49350,2024-02-04 06:29:00,54,144,Móvel,3,198
49351,2024-02-04 06:30:00,104,121,Móvel,4,225
49352,2024-02-04 06:31:00,33,117,Brinquedo,8,150
49353,2024-02-04 06:32:00,14,114,Eletrônico,8,128
49354,2024-02-04 06:33:00,36,13,Alimento,9,49
49355,2024-02-04 06:34:00,88,95,Brinquedo,6,183
49356,2024-02-04 06:35:00,61,59,Eletrônico,2,120
49357,2024-02-04 06:36:00,10,61,Alimento,6,71
49358,2024-02-04 06:37:00,52,49,Alimento,1,101
49359,2024-02-04 06:38:00,37,105,Eletrônico,6,142
49360,2024-02-04 06:39:00,104,131,Eletrônico,5,235
49361,2024-02-04 06:40:00,106,168,Brinquedo,7,274
49362,2024-02-04 06:41:00,48,94,Móvel,6,142
49363,2024-02-04 06:42:00,56,164,Eletrônico,9,220
49364,2024-02-04 06:43:00,107,57,Móvel,2,164
49365,2024-02-04 06:44:00,37,76,Móvel,4,113
49366,2024-02-04 06:45:00,119,17,Alimento,6,136
49367,2024-02-04 06:46:00,18,150,Alimento,5,168
49368,2024-02-04 06:47:00,84,146,Vestuário,2,230
49369,2024-02-04 06:48:00,58,95,Eletrônico,5,153
49370,2024-02-04 06:49:00,91,27,Móvel,8,118
49371,2024-02-04 06:50:00,106,32,Alimento,7,138
49372,2024-02-04 06:51:00,113,163,Eletrônico,6,276
49373,2024-02-04 06:52:00,44,52,Móvel,9,96
49374,2024-02-04 06:53:00,53,63,Vestuário,1,116
49375,2024-02-04 06:54:00,94,89,Móvel,5,183
49376,2024-02-04 06:55:00,52,130,Vestuário,6,182
49377,2024-02-04 06:56:00,99,160,Móvel,2,259
49378,2024-02-04 06:57:00,27,104,Brinquedo,8,131
49379,2024-02-04 06:58:00,70,159,Alimento,5,229
49380,2024-02-04 06:59:00,91,133,Alimento,7,224
49381,2024-02-04 07:00:00,53,152,Vestuário,6,205
49382,2024-02-04 07:01:00,91,146,Alimento,9,237
49383,2024-02-04 07:02:00,29,14,Vestuário,7,43
49384,2024-02-04 07:03:00,40,177,Eletrônico,7,217
49385,2024-02-04 07:04:00,108,86,Eletrônico,8,194
49386,2024-02-04 07:05:00,88,144,Brinquedo,6,232
49387,2024-02-04 07:06:00,116,62,Eletrônico,6,178
49388,2024-02-04 07:07:00,29,105,Vestuário,3,134
49389,2024-02-04 07:08:00,49,82,Brinquedo,7,131
49390,2024-02-04 07:09:00,85,83,Brinquedo,8,168
49391,2024-02-04 07:10:00,56,113,Móvel,2,169
49392,2024-02-04 07:11:00,49,103,Vestuário,5,152
49393,2024-02-04 07:12:00,72,59,Alimento,1,131
49394,2024-02-04 07:13:00,96,49,Eletrônico,1,145
49395,2024-02-04 07:14:00,33,89,Eletrônico,6,122
49396,2024-02-04 07:15:00,95,50,Alimento,9,145
49397,2024-02-04 07:16:00,110,13,Alimento,8,123
49398,2024-02-04 07:17:00,77,59,Móvel,9,136
49399,2024-02-04 07:18:00,61,111,Brinquedo,9,172
49400,2024-02-04 07:19:00,62,129,Brinquedo,2,191
49401,2024-02-04 07:20:00,59,31,Alimento,8,90
49402,2024-02-04 07:21:00,14,70,Alimento,2,84
49403,2024-02-04 07:22:00,79,165,Brinquedo,1,244
49404,2024-02-04 07:23:00,10,67,Brinquedo,9,77
49405,2024-02-04 07:24:00,93,49,Eletrônico,9,142
49406,2024-02-04 07:25:00,62,35,Brinquedo,7,97
49407,2024-02-04 07:26:00,94,105,Brinquedo,2,199
49408,2024-02-04 07:27:00,35,65,Vestuário,2,100
49409,2024-02-04 07:28:00,20,54,Móvel,1,74
49410,2024-02-04 07:29:00,105,129,Vestuário,9,234
49411,2024-02-04 07:30:00,51,168,Alimento,8,219
49412,2024-02-04 07:31:00,20,35,Móvel,8,55
49413,2024-02-04 07:32:00,78,11,Alimento,6,89
49414,2024-02-04 07:33:00,112,104,Eletrônico,3,216
49415,2024-02-04 07:34:00,85,49,Eletrônico,6,134
49416,2024-02-04 07:35:00,91,170,Vestuário,2,261
49417,2024-02-04 07:36:00,13,69,Móvel,3,82
49418,2024-02-04 07:37:00,21,86,Eletrônico,3,107
49419,2024-02-04 07:38:00,39,142,Vestuário,6,181
49420,2024-02-04 07:39:00,68,46,Vestuário,9,114
49421,2024-02-04 07:40:00,12,160,Alimento,2,172
49422,2024-02-04 07:41:00,95,50,Vestuário,5,145
49423,2024-02-04 07:42:00,31,93,Móvel,1,124
49424,2024-02-04 07:43:00,113,116,Brinquedo,8,229
49425,2024-02-04 07:44:00,28,140,Móvel,1,168
49426,2024-02-04 07:45:00,44,41,Vestuário,1,85
49427,2024-02-04 07:46:00,90,77,Móvel,9,167
49428,2024-02-04 07:47:00,108,171,Vestuário,5,279
49429,2024-02-04 07:48:00,79,111,Vestuário,6,190
49430,2024-02-04 07:49:00,25,99,Brinquedo,7,124
49431,2024-02-04 07:50:00,84,155,Eletrônico,8,239
49432,2024-02-04 07:51:00,94,178,Brinquedo,2,272
49433,2024-02-04 07:52:00,84,159,Alimento,4,243
49434,2024-02-04 07:53:00,84,65,Brinquedo,3,149
49435,2024-02-04 07:54:00,92,36,Brinquedo,4,128
49436,2024-02-04 07:55:00,111,97,Brinquedo,9,208
49437,2024-02-04 07:56:00,74,142,Alimento,8,216
49438,2024-02-04 07:57:00,12,137,Brinquedo,9,149
49439,2024-02-04 07:58:00,47,135,Vestuário,4,182
49440,2024-02-04 07:59:00,75,14,Brinquedo,3,89
49441,2024-02-04 08:00:00,39,133,Alimento,8,172
49442,2024-02-04 08:01:00,51,148,Eletrônico,1,199
49443,2024-02-04 08:02:00,71,128,Móvel,6,199
49444,2024-02-04 08:03:00,96,82,Brinquedo,1,178
49445,2024-02-04 08:04:00,86,65,Móvel,2,151
49446,2024-02-04 08:05:00,22,49,Brinquedo,7,71
49447,2024-02-04 08:06:00,102,156,Eletrônico,7,258
49448,2024-02-04 08:07:00,16,58,Móvel,8,74
49449,2024-02-04 08:08:00,112,146,Vestuário,3,258
49450,2024-02-04 08:09:00,104,66,Alimento,3,170
49451,2024-02-04 08:10:00,110,110,Móvel,9,220
49452,2024-02-04 08:11:00,104,156,Móvel,2,260
49453,2024-02-04 08:12:00,118,78,Móvel,2,196
49454,2024-02-04 08:13:00,57,13,Vestuário,5,70
49455,2024-02-04 08:14:00,99,23,Vestuário,6,122
49456,2024-02-04 08:15:00,80,32,Alimento,8,112
49457,2024-02-04 08:16:00,74,47,Brinquedo,6,121
49458,2024-02-04 08:17:00,60,28,Alimento,5,88
49459,2024-02-04 08:18:00,104,62,Brinquedo,4,166
49460,2024-02-04 08:19:00,57,146,Eletrônico,2,203
49461,2024-02-04 08:20:00,37,58,Eletrônico,1,95
49462,2024-02-04 08:21:00,36,86,Vestuário,4,122
49463,2024-02-04 08:22:00,77,78,Vestuário,5,155
49464,2024-02-04 08:23:00,86,140,Móvel,3,226
49465,2024-02-04 08:24:00,112,119,Vestuário,1,231
49466,2024-02-04 08:25:00,101,121,Móvel,2,222
49467,2024-02-04 08:26:00,111,152,Vestuário,2,263
49468,2024-02-04 08:27:00,104,166,Brinquedo,3,270
49469,2024-02-04 08:28:00,97,37,Eletrônico,9,134
49470,2024-02-04 08:29:00,90,124,Vestuário,3,214
49471,2024-02-04 08:30:00,67,81,Eletrônico,4,148
49472,2024-02-04 08:31:00,65,138,Eletrônico,9,203
49473,2024-02-04 08:32:00,86,61,Brinquedo,4,147
49474,2024-02-04 08:33:00,24,68,Brinquedo,9,92
49475,2024-02-04 08:34:00,96,70,Eletrônico,2,166
49476,2024-02-04 08:35:00,53,169,Eletrônico,3,222
49477,2024-02-04 08:36:00,115,85,Brinquedo,6,200
49478,2024-02-04 08:37:00,43,158,Brinquedo,6,201
49479,2024-02-04 08:38:00,105,47,Móvel,4,152
49480,2024-02-04 08:39:00,114,170,Vestuário,1,284
49481,2024-02-04 08:40:00,90,24,Eletrônico,3,114
49482,2024-02-04 08:41:00,34,64,Vestuário,1,98
49483,2024-02-04 08:42:00,30,44,Vestuário,4,74
49484,2024-02-04 08:43:00,91,24,Alimento,9,115
49485,2024-02-04 08:44:00,60,92,Móvel,5,152
49486,2024-02-04 08:45:00,94,122,Brinquedo,5,216
49487,2024-02-04 08:46:00,40,148,Brinquedo,9,188
49488,2024-02-04 08:47:00,103,22,Brinquedo,7,125
49489,2024-02-04 08:48:00,56,148,Vestuário,4,204
49490,2024-02-04 08:49:00,68,135,Vestuário,6,203
49491,2024-02-04 08:50:00,75,165,Alimento,7,240
49492,2024-02-04 08:51:00,110,67,Eletrônico,8,177
49493,2024-02-04 08:52:00,24,37,Vestuário,7,61
49494,2024-02-04 08:53:00,49,46,Alimento,4,95
49495,2024-02-04 08:54:00,94,88,Eletrônico,7,182
49496,2024-02-04 08:55:00,17,53,Móvel,1,70
49497,2024-02-04 08:56:00,14,95,Vestuário,3,109
49498,2024-02-04 08:57:00,51,34,Alimento,8,85
49499,2024-02-04 08:58:00,84,69,Móvel,5,153
49500,2024-02-04 08:59:00,96,85,Brinquedo,4,181
49501,2024-02-04 09:00:00,53,20,Vestuário,3,73
49502,2024-02-04 09:01:00,70,134,Alimento,7,204
49503,2024-02-04 09:02:00,100,119,Vestuário,5,219
49504,2024-02-04 09:03:00,51,132,Eletrônico,3,183
49505,2024-02-04 09:04:00,38,104,Alimento,2,142
49506,2024-02-04 09:05:00,111,100,Alimento,3,211
49507,2024-02-04 09:06:00,66,15,Vestuário,9,81
49508,2024-02-04 09:07:00,85,85,Vestuário,9,170
49509,2024-02-04 09:08:00,107,140,Eletrônico,6,247
49510,2024-02-04 09:09:00,107,148,Móvel,6,255
49511,2024-02-04 09:10:00,83,109,Vestuário,2,192
49512,2024-02-04 09:11:00,34,91,Móvel,9,125
49513,2024-02-04 09:12:00,73,27,Brinquedo,9,100
49514,2024-02-04 09:13:00,66,84,Alimento,6,150
49515,2024-02-04 09:14:00,106,113,Eletrônico,9,219
49516,2024-02-04 09:15:00,44,11,Móvel,4,55
49517,2024-02-04 09:16:00,46,152,Vestuário,8,198
49518,2024-02-04 09:17:00,72,149,Móvel,1,221
49519,2024-02-04 09:18:00,97,61,Móvel,6,158
49520,2024-02-04 09:19:00,75,40,Eletrônico,6,115
49521,2024-02-04 09:20:00,87,52,Alimento,7,139
49522,2024-02-04 09:21:00,60,65,Alimento,8,125
49523,2024-02-04 09:22:00,70,80,Móvel,9,150
49524,2024-02-04 09:23:00,99,12,Vestuário,3,111
49525,2024-02-04 09:24:00,58,114,Alimento,2,172
49526,2024-02-04 09:25:00,66,109,Brinquedo,1,175
49527,2024-02-04 09:26:00,71,170,Brinquedo,2,241
49528,2024-02-04 09:27:00,49,73,Vestuário,8,122
49529,2024-02-04 09:28:00,87,99,Brinquedo,6,186
49530,2024-02-04 09:29:00,20,34,Móvel,4,54
49531,2024-02-04 09:30:00,43,174,Alimento,4,217
49532,2024-02-04 09:31:00,14,126,Brinquedo,7,140
49533,2024-02-04 09:32:00,31,141,Móvel,8,172
49534,2024-02-04 09:33:00,11,113,Eletrônico,7,124
49535,2024-02-04 09:34:00,104,179,Vestuário,8,283
49536,2024-02-04 09:35:00,74,102,Vestuário,7,176
49537,2024-02-04 09:36:00,40,166,Alimento,5,206
49538,2024-02-04 09:37:00,89,152,Eletrônico,2,241
49539,2024-02-04 09:38:00,22,114,Móvel,1,136
49540,2024-02-04 09:39:00,104,158,Brinquedo,6,262
49541,2024-02-04 09:40:00,46,164,Brinquedo,1,210
49542,2024-02-04 09:41:00,49,58,Brinquedo,1,107
49543,2024-02-04 09:42:00,57,73,Eletrônico,3,130
49544,2024-02-04 09:43:00,107,10,Brinquedo,5,117
49545,2024-02-04 09:44:00,16,117,Móvel,2,133
49546,2024-02-04 09:45:00,11,27,Alimento,7,38
49547,2024-02-04 09:46:00,62,179,Brinquedo,6,241
49548,2024-02-04 09:47:00,103,100,Brinquedo,1,203
49549,2024-02-04 09:48:00,16,17,Alimento,5,33
49550,2024-02-04 09:49:00,11,73,Alimento,4,84
49551,2024-02-04 09:50:00,46,56,Vestuário,9,102
49552,2024-02-04 09:51:00,71,60,Móvel,6,131
49553,2024-02-04 09:52:00,119,177,Alimento,9,296
49554,2024-02-04 09:53:00,111,88,Alimento,6,199
49555,2024-02-04 09:54:00,52,163,Vestuário,1,215
49556,2024-02-04 09:55:00,20,135,Eletrônico,5,155
49557,2024-02-04 09:56:00,62,141,Vestuário,2,203
49558,2024-02-04 09:57:00,30,160,Móvel,7,190
49559,2024-02-04 09:58:00,75,66,Móvel,3,141
49560,2024-02-04 09:59:00,55,135,Brinquedo,8,190
49561,2024-02-04 10:00:00,11,111,Brinquedo,6,122
49562,2024-02-04 10:01:00,77,172,Vestuário,5,249
49563,2024-02-04 10:02:00,16,33,Móvel,1,49
49564,2024-02-04 10:03:00,27,65,Alimento,2,92
49565,2024-02-04 10:04:00,87,21,Eletrônico,7,108
49566,2024-02-04 10:05:00,70,44,Brinquedo,5,114
49567,2024-02-04 10:06:00,68,93,Móvel,6,161
49568,2024-02-04 10:07:00,81,113,Alimento,5,194
49569,2024-02-04 10:08:00,68,63,Vestuário,9,131
49570,2024-02-04 10:09:00,75,105,Brinquedo,5,180
49571,2024-02-04 10:10:00,32,43,Vestuário,9,75
49572,2024-02-04 10:11:00,106,131,Eletrônico,2,237
49573,2024-02-04 10:12:00,72,13,Vestuário,3,85
49574,2024-02-04 10:13:00,42,48,Eletrônico,8,90
49575,2024-02-04 10:14:00,22,127,Brinquedo,9,149
49576,2024-02-04 10:15:00,56,95,Móvel,3,151
49577,2024-02-04 10:16:00,43,177,Móvel,4,220
49578,2024-02-04 10:17:00,92,20,Eletrônico,5,112
49579,2024-02-04 10:18:00,90,76,Móvel,1,166
49580,2024-02-04 10:19:00,27,18,Vestuário,5,45
49581,2024-02-04 10:20:00,98,44,Brinquedo,2,142
49582,2024-02-04 10:21:00,71,10,Alimento,9,81
49583,2024-02-04 10:22:00,76,141,Brinquedo,7,217
49584,2024-02-04 10:23:00,111,15,Brinquedo,8,126
49585,2024-02-04 10:24:00,90,117,Móvel,7,207
49586,2024-02-04 10:25:00,107,101,Alimento,2,208
49587,2024-02-04 10:26:00,51,10,Móvel,5,61
49588,2024-02-04 10:27:00,115,149,Brinquedo,5,264
49589,2024-02-04 10:28:00,89,129,Vestuário,6,218
49590,2024-02-04 10:29:00,66,130,Móvel,9,196
49591,2024-02-04 10:30:00,105,59,Eletrônico,2,164
49592,2024-02-04 10:31:00,20,20,Móvel,7,40
49593,2024-02-04 10:32:00,68,65,Vestuário,1,133
49594,2024-02-04 10:33:00,103,35,Eletrônico,4,138
49595,2024-02-04 10:34:00,107,32,Móvel,6,139
49596,2024-02-04 10:35:00,34,145,Vestuário,7,179
49597,2024-02-04 10:36:00,31,38,Vestuário,8,69
49598,2024-02-04 10:37:00,78,175,Vestuário,7,253
49599,2024-02-04 10:38:00,93,170,Móvel,7,263
49600,2024-02-04 10:39:00,14,93,Móvel,2,107
49601,2024-02-04 10:40:00,38,90,Vestuário,4,128
49602,2024-02-04 10:41:00,21,175,Brinquedo,6,196
49603,2024-02-04 10:42:00,90,173,Alimento,2,263
49604,2024-02-04 10:43:00,103,130,Brinquedo,1,233
49605,2024-02-04 10:44:00,45,21,Vestuário,3,66
49606,2024-02-04 10:45:00,99,93,Móvel,4,192
49607,2024-02-04 10:46:00,94,141,Eletrônico,7,235
49608,2024-02-04 10:47:00,48,87,Móvel,4,135
49609,2024-02-04 10:48:00,29,59,Móvel,9,88
49610,2024-02-04 10:49:00,96,12,Eletrônico,5,108
49611,2024-02-04 10:50:00,106,75,Eletrônico,1,181
49612,2024-02-04 10:51:00,68,54,Vestuário,7,122
49613,2024-02-04 10:52:00,58,177,Móvel,2,235
49614,2024-02-04 10:53:00,26,146,Brinquedo,7,172
49615,2024-02-04 10:54:00,51,177,Eletrônico,3,228
49616,2024-02-04 10:55:00,36,23,Brinquedo,5,59
49617,2024-02-04 10:56:00,30,118,Brinquedo,3,148
49618,2024-02-04 10:57:00,59,39,Eletrônico,2,98
49619,2024-02-04 10:58:00,70,29,Brinquedo,7,99
49620,2024-02-04 10:59:00,41,18,Eletrônico,1,59
49621,2024-02-04 11:00:00,12,43,Brinquedo,6,55
49622,2024-02-04 11:01:00,84,138,Vestuário,1,222
49623,2024-02-04 11:02:00,67,150,Móvel,6,217
49624,2024-02-04 11:03:00,59,143,Alimento,7,202
49625,2024-02-04 11:04:00,68,66,Vestuário,9,134
49626,2024-02-04 11:05:00,77,178,Eletrônico,7,255
49627,2024-02-04 11:06:00,88,127,Eletrônico,5,215
49628,2024-02-04 11:07:00,81,157,Alimento,2,238
49629,2024-02-04 11:08:00,49,159,Eletrônico,6,208
49630,2024-02-04 11:09:00,77,33,Móvel,4,110
49631,2024-02-04 11:10:00,49,157,Eletrônico,3,206
49632,2024-02-04 11:11:00,102,73,Brinquedo,5,175
49633,2024-02-04 11:12:00,30,13,Eletrônico,4,43
49634,2024-02-04 11:13:00,34,13,Móvel,9,47
49635,2024-02-04 11:14:00,82,39,Brinquedo,6,121
49636,2024-02-04 11:15:00,43,122,Brinquedo,4,165
49637,2024-02-04 11:16:00,19,28,Eletrônico,4,47
49638,2024-02-04 11:17:00,81,120,Brinquedo,2,201
49639,2024-02-04 11:18:00,55,58,Vestuário,5,113
49640,2024-02-04 11:19:00,104,154,Móvel,6,258
49641,2024-02-04 11:20:00,59,71,Vestuário,4,130
49642,2024-02-04 11:21:00,57,102,Alimento,8,159
49643,2024-02-04 11:22:00,83,113,Eletrônico,3,196
49644,2024-02-04 11:23:00,92,172,Brinquedo,4,264
49645,2024-02-04 11:24:00,29,20,Vestuário,7,49
49646,2024-02-04 11:25:00,20,117,Móvel,9,137
49647,2024-02-04 11:26:00,54,11,Brinquedo,2,65
49648,2024-02-04 11:27:00,44,29,Alimento,3,73
49649,2024-02-04 11:28:00,54,115,Móvel,9,169
49650,2024-02-04 11:29:00,35,24,Vestuário,5,59
49651,2024-02-04 11:30:00,63,145,Brinquedo,4,208
49652,2024-02-04 11:31:00,108,36,Alimento,1,144
49653,2024-02-04 11:32:00,82,78,Brinquedo,5,160
49654,2024-02-04 11:33:00,55,140,Vestuário,5,195
49655,2024-02-04 11:34:00,48,35,Móvel,7,83
49656,2024-02-04 11:35:00,91,131,Vestuário,5,222
49657,2024-02-04 11:36:00,88,140,Eletrônico,3,228
49658,2024-02-04 11:37:00,37,173,Alimento,4,210
49659,2024-02-04 11:38:00,68,66,Móvel,9,134
49660,2024-02-04 11:39:00,76,50,Alimento,4,126
49661,2024-02-04 11:40:00,47,96,Vestuário,4,143
49662,2024-02-04 11:41:00,80,96,Móvel,4,176
49663,2024-02-04 11:42:00,114,49,Alimento,3,163
49664,2024-02-04 11:43:00,93,12,Brinquedo,9,105
49665,2024-02-04 11:44:00,82,154,Brinquedo,4,236
49666,2024-02-04 11:45:00,69,19,Eletrônico,9,88
49667,2024-02-04 11:46:00,44,141,Eletrônico,6,185
49668,2024-02-04 11:47:00,51,147,Eletrônico,5,198
49669,2024-02-04 11:48:00,41,11,Eletrônico,6,52
49670,2024-02-04 11:49:00,101,101,Eletrônico,5,202
49671,2024-02-04 11:50:00,30,103,Alimento,5,133
49672,2024-02-04 11:51:00,29,35,Eletrônico,5,64
49673,2024-02-04 11:52:00,71,63,Eletrônico,1,134
49674,2024-02-04 11:53:00,65,100,Vestuário,7,165
49675,2024-02-04 11:54:00,74,20,Móvel,2,94
49676,2024-02-04 11:55:00,52,45,Brinquedo,1,97
49677,2024-02-04 11:56:00,87,179,Alimento,9,266
49678,2024-02-04 11:57:00,70,73,Alimento,5,143
49679,2024-02-04 11:58:00,84,43,Vestuário,4,127
49680,2024-02-04 11:59:00,38,27,Vestuário,4,65
49681,2024-02-04 12:00:00,62,74,Vestuário,1,136
49682,2024-02-04 12:01:00,64,17,Eletrônico,4,81
49683,2024-02-04 12:02:00,78,105,Alimento,8,183
49684,2024-02-04 12:03:00,94,103,Brinquedo,7,197
49685,2024-02-04 12:04:00,64,12,Alimento,6,76
49686,2024-02-04 12:05:00,10,70,Brinquedo,3,80
49687,2024-02-04 12:06:00,107,45,Vestuário,6,152
49688,2024-02-04 12:07:00,111,159,Móvel,8,270
49689,2024-02-04 12:08:00,95,129,Eletrônico,9,224
49690,2024-02-04 12:09:00,12,121,Eletrônico,2,133
49691,2024-02-04 12:10:00,118,89,Móvel,2,207
49692,2024-02-04 12:11:00,81,96,Móvel,1,177
49693,2024-02-04 12:12:00,87,122,Brinquedo,5,209
49694,2024-02-04 12:13:00,38,98,Eletrônico,6,136
49695,2024-02-04 12:14:00,56,159,Alimento,5,215
49696,2024-02-04 12:15:00,56,141,Eletrônico,8,197
49697,2024-02-04 12:16:00,100,107,Móvel,3,207
49698,2024-02-04 12:17:00,25,120,Vestuário,4,145
49699,2024-02-04 12:18:00,67,128,Brinquedo,9,195
49700,2024-02-04 12:19:00,74,152,Brinquedo,2,226
49701,2024-02-04 12:20:00,117,133,Alimento,1,250
49702,2024-02-04 12:21:00,104,145,Móvel,9,249
49703,2024-02-04 12:22:00,44,95,Alimento,4,139
49704,2024-02-04 12:23:00,97,30,Vestuário,4,127
49705,2024-02-04 12:24:00,90,23,Vestuário,7,113
49706,2024-02-04 12:25:00,39,149,Eletrônico,8,188
49707,2024-02-04 12:26:00,107,70,Vestuário,8,177
49708,2024-02-04 12:27:00,117,164,Móvel,2,281
49709,2024-02-04 12:28:00,22,37,Alimento,1,59
49710,2024-02-04 12:29:00,11,83,Móvel,6,94
49711,2024-02-04 12:30:00,72,105,Brinquedo,5,177
49712,2024-02-04 12:31:00,43,123,Vestuário,6,166
49713,2024-02-04 12:32:00,40,148,Alimento,2,188
49714,2024-02-04 12:33:00,32,157,Brinquedo,1,189
49715,2024-02-04 12:34:00,13,145,Brinquedo,6,158
49716,2024-02-04 12:35:00,71,160,Brinquedo,4,231
49717,2024-02-04 12:36:00,99,82,Vestuário,2,181
49718,2024-02-04 12:37:00,45,14,Móvel,5,59
49719,2024-02-04 12:38:00,48,167,Alimento,6,215
49720,2024-02-04 12:39:00,23,19,Vestuário,7,42
49721,2024-02-04 12:40:00,57,21,Alimento,5,78
49722,2024-02-04 12:41:00,38,174,Eletrônico,7,212
49723,2024-02-04 12:42:00,100,36,Móvel,4,136
49724,2024-02-04 12:43:00,113,113,Alimento,5,226
49725,2024-02-04 12:44:00,95,16,Vestuário,1,111
49726,2024-02-04 12:45:00,32,168,Eletrônico,8,200
49727,2024-02-04 12:46:00,15,125,Alimento,6,140
49728,2024-02-04 12:47:00,20,150,Móvel,1,170
49729,2024-02-04 12:48:00,10,28,Móvel,4,38
49730,2024-02-04 12:49:00,98,133,Móvel,3,231
49731,2024-02-04 12:50:00,47,126,Vestuário,3,173
49732,2024-02-04 12:51:00,116,93,Eletrônico,1,209
49733,2024-02-04 12:52:00,35,95,Alimento,5,130
49734,2024-02-04 12:53:00,78,32,Alimento,7,110
49735,2024-02-04 12:54:00,100,113,Móvel,2,213
49736,2024-02-04 12:55:00,73,118,Vestuário,7,191
49737,2024-02-04 12:56:00,28,97,Vestuário,8,125
49738,2024-02-04 12:57:00,63,153,Móvel,3,216
49739,2024-02-04 12:58:00,64,155,Móvel,8,219
49740,2024-02-04 12:59:00,39,16,Brinquedo,6,55
49741,2024-02-04 13:00:00,55,156,Eletrônico,7,211
49742,2024-02-04 13:01:00,36,63,Móvel,4,99
49743,2024-02-04 13:02:00,53,93,Brinquedo,3,146
49744,2024-02-04 13:03:00,46,93,Brinquedo,2,139
49745,2024-02-04 13:04:00,109,31,Eletrônico,7,140
49746,2024-02-04 13:05:00,44,105,Vestuário,9,149
49747,2024-02-04 13:06:00,66,22,Móvel,3,88
49748,2024-02-04 13:07:00,24,129,Móvel,4,153
49749,2024-02-04 13:08:00,89,165,Brinquedo,9,254
49750,2024-02-04 13:09:00,52,108,Alimento,7,160
49751,2024-02-04 13:10:00,105,128,Móvel,3,233
49752,2024-02-04 13:11:00,19,157,Móvel,2,176
49753,2024-02-04 13:12:00,29,86,Alimento,3,115
49754,2024-02-04 13:13:00,25,26,Brinquedo,5,51
49755,2024-02-04 13:14:00,73,140,Brinquedo,5,213
49756,2024-02-04 13:15:00,118,13,Alimento,3,131
49757,2024-02-04 13:16:00,58,155,Vestuário,8,213
49758,2024-02-04 13:17:00,18,173,Móvel,3,191
49759,2024-02-04 13:18:00,10,15,Alimento,4,25
49760,2024-02-04 13:19:00,68,153,Móvel,7,221
49761,2024-02-04 13:20:00,66,22,Móvel,4,88
49762,2024-02-04 13:21:00,91,15,Eletrônico,3,106
49763,2024-02-04 13:22:00,21,58,Eletrônico,8,79
49764,2024-02-04 13:23:00,67,157,Vestuário,1,224
49765,2024-02-04 13:24:00,54,175,Móvel,8,229
49766,2024-02-04 13:25:00,69,161,Vestuário,9,230
49767,2024-02-04 13:26:00,41,121,Alimento,1,162
49768,2024-02-04 13:27:00,106,97,Alimento,8,203
49769,2024-02-04 13:28:00,11,19,Vestuário,8,30
49770,2024-02-04 13:29:00,21,37,Brinquedo,3,58
49771,2024-02-04 13:30:00,70,72,Brinquedo,1,142
49772,2024-02-04 13:31:00,46,172,Alimento,9,218
49773,2024-02-04 13:32:00,85,109,Vestuário,4,194
49774,2024-02-04 13:33:00,43,145,Alimento,9,188
49775,2024-02-04 13:34:00,93,46,Eletrônico,3,139
49776,2024-02-04 13:35:00,98,15,Móvel,8,113
49777,2024-02-04 13:36:00,15,51,Eletrônico,6,66
49778,2024-02-04 13:37:00,41,165,Alimento,8,206
49779,2024-02-04 13:38:00,76,135,Brinquedo,9,211
49780,2024-02-04 13:39:00,29,132,Eletrônico,8,161
49781,2024-02-04 13:40:00,50,129,Alimento,7,179
49782,2024-02-04 13:41:00,33,49,Vestuário,6,82
49783,2024-02-04 13:42:00,62,46,Vestuário,2,108
49784,2024-02-04 13:43:00,109,24,Eletrônico,7,133
49785,2024-02-04 13:44:00,78,38,Móvel,8,116
49786,2024-02-04 13:45:00,13,70,Vestuário,2,83
49787,2024-02-04 13:46:00,66,32,Eletrônico,6,98
49788,2024-02-04 13:47:00,75,32,Brinquedo,7,107
49789,2024-02-04 13:48:00,109,44,Vestuário,3,153
49790,2024-02-04 13:49:00,47,26,Brinquedo,7,73
49791,2024-02-04 13:50:00,44,26,Brinquedo,8,70
49792,2024-02-04 13:51:00,112,112,Vestuário,4,224
49793,2024-02-04 13:52:00,106,155,Eletrônico,9,261
49794,2024-02-04 13:53:00,44,138,Eletrônico,4,182
49795,2024-02-04 13:54:00,10,105,Eletrônico,6,115
49796,2024-02-04 13:55:00,110,24,Brinquedo,1,134
49797,2024-02-04 13:56:00,47,36,Vestuário,6,83
49798,2024-02-04 13:57:00,89,100,Eletrônico,9,189
49799,2024-02-04 13:58:00,13,51,Alimento,5,64
49800,2024-02-04 13:59:00,111,102,Móvel,1,213
49801,2024-02-04 14:00:00,70,34,Alimento,7,104
49802,2024-02-04 14:01:00,57,31,Alimento,8,88
49803,2024-02-04 14:02:00,11,86,Eletrônico,9,97
49804,2024-02-04 14:03:00,40,129,Eletrônico,4,169
49805,2024-02-04 14:04:00,115,23,Eletrônico,1,138
49806,2024-02-04 14:05:00,21,93,Alimento,2,114
49807,2024-02-04 14:06:00,115,133,Vestuário,2,248
49808,2024-02-04 14:07:00,76,128,Alimento,7,204
49809,2024-02-04 14:08:00,111,84,Móvel,2,195
49810,2024-02-04 14:09:00,46,61,Brinquedo,2,107
49811,2024-02-04 14:10:00,34,104,Brinquedo,7,138
49812,2024-02-04 14:11:00,113,63,Móvel,4,176
49813,2024-02-04 14:12:00,80,67,Brinquedo,3,147
49814,2024-02-04 14:13:00,10,72,Brinquedo,4,82
49815,2024-02-04 14:14:00,40,96,Brinquedo,8,136
49816,2024-02-04 14:15:00,10,99,Móvel,3,109
49817,2024-02-04 14:16:00,110,146,Vestuário,6,256
49818,2024-02-04 14:17:00,42,94,Eletrônico,6,136
49819,2024-02-04 14:18:00,14,57,Alimento,3,71
49820,2024-02-04 14:19:00,35,50,Móvel,9,85
49821,2024-02-04 14:20:00,110,147,Eletrônico,4,257
49822,2024-02-04 14:21:00,64,103,Eletrônico,8,167
49823,2024-02-04 14:22:00,96,122,Alimento,7,218
49824,2024-02-04 14:23:00,102,14,Eletrônico,2,116
49825,2024-02-04 14:24:00,46,108,Alimento,9,154
49826,2024-02-04 14:25:00,77,101,Alimento,9,178
49827,2024-02-04 14:26:00,53,45,Alimento,7,98
49828,2024-02-04 14:27:00,35,53,Brinquedo,4,88
49829,2024-02-04 14:28:00,12,149,Brinquedo,3,161
49830,2024-02-04 14:29:00,66,17,Brinquedo,3,83
49831,2024-02-04 14:30:00,70,27,Eletrônico,9,97
49832,2024-02-04 14:31:00,116,137,Eletrônico,5,253
49833,2024-02-04 14:32:00,108,77,Vestuário,5,185
49834,2024-02-04 14:33:00,88,168,Alimento,5,256
49835,2024-02-04 14:34:00,38,126,Eletrônico,8,164
49836,2024-02-04 14:35:00,76,87,Móvel,3,163
49837,2024-02-04 14:36:00,103,120,Brinquedo,9,223
49838,2024-02-04 14:37:00,65,86,Alimento,5,151
49839,2024-02-04 14:38:00,73,113,Vestuário,8,186
49840,2024-02-04 14:39:00,114,155,Alimento,9,269
49841,2024-02-04 14:40:00,22,44,Eletrônico,9,66
49842,2024-02-04 14:41:00,115,143,Alimento,3,258
49843,2024-02-04 14:42:00,29,97,Móvel,1,126
49844,2024-02-04 14:43:00,76,21,Alimento,8,97
49845,2024-02-04 14:44:00,113,88,Móvel,1,201
49846,2024-02-04 14:45:00,12,84,Eletrônico,5,96
49847,2024-02-04 14:46:00,82,146,Eletrônico,5,228
49848,2024-02-04 14:47:00,55,147,Brinquedo,3,202
49849,2024-02-04 14:48:00,51,10,Móvel,2,61
49850,2024-02-04 14:49:00,105,147,Vestuário,7,252
49851,2024-02-04 14:50:00,52,44,Vestuário,3,96
49852,2024-02-04 14:51:00,30,40,Alimento,1,70
49853,2024-02-04 14:52:00,110,40,Brinquedo,5,150
49854,2024-02-04 14:53:00,56,89,Móvel,8,145
49855,2024-02-04 14:54:00,83,175,Eletrônico,4,258
49856,2024-02-04 14:55:00,78,45,Móvel,6,123
49857,2024-02-04 14:56:00,32,44,Móvel,7,76
49858,2024-02-04 14:57:00,48,168,Brinquedo,7,216
49859,2024-02-04 14:58:00,35,93,Móvel,9,128
49860,2024-02-04 14:59:00,86,30,Brinquedo,6,116
49861,2024-02-04 15:00:00,89,118,Vestuário,7,207
49862,2024-02-04 15:01:00,59,164,Móvel,8,223
49863,2024-02-04 15:02:00,58,63,Brinquedo,1,121
49864,2024-02-04 15:03:00,90,79,Móvel,9,169
49865,2024-02-04 15:04:00,56,52,Móvel,6,108
49866,2024-02-04 15:05:00,19,157,Vestuário,3,176
49867,2024-02-04 15:06:00,29,106,Alimento,5,135
49868,2024-02-04 15:07:00,78,13,Eletrônico,8,91
49869,2024-02-04 15:08:00,85,98,Eletrônico,2,183
49870,2024-02-04 15:09:00,43,113,Alimento,7,156
49871,2024-02-04 15:10:00,47,124,Vestuário,9,171
49872,2024-02-04 15:11:00,16,145,Móvel,1,161
49873,2024-02-04 15:12:00,55,38,Móvel,8,93
49874,2024-02-04 15:13:00,68,65,Vestuário,6,133
49875,2024-02-04 15:14:00,62,109,Alimento,2,171
49876,2024-02-04 15:15:00,34,77,Vestuário,9,111
49877,2024-02-04 15:16:00,68,36,Vestuário,7,104
49878,2024-02-04 15:17:00,113,150,Vestuário,8,263
49879,2024-02-04 15:18:00,48,62,Brinquedo,8,110
49880,2024-02-04 15:19:00,65,49,Alimento,7,114
49881,2024-02-04 15:20:00,82,83,Vestuário,2,165
49882,2024-02-04 15:21:00,73,111,Brinquedo,4,184
49883,2024-02-04 15:22:00,89,136,Vestuário,4,225
49884,2024-02-04 15:23:00,80,170,Vestuário,2,250
49885,2024-02-04 15:24:00,100,116,Móvel,5,216
49886,2024-02-04 15:25:00,11,43,Móvel,4,54
49887,2024-02-04 15:26:00,72,178,Alimento,1,250
49888,2024-02-04 15:27:00,98,13,Móvel,7,111
49889,2024-02-04 15:28:00,66,143,Móvel,5,209
49890,2024-02-04 15:29:00,61,53,Alimento,8,114
49891,2024-02-04 15:30:00,54,91,Móvel,9,145
49892,2024-02-04 15:31:00,61,125,Vestuário,3,186
49893,2024-02-04 15:32:00,61,75,Vestuário,7,136
49894,2024-02-04 15:33:00,51,27,Móvel,6,78
49895,2024-02-04 15:34:00,48,80,Vestuário,9,128
49896,2024-02-04 15:35:00,23,20,Brinquedo,4,43
49897,2024-02-04 15:36:00,49,31,Eletrônico,7,80
49898,2024-02-04 15:37:00,26,120,Alimento,8,146
49899,2024-02-04 15:38:00,114,68,Eletrônico,3,182
49900,2024-02-04 15:39:00,11,143,Eletrônico,3,154
49901,2024-02-04 15:40:00,55,92,Eletrônico,3,147
49902,2024-02-04 15:41:00,79,19,Alimento,5,98
49903,2024-02-04 15:42:00,119,59,Móvel,3,178
49904,2024-02-04 15:43:00,31,164,Brinquedo,4,195
49905,2024-02-04 15:44:00,51,61,Móvel,4,112
49906,2024-02-04 15:45:00,92,90,Alimento,5,182
49907,2024-02-04 15:46:00,115,91,Eletrônico,9,206
49908,2024-02-04 15:47:00,68,60,Vestuário,2,128
49909,2024-02-04 15:48:00,16,164,Brinquedo,9,180
49910,2024-02-04 15:49:00,67,135,Móvel,5,202
49911,2024-02-04 15:50:00,24,163,Brinquedo,4,187
49912,2024-02-04 15:51:00,75,119,Brinquedo,9,194
49913,2024-02-04 15:52:00,83,96,Eletrônico,9,179
49914,2024-02-04 15:53:00,112,169,Vestuário,9,281
49915,2024-02-04 15:54:00,108,32,Alimento,5,140
49916,2024-02-04 15:55:00,83,147,Brinquedo,8,230
49917,2024-02-04 15:56:00,113,165,Móvel,7,278
49918,2024-02-04 15:57:00,11,75,Brinquedo,9,86
49919,2024-02-04 15:58:00,76,142,Alimento,2,218
49920,2024-02-04 15:59:00,30,46,Alimento,6,76
49921,2024-02-04 16:00:00,111,54,Eletrônico,4,165
49922,2024-02-04 16:01:00,29,74,Alimento,5,103
49923,2024-02-04 16:02:00,32,16,Brinquedo,5,48
49924,2024-02-04 16:03:00,27,151,Alimento,1,178
49925,2024-02-04 16:04:00,97,165,Eletrônico,7,262
49926,2024-02-04 16:05:00,77,22,Brinquedo,5,99
49927,2024-02-04 16:06:00,25,115,Alimento,8,140
49928,2024-02-04 16:07:00,119,97,Vestuário,7,216
49929,2024-02-04 16:08:00,82,58,Brinquedo,5,140
49930,2024-02-04 16:09:00,94,43,Brinquedo,1,137
49931,2024-02-04 16:10:00,59,113,Eletrônico,3,172
49932,2024-02-04 16:11:00,56,81,Eletrônico,6,137
49933,2024-02-04 16:12:00,72,71,Eletrônico,6,143
49934,2024-02-04 16:13:00,25,171,Alimento,9,196
49935,2024-02-04 16:14:00,112,64,Móvel,2,176
49936,2024-02-04 16:15:00,60,23,Móvel,2,83
49937,2024-02-04 16:16:00,25,138,Eletrônico,7,163
49938,2024-02-04 16:17:00,43,108,Móvel,6,151
49939,2024-02-04 16:18:00,63,165,Eletrônico,5,228
49940,2024-02-04 16:19:00,32,41,Brinquedo,7,73
49941,2024-02-04 16:20:00,58,144,Móvel,2,202
49942,2024-02-04 16:21:00,46,95,Brinquedo,9,141
49943,2024-02-04 16:22:00,62,157,Móvel,5,219
49944,2024-02-04 16:23:00,55,16,Móvel,5,71
49945,2024-02-04 16:24:00,51,123,Alimento,8,174
49946,2024-02-04 16:25:00,19,93,Vestuário,7,112
49947,2024-02-04 16:26:00,29,147,Vestuário,7,176
49948,2024-02-04 16:27:00,98,178,Eletrônico,7,276
49949,2024-02-04 16:28:00,91,161,Brinquedo,3,252
49950,2024-02-04 16:29:00,62,133,Alimento,7,195
49951,2024-02-04 16:30:00,17,148,Móvel,1,165
49952,2024-02-04 16:31:00,107,169,Brinquedo,5,276
49953,2024-02-04 16:32:00,19,73,Móvel,7,92
49954,2024-02-04 16:33:00,93,85,Móvel,8,178
49955,2024-02-04 16:34:00,74,91,Alimento,8,165
49956,2024-02-04 16:35:00,19,33,Brinquedo,4,52
49957,2024-02-04 16:36:00,119,60,Eletrônico,7,179
49958,2024-02-04 16:37:00,24,22,Vestuário,9,46
49959,2024-02-04 16:38:00,10,29,Brinquedo,3,39
49960,2024-02-04 16:39:00,42,119,Alimento,5,161
49961,2024-02-04 16:40:00,86,73,Eletrônico,7,159
49962,2024-02-04 16:41:00,23,24,Vestuário,5,47
49963,2024-02-04 16:42:00,100,75,Móvel,3,175
49964,2024-02-04 16:43:00,54,50,Eletrônico,8,104
49965,2024-02-04 16:44:00,74,55,Vestuário,9,129
49966,2024-02-04 16:45:00,59,64,Móvel,7,123
49967,2024-02-04 16:46:00,16,124,Brinquedo,4,140
49968,2024-02-04 16:47:00,43,148,Alimento,1,191
49969,2024-02-04 16:48:00,53,85,Móvel,5,138
49970,2024-02-04 16:49:00,10,110,Alimento,3,120
49971,2024-02-04 16:50:00,19,46,Brinquedo,9,65
49972,2024-02-04 16:51:00,31,23,Brinquedo,9,54
49973,2024-02-04 16:52:00,23,34,Brinquedo,7,57
49974,2024-02-04 16:53:00,57,136,Móvel,8,193
49975,2024-02-04 16:54:00,30,81,Eletrônico,2,111
49976,2024-02-04 16:55:00,30,86,Móvel,7,116
49977,2024-02-04 16:56:00,21,24,Alimento,4,45
49978,2024-02-04 16:57:00,77,86,Móvel,9,163
49979,2024-02-04 16:58:00,46,153,Brinquedo,3,199
49980,2024-02-04 16:59:00,99,179,Alimento,1,278
49981,2024-02-04 17:00:00,74,150,Brinquedo,8,224
49982,2024-02-04 17:01:00,113,36,Alimento,5,149
49983,2024-02-04 17:02:00,69,30,Eletrônico,5,99
49984,2024-02-04 17:03:00,20,88,Vestuário,6,108
49985,2024-02-04 17:04:00,66,100,Eletrônico,7,166
49986,2024-02-04 17:05:00,117,123,Alimento,2,240
49987,2024-02-04 17:06:00,53,47,Eletrônico,1,100
49988,2024-02-04 17:07:00,84,65,Móvel,6,149
49989,2024-02-04 17:08:00,104,122,Eletrônico,2,226
49990,2024-02-04 17:09:00,97,42,Brinquedo,6,139
49991,2024-02-04 17:10:00,64,101,Brinquedo,6,165
49992,2024-02-04 17:11:00,16,133,Vestuário,6,149
49993,2024-02-04 17:12:00,95,93,Eletrônico,5,188
49994,2024-02-04 17:13:00,91,16,Eletrônico,8,107
49995,2024-02-04 17:14:00,108,63,Brinquedo,1,171
49996,2024-02-04 17:15:00,40,100,Eletrônico,2,140
49997,2024-02-04 17:16:00,52,106,Eletrônico,5,158
49998,2024-02-04 17:17:00,112,76,Alimento,4,188
49999,2024-02-04 17:18:00,56,138,Vestuário,7,194
50000,2024-02-04 17:19:00,15,53,Brinquedo,1,68
